"Date","Season","home","visitor","FT","hgoal","vgoal","division","tier","totgoal","goaldif","result"
1933-07-01,1932,"CA Paris (alt)","AS Cannes","5-1",5,1,"1",1,6,4,"H"
1933-07-01,1932,"SC Fives Lille","FC Sete","4-2",4,2,"1",1,6,2,"H"
1933-07-01,1932,"Olympique Marseille","OGC Nice","4-0",4,0,"1",1,4,4,"H"
1933-07-01,1932,"SC Nimes","Olympique Lillois Lille","3-3",3,3,"1",1,6,0,"D"
1933-07-01,1932,"FC Antibes","Stade Rennes","1-1",1,1,"1",1,2,0,"D"
1933-07-01,1932,"Stade Olympique Montpellierain","Racing Club de France","1-0",1,0,"1",1,1,1,"H"
1933-07-01,1932,"Excelsior Roubaix","FC Sochaux","2-1",2,1,"1",1,3,1,"H"
1933-07-01,1932,"FC Sete","CA Paris (alt)","6-2",6,2,"1",1,8,4,"H"
1933-07-01,1932,"OGC Nice","Excelsior Roubaix","3-3",3,3,"1",1,6,0,"D"
1933-07-01,1932,"Racing Club de France","Olympique Lillois Lille","1-0",1,0,"1",1,1,1,"H"
1933-07-01,1932,"AS Cannes","Olympique Marseille","1-1",1,1,"1",1,2,0,"D"
1933-07-01,1932,"SC Fives Lille","SC Nimes","5-2",5,2,"1",1,7,3,"H"
1933-07-01,1932,"Stade Rennes","Stade Olympique Montpellierain","2-6",2,6,"1",1,8,-4,"D"
1933-07-01,1932,"FC Sochaux","FC Antibes","6-4",6,4,"1",1,10,2,"H"
1933-07-01,1932,"FC Antibes","OGC Nice","3-2",3,2,"1",1,5,1,"H"
1933-07-01,1932,"Stade Olympique Montpellierain","FC Sochaux","3-2",3,2,"1",1,5,1,"H"
1933-07-01,1932,"Olympique Marseille","FC Sete","3-3",3,3,"1",1,6,0,"D"
1933-07-01,1932,"Olympique Lillois Lille","Stade Rennes","5-4",5,4,"1",1,9,1,"H"
1933-07-01,1932,"Excelsior Roubaix","AS Cannes","3-1",3,1,"1",1,4,2,"H"
1933-07-01,1932,"SC Nimes","Racing Club de France","3-1",3,1,"1",1,4,2,"H"
1933-07-01,1932,"CA Paris (alt)","SC Fives Lille","0-1",0,1,"1",1,1,-1,"D"
1933-07-01,1932,"FC Sete","Excelsior Roubaix","4-2",4,2,"1",1,6,2,"H"
1933-07-01,1932,"AS Cannes","FC Antibes","1-0",1,0,"1",1,1,1,"H"
1933-07-01,1932,"Stade Rennes","Racing Club de France","2-1",2,1,"1",1,3,1,"H"
1933-07-01,1932,"CA Paris (alt)","SC Nimes","7-0",7,0,"1",1,7,7,"H"
1933-07-01,1932,"SC Fives Lille","Olympique Marseille","2-3",2,3,"1",1,5,-1,"D"
1933-07-01,1932,"FC Sochaux","Olympique Lillois Lille","3-5",3,5,"1",1,8,-2,"D"
1933-07-01,1932,"OGC Nice","Stade Olympique Montpellierain","1-1",1,1,"1",1,2,0,"D"
1933-07-01,1932,"OGC Nice","CA Paris (alt)","5-2",5,2,"1",1,7,3,"H"
1933-07-01,1932,"Stade Rennes","Excelsior Roubaix","5-2",5,2,"1",1,7,3,"H"
1933-07-01,1932,"Racing Club de France","FC Antibes","5-2",5,2,"1",1,7,3,"H"
1933-07-01,1932,"FC Sochaux","Olympique Marseille","4-1",4,1,"1",1,5,3,"H"
1933-07-01,1932,"AS Cannes","SC Fives Lille","0-0",0,0,"1",1,0,0,"D"
1933-07-01,1932,"FC Sete","SC Nimes","8-2",8,2,"1",1,10,6,"H"
1933-07-01,1932,"Olympique Lillois Lille","Stade Olympique Montpellierain","6-2",6,2,"1",1,8,4,"H"
1933-07-01,1932,"FC Sete","AS Cannes","4-0",4,0,"1",1,4,4,"H"
1933-07-01,1932,"CA Paris (alt)","FC Sochaux","4-6",4,6,"1",1,10,-2,"D"
1933-07-01,1932,"FC Antibes","Olympique Lillois Lille","3-1",3,1,"1",1,4,2,"H"
1933-07-01,1932,"Excelsior Roubaix","Racing Club de France","3-6",3,6,"1",1,9,-3,"D"
1933-07-01,1932,"Olympique Marseille","Stade Rennes","7-1",7,1,"1",1,8,6,"H"
1933-07-01,1932,"SC Nimes","Stade Olympique Montpellierain","2-0",2,0,"1",1,2,2,"H"
1933-07-01,1932,"SC Fives Lille","OGC Nice","5-2",5,2,"1",1,7,3,"H"
1933-07-01,1932,"OGC Nice","FC Sete","1-4",1,4,"1",1,5,-3,"D"
1933-07-01,1932,"Stade Rennes","CA Paris (alt)","8-2",8,2,"1",1,10,6,"H"
1933-07-01,1932,"Olympique Lillois Lille","Excelsior Roubaix","4-2",4,2,"1",1,6,2,"H"
1933-07-01,1932,"Stade Olympique Montpellierain","FC Antibes","3-2",3,2,"1",1,5,1,"H"
1933-07-01,1932,"AS Cannes","SC Nimes","1-1",1,1,"1",1,2,0,"D"
1933-07-01,1932,"Racing Club de France","Olympique Marseille","0-1",0,1,"1",1,1,-1,"D"
1933-07-01,1932,"FC Sochaux","SC Fives Lille","1-3",1,3,"1",1,4,-2,"D"
1933-07-01,1932,"FC Sete","FC Sochaux","3-1",3,1,"1",1,4,2,"H"
1933-07-01,1932,"SC Nimes","FC Antibes","5-0",5,0,"1",1,5,5,"H"
1933-07-01,1932,"AS Cannes","OGC Nice","2-2",2,2,"1",1,4,0,"D"
1933-07-01,1932,"CA Paris (alt)","Racing Club de France","1-4",1,4,"1",1,5,-3,"D"
1933-07-01,1932,"Excelsior Roubaix","Stade Olympique Montpellierain","3-2",3,2,"1",1,5,1,"H"
1933-07-01,1932,"Olympique Marseille","Olympique Lillois Lille","1-3",1,3,"1",1,4,-2,"D"
1933-07-01,1932,"SC Fives Lille","Stade Rennes","5-0",5,0,"1",1,5,5,"H"
1933-07-01,1932,"OGC Nice","SC Nimes","1-2",1,2,"1",1,3,-1,"D"
1933-07-01,1932,"FC Sochaux","AS Cannes","3-3",3,3,"1",1,6,0,"D"
1933-07-01,1932,"Olympique Lillois Lille","CA Paris (alt)","4-1",4,1,"1",1,5,3,"H"
1933-07-01,1932,"Stade Rennes","FC Sete","4-4",4,4,"1",1,8,0,"D"
1933-07-01,1932,"Racing Club de France","SC Fives Lille","1-0",1,0,"1",1,1,1,"H"
1933-07-01,1932,"Stade Olympique Montpellierain","Olympique Marseille","3-3",3,3,"1",1,6,0,"D"
1933-07-01,1932,"FC Antibes","Excelsior Roubaix","2-1",2,1,"1",1,3,1,"H"
1933-07-01,1932,"SC Nimes","Excelsior Roubaix","3-0",3,0,"1",1,3,3,"H"
1933-07-01,1932,"Olympique Marseille","FC Antibes","3-2",3,2,"1",1,5,1,"H"
1933-07-01,1932,"SC Fives Lille","Olympique Lillois Lille","3-0",3,0,"1",1,3,3,"H"
1933-07-01,1932,"AS Cannes","Stade Rennes","0-2",0,2,"1",1,2,-2,"D"
1933-07-01,1932,"FC Sete","Racing Club de France","2-1",2,1,"1",1,3,1,"H"
1933-07-01,1932,"OGC Nice","FC Sochaux","2-1",2,1,"1",1,3,1,"H"
1933-07-01,1932,"CA Paris (alt)","Stade Olympique Montpellierain","1-4",1,4,"1",1,5,-3,"D"
1933-07-01,1932,"Racing Club de France","AS Cannes","5-1",5,1,"1",1,6,4,"H"
1933-07-01,1932,"Olympique Lillois Lille","FC Sete","6-0",6,0,"1",1,6,6,"H"
1933-07-01,1932,"Stade Olympique Montpellierain","SC Fives Lille","4-1",4,1,"1",1,5,3,"H"
1933-07-01,1932,"FC Sochaux","SC Nimes","6-3",6,3,"1",1,9,3,"H"
1933-07-01,1932,"Excelsior Roubaix","Olympique Marseille","4-3",4,3,"1",1,7,1,"H"
1933-07-01,1932,"Stade Rennes","OGC Nice","2-1",2,1,"1",1,3,1,"H"
1933-07-01,1932,"FC Antibes","CA Paris (alt)","3-1",3,1,"1",1,4,2,"H"
1933-07-01,1932,"CA Paris (alt)","Excelsior Roubaix","3-6",3,6,"1",1,9,-3,"D"
1933-07-01,1932,"AS Cannes","Olympique Lillois Lille","2-0",2,0,"1",1,2,2,"H"
1933-07-01,1932,"SC Nimes","Olympique Marseille","0-2",0,2,"1",1,2,-2,"D"
1933-07-01,1932,"OGC Nice","Racing Club de France","2-0",2,0,"1",1,2,2,"H"
1933-07-01,1932,"FC Sochaux","Stade Rennes","6-2",6,2,"1",1,8,4,"H"
1933-07-01,1932,"SC Fives Lille","FC Antibes","0-0",0,0,"1",1,0,0,"D"
1933-07-01,1932,"FC Sete","Stade Olympique Montpellierain","1-1",1,1,"1",1,2,0,"D"
1933-07-01,1932,"Stade Olympique Montpellierain","AS Cannes","0-0",0,0,"1",1,0,0,"D"
1933-07-01,1932,"FC Antibes","FC Sete","3-0",3,0,"1",1,3,3,"H"
1933-07-01,1932,"Olympique Marseille","CA Paris (alt)","3-1",3,1,"1",1,4,2,"H"
1933-07-01,1932,"Stade Rennes","SC Nimes","6-2",6,2,"1",1,8,4,"H"
1933-07-01,1932,"Olympique Lillois Lille","OGC Nice","3-0",3,0,"1",1,3,3,"H"
1933-07-01,1932,"Racing Club de France","FC Sochaux","0-2",0,2,"1",1,2,-2,"D"
1933-07-01,1932,"Excelsior Roubaix","SC Fives Lille","1-1",1,1,"1",1,2,0,"D"
1933-07-01,1932,"AS Cannes","CA Paris (alt)","3-1",3,1,"1",1,4,2,"H"
1933-07-01,1932,"Stade Rennes","FC Antibes","2-2",2,2,"1",1,4,0,"D"
1933-07-01,1932,"OGC Nice","Olympique Marseille","0-3",0,3,"1",1,3,-3,"D"
1933-07-01,1932,"FC Sete","SC Fives Lille","2-2",2,2,"1",1,4,0,"D"
1933-07-01,1932,"Olympique Lillois Lille","SC Nimes","3-1",3,1,"1",1,4,2,"H"
1933-07-01,1932,"Racing Club de France","Stade Olympique Montpellierain","3-0",3,0,"1",1,3,3,"H"
1933-07-01,1932,"FC Sochaux","Excelsior Roubaix","1-2",1,2,"1",1,3,-1,"D"
1933-07-01,1932,"FC Antibes","FC Sochaux","3-1",3,1,"1",1,4,2,"H"
1933-07-01,1932,"CA Paris (alt)","FC Sete","2-3",2,3,"1",1,5,-1,"D"
1933-07-01,1932,"Olympique Lillois Lille","Racing Club de France","0-0",0,0,"1",1,0,0,"D"
1933-07-01,1932,"Stade Olympique Montpellierain","Stade Rennes","1-2",1,2,"1",1,3,-1,"D"
1933-07-01,1932,"Olympique Marseille","AS Cannes","4-0",4,0,"1",1,4,4,"H"
1933-07-01,1932,"SC Nimes","SC Fives Lille","3-4",3,4,"1",1,7,-1,"D"
1933-07-01,1932,"Excelsior Roubaix","OGC Nice","3-1",3,1,"1",1,4,2,"H"
1933-07-01,1932,"AS Cannes","Excelsior Roubaix","1-0",1,0,"1",1,1,1,"H"
1933-07-01,1932,"SC Fives Lille","CA Paris (alt)","2-0",2,0,"1",1,2,2,"H"
1933-07-01,1932,"Stade Rennes","Olympique Lillois Lille","1-5",1,5,"1",1,6,-4,"D"
1933-07-01,1932,"FC Sochaux","Stade Olympique Montpellierain","0-0",0,0,"1",1,0,0,"D"
1933-07-01,1932,"OGC Nice","FC Antibes","1-1",1,1,"1",1,2,0,"D"
1933-07-01,1932,"FC Sete","Olympique Marseille","1-0",1,0,"1",1,1,1,"H"
1933-07-01,1932,"Racing Club de France","SC Nimes","1-1",1,1,"1",1,2,0,"D"
1933-07-01,1932,"SC Nimes","CA Paris (alt)","5-1",5,1,"1",1,6,4,"H"
1933-07-01,1932,"Olympique Lillois Lille","FC Sochaux","2-2",2,2,"1",1,4,0,"D"
1933-07-01,1932,"Racing Club de France","Stade Rennes","2-3",2,3,"1",1,5,-1,"D"
1933-07-01,1932,"Stade Olympique Montpellierain","OGC Nice","3-1",3,1,"1",1,4,2,"H"
1933-07-01,1932,"Olympique Marseille","SC Fives Lille","2-1",2,1,"1",1,3,1,"H"
1933-07-01,1932,"FC Antibes","AS Cannes","4-1",4,1,"1",1,5,3,"H"
1933-07-01,1932,"Excelsior Roubaix","FC Sete","3-3",3,3,"1",1,6,0,"D"
1933-07-01,1932,"SC Fives Lille","AS Cannes","1-2",1,2,"1",1,3,-1,"D"
1933-07-01,1932,"SC Nimes","FC Sete","0-2",0,2,"1",1,2,-2,"D"
1933-07-01,1932,"FC Antibes","Racing Club de France","1-0",1,0,"1",1,1,1,"H"
1933-07-01,1932,"Stade Olympique Montpellierain","Olympique Lillois Lille","2-1",2,1,"1",1,3,1,"H"
1933-07-01,1932,"Excelsior Roubaix","Stade Rennes","4-2",4,2,"1",1,6,2,"H"
1933-07-01,1932,"CA Paris (alt)","OGC Nice","6-1",6,1,"1",1,7,5,"H"
1933-07-01,1932,"Olympique Marseille","FC Sochaux","4-0",4,0,"1",1,4,4,"H"
1933-07-01,1932,"FC Sochaux","CA Paris (alt)","2-3",2,3,"1",1,5,-1,"D"
1933-07-01,1932,"AS Cannes","FC Sete","4-1",4,1,"1",1,5,3,"H"
1933-07-01,1932,"Stade Olympique Montpellierain","SC Nimes","2-4",2,4,"1",1,6,-2,"D"
1933-07-01,1932,"Racing Club de France","Excelsior Roubaix","3-3",3,3,"1",1,6,0,"D"
1933-07-01,1932,"Olympique Lillois Lille","FC Antibes","4-0",4,0,"1",1,4,4,"H"
1933-07-01,1932,"Stade Rennes","Olympique Marseille","1-0",1,0,"1",1,1,1,"H"
1933-07-01,1932,"OGC Nice","SC Fives Lille","0-0",0,0,"1",1,0,0,"D"
1933-07-01,1932,"SC Nimes","AS Cannes","4-1",4,1,"1",1,5,3,"H"
1933-07-01,1932,"SC Fives Lille","FC Sochaux","3-0",3,0,"1",1,3,3,"H"
1933-07-01,1932,"Excelsior Roubaix","Olympique Lillois Lille","2-0",2,0,"1",1,2,2,"H"
1933-07-01,1932,"Olympique Marseille","Racing Club de France","4-1",4,1,"1",1,5,3,"H"
1933-07-01,1932,"FC Sete","OGC Nice","4-0",4,0,"1",1,4,4,"H"
1933-07-01,1932,"FC Antibes","Stade Olympique Montpellierain","3-3",3,3,"1",1,6,0,"D"
1933-07-01,1932,"CA Paris (alt)","Stade Rennes","3-6",3,6,"1",1,9,-3,"D"
1933-07-01,1932,"OGC Nice","AS Cannes","3-1",3,1,"1",1,4,2,"H"
1933-07-01,1932,"FC Sochaux","FC Sete","3-2",3,2,"1",1,5,1,"H"
1933-07-01,1932,"FC Antibes","SC Nimes","4-2",4,2,"1",1,6,2,"H"
1933-07-01,1932,"Olympique Lillois Lille","Olympique Marseille","6-1",6,1,"1",1,7,5,"H"
1933-07-01,1932,"Racing Club de France","CA Paris (alt)","4-1",4,1,"1",1,5,3,"H"
1933-07-01,1932,"Stade Olympique Montpellierain","Excelsior Roubaix","2-6",2,6,"1",1,8,-4,"D"
1933-07-01,1932,"Stade Rennes","SC Fives Lille","1-0",1,0,"1",1,1,1,"H"
1933-07-01,1932,"Excelsior Roubaix","FC Antibes","2-3",2,3,"1",1,5,-1,"D"
1933-07-01,1932,"AS Cannes","FC Sochaux","4-0",4,0,"1",1,4,4,"H"
1933-07-01,1932,"CA Paris (alt)","Olympique Lillois Lille","0-3",0,3,"1",1,3,-3,"D"
1933-07-01,1932,"FC Sete","Stade Rennes","3-1",3,1,"1",1,4,2,"H"
1933-07-01,1932,"Olympique Marseille","Stade Olympique Montpellierain","3-1",3,1,"1",1,4,2,"H"
1933-07-01,1932,"SC Nimes","OGC Nice","5-2",5,2,"1",1,7,3,"H"
1933-07-01,1932,"SC Fives Lille","Racing Club de France","3-3",3,3,"1",1,6,0,"D"
1933-07-01,1932,"Stade Rennes","AS Cannes","2-2",2,2,"1",1,4,0,"D"
1933-07-01,1932,"FC Antibes","Olympique Marseille","1-3",1,3,"1",1,4,-2,"D"
1933-07-01,1932,"Stade Olympique Montpellierain","CA Paris (alt)","3-2",3,2,"1",1,5,1,"H"
1933-07-01,1932,"FC Sochaux","OGC Nice","3-1",3,1,"1",1,4,2,"H"
1933-07-01,1932,"Racing Club de France","FC Sete","1-1",1,1,"1",1,2,0,"D"
1933-07-01,1932,"Olympique Lillois Lille","SC Fives Lille","1-1",1,1,"1",1,2,0,"D"
1933-07-01,1932,"Excelsior Roubaix","SC Nimes","1-0",1,0,"1",1,1,1,"H"
1933-07-01,1932,"CA Paris (alt)","FC Antibes","1-3",1,3,"1",1,4,-2,"D"
1933-07-01,1932,"FC Sete","Olympique Lillois Lille","1-0",1,0,"1",1,1,1,"H"
1933-07-01,1932,"AS Cannes","Racing Club de France","6-2",6,2,"1",1,8,4,"H"
1933-07-01,1932,"Olympique Marseille","Excelsior Roubaix","2-4",2,4,"1",1,6,-2,"D"
1933-07-01,1932,"SC Nimes","FC Sochaux","7-1",7,1,"1",1,8,6,"H"
1933-07-01,1932,"OGC Nice","Stade Rennes","4-2",4,2,"1",1,6,2,"H"
1933-07-01,1932,"SC Fives Lille","Stade Olympique Montpellierain","2-1",2,1,"1",1,3,1,"H"
1933-07-01,1932,"Excelsior Roubaix","CA Paris (alt)","3-2",3,2,"1",1,5,1,"H"
1933-07-01,1932,"Olympique Lillois Lille","AS Cannes","3-1",3,1,"1",1,4,2,"H"
1933-07-01,1932,"Stade Rennes","FC Sochaux","2-2",2,2,"1",1,4,0,"D"
1933-07-01,1932,"Stade Olympique Montpellierain","FC Sete","4-1",4,1,"1",1,5,3,"H"
1933-07-01,1932,"Racing Club de France","OGC Nice","4-3",4,3,"1",1,7,1,"H"
1933-07-01,1932,"Olympique Marseille","SC Nimes","7-3",7,3,"1",1,10,4,"H"
1933-07-01,1932,"FC Antibes","SC Fives Lille","0-7",0,7,"1",1,7,-7,"D"
1933-07-01,1932,"SC Fives Lille","Excelsior Roubaix","1-0",1,0,"1",1,1,1,"H"
1933-07-01,1932,"CA Paris (alt)","Olympique Marseille","3-1",3,1,"1",1,4,2,"H"
1933-07-01,1932,"OGC Nice","Olympique Lillois Lille","3-2",3,2,"1",1,5,1,"H"
1933-07-01,1932,"FC Sochaux","Racing Club de France","3-2",3,2,"1",1,5,1,"H"
1933-07-01,1932,"SC Nimes","Stade Rennes","5-3",5,3,"1",1,8,2,"H"
1933-07-01,1932,"AS Cannes","Stade Olympique Montpellierain","3-1",3,1,"1",1,4,2,"H"
1933-07-01,1932,"FC Sete","FC Antibes","4-2",4,2,"1",1,6,2,"H"
1934-07-01,1933,"FC Sochaux","Excelsior Roubaix","0-2",0,2,"1",1,2,-2,"D"
1934-07-01,1933,"Olympique Lillois Lille","AS Cannes","0-0",0,0,"1",1,0,0,"D"
1934-07-01,1933,"FC Mulhouse","SC Nimes","6-0",6,0,"1",1,6,6,"H"
1934-07-01,1933,"FC Antibes","SC Fives Lille","2-3",2,3,"1",1,5,-1,"D"
1934-07-01,1933,"Olympique Ales","Olympique Marseille","1-0",1,0,"1",1,1,1,"H"
1934-07-01,1933,"Red Star Olympique","Stade Rennes","2-1",2,1,"1",1,3,1,"H"
1934-07-01,1933,"RC Strasbourg","FC Sete","5-2",5,2,"1",1,7,3,"H"
1934-07-01,1933,"Stade Olympique Montpellierain","Racing Club de France","3-3",3,3,"1",1,6,0,"D"
1934-07-01,1933,"FC Sochaux","Stade Rennes","2-1",2,1,"1",1,3,1,"H"
1934-07-01,1933,"FC Mulhouse","Olympique Marseille","3-4",3,4,"1",1,7,-1,"D"
1934-07-01,1933,"Olympique Lillois Lille","FC Sete","2-0",2,0,"1",1,2,2,"H"
1934-07-01,1933,"FC Antibes","Red Star Olympique","1-1",1,1,"1",1,2,0,"D"
1934-07-01,1933,"Racing Club de France","Excelsior Roubaix","3-1",3,1,"1",1,4,2,"H"
1934-07-01,1933,"Olympique Ales","SC Nimes","2-4",2,4,"1",1,6,-2,"D"
1934-07-01,1933,"RC Strasbourg","AS Cannes","1-1",1,1,"1",1,2,0,"D"
1934-07-01,1933,"Stade Olympique Montpellierain","SC Fives Lille","2-0",2,0,"1",1,2,2,"H"
1934-07-01,1933,"Excelsior Roubaix","RC Strasbourg","1-2",1,2,"1",1,3,-1,"D"
1934-07-01,1933,"Racing Club de France","Olympique Ales","6-3",6,3,"1",1,9,3,"H"
1934-07-01,1933,"FC Sete","Red Star Olympique","2-2",2,2,"1",1,4,0,"D"
1934-07-01,1933,"SC Nimes","Stade Olympique Montpellierain","4-5",4,5,"1",1,9,-1,"D"
1934-07-01,1933,"AS Cannes","FC Sochaux","0-2",0,2,"1",1,2,-2,"D"
1934-07-01,1933,"SC Fives Lille","FC Mulhouse","0-2",0,2,"1",1,2,-2,"D"
1934-07-01,1933,"Stade Rennes","Olympique Lillois Lille","4-0",4,0,"1",1,4,4,"H"
1934-07-01,1933,"Olympique Marseille","FC Antibes","7-2",7,2,"1",1,9,5,"H"
1934-07-01,1933,"SC Nimes","FC Antibes","3-1",3,1,"1",1,4,2,"H"
1934-07-01,1933,"Olympique Marseille","Stade Olympique Montpellierain","4-1",4,1,"1",1,5,3,"H"
1934-07-01,1933,"Stade Rennes","RC Strasbourg","0-2",0,2,"1",1,2,-2,"D"
1934-07-01,1933,"SC Fives Lille","Olympique Ales","1-0",1,0,"1",1,1,1,"H"
1934-07-01,1933,"AS Cannes","Red Star Olympique","6-2",6,2,"1",1,8,4,"H"
1934-07-01,1933,"Excelsior Roubaix","Olympique Lillois Lille","2-1",2,1,"1",1,3,1,"H"
1934-07-01,1933,"Racing Club de France","FC Mulhouse","2-3",2,3,"1",1,5,-1,"D"
1934-07-01,1933,"FC Sete","FC Sochaux","1-1",1,1,"1",1,2,0,"D"
1934-07-01,1933,"FC Sochaux","SC Fives Lille","2-1",2,1,"1",1,3,1,"H"
1934-07-01,1933,"FC Mulhouse","Stade Rennes","2-2",2,2,"1",1,4,0,"D"
1934-07-01,1933,"Olympique Lillois Lille","Olympique Marseille","5-0",5,0,"1",1,5,5,"H"
1934-07-01,1933,"FC Antibes","FC Sete","1-0",1,0,"1",1,1,1,"H"
1934-07-01,1933,"Red Star Olympique","Racing Club de France","1-2",1,2,"1",1,3,-1,"D"
1934-07-01,1933,"Olympique Ales","Excelsior Roubaix","0-3",0,3,"1",1,3,-3,"D"
1934-07-01,1933,"RC Strasbourg","SC Nimes","3-0",3,0,"1",1,3,3,"H"
1934-07-01,1933,"Stade Olympique Montpellierain","AS Cannes","2-3",2,3,"1",1,5,-1,"D"
1934-07-01,1933,"FC Sochaux","SC Nimes","1-0",1,0,"1",1,1,1,"H"
1934-07-01,1933,"Olympique Ales","FC Sete","3-0",3,0,"1",1,3,3,"H"
1934-07-01,1933,"Racing Club de France","RC Strasbourg","2-2",2,2,"1",1,4,0,"D"
1934-07-01,1933,"Stade Olympique Montpellierain","Excelsior Roubaix","0-2",0,2,"1",1,2,-2,"D"
1934-07-01,1933,"AS Cannes","FC Mulhouse","5-0",5,0,"1",1,5,5,"H"
1934-07-01,1933,"SC Fives Lille","Olympique Lillois Lille","2-1",2,1,"1",1,3,1,"H"
1934-07-01,1933,"Stade Rennes","FC Antibes","4-1",4,1,"1",1,5,3,"H"
1934-07-01,1933,"Olympique Marseille","Red Star Olympique","4-3",4,3,"1",1,7,1,"H"
1934-07-01,1933,"FC Sochaux","Red Star Olympique","4-3",4,3,"1",1,7,1,"H"
1934-07-01,1933,"FC Mulhouse","Olympique Ales","2-0",2,0,"1",1,2,2,"H"
1934-07-01,1933,"Olympique Lillois Lille","RC Strasbourg","2-1",2,1,"1",1,3,1,"H"
1934-07-01,1933,"FC Antibes","Stade Olympique Montpellierain","4-0",4,0,"1",1,4,4,"H"
1934-07-01,1933,"Stade Rennes","Excelsior Roubaix","0-1",0,1,"1",1,1,-1,"D"
1934-07-01,1933,"SC Nimes","Olympique Marseille","1-1",1,1,"1",1,2,0,"D"
1934-07-01,1933,"FC Sete","AS Cannes","1-1",1,1,"1",1,2,0,"D"
1934-07-01,1933,"Racing Club de France","SC Fives Lille","7-0",7,0,"1",1,7,7,"H"
1934-07-01,1933,"Stade Olympique Montpellierain","FC Sochaux","0-4",0,4,"1",1,4,-4,"D"
1934-07-01,1933,"Red Star Olympique","FC Mulhouse","3-1",3,1,"1",1,4,2,"H"
1934-07-01,1933,"Olympique Ales","Olympique Lillois Lille","3-1",3,1,"1",1,4,2,"H"
1934-07-01,1933,"RC Strasbourg","FC Antibes","6-1",6,1,"1",1,7,5,"H"
1934-07-01,1933,"SC Fives Lille","Stade Rennes","4-1",4,1,"1",1,5,3,"H"
1934-07-01,1933,"Excelsior Roubaix","Olympique Marseille","0-3",0,3,"1",1,3,-3,"D"
1934-07-01,1933,"SC Nimes","FC Sete","1-3",1,3,"1",1,4,-2,"D"
1934-07-01,1933,"AS Cannes","Racing Club de France","0-2",0,2,"1",1,2,-2,"D"
1934-07-01,1933,"FC Sochaux","Racing Club de France","3-1",3,1,"1",1,4,2,"H"
1934-07-01,1933,"Excelsior Roubaix","FC Mulhouse","1-2",1,2,"1",1,3,-1,"D"
1934-07-01,1933,"Olympique Lillois Lille","SC Nimes","3-1",3,1,"1",1,4,2,"H"
1934-07-01,1933,"AS Cannes","FC Antibes","3-1",3,1,"1",1,4,2,"H"
1934-07-01,1933,"Red Star Olympique","SC Fives Lille","5-2",5,2,"1",1,7,3,"H"
1934-07-01,1933,"Stade Rennes","Olympique Ales","6-0",6,0,"1",1,6,6,"H"
1934-07-01,1933,"Olympique Marseille","RC Strasbourg","1-1",1,1,"1",1,2,0,"D"
1934-07-01,1933,"Stade Olympique Montpellierain","FC Sete","0-2",0,2,"1",1,2,-2,"D"
1934-07-01,1933,"FC Sochaux","RC Strasbourg","2-3",2,3,"1",1,5,-1,"D"
1934-07-01,1933,"Olympique Lillois Lille","Red Star Olympique","0-4",0,4,"1",1,4,-4,"D"
1934-07-01,1933,"Stade Rennes","AS Cannes","3-0",3,0,"1",1,3,3,"H"
1934-07-01,1933,"FC Sete","Excelsior Roubaix","2-2",2,2,"1",1,4,0,"D"
1934-07-01,1933,"FC Mulhouse","Stade Olympique Montpellierain","4-1",4,1,"1",1,5,3,"H"
1934-07-01,1933,"FC Antibes","Olympique Ales","1-0",1,0,"1",1,1,1,"H"
1934-07-01,1933,"Olympique Marseille","SC Fives Lille","5-1",5,1,"1",1,6,4,"H"
1934-07-01,1933,"Racing Club de France","SC Nimes","2-0",2,0,"1",1,2,2,"H"
1934-07-01,1933,"RC Strasbourg","FC Mulhouse","4-2",4,2,"1",1,6,2,"H"
1934-07-01,1933,"Olympique Ales","FC Sochaux","0-5",0,5,"1",1,5,-5,"D"
1934-07-01,1933,"Stade Olympique Montpellierain","Olympique Lillois Lille","1-3",1,3,"1",1,4,-2,"D"
1934-07-01,1933,"Racing Club de France","FC Antibes","5-1",5,1,"1",1,6,4,"H"
1934-07-01,1933,"SC Nimes","Stade Rennes","1-2",1,2,"1",1,3,-1,"D"
1934-07-01,1933,"AS Cannes","Olympique Marseille","3-0",3,0,"1",1,3,3,"H"
1934-07-01,1933,"SC Fives Lille","FC Sete","1-2",1,2,"1",1,3,-1,"D"
1934-07-01,1933,"Excelsior Roubaix","Red Star Olympique","2-0",2,0,"1",1,2,2,"H"
1934-07-01,1933,"FC Sochaux","FC Mulhouse","8-0",8,0,"1",1,8,8,"H"
1934-07-01,1933,"Olympique Lillois Lille","FC Antibes","10-0",10,0,"1",1,10,10,"H"
1934-07-01,1933,"Red Star Olympique","Olympique Ales","3-1",3,1,"1",1,4,2,"H"
1934-07-01,1933,"RC Strasbourg","Stade Olympique Montpellierain","2-1",2,1,"1",1,3,1,"H"
1934-07-01,1933,"AS Cannes","SC Fives Lille","2-0",2,0,"1",1,2,2,"H"
1934-07-01,1933,"SC Nimes","Excelsior Roubaix","1-1",1,1,"1",1,2,0,"D"
1934-07-01,1933,"Stade Rennes","Olympique Marseille","1-1",1,1,"1",1,2,0,"D"
1934-07-01,1933,"FC Sete","Racing Club de France","2-2",2,2,"1",1,4,0,"D"
1934-07-01,1933,"FC Antibes","FC Sochaux","1-1",1,1,"1",1,2,0,"D"
1934-07-01,1933,"FC Mulhouse","Olympique Lillois Lille","1-0",1,0,"1",1,1,1,"H"
1934-07-01,1933,"Stade Olympique Montpellierain","Red Star Olympique","0-3",0,3,"1",1,3,-3,"D"
1934-07-01,1933,"Olympique Ales","RC Strasbourg","1-5",1,5,"1",1,6,-4,"D"
1934-07-01,1933,"SC Fives Lille","Excelsior Roubaix","0-0",0,0,"1",1,0,0,"D"
1934-07-01,1933,"SC Nimes","AS Cannes","1-2",1,2,"1",1,3,-1,"D"
1934-07-01,1933,"Racing Club de France","Stade Rennes","2-1",2,1,"1",1,3,1,"H"
1934-07-01,1933,"Olympique Marseille","FC Sete","1-1",1,1,"1",1,2,0,"D"
1934-07-01,1933,"FC Sochaux","Olympique Lillois Lille","5-2",5,2,"1",1,7,3,"H"
1934-07-01,1933,"FC Antibes","FC Mulhouse","1-1",1,1,"1",1,2,0,"D"
1934-07-01,1933,"RC Strasbourg","Red Star Olympique","5-2",5,2,"1",1,7,3,"H"
1934-07-01,1933,"Excelsior Roubaix","AS Cannes","2-0",2,0,"1",1,2,2,"H"
1934-07-01,1933,"FC Sete","Stade Rennes","2-0",2,0,"1",1,2,2,"H"
1934-07-01,1933,"Racing Club de France","Olympique Marseille","5-1",5,1,"1",1,6,4,"H"
1934-07-01,1933,"SC Fives Lille","SC Nimes","3-1",3,1,"1",1,4,2,"H"
1934-07-01,1933,"Olympique Ales","Stade Olympique Montpellierain","1-1",1,1,"1",1,2,0,"D"
1934-07-01,1933,"Olympique Ales","AS Cannes","5-1",5,1,"1",1,6,4,"H"
1934-07-01,1933,"Red Star Olympique","SC Nimes","2-2",2,2,"1",1,4,0,"D"
1934-07-01,1933,"Stade Olympique Montpellierain","Stade Rennes","4-1",4,1,"1",1,5,3,"H"
1934-07-01,1933,"RC Strasbourg","SC Fives Lille","2-1",2,1,"1",1,3,1,"H"
1934-07-01,1933,"FC Antibes","Excelsior Roubaix","4-2",4,2,"1",1,6,2,"H"
1934-07-01,1933,"Olympique Lillois Lille","Racing Club de France","0-0",0,0,"1",1,0,0,"D"
1934-07-01,1933,"FC Mulhouse","FC Sete","1-1",1,1,"1",1,2,0,"D"
1934-07-01,1933,"Olympique Marseille","FC Sochaux","1-3",1,3,"1",1,4,-2,"D"
1934-07-01,1933,"Excelsior Roubaix","FC Sochaux","0-1",0,1,"1",1,1,-1,"D"
1934-07-01,1933,"AS Cannes","Olympique Lillois Lille","1-2",1,2,"1",1,3,-1,"D"
1934-07-01,1933,"SC Nimes","FC Mulhouse","3-2",3,2,"1",1,5,1,"H"
1934-07-01,1933,"SC Fives Lille","FC Antibes","2-1",2,1,"1",1,3,1,"H"
1934-07-01,1933,"Olympique Marseille","Olympique Ales","3-2",3,2,"1",1,5,1,"H"
1934-07-01,1933,"Stade Rennes","Red Star Olympique","3-1",3,1,"1",1,4,2,"H"
1934-07-01,1933,"FC Sete","RC Strasbourg","1-0",1,0,"1",1,1,1,"H"
1934-07-01,1933,"Racing Club de France","Stade Olympique Montpellierain","1-0",1,0,"1",1,1,1,"H"
1934-07-01,1933,"Stade Rennes","FC Sochaux","3-3",3,3,"1",1,6,0,"D"
1934-07-01,1933,"Olympique Marseille","FC Mulhouse","8-3",8,3,"1",1,11,5,"H"
1934-07-01,1933,"FC Sete","Olympique Lillois Lille","3-1",3,1,"1",1,4,2,"H"
1934-07-01,1933,"Red Star Olympique","FC Antibes","2-2",2,2,"1",1,4,0,"D"
1934-07-01,1933,"Excelsior Roubaix","Racing Club de France","5-3",5,3,"1",1,8,2,"H"
1934-07-01,1933,"SC Nimes","Olympique Ales","1-1",1,1,"1",1,2,0,"D"
1934-07-01,1933,"AS Cannes","RC Strasbourg","0-1",0,1,"1",1,1,-1,"D"
1934-07-01,1933,"SC Fives Lille","Stade Olympique Montpellierain","1-0",1,0,"1",1,1,1,"H"
1934-07-01,1933,"RC Strasbourg","Excelsior Roubaix","1-1",1,1,"1",1,2,0,"D"
1934-07-01,1933,"Olympique Ales","Racing Club de France","7-2",7,2,"1",1,9,5,"H"
1934-07-01,1933,"Red Star Olympique","FC Sete","3-4",3,4,"1",1,7,-1,"D"
1934-07-01,1933,"Stade Olympique Montpellierain","SC Nimes","0-3",0,3,"1",1,3,-3,"D"
1934-07-01,1933,"FC Sochaux","AS Cannes","4-2",4,2,"1",1,6,2,"H"
1934-07-01,1933,"FC Mulhouse","SC Fives Lille","1-0",1,0,"1",1,1,1,"H"
1934-07-01,1933,"Olympique Lillois Lille","Stade Rennes","3-1",3,1,"1",1,4,2,"H"
1934-07-01,1933,"FC Antibes","Olympique Marseille","1-7",1,7,"1",1,8,-6,"D"
1934-07-01,1933,"FC Antibes","SC Nimes","4-1",4,1,"1",1,5,3,"H"
1934-07-01,1933,"Stade Olympique Montpellierain","Olympique Marseille","3-2",3,2,"1",1,5,1,"H"
1934-07-01,1933,"RC Strasbourg","Stade Rennes","2-1",2,1,"1",1,3,1,"H"
1934-07-01,1933,"Olympique Ales","SC Fives Lille","2-1",2,1,"1",1,3,1,"H"
1934-07-01,1933,"Red Star Olympique","AS Cannes","2-1",2,1,"1",1,3,1,"H"
1934-07-01,1933,"FC Mulhouse","Racing Club de France","3-1",3,1,"1",1,4,2,"H"
1934-07-01,1933,"FC Sochaux","FC Sete","0-0",0,0,"1",1,0,0,"D"
1934-07-01,1933,"Olympique Lillois Lille","Excelsior Roubaix","4-0",4,0,"1",1,4,4,"H"
1934-07-01,1933,"SC Fives Lille","FC Sochaux","0-3",0,3,"1",1,3,-3,"D"
1934-07-01,1933,"Stade Rennes","FC Mulhouse","6-2",6,2,"1",1,8,4,"H"
1934-07-01,1933,"Olympique Marseille","Olympique Lillois Lille","3-1",3,1,"1",1,4,2,"H"
1934-07-01,1933,"FC Sete","FC Antibes","1-1",1,1,"1",1,2,0,"D"
1934-07-01,1933,"Racing Club de France","Red Star Olympique","2-2",2,2,"1",1,4,0,"D"
1934-07-01,1933,"Excelsior Roubaix","Olympique Ales","2-0",2,0,"1",1,2,2,"H"
1934-07-01,1933,"SC Nimes","RC Strasbourg","0-1",0,1,"1",1,1,-1,"D"
1934-07-01,1933,"AS Cannes","Stade Olympique Montpellierain","7-2",7,2,"1",1,9,5,"H"
1934-07-01,1933,"SC Nimes","FC Sochaux","0-2",0,2,"1",1,2,-2,"D"
1934-07-01,1933,"FC Sete","Olympique Ales","1-0",1,0,"1",1,1,1,"H"
1934-07-01,1933,"RC Strasbourg","Racing Club de France","6-0",6,0,"1",1,6,6,"H"
1934-07-01,1933,"Excelsior Roubaix","Stade Olympique Montpellierain","6-1",6,1,"1",1,7,5,"H"
1934-07-01,1933,"FC Mulhouse","AS Cannes","4-0",4,0,"1",1,4,4,"H"
1934-07-01,1933,"Olympique Lillois Lille","SC Fives Lille","3-0",3,0,"1",1,3,3,"H"
1934-07-01,1933,"FC Antibes","Stade Rennes","0-0",0,0,"1",1,0,0,"D"
1934-07-01,1933,"Red Star Olympique","Olympique Marseille","4-1",4,1,"1",1,5,3,"H"
1934-07-01,1933,"Red Star Olympique","FC Sochaux","2-7",2,7,"1",1,9,-5,"D"
1934-07-01,1933,"Olympique Ales","FC Mulhouse","2-2",2,2,"1",1,4,0,"D"
1934-07-01,1933,"RC Strasbourg","Olympique Lillois Lille","4-1",4,1,"1",1,5,3,"H"
1934-07-01,1933,"Stade Olympique Montpellierain","FC Antibes","2-0",2,0,"1",1,2,2,"H"
1934-07-01,1933,"Excelsior Roubaix","Stade Rennes","0-0",0,0,"1",1,0,0,"D"
1934-07-01,1933,"Olympique Marseille","SC Nimes","2-1",2,1,"1",1,3,1,"H"
1934-07-01,1933,"AS Cannes","FC Sete","2-0",2,0,"1",1,2,2,"H"
1934-07-01,1933,"SC Fives Lille","Racing Club de France","2-1",2,1,"1",1,3,1,"H"
1934-07-01,1933,"FC Sochaux","Stade Olympique Montpellierain","9-0",9,0,"1",1,9,9,"H"
1934-07-01,1933,"FC Mulhouse","Red Star Olympique","0-0",0,0,"1",1,0,0,"D"
1934-07-01,1933,"Olympique Lillois Lille","Olympique Ales","2-1",2,1,"1",1,3,1,"H"
1934-07-01,1933,"FC Antibes","RC Strasbourg","1-3",1,3,"1",1,4,-2,"D"
1934-07-01,1933,"Stade Rennes","SC Fives Lille","3-1",3,1,"1",1,4,2,"H"
1934-07-01,1933,"Olympique Marseille","Excelsior Roubaix","2-4",2,4,"1",1,6,-2,"D"
1934-07-01,1933,"FC Sete","SC Nimes","2-2",2,2,"1",1,4,0,"D"
1934-07-01,1933,"Racing Club de France","AS Cannes","3-2",3,2,"1",1,5,1,"H"
1934-07-01,1933,"Racing Club de France","FC Sochaux","1-2",1,2,"1",1,3,-1,"D"
1934-07-01,1933,"FC Mulhouse","Excelsior Roubaix","6-1",6,1,"1",1,7,5,"H"
1934-07-01,1933,"SC Nimes","Olympique Lillois Lille","1-2",1,2,"1",1,3,-1,"D"
1934-07-01,1933,"FC Antibes","AS Cannes","1-1",1,1,"1",1,2,0,"D"
1934-07-01,1933,"SC Fives Lille","Red Star Olympique","6-0",6,0,"1",1,6,6,"H"
1934-07-01,1933,"Olympique Ales","Stade Rennes","3-2",3,2,"1",1,5,1,"H"
1934-07-01,1933,"RC Strasbourg","Olympique Marseille","1-0",1,0,"1",1,1,1,"H"
1934-07-01,1933,"FC Sete","Stade Olympique Montpellierain","3-0",3,0,"1",1,3,3,"H"
1934-07-01,1933,"RC Strasbourg","FC Sochaux","0-1",0,1,"1",1,1,-1,"D"
1934-07-01,1933,"Red Star Olympique","Olympique Lillois Lille","1-1",1,1,"1",1,2,0,"D"
1934-07-01,1933,"AS Cannes","Stade Rennes","3-0",3,0,"1",1,3,3,"H"
1934-07-01,1933,"Excelsior Roubaix","FC Sete","0-1",0,1,"1",1,1,-1,"D"
1934-07-01,1933,"Stade Olympique Montpellierain","FC Mulhouse","5-3",5,3,"1",1,8,2,"H"
1934-07-01,1933,"Olympique Ales","FC Antibes","2-1",2,1,"1",1,3,1,"H"
1934-07-01,1933,"SC Fives Lille","Olympique Marseille","6-3",6,3,"1",1,9,3,"H"
1934-07-01,1933,"SC Nimes","Racing Club de France","0-2",0,2,"1",1,2,-2,"D"
1934-07-01,1933,"FC Mulhouse","RC Strasbourg","4-1",4,1,"1",1,5,3,"H"
1934-07-01,1933,"FC Sochaux","Olympique Ales","6-2",6,2,"1",1,8,4,"H"
1934-07-01,1933,"Olympique Lillois Lille","Stade Olympique Montpellierain","4-1",4,1,"1",1,5,3,"H"
1934-07-01,1933,"FC Antibes","Racing Club de France","2-5",2,5,"1",1,7,-3,"D"
1934-07-01,1933,"Stade Rennes","SC Nimes","2-0",2,0,"1",1,2,2,"H"
1934-07-01,1933,"Olympique Marseille","AS Cannes","2-2",2,2,"1",1,4,0,"D"
1934-07-01,1933,"FC Sete","SC Fives Lille","4-0",4,0,"1",1,4,4,"H"
1934-07-01,1933,"Red Star Olympique","Excelsior Roubaix","1-3",1,3,"1",1,4,-2,"D"
1934-07-01,1933,"FC Mulhouse","FC Sochaux","1-5",1,5,"1",1,6,-4,"D"
1934-07-01,1933,"FC Antibes","Olympique Lillois Lille","1-0",1,0,"1",1,1,1,"H"
1934-07-01,1933,"Olympique Ales","Red Star Olympique","3-2",3,2,"1",1,5,1,"H"
1934-07-01,1933,"Stade Olympique Montpellierain","RC Strasbourg","0-0",0,0,"1",1,0,0,"D"
1934-07-01,1933,"SC Fives Lille","AS Cannes","1-2",1,2,"1",1,3,-1,"D"
1934-07-01,1933,"Excelsior Roubaix","SC Nimes","4-0",4,0,"1",1,4,4,"H"
1934-07-01,1933,"Olympique Marseille","Stade Rennes","4-1",4,1,"1",1,5,3,"H"
1934-07-01,1933,"Racing Club de France","FC Sete","6-2",6,2,"1",1,8,4,"H"
1934-07-01,1933,"FC Sochaux","FC Antibes","3-7",3,7,"1",1,10,-4,"D"
1934-07-01,1933,"Olympique Lillois Lille","FC Mulhouse","0-1",0,1,"1",1,1,-1,"D"
1934-07-01,1933,"Red Star Olympique","Stade Olympique Montpellierain","0-1",0,1,"1",1,1,-1,"D"
1934-07-01,1933,"RC Strasbourg","Olympique Ales","3-2",3,2,"1",1,5,1,"H"
1934-07-01,1933,"Excelsior Roubaix","SC Fives Lille","0-1",0,1,"1",1,1,-1,"D"
1934-07-01,1933,"AS Cannes","SC Nimes","1-0",1,0,"1",1,1,1,"H"
1934-07-01,1933,"Stade Rennes","Racing Club de France","0-1",0,1,"1",1,1,-1,"D"
1934-07-01,1933,"FC Sete","Olympique Marseille","6-3",6,3,"1",1,9,3,"H"
1934-07-01,1933,"Olympique Lillois Lille","FC Sochaux","2-1",2,1,"1",1,3,1,"H"
1934-07-01,1933,"FC Mulhouse","FC Antibes","4-1",4,1,"1",1,5,3,"H"
1934-07-01,1933,"Red Star Olympique","RC Strasbourg","1-3",1,3,"1",1,4,-2,"D"
1934-07-01,1933,"AS Cannes","Excelsior Roubaix","5-2",5,2,"1",1,7,3,"H"
1934-07-01,1933,"Stade Rennes","FC Sete","4-1",4,1,"1",1,5,3,"H"
1934-07-01,1933,"Olympique Marseille","Racing Club de France","3-2",3,2,"1",1,5,1,"H"
1934-07-01,1933,"SC Nimes","SC Fives Lille","1-4",1,4,"1",1,5,-3,"D"
1934-07-01,1933,"Stade Olympique Montpellierain","Olympique Ales","0-3",0,3,"1",1,3,-3,"D"
1934-07-01,1933,"AS Cannes","Olympique Ales","6-2",6,2,"1",1,8,4,"H"
1934-07-01,1933,"SC Nimes","Red Star Olympique","2-1",2,1,"1",1,3,1,"H"
1934-07-01,1933,"Stade Rennes","Stade Olympique Montpellierain","4-1",4,1,"1",1,5,3,"H"
1934-07-01,1933,"SC Fives Lille","RC Strasbourg","1-3",1,3,"1",1,4,-2,"D"
1934-07-01,1933,"Excelsior Roubaix","FC Antibes","1-4",1,4,"1",1,5,-3,"D"
1934-07-01,1933,"Racing Club de France","Olympique Lillois Lille","3-0",3,0,"1",1,3,3,"H"
1934-07-01,1933,"FC Sete","FC Mulhouse","2-0",2,0,"1",1,2,2,"H"
1934-07-01,1933,"FC Sochaux","Olympique Marseille","4-0",4,0,"1",1,4,4,"H"
1935-07-01,1934,"AS Cannes","Olympique Ales","3-1",3,1,"1",1,4,2,"H"
1935-07-01,1934,"Olympique Lillois Lille","Stade Rennes","0-0",0,0,"1",1,0,0,"D"
1935-07-01,1934,"Olympique Marseille","Excelsior Roubaix","2-5",2,5,"1",1,7,-3,"D"
1935-07-01,1934,"FC Mulhouse","Red Star Olympique","3-2",3,2,"1",1,5,1,"H"
1935-07-01,1934,"Racing Club de France","FC Metz","3-5",3,5,"1",1,8,-2,"D"
1935-07-01,1934,"FC Sete","FC Antibes","4-0",4,0,"1",1,4,4,"H"
1935-07-01,1934,"FC Sochaux","US Valenciennes-Anzin","12-1",12,1,"1",1,13,11,"H"
1935-07-01,1934,"RC Strasbourg","SC Fives Lille","2-1",2,1,"1",1,3,1,"H"
1935-07-01,1934,"Olympique Ales","FC Sete","1-2",1,2,"1",1,3,-1,"D"
1935-07-01,1934,"FC Antibes","RC Strasbourg","1-1",1,1,"1",1,2,0,"D"
1935-07-01,1934,"Excelsior Roubaix","FC Mulhouse","4-0",4,0,"1",1,4,4,"H"
1935-07-01,1934,"SC Fives Lille","Racing Club de France","2-0",2,0,"1",1,2,2,"H"
1935-07-01,1934,"FC Metz","FC Sochaux","3-2",3,2,"1",1,5,1,"H"
1935-07-01,1934,"Red Star Olympique","Olympique Lillois Lille","0-2",0,2,"1",1,2,-2,"D"
1935-07-01,1934,"Stade Rennes","AS Cannes","1-3",1,3,"1",1,4,-2,"D"
1935-07-01,1934,"US Valenciennes-Anzin","Olympique Marseille","2-2",2,2,"1",1,4,0,"D"
1935-07-01,1934,"AS Cannes","Red Star Olympique","2-1",2,1,"1",1,3,1,"H"
1935-07-01,1934,"Olympique Lillois Lille","Excelsior Roubaix","3-2",3,2,"1",1,5,1,"H"
1935-07-01,1934,"Olympique Marseille","FC Metz","3-0",3,0,"1",1,3,3,"H"
1935-07-01,1934,"FC Mulhouse","US Valenciennes-Anzin","3-2",3,2,"1",1,5,1,"H"
1935-07-01,1934,"Racing Club de France","FC Antibes","3-2",3,2,"1",1,5,1,"H"
1935-07-01,1934,"FC Sete","Stade Rennes","4-2",4,2,"1",1,6,2,"H"
1935-07-01,1934,"FC Sochaux","SC Fives Lille","0-0",0,0,"1",1,0,0,"D"
1935-07-01,1934,"RC Strasbourg","Olympique Ales","6-1",6,1,"1",1,7,5,"H"
1935-07-01,1934,"Olympique Ales","Racing Club de France","0-2",0,2,"1",1,2,-2,"D"
1935-07-01,1934,"FC Antibes","FC Sochaux","1-3",1,3,"1",1,4,-2,"D"
1935-07-01,1934,"Excelsior Roubaix","AS Cannes","2-0",2,0,"1",1,2,2,"H"
1935-07-01,1934,"SC Fives Lille","Olympique Marseille","1-2",1,2,"1",1,3,-1,"D"
1935-07-01,1934,"FC Metz","FC Mulhouse","2-1",2,1,"1",1,3,1,"H"
1935-07-01,1934,"Red Star Olympique","FC Sete","1-1",1,1,"1",1,2,0,"D"
1935-07-01,1934,"Stade Rennes","RC Strasbourg","2-0",2,0,"1",1,2,2,"H"
1935-07-01,1934,"US Valenciennes-Anzin","Olympique Lillois Lille","1-5",1,5,"1",1,6,-4,"D"
1935-07-01,1934,"AS Cannes","US Valenciennes-Anzin","5-1",5,1,"1",1,6,4,"H"
1935-07-01,1934,"Olympique Lillois Lille","FC Metz","3-0",3,0,"1",1,3,3,"H"
1935-07-01,1934,"Olympique Marseille","FC Antibes","4-1",4,1,"1",1,5,3,"H"
1935-07-01,1934,"FC Mulhouse","SC Fives Lille","3-1",3,1,"1",1,4,2,"H"
1935-07-01,1934,"Racing Club de France","Stade Rennes","4-0",4,0,"1",1,4,4,"H"
1935-07-01,1934,"FC Sete","Excelsior Roubaix","1-3",1,3,"1",1,4,-2,"D"
1935-07-01,1934,"FC Sochaux","Olympique Ales","7-0",7,0,"1",1,7,7,"H"
1935-07-01,1934,"RC Strasbourg","Red Star Olympique","6-0",6,0,"1",1,6,6,"H"
1935-07-01,1934,"Olympique Ales","Olympique Marseille","3-3",3,3,"1",1,6,0,"D"
1935-07-01,1934,"FC Antibes","FC Mulhouse","3-2",3,2,"1",1,5,1,"H"
1935-07-01,1934,"Excelsior Roubaix","RC Strasbourg","2-1",2,1,"1",1,3,1,"H"
1935-07-01,1934,"FC Metz","AS Cannes","2-1",2,1,"1",1,3,1,"H"
1935-07-01,1934,"Red Star Olympique","Racing Club de France","1-4",1,4,"1",1,5,-3,"D"
1935-07-01,1934,"Stade Rennes","FC Sochaux","1-1",1,1,"1",1,2,0,"D"
1935-07-01,1934,"US Valenciennes-Anzin","FC Sete","5-3",5,3,"1",1,8,2,"H"
1935-07-01,1934,"Olympique Lillois Lille","SC Fives Lille","1-0",1,0,"1",1,1,1,"H"
1935-07-01,1934,"AS Cannes","SC Fives Lille","1-0",1,0,"1",1,1,1,"H"
1935-07-01,1934,"Olympique Lillois Lille","FC Antibes","6-3",6,3,"1",1,9,3,"H"
1935-07-01,1934,"Olympique Marseille","Stade Rennes","7-1",7,1,"1",1,8,6,"H"
1935-07-01,1934,"FC Mulhouse","Olympique Ales","3-3",3,3,"1",1,6,0,"D"
1935-07-01,1934,"Racing Club de France","Excelsior Roubaix","3-2",3,2,"1",1,5,1,"H"
1935-07-01,1934,"FC Sete","FC Metz","2-1",2,1,"1",1,3,1,"H"
1935-07-01,1934,"FC Sochaux","Red Star Olympique","0-1",0,1,"1",1,1,-1,"D"
1935-07-01,1934,"RC Strasbourg","US Valenciennes-Anzin","4-0",4,0,"1",1,4,4,"H"
1935-07-01,1934,"Olympique Ales","Olympique Lillois Lille","1-1",1,1,"1",1,2,0,"D"
1935-07-01,1934,"FC Antibes","AS Cannes","0-1",0,1,"1",1,1,-1,"D"
1935-07-01,1934,"Excelsior Roubaix","FC Sochaux","2-2",2,2,"1",1,4,0,"D"
1935-07-01,1934,"SC Fives Lille","FC Sete","3-0",3,0,"1",1,3,3,"H"
1935-07-01,1934,"FC Metz","RC Strasbourg","5-1",5,1,"1",1,6,4,"H"
1935-07-01,1934,"Red Star Olympique","Olympique Marseille","0-2",0,2,"1",1,2,-2,"D"
1935-07-01,1934,"Stade Rennes","FC Mulhouse","5-1",5,1,"1",1,6,4,"H"
1935-07-01,1934,"US Valenciennes-Anzin","Racing Club de France","5-3",5,3,"1",1,8,2,"H"
1935-07-01,1934,"FC Antibes","Olympique Ales","3-2",3,2,"1",1,5,1,"H"
1935-07-01,1934,"SC Fives Lille","Stade Rennes","1-3",1,3,"1",1,4,-2,"D"
1935-07-01,1934,"FC Metz","Red Star Olympique","5-1",5,1,"1",1,6,4,"H"
1935-07-01,1934,"Racing Club de France","FC Mulhouse","3-1",3,1,"1",1,4,2,"H"
1935-07-01,1934,"FC Sete","AS Cannes","2-0",2,0,"1",1,2,2,"H"
1935-07-01,1934,"FC Sochaux","Olympique Marseille","4-0",4,0,"1",1,4,4,"H"
1935-07-01,1934,"RC Strasbourg","Olympique Lillois Lille","3-2",3,2,"1",1,5,1,"H"
1935-07-01,1934,"US Valenciennes-Anzin","Excelsior Roubaix","4-0",4,0,"1",1,4,4,"H"
1935-07-01,1934,"Olympique Ales","US Valenciennes-Anzin","3-5",3,5,"1",1,8,-2,"D"
1935-07-01,1934,"AS Cannes","RC Strasbourg","0-2",0,2,"1",1,2,-2,"D"
1935-07-01,1934,"Excelsior Roubaix","FC Metz","2-3",2,3,"1",1,5,-1,"D"
1935-07-01,1934,"Olympique Lillois Lille","Racing Club de France","4-0",4,0,"1",1,4,4,"H"
1935-07-01,1934,"Olympique Marseille","FC Sete","1-0",1,0,"1",1,1,1,"H"
1935-07-01,1934,"FC Mulhouse","FC Sochaux","3-6",3,6,"1",1,9,-3,"D"
1935-07-01,1934,"Red Star Olympique","SC Fives Lille","1-4",1,4,"1",1,5,-3,"D"
1935-07-01,1934,"Stade Rennes","FC Antibes","2-1",2,1,"1",1,3,1,"H"
1935-07-01,1934,"FC Antibes","Red Star Olympique","2-0",2,0,"1",1,2,2,"H"
1935-07-01,1934,"SC Fives Lille","Excelsior Roubaix","1-0",1,0,"1",1,1,1,"H"
1935-07-01,1934,"FC Metz","Olympique Ales","1-1",1,1,"1",1,2,0,"D"
1935-07-01,1934,"FC Mulhouse","FC Sete","2-1",2,1,"1",1,3,1,"H"
1935-07-01,1934,"Racing Club de France","AS Cannes","5-0",5,0,"1",1,5,5,"H"
1935-07-01,1934,"FC Sochaux","Olympique Lillois Lille","1-1",1,1,"1",1,2,0,"D"
1935-07-01,1934,"RC Strasbourg","Olympique Marseille","4-1",4,1,"1",1,5,3,"H"
1935-07-01,1934,"US Valenciennes-Anzin","Stade Rennes","3-1",3,1,"1",1,4,2,"H"
1935-07-01,1934,"AS Cannes","FC Sochaux","1-0",1,0,"1",1,1,1,"H"
1935-07-01,1934,"Excelsior Roubaix","FC Antibes","2-0",2,0,"1",1,2,2,"H"
1935-07-01,1934,"SC Fives Lille","Olympique Ales","1-2",1,2,"1",1,3,-1,"D"
1935-07-01,1934,"Olympique Marseille","Racing Club de France","2-5",2,5,"1",1,7,-3,"D"
1935-07-01,1934,"FC Metz","Stade Rennes","2-0",2,0,"1",1,2,2,"H"
1935-07-01,1934,"Red Star Olympique","US Valenciennes-Anzin","2-0",2,0,"1",1,2,2,"H"
1935-07-01,1934,"FC Sete","Olympique Lillois Lille","2-1",2,1,"1",1,3,1,"H"
1935-07-01,1934,"RC Strasbourg","FC Mulhouse","3-0",3,0,"1",1,3,3,"H"
1935-07-01,1934,"Olympique Ales","Red Star Olympique","0-0",0,0,"1",1,0,0,"D"
1935-07-01,1934,"FC Antibes","FC Metz","0-0",0,0,"1",1,0,0,"D"
1935-07-01,1934,"Olympique Lillois Lille","FC Mulhouse","4-0",4,0,"1",1,4,4,"H"
1935-07-01,1934,"Olympique Marseille","AS Cannes","3-0",3,0,"1",1,3,3,"H"
1935-07-01,1934,"Racing Club de France","RC Strasbourg","4-1",4,1,"1",1,5,3,"H"
1935-07-01,1934,"Stade Rennes","Excelsior Roubaix","2-2",2,2,"1",1,4,0,"D"
1935-07-01,1934,"FC Sochaux","FC Sete","2-2",2,2,"1",1,4,0,"D"
1935-07-01,1934,"US Valenciennes-Anzin","SC Fives Lille","1-2",1,2,"1",1,3,-1,"D"
1935-07-01,1934,"Olympique Ales","Excelsior Roubaix","3-2",3,2,"1",1,5,1,"H"
1935-07-01,1934,"FC Antibes","US Valenciennes-Anzin","3-1",3,1,"1",1,4,2,"H"
1935-07-01,1934,"Olympique Lillois Lille","Olympique Marseille","1-0",1,0,"1",1,1,1,"H"
1935-07-01,1934,"FC Metz","SC Fives Lille","0-2",0,2,"1",1,2,-2,"D"
1935-07-01,1934,"FC Mulhouse","AS Cannes","2-2",2,2,"1",1,4,0,"D"
1935-07-01,1934,"Red Star Olympique","Stade Rennes","0-1",0,1,"1",1,1,-1,"D"
1935-07-01,1934,"FC Sete","Racing Club de France","1-1",1,1,"1",1,2,0,"D"
1935-07-01,1934,"FC Sochaux","RC Strasbourg","1-1",1,1,"1",1,2,0,"D"
1935-07-01,1934,"AS Cannes","Olympique Lillois Lille","0-0",0,0,"1",1,0,0,"D"
1935-07-01,1934,"Excelsior Roubaix","Red Star Olympique","6-4",6,4,"1",1,10,2,"H"
1935-07-01,1934,"SC Fives Lille","FC Antibes","1-1",1,1,"1",1,2,0,"D"
1935-07-01,1934,"Olympique Marseille","FC Mulhouse","6-2",6,2,"1",1,8,4,"H"
1935-07-01,1934,"Racing Club de France","FC Sochaux","1-1",1,1,"1",1,2,0,"D"
1935-07-01,1934,"Stade Rennes","Olympique Ales","2-0",2,0,"1",1,2,2,"H"
1935-07-01,1934,"RC Strasbourg","FC Sete","4-0",4,0,"1",1,4,4,"H"
1935-07-01,1934,"US Valenciennes-Anzin","FC Metz","3-1",3,1,"1",1,4,2,"H"
1935-07-01,1934,"Olympique Ales","AS Cannes","3-1",3,1,"1",1,4,2,"H"
1935-07-01,1934,"Stade Rennes","Olympique Lillois Lille","1-1",1,1,"1",1,2,0,"D"
1935-07-01,1934,"Excelsior Roubaix","Olympique Marseille","1-1",1,1,"1",1,2,0,"D"
1935-07-01,1934,"Red Star Olympique","FC Mulhouse","7-1",7,1,"1",1,8,6,"H"
1935-07-01,1934,"FC Metz","Racing Club de France","1-2",1,2,"1",1,3,-1,"D"
1935-07-01,1934,"FC Antibes","FC Sete","1-4",1,4,"1",1,5,-3,"D"
1935-07-01,1934,"US Valenciennes-Anzin","FC Sochaux","0-5",0,5,"1",1,5,-5,"D"
1935-07-01,1934,"SC Fives Lille","RC Strasbourg","0-1",0,1,"1",1,1,-1,"D"
1935-07-01,1934,"FC Sete","Olympique Ales","1-0",1,0,"1",1,1,1,"H"
1935-07-01,1934,"RC Strasbourg","FC Antibes","2-1",2,1,"1",1,3,1,"H"
1935-07-01,1934,"FC Mulhouse","Excelsior Roubaix","0-4",0,4,"1",1,4,-4,"D"
1935-07-01,1934,"Racing Club de France","SC Fives Lille","4-0",4,0,"1",1,4,4,"H"
1935-07-01,1934,"FC Sochaux","FC Metz","6-0",6,0,"1",1,6,6,"H"
1935-07-01,1934,"Olympique Lillois Lille","Red Star Olympique","2-1",2,1,"1",1,3,1,"H"
1935-07-01,1934,"AS Cannes","Stade Rennes","6-0",6,0,"1",1,6,6,"H"
1935-07-01,1934,"Olympique Marseille","US Valenciennes-Anzin","1-0",1,0,"1",1,1,1,"H"
1935-07-01,1934,"Red Star Olympique","AS Cannes","0-3",0,3,"1",1,3,-3,"D"
1935-07-01,1934,"Excelsior Roubaix","Olympique Lillois Lille","1-2",1,2,"1",1,3,-1,"D"
1935-07-01,1934,"FC Metz","Olympique Marseille","5-2",5,2,"1",1,7,3,"H"
1935-07-01,1934,"US Valenciennes-Anzin","FC Mulhouse","8-2",8,2,"1",1,10,6,"H"
1935-07-01,1934,"FC Antibes","Racing Club de France","3-9",3,9,"1",1,12,-6,"D"
1935-07-01,1934,"Stade Rennes","FC Sete","1-0",1,0,"1",1,1,1,"H"
1935-07-01,1934,"SC Fives Lille","FC Sochaux","2-1",2,1,"1",1,3,1,"H"
1935-07-01,1934,"Olympique Ales","RC Strasbourg","0-2",0,2,"1",1,2,-2,"D"
1935-07-01,1934,"Racing Club de France","Olympique Ales","3-1",3,1,"1",1,4,2,"H"
1935-07-01,1934,"FC Sochaux","FC Antibes","5-1",5,1,"1",1,6,4,"H"
1935-07-01,1934,"AS Cannes","Excelsior Roubaix","2-3",2,3,"1",1,5,-1,"D"
1935-07-01,1934,"Olympique Marseille","SC Fives Lille","3-2",3,2,"1",1,5,1,"H"
1935-07-01,1934,"FC Mulhouse","FC Metz","3-0",3,0,"1",1,3,3,"H"
1935-07-01,1934,"FC Sete","Red Star Olympique","3-2",3,2,"1",1,5,1,"H"
1935-07-01,1934,"RC Strasbourg","Stade Rennes","8-0",8,0,"1",1,8,8,"H"
1935-07-01,1934,"Olympique Lillois Lille","US Valenciennes-Anzin","3-0",3,0,"1",1,3,3,"H"
1935-07-01,1934,"US Valenciennes-Anzin","AS Cannes","2-5",2,5,"1",1,7,-3,"D"
1935-07-01,1934,"FC Metz","Olympique Lillois Lille","1-2",1,2,"1",1,3,-1,"D"
1935-07-01,1934,"FC Antibes","Olympique Marseille","3-2",3,2,"1",1,5,1,"H"
1935-07-01,1934,"SC Fives Lille","FC Mulhouse","3-0",3,0,"1",1,3,3,"H"
1935-07-01,1934,"Stade Rennes","Racing Club de France","0-3",0,3,"1",1,3,-3,"D"
1935-07-01,1934,"Excelsior Roubaix","FC Sete","2-0",2,0,"1",1,2,2,"H"
1935-07-01,1934,"Olympique Ales","FC Sochaux","0-0",0,0,"1",1,0,0,"D"
1935-07-01,1934,"Red Star Olympique","RC Strasbourg","1-2",1,2,"1",1,3,-1,"D"
1935-07-01,1934,"Olympique Marseille","Olympique Ales","2-0",2,0,"1",1,2,2,"H"
1935-07-01,1934,"FC Mulhouse","FC Antibes","2-2",2,2,"1",1,4,0,"D"
1935-07-01,1934,"RC Strasbourg","Excelsior Roubaix","1-0",1,0,"1",1,1,1,"H"
1935-07-01,1934,"AS Cannes","FC Metz","2-1",2,1,"1",1,3,1,"H"
1935-07-01,1934,"Racing Club de France","Red Star Olympique","4-1",4,1,"1",1,5,3,"H"
1935-07-01,1934,"FC Sochaux","Stade Rennes","2-0",2,0,"1",1,2,2,"H"
1935-07-01,1934,"FC Sete","US Valenciennes-Anzin","1-1",1,1,"1",1,2,0,"D"
1935-07-01,1934,"SC Fives Lille","Olympique Lillois Lille","1-1",1,1,"1",1,2,0,"D"
1935-07-01,1934,"SC Fives Lille","AS Cannes","5-1",5,1,"1",1,6,4,"H"
1935-07-01,1934,"FC Antibes","Olympique Lillois Lille","3-1",3,1,"1",1,4,2,"H"
1935-07-01,1934,"Stade Rennes","Olympique Marseille","1-1",1,1,"1",1,2,0,"D"
1935-07-01,1934,"Olympique Ales","FC Mulhouse","3-3",3,3,"1",1,6,0,"D"
1935-07-01,1934,"Excelsior Roubaix","Racing Club de France","0-2",0,2,"1",1,2,-2,"D"
1935-07-01,1934,"FC Metz","FC Sete","3-1",3,1,"1",1,4,2,"H"
1935-07-01,1934,"Red Star Olympique","FC Sochaux","2-2",2,2,"1",1,4,0,"D"
1935-07-01,1934,"US Valenciennes-Anzin","RC Strasbourg","1-1",1,1,"1",1,2,0,"D"
1935-07-01,1934,"Olympique Lillois Lille","Olympique Ales","3-0",3,0,"1",1,3,3,"H"
1935-07-01,1934,"AS Cannes","FC Antibes","2-1",2,1,"1",1,3,1,"H"
1935-07-01,1934,"FC Sochaux","Excelsior Roubaix","6-2",6,2,"1",1,8,4,"H"
1935-07-01,1934,"FC Sete","SC Fives Lille","1-0",1,0,"1",1,1,1,"H"
1935-07-01,1934,"RC Strasbourg","FC Metz","4-0",4,0,"1",1,4,4,"H"
1935-07-01,1934,"Olympique Marseille","Red Star Olympique","1-4",1,4,"1",1,5,-3,"D"
1935-07-01,1934,"FC Mulhouse","Stade Rennes","2-2",2,2,"1",1,4,0,"D"
1935-07-01,1934,"Racing Club de France","US Valenciennes-Anzin","2-1",2,1,"1",1,3,1,"H"
1935-07-01,1934,"Olympique Ales","FC Antibes","1-2",1,2,"1",1,3,-1,"D"
1935-07-01,1934,"Stade Rennes","SC Fives Lille","2-3",2,3,"1",1,5,-1,"D"
1935-07-01,1934,"Red Star Olympique","FC Metz","6-2",6,2,"1",1,8,4,"H"
1935-07-01,1934,"FC Mulhouse","Racing Club de France","3-0",3,0,"1",1,3,3,"H"
1935-07-01,1934,"AS Cannes","FC Sete","3-2",3,2,"1",1,5,1,"H"
1935-07-01,1934,"Olympique Marseille","FC Sochaux","4-1",4,1,"1",1,5,3,"H"
1935-07-01,1934,"Olympique Lillois Lille","RC Strasbourg","4-0",4,0,"1",1,4,4,"H"
1935-07-01,1934,"Excelsior Roubaix","US Valenciennes-Anzin","3-1",3,1,"1",1,4,2,"H"
1935-07-01,1934,"US Valenciennes-Anzin","Olympique Ales","2-4",2,4,"1",1,6,-2,"D"
1935-07-01,1934,"RC Strasbourg","AS Cannes","0-2",0,2,"1",1,2,-2,"D"
1935-07-01,1934,"FC Metz","Excelsior Roubaix","3-5",3,5,"1",1,8,-2,"D"
1935-07-01,1934,"Racing Club de France","Olympique Lillois Lille","2-3",2,3,"1",1,5,-1,"D"
1935-07-01,1934,"FC Sete","Olympique Marseille","1-0",1,0,"1",1,1,1,"H"
1935-07-01,1934,"FC Sochaux","FC Mulhouse","0-1",0,1,"1",1,1,-1,"D"
1935-07-01,1934,"SC Fives Lille","Red Star Olympique","2-1",2,1,"1",1,3,1,"H"
1935-07-01,1934,"FC Antibes","Stade Rennes","3-1",3,1,"1",1,4,2,"H"
1935-07-01,1934,"Red Star Olympique","FC Antibes","4-1",4,1,"1",1,5,3,"H"
1935-07-01,1934,"Excelsior Roubaix","SC Fives Lille","4-3",4,3,"1",1,7,1,"H"
1935-07-01,1934,"Olympique Ales","FC Metz","1-1",1,1,"1",1,2,0,"D"
1935-07-01,1934,"FC Sete","FC Mulhouse","3-1",3,1,"1",1,4,2,"H"
1935-07-01,1934,"AS Cannes","Racing Club de France","0-2",0,2,"1",1,2,-2,"D"
1935-07-01,1934,"Olympique Lillois Lille","FC Sochaux","2-3",2,3,"1",1,5,-1,"D"
1935-07-01,1934,"Olympique Marseille","RC Strasbourg","1-0",1,0,"1",1,1,1,"H"
1935-07-01,1934,"Stade Rennes","US Valenciennes-Anzin","1-1",1,1,"1",1,2,0,"D"
1935-07-01,1934,"FC Sochaux","AS Cannes","1-1",1,1,"1",1,2,0,"D"
1935-07-01,1934,"FC Antibes","Excelsior Roubaix","1-0",1,0,"1",1,1,1,"H"
1935-07-01,1934,"Olympique Ales","SC Fives Lille","0-3",0,3,"1",1,3,-3,"D"
1935-07-01,1934,"Racing Club de France","Olympique Marseille","2-2",2,2,"1",1,4,0,"D"
1935-07-01,1934,"Stade Rennes","FC Metz","2-0",2,0,"1",1,2,2,"H"
1935-07-01,1934,"US Valenciennes-Anzin","Red Star Olympique","0-2",0,2,"1",1,2,-2,"D"
1935-07-01,1934,"Olympique Lillois Lille","FC Sete","0-2",0,2,"1",1,2,-2,"D"
1935-07-01,1934,"FC Mulhouse","RC Strasbourg","2-4",2,4,"1",1,6,-2,"D"
1935-07-01,1934,"Red Star Olympique","Olympique Ales","1-2",1,2,"1",1,3,-1,"D"
1935-07-01,1934,"FC Metz","FC Antibes","2-1",2,1,"1",1,3,1,"H"
1935-07-01,1934,"FC Mulhouse","Olympique Lillois Lille","2-3",2,3,"1",1,5,-1,"D"
1935-07-01,1934,"AS Cannes","Olympique Marseille","3-1",3,1,"1",1,4,2,"H"
1935-07-01,1934,"RC Strasbourg","Racing Club de France","0-1",0,1,"1",1,1,-1,"D"
1935-07-01,1934,"Excelsior Roubaix","Stade Rennes","1-1",1,1,"1",1,2,0,"D"
1935-07-01,1934,"FC Sete","FC Sochaux","1-4",1,4,"1",1,5,-3,"D"
1935-07-01,1934,"SC Fives Lille","US Valenciennes-Anzin","3-2",3,2,"1",1,5,1,"H"
1935-07-01,1934,"Excelsior Roubaix","Olympique Ales","1-1",1,1,"1",1,2,0,"D"
1935-07-01,1934,"US Valenciennes-Anzin","FC Antibes","0-0",0,0,"1",1,0,0,"D"
1935-07-01,1934,"Olympique Marseille","Olympique Lillois Lille","1-0",1,0,"1",1,1,1,"H"
1935-07-01,1934,"SC Fives Lille","FC Metz","3-0",3,0,"1",1,3,3,"H"
1935-07-01,1934,"AS Cannes","FC Mulhouse","2-2",2,2,"1",1,4,0,"D"
1935-07-01,1934,"Stade Rennes","Red Star Olympique","3-0",3,0,"1",1,3,3,"H"
1935-07-01,1934,"Racing Club de France","FC Sete","2-1",2,1,"1",1,3,1,"H"
1935-07-01,1934,"RC Strasbourg","FC Sochaux","2-1",2,1,"1",1,3,1,"H"
1935-07-01,1934,"Olympique Lillois Lille","AS Cannes","1-1",1,1,"1",1,2,0,"D"
1935-07-01,1934,"Red Star Olympique","Excelsior Roubaix","3-2",3,2,"1",1,5,1,"H"
1935-07-01,1934,"FC Antibes","SC Fives Lille","3-1",3,1,"1",1,4,2,"H"
1935-07-01,1934,"FC Mulhouse","Olympique Marseille","3-1",3,1,"1",1,4,2,"H"
1935-07-01,1934,"FC Sochaux","Racing Club de France","2-2",2,2,"1",1,4,0,"D"
1935-07-01,1934,"Olympique Ales","Stade Rennes","2-6",2,6,"1",1,8,-4,"D"
1935-07-01,1934,"FC Sete","RC Strasbourg","3-1",3,1,"1",1,4,2,"H"
1935-07-01,1934,"FC Metz","US Valenciennes-Anzin","5-4",5,4,"1",1,9,1,"H"
1936-07-01,1935,"FC Sete","Red Star Olympique","2-1",2,1,"1",1,3,1,"H"
1936-07-01,1935,"RC Roubaix","FC Mulhouse","4-1",4,1,"1",1,5,3,"H"
1936-07-01,1935,"Olympique Lillois Lille","FC Antibes","3-2",3,2,"1",1,5,1,"H"
1936-07-01,1935,"FC Rouen","SC Fives Lille","2-1",2,1,"1",1,3,1,"H"
1936-07-01,1935,"AS Cannes","RC Strasbourg","0-0",0,0,"1",1,0,0,"D"
1936-07-01,1935,"FC Sochaux","Excelsior Roubaix","2-1",2,1,"1",1,3,1,"H"
1936-07-01,1935,"FC Metz","Olympique Marseille","3-1",3,1,"1",1,4,2,"H"
1936-07-01,1935,"Racing Club de France","Stade Rennes","3-1",3,1,"1",1,4,2,"H"
1936-07-01,1935,"Olympique Marseille","Racing Club de France","4-1",4,1,"1",1,5,3,"H"
1936-07-01,1935,"Excelsior Roubaix","FC Metz","2-2",2,2,"1",1,4,0,"D"
1936-07-01,1935,"RC Strasbourg","FC Sochaux","3-2",3,2,"1",1,5,1,"H"
1936-07-01,1935,"SC Fives Lille","AS Cannes","1-2",1,2,"1",1,3,-1,"D"
1936-07-01,1935,"FC Antibes","FC Rouen","1-1",1,1,"1",1,2,0,"D"
1936-07-01,1935,"FC Mulhouse","Olympique Lillois Lille","1-3",1,3,"1",1,4,-2,"D"
1936-07-01,1935,"Red Star Olympique","RC Roubaix","2-2",2,2,"1",1,4,0,"D"
1936-07-01,1935,"Stade Rennes","FC Sete","3-1",3,1,"1",1,4,2,"H"
1936-07-01,1935,"Olympique Marseille","FC Rouen","3-0",3,0,"1",1,3,3,"H"
1936-07-01,1935,"Excelsior Roubaix","Olympique Lillois Lille","0-1",0,1,"1",1,1,-1,"D"
1936-07-01,1935,"RC Strasbourg","RC Roubaix","5-1",5,1,"1",1,6,4,"H"
1936-07-01,1935,"SC Fives Lille","FC Sete","3-2",3,2,"1",1,5,1,"H"
1936-07-01,1935,"FC Antibes","Racing Club de France","1-3",1,3,"1",1,4,-2,"D"
1936-07-01,1935,"FC Mulhouse","FC Metz","2-4",2,4,"1",1,6,-2,"D"
1936-07-01,1935,"Red Star Olympique","FC Sochaux","2-2",2,2,"1",1,4,0,"D"
1936-07-01,1935,"Stade Rennes","AS Cannes","0-2",0,2,"1",1,2,-2,"D"
1936-07-01,1935,"FC Sete","Excelsior Roubaix","2-0",2,0,"1",1,2,2,"H"
1936-07-01,1935,"RC Roubaix","Olympique Marseille","2-2",2,2,"1",1,4,0,"D"
1936-07-01,1935,"Olympique Lillois Lille","Stade Rennes","3-1",3,1,"1",1,4,2,"H"
1936-07-01,1935,"FC Rouen","Red Star Olympique","7-1",7,1,"1",1,8,6,"H"
1936-07-01,1935,"AS Cannes","FC Mulhouse","6-4",6,4,"1",1,10,2,"H"
1936-07-01,1935,"FC Sochaux","FC Antibes","2-0",2,0,"1",1,2,2,"H"
1936-07-01,1935,"FC Metz","SC Fives Lille","1-3",1,3,"1",1,4,-2,"D"
1936-07-01,1935,"Racing Club de France","RC Strasbourg","2-2",2,2,"1",1,4,0,"D"
1936-07-01,1935,"AS Cannes","Olympique Lillois Lille","0-2",0,2,"1",1,2,-2,"D"
1936-07-01,1935,"FC Sochaux","RC Roubaix","2-0",2,0,"1",1,2,2,"H"
1936-07-01,1935,"FC Metz","FC Sete","4-0",4,0,"1",1,4,4,"H"
1936-07-01,1935,"Racing Club de France","FC Rouen","2-4",2,4,"1",1,6,-2,"D"
1936-07-01,1935,"Olympique Marseille","Red Star Olympique","3-2",3,2,"1",1,5,1,"H"
1936-07-01,1935,"Excelsior Roubaix","FC Mulhouse","5-1",5,1,"1",1,6,4,"H"
1936-07-01,1935,"RC Strasbourg","FC Antibes","2-1",2,1,"1",1,3,1,"H"
1936-07-01,1935,"SC Fives Lille","Stade Rennes","5-1",5,1,"1",1,6,4,"H"
1936-07-01,1935,"FC Sete","Racing Club de France","3-0",3,0,"1",1,3,3,"H"
1936-07-01,1935,"RC Roubaix","FC Metz","1-2",1,2,"1",1,3,-1,"D"
1936-07-01,1935,"Olympique Lillois Lille","FC Sochaux","2-1",2,1,"1",1,3,1,"H"
1936-07-01,1935,"FC Rouen","AS Cannes","2-2",2,2,"1",1,4,0,"D"
1936-07-01,1935,"FC Antibes","SC Fives Lille","5-2",5,2,"1",1,7,3,"H"
1936-07-01,1935,"FC Mulhouse","RC Strasbourg","1-9",1,9,"1",1,10,-8,"D"
1936-07-01,1935,"Red Star Olympique","Excelsior Roubaix","3-2",3,2,"1",1,5,1,"H"
1936-07-01,1935,"Stade Rennes","Olympique Marseille","3-1",3,1,"1",1,4,2,"H"
1936-07-01,1935,"Olympique Lillois Lille","FC Metz","5-0",5,0,"1",1,5,5,"H"
1936-07-01,1935,"AS Cannes","FC Sete","2-2",2,2,"1",1,4,0,"D"
1936-07-01,1935,"FC Sochaux","FC Rouen","2-0",2,0,"1",1,2,2,"H"
1936-07-01,1935,"Racing Club de France","RC Roubaix","2-0",2,0,"1",1,2,2,"H"
1936-07-01,1935,"Olympique Marseille","FC Antibes","2-0",2,0,"1",1,2,2,"H"
1936-07-01,1935,"Excelsior Roubaix","Stade Rennes","3-1",3,1,"1",1,4,2,"H"
1936-07-01,1935,"RC Strasbourg","Red Star Olympique","3-0",3,0,"1",1,3,3,"H"
1936-07-01,1935,"FC Mulhouse","SC Fives Lille","1-0",1,0,"1",1,1,1,"H"
1936-07-01,1935,"FC Sete","FC Rouen","2-0",2,0,"1",1,2,2,"H"
1936-07-01,1935,"RC Roubaix","Olympique Lillois Lille","0-1",0,1,"1",1,1,-1,"D"
1936-07-01,1935,"AS Cannes","Racing Club de France","1-2",1,2,"1",1,3,-1,"D"
1936-07-01,1935,"FC Metz","FC Sochaux","2-2",2,2,"1",1,4,0,"D"
1936-07-01,1935,"RC Strasbourg","Olympique Marseille","1-0",1,0,"1",1,1,1,"H"
1936-07-01,1935,"SC Fives Lille","Excelsior Roubaix","6-2",6,2,"1",1,8,4,"H"
1936-07-01,1935,"Red Star Olympique","FC Antibes","3-1",3,1,"1",1,4,2,"H"
1936-07-01,1935,"Stade Rennes","FC Mulhouse","1-2",1,2,"1",1,3,-1,"D"
1936-07-01,1935,"FC Sete","Olympique Lillois Lille","3-0",3,0,"1",1,3,3,"H"
1936-07-01,1935,"FC Rouen","RC Roubaix","4-0",4,0,"1",1,4,4,"H"
1936-07-01,1935,"FC Sochaux","Racing Club de France","2-1",2,1,"1",1,3,1,"H"
1936-07-01,1935,"FC Metz","AS Cannes","3-1",3,1,"1",1,4,2,"H"
1936-07-01,1935,"Excelsior Roubaix","RC Strasbourg","3-3",3,3,"1",1,6,0,"D"
1936-07-01,1935,"SC Fives Lille","Olympique Marseille","4-3",4,3,"1",1,7,1,"H"
1936-07-01,1935,"FC Antibes","Stade Rennes","1-0",1,0,"1",1,1,1,"H"
1936-07-01,1935,"Red Star Olympique","FC Mulhouse","3-2",3,2,"1",1,5,1,"H"
1936-07-01,1935,"RC Roubaix","FC Sete","1-1",1,1,"1",1,2,0,"D"
1936-07-01,1935,"Olympique Lillois Lille","FC Rouen","3-3",3,3,"1",1,6,0,"D"
1936-07-01,1935,"AS Cannes","FC Sochaux","2-1",2,1,"1",1,3,1,"H"
1936-07-01,1935,"Racing Club de France","FC Metz","2-0",2,0,"1",1,2,2,"H"
1936-07-01,1935,"Olympique Marseille","Excelsior Roubaix","4-4",4,4,"1",1,8,0,"D"
1936-07-01,1935,"RC Strasbourg","SC Fives Lille","1-1",1,1,"1",1,2,0,"D"
1936-07-01,1935,"FC Mulhouse","FC Antibes","2-3",2,3,"1",1,5,-1,"D"
1936-07-01,1935,"Stade Rennes","Red Star Olympique","1-3",1,3,"1",1,4,-2,"D"
1936-07-01,1935,"FC Sete","Olympique Marseille","2-2",2,2,"1",1,4,0,"D"
1936-07-01,1935,"FC Rouen","FC Mulhouse","4-2",4,2,"1",1,6,2,"H"
1936-07-01,1935,"AS Cannes","FC Antibes","2-3",2,3,"1",1,5,-1,"D"
1936-07-01,1935,"FC Metz","RC Strasbourg","0-0",0,0,"1",1,0,0,"D"
1936-07-01,1935,"Excelsior Roubaix","Racing Club de France","4-2",4,2,"1",1,6,2,"H"
1936-07-01,1935,"SC Fives Lille","FC Sochaux","0-1",0,1,"1",1,1,-1,"D"
1936-07-01,1935,"Red Star Olympique","Olympique Lillois Lille","2-1",2,1,"1",1,3,1,"H"
1936-07-01,1935,"Stade Rennes","RC Roubaix","1-1",1,1,"1",1,2,0,"D"
1936-07-01,1935,"FC Sochaux","Stade Rennes","1-0",1,0,"1",1,1,1,"H"
1936-07-01,1935,"FC Metz","Red Star Olympique","4-0",4,0,"1",1,4,4,"H"
1936-07-01,1935,"Racing Club de France","FC Mulhouse","4-1",4,1,"1",1,5,3,"H"
1936-07-01,1935,"Olympique Marseille","AS Cannes","2-0",2,0,"1",1,2,2,"H"
1936-07-01,1935,"Excelsior Roubaix","FC Rouen","0-0",0,0,"1",1,0,0,"D"
1936-07-01,1935,"RC Strasbourg","Olympique Lillois Lille","2-1",2,1,"1",1,3,1,"H"
1936-07-01,1935,"SC Fives Lille","RC Roubaix","3-2",3,2,"1",1,5,1,"H"
1936-07-01,1935,"FC Antibes","FC Sete","2-1",2,1,"1",1,3,1,"H"
1936-07-01,1935,"FC Sete","FC Sochaux","1-1",1,1,"1",1,2,0,"D"
1936-07-01,1935,"RC Roubaix","AS Cannes","2-1",2,1,"1",1,3,1,"H"
1936-07-01,1935,"Olympique Lillois Lille","Racing Club de France","1-0",1,0,"1",1,1,1,"H"
1936-07-01,1935,"FC Rouen","FC Metz","3-2",3,2,"1",1,5,1,"H"
1936-07-01,1935,"FC Antibes","Excelsior Roubaix","3-0",3,0,"1",1,3,3,"H"
1936-07-01,1935,"FC Mulhouse","Olympique Marseille","1-3",1,3,"1",1,4,-2,"D"
1936-07-01,1935,"Red Star Olympique","SC Fives Lille","0-0",0,0,"1",1,0,0,"D"
1936-07-01,1935,"Stade Rennes","RC Strasbourg","2-1",2,1,"1",1,3,1,"H"
1936-07-01,1935,"FC Sete","FC Mulhouse","4-1",4,1,"1",1,5,3,"H"
1936-07-01,1935,"RC Roubaix","FC Antibes","5-3",5,3,"1",1,8,2,"H"
1936-07-01,1935,"Olympique Lillois Lille","SC Fives Lille","1-3",1,3,"1",1,4,-2,"D"
1936-07-01,1935,"FC Rouen","RC Strasbourg","2-1",2,1,"1",1,3,1,"H"
1936-07-01,1935,"AS Cannes","Excelsior Roubaix","1-4",1,4,"1",1,5,-3,"D"
1936-07-01,1935,"FC Sochaux","Olympique Marseille","3-1",3,1,"1",1,4,2,"H"
1936-07-01,1935,"FC Metz","Stade Rennes","2-1",2,1,"1",1,3,1,"H"
1936-07-01,1935,"Racing Club de France","Red Star Olympique","4-2",4,2,"1",1,6,2,"H"
1936-07-01,1935,"Olympique Marseille","Olympique Lillois Lille","2-1",2,1,"1",1,3,1,"H"
1936-07-01,1935,"Excelsior Roubaix","RC Roubaix","3-2",3,2,"1",1,5,1,"H"
1936-07-01,1935,"RC Strasbourg","FC Sete","1-1",1,1,"1",1,2,0,"D"
1936-07-01,1935,"SC Fives Lille","Racing Club de France","1-3",1,3,"1",1,4,-2,"D"
1936-07-01,1935,"FC Antibes","FC Metz","2-2",2,2,"1",1,4,0,"D"
1936-07-01,1935,"FC Mulhouse","FC Sochaux","4-1",4,1,"1",1,5,3,"H"
1936-07-01,1935,"Red Star Olympique","AS Cannes","3-3",3,3,"1",1,6,0,"D"
1936-07-01,1935,"Stade Rennes","FC Rouen","0-1",0,1,"1",1,1,-1,"D"
1936-07-01,1935,"Red Star Olympique","FC Sete","1-0",1,0,"1",1,1,1,"H"
1936-07-01,1935,"FC Mulhouse","RC Roubaix","2-1",2,1,"1",1,3,1,"H"
1936-07-01,1935,"FC Antibes","Olympique Lillois Lille","2-2",2,2,"1",1,4,0,"D"
1936-07-01,1935,"SC Fives Lille","FC Rouen","2-1",2,1,"1",1,3,1,"H"
1936-07-01,1935,"RC Strasbourg","AS Cannes","1-3",1,3,"1",1,4,-2,"D"
1936-07-01,1935,"Excelsior Roubaix","FC Sochaux","1-0",1,0,"1",1,1,1,"H"
1936-07-01,1935,"Olympique Marseille","FC Metz","4-0",4,0,"1",1,4,4,"H"
1936-07-01,1935,"Stade Rennes","Racing Club de France","1-3",1,3,"1",1,4,-2,"D"
1936-07-01,1935,"Racing Club de France","Olympique Marseille","1-1",1,1,"1",1,2,0,"D"
1936-07-01,1935,"FC Metz","Excelsior Roubaix","2-1",2,1,"1",1,3,1,"H"
1936-07-01,1935,"FC Sochaux","RC Strasbourg","3-2",3,2,"1",1,5,1,"H"
1936-07-01,1935,"AS Cannes","SC Fives Lille","0-0",0,0,"1",1,0,0,"D"
1936-07-01,1935,"FC Rouen","FC Antibes","5-1",5,1,"1",1,6,4,"H"
1936-07-01,1935,"Olympique Lillois Lille","FC Mulhouse","1-1",1,1,"1",1,2,0,"D"
1936-07-01,1935,"RC Roubaix","Red Star Olympique","2-3",2,3,"1",1,5,-1,"D"
1936-07-01,1935,"FC Sete","Stade Rennes","1-1",1,1,"1",1,2,0,"D"
1936-07-01,1935,"FC Rouen","Olympique Marseille","1-0",1,0,"1",1,1,1,"H"
1936-07-01,1935,"Olympique Lillois Lille","Excelsior Roubaix","5-4",5,4,"1",1,9,1,"H"
1936-07-01,1935,"RC Roubaix","RC Strasbourg","2-1",2,1,"1",1,3,1,"H"
1936-07-01,1935,"FC Sete","SC Fives Lille","2-1",2,1,"1",1,3,1,"H"
1936-07-01,1935,"Racing Club de France","FC Antibes","2-1",2,1,"1",1,3,1,"H"
1936-07-01,1935,"FC Metz","FC Mulhouse","8-1",8,1,"1",1,9,7,"H"
1936-07-01,1935,"FC Sochaux","Red Star Olympique","4-2",4,2,"1",1,6,2,"H"
1936-07-01,1935,"AS Cannes","Stade Rennes","1-2",1,2,"1",1,3,-1,"D"
1936-07-01,1935,"Excelsior Roubaix","FC Sete","3-1",3,1,"1",1,4,2,"H"
1936-07-01,1935,"Olympique Marseille","RC Roubaix","4-1",4,1,"1",1,5,3,"H"
1936-07-01,1935,"Stade Rennes","Olympique Lillois Lille","0-0",0,0,"1",1,0,0,"D"
1936-07-01,1935,"Red Star Olympique","FC Rouen","0-1",0,1,"1",1,1,-1,"D"
1936-07-01,1935,"FC Mulhouse","AS Cannes","1-1",1,1,"1",1,2,0,"D"
1936-07-01,1935,"FC Antibes","FC Sochaux","1-3",1,3,"1",1,4,-2,"D"
1936-07-01,1935,"SC Fives Lille","FC Metz","6-0",6,0,"1",1,6,6,"H"
1936-07-01,1935,"RC Strasbourg","Racing Club de France","0-0",0,0,"1",1,0,0,"D"
1936-07-01,1935,"Olympique Lillois Lille","AS Cannes","4-3",4,3,"1",1,7,1,"H"
1936-07-01,1935,"RC Roubaix","FC Sochaux","3-2",3,2,"1",1,5,1,"H"
1936-07-01,1935,"FC Sete","FC Metz","3-0",3,0,"1",1,3,3,"H"
1936-07-01,1935,"FC Rouen","Racing Club de France","0-1",0,1,"1",1,1,-1,"D"
1936-07-01,1935,"Red Star Olympique","Olympique Marseille","0-5",0,5,"1",1,5,-5,"D"
1936-07-01,1935,"FC Mulhouse","Excelsior Roubaix","1-4",1,4,"1",1,5,-3,"D"
1936-07-01,1935,"FC Antibes","RC Strasbourg","1-6",1,6,"1",1,7,-5,"D"
1936-07-01,1935,"Stade Rennes","SC Fives Lille","1-0",1,0,"1",1,1,1,"H"
1936-07-01,1935,"Racing Club de France","FC Sete","4-1",4,1,"1",1,5,3,"H"
1936-07-01,1935,"FC Metz","RC Roubaix","4-0",4,0,"1",1,4,4,"H"
1936-07-01,1935,"FC Sochaux","Olympique Lillois Lille","1-1",1,1,"1",1,2,0,"D"
1936-07-01,1935,"AS Cannes","FC Rouen","4-1",4,1,"1",1,5,3,"H"
1936-07-01,1935,"SC Fives Lille","FC Antibes","1-1",1,1,"1",1,2,0,"D"
1936-07-01,1935,"RC Strasbourg","FC Mulhouse","7-2",7,2,"1",1,9,5,"H"
1936-07-01,1935,"Excelsior Roubaix","Red Star Olympique","2-2",2,2,"1",1,4,0,"D"
1936-07-01,1935,"Olympique Marseille","Stade Rennes","3-0",3,0,"1",1,3,3,"H"
1936-07-01,1935,"FC Metz","Olympique Lillois Lille","2-1",2,1,"1",1,3,1,"H"
1936-07-01,1935,"FC Sete","AS Cannes","0-0",0,0,"1",1,0,0,"D"
1936-07-01,1935,"FC Rouen","FC Sochaux","6-1",6,1,"1",1,7,5,"H"
1936-07-01,1935,"RC Roubaix","Racing Club de France","2-0",2,0,"1",1,2,2,"H"
1936-07-01,1935,"FC Antibes","Olympique Marseille","1-3",1,3,"1",1,4,-2,"D"
1936-07-01,1935,"Stade Rennes","Excelsior Roubaix","5-4",5,4,"1",1,9,1,"H"
1936-07-01,1935,"Red Star Olympique","RC Strasbourg","1-1",1,1,"1",1,2,0,"D"
1936-07-01,1935,"SC Fives Lille","FC Mulhouse","3-0",3,0,"1",1,3,3,"H"
1936-07-01,1935,"FC Rouen","FC Sete","5-0",5,0,"1",1,5,5,"H"
1936-07-01,1935,"Olympique Lillois Lille","RC Roubaix","2-3",2,3,"1",1,5,-1,"D"
1936-07-01,1935,"Racing Club de France","AS Cannes","2-1",2,1,"1",1,3,1,"H"
1936-07-01,1935,"FC Sochaux","FC Metz","2-1",2,1,"1",1,3,1,"H"
1936-07-01,1935,"Olympique Marseille","RC Strasbourg","4-0",4,0,"1",1,4,4,"H"
1936-07-01,1935,"Excelsior Roubaix","SC Fives Lille","4-1",4,1,"1",1,5,3,"H"
1936-07-01,1935,"FC Antibes","Red Star Olympique","2-0",2,0,"1",1,2,2,"H"
1936-07-01,1935,"FC Mulhouse","Stade Rennes","5-2",5,2,"1",1,7,3,"H"
1936-07-01,1935,"Olympique Lillois Lille","FC Sete","2-0",2,0,"1",1,2,2,"H"
1936-07-01,1935,"RC Roubaix","FC Rouen","3-0",3,0,"1",1,3,3,"H"
1936-07-01,1935,"Racing Club de France","FC Sochaux","1-0",1,0,"1",1,1,1,"H"
1936-07-01,1935,"AS Cannes","FC Metz","5-1",5,1,"1",1,6,4,"H"
1936-07-01,1935,"RC Strasbourg","Excelsior Roubaix","0-1",0,1,"1",1,1,-1,"D"
1936-07-01,1935,"Olympique Marseille","SC Fives Lille","1-0",1,0,"1",1,1,1,"H"
1936-07-01,1935,"Stade Rennes","FC Antibes","0-1",0,1,"1",1,1,-1,"D"
1936-07-01,1935,"FC Mulhouse","Red Star Olympique","1-3",1,3,"1",1,4,-2,"D"
1936-07-01,1935,"FC Sete","RC Roubaix","2-1",2,1,"1",1,3,1,"H"
1936-07-01,1935,"FC Rouen","Olympique Lillois Lille","0-2",0,2,"1",1,2,-2,"D"
1936-07-01,1935,"FC Sochaux","AS Cannes","1-1",1,1,"1",1,2,0,"D"
1936-07-01,1935,"FC Metz","Racing Club de France","3-1",3,1,"1",1,4,2,"H"
1936-07-01,1935,"Excelsior Roubaix","Olympique Marseille","0-3",0,3,"1",1,3,-3,"D"
1936-07-01,1935,"SC Fives Lille","RC Strasbourg","2-0",2,0,"1",1,2,2,"H"
1936-07-01,1935,"FC Antibes","FC Mulhouse","3-2",3,2,"1",1,5,1,"H"
1936-07-01,1935,"Red Star Olympique","Stade Rennes","0-1",0,1,"1",1,1,-1,"D"
1936-07-01,1935,"Olympique Marseille","FC Sete","2-1",2,1,"1",1,3,1,"H"
1936-07-01,1935,"FC Mulhouse","FC Rouen","3-2",3,2,"1",1,5,1,"H"
1936-07-01,1935,"FC Antibes","AS Cannes","4-1",4,1,"1",1,5,3,"H"
1936-07-01,1935,"RC Strasbourg","FC Metz","1-1",1,1,"1",1,2,0,"D"
1936-07-01,1935,"Racing Club de France","Excelsior Roubaix","3-6",3,6,"1",1,9,-3,"D"
1936-07-01,1935,"FC Sochaux","SC Fives Lille","1-0",1,0,"1",1,1,1,"H"
1936-07-01,1935,"Olympique Lillois Lille","Red Star Olympique","0-0",0,0,"1",1,0,0,"D"
1936-07-01,1935,"RC Roubaix","Stade Rennes","4-3",4,3,"1",1,7,1,"H"
1936-07-01,1935,"Stade Rennes","FC Sochaux","1-1",1,1,"1",1,2,0,"D"
1936-07-01,1935,"Red Star Olympique","FC Metz","2-1",2,1,"1",1,3,1,"H"
1936-07-01,1935,"FC Mulhouse","Racing Club de France","0-2",0,2,"1",1,2,-2,"D"
1936-07-01,1935,"AS Cannes","Olympique Marseille","3-0",3,0,"1",1,3,3,"H"
1936-07-01,1935,"FC Rouen","Excelsior Roubaix","2-1",2,1,"1",1,3,1,"H"
1936-07-01,1935,"Olympique Lillois Lille","RC Strasbourg","1-2",1,2,"1",1,3,-1,"D"
1936-07-01,1935,"RC Roubaix","SC Fives Lille","2-1",2,1,"1",1,3,1,"H"
1936-07-01,1935,"FC Sete","FC Antibes","4-0",4,0,"1",1,4,4,"H"
1936-07-01,1935,"FC Sochaux","FC Sete","6-2",6,2,"1",1,8,4,"H"
1936-07-01,1935,"AS Cannes","RC Roubaix","0-0",0,0,"1",1,0,0,"D"
1936-07-01,1935,"Racing Club de France","Olympique Lillois Lille","3-0",3,0,"1",1,3,3,"H"
1936-07-01,1935,"FC Metz","FC Rouen","4-4",4,4,"1",1,8,0,"D"
1936-07-01,1935,"Excelsior Roubaix","FC Antibes","1-2",1,2,"1",1,3,-1,"D"
1936-07-01,1935,"Olympique Marseille","FC Mulhouse","5-1",5,1,"1",1,6,4,"H"
1936-07-01,1935,"SC Fives Lille","Red Star Olympique","1-2",1,2,"1",1,3,-1,"D"
1936-07-01,1935,"RC Strasbourg","Stade Rennes","3-0",3,0,"1",1,3,3,"H"
1936-07-01,1935,"FC Mulhouse","FC Sete","1-1",1,1,"1",1,2,0,"D"
1936-07-01,1935,"FC Antibes","RC Roubaix","2-3",2,3,"1",1,5,-1,"D"
1936-07-01,1935,"SC Fives Lille","Olympique Lillois Lille","1-0",1,0,"1",1,1,1,"H"
1936-07-01,1935,"RC Strasbourg","FC Rouen","4-0",4,0,"1",1,4,4,"H"
1936-07-01,1935,"Excelsior Roubaix","AS Cannes","5-0",5,0,"1",1,5,5,"H"
1936-07-01,1935,"Olympique Marseille","FC Sochaux","0-1",0,1,"1",1,1,-1,"D"
1936-07-01,1935,"Stade Rennes","FC Metz","5-1",5,1,"1",1,6,4,"H"
1936-07-01,1935,"Red Star Olympique","Racing Club de France","2-0",2,0,"1",1,2,2,"H"
1936-07-01,1935,"Olympique Lillois Lille","Olympique Marseille","2-1",2,1,"1",1,3,1,"H"
1936-07-01,1935,"RC Roubaix","Excelsior Roubaix","0-2",0,2,"1",1,2,-2,"D"
1936-07-01,1935,"FC Sete","RC Strasbourg","1-0",1,0,"1",1,1,1,"H"
1936-07-01,1935,"Racing Club de France","SC Fives Lille","3-2",3,2,"1",1,5,1,"H"
1936-07-01,1935,"FC Metz","FC Antibes","1-0",1,0,"1",1,1,1,"H"
1936-07-01,1935,"FC Sochaux","FC Mulhouse","5-1",5,1,"1",1,6,4,"H"
1936-07-01,1935,"AS Cannes","Red Star Olympique","0-2",0,2,"1",1,2,-2,"D"
1936-07-01,1935,"FC Rouen","Stade Rennes","1-0",1,0,"1",1,1,1,"H"
1937-07-01,1936,"RC Lens","Olympique Marseille","4-3",4,3,"1",1,7,1,"H"
1937-07-01,1936,"FC Sete","Racing Club de France","2-2",2,2,"1",1,4,0,"D"
1937-07-01,1936,"AS Cannes","RC Strasbourg","2-3",2,3,"1",1,5,-1,"D"
1937-07-01,1936,"US Valenciennes-Anzin","FC Sochaux","0-0",0,0,"1",1,0,0,"D"
1937-07-01,1936,"SC Fives Lille","FC Antibes","3-1",3,1,"1",1,4,2,"H"
1937-07-01,1936,"Red Star Olympique","Excelsior Roubaix","2-2",2,2,"1",1,4,0,"D"
1937-07-01,1936,"FC Metz","Olympique Lillois Lille","1-0",1,0,"1",1,1,1,"H"
1937-07-01,1936,"RC Roubaix","FC Rouen","0-3",0,3,"1",1,3,-3,"D"
1937-07-01,1936,"Olympique Marseille","AS Cannes","2-2",2,2,"1",1,4,0,"D"
1937-07-01,1936,"FC Rouen","Red Star Olympique","4-0",4,0,"1",1,4,4,"H"
1937-07-01,1936,"FC Metz","RC Strasbourg","4-0",4,0,"1",1,4,4,"H"
1937-07-01,1936,"Excelsior Roubaix","RC Lens","1-1",1,1,"1",1,2,0,"D"
1937-07-01,1936,"FC Sochaux","SC Fives Lille","6-2",6,2,"1",1,8,4,"H"
1937-07-01,1936,"Racing Club de France","RC Roubaix","2-1",2,1,"1",1,3,1,"H"
1937-07-01,1936,"Olympique Lillois Lille","US Valenciennes-Anzin","0-1",0,1,"1",1,1,-1,"D"
1937-07-01,1936,"FC Antibes","FC Sete","1-1",1,1,"1",1,2,0,"D"
1937-07-01,1936,"RC Lens","AS Cannes","2-2",2,2,"1",1,4,0,"D"
1937-07-01,1936,"RC Strasbourg","Olympique Marseille","2-2",2,2,"1",1,4,0,"D"
1937-07-01,1936,"Red Star Olympique","FC Metz","2-2",2,2,"1",1,4,0,"D"
1937-07-01,1936,"FC Sochaux","FC Rouen","5-0",5,0,"1",1,5,5,"H"
1937-07-01,1936,"FC Sete","SC Fives Lille","1-0",1,0,"1",1,1,1,"H"
1937-07-01,1936,"FC Antibes","Racing Club de France","2-2",2,2,"1",1,4,0,"D"
1937-07-01,1936,"RC Roubaix","US Valenciennes-Anzin","3-2",3,2,"1",1,5,1,"H"
1937-07-01,1936,"Olympique Lillois Lille","Excelsior Roubaix","1-1",1,1,"1",1,2,0,"D"
1937-07-01,1936,"AS Cannes","Red Star Olympique","5-5",5,5,"1",1,10,0,"D"
1937-07-01,1936,"US Valenciennes-Anzin","FC Sete","0-0",0,0,"1",1,0,0,"D"
1937-07-01,1936,"Racing Club de France","RC Strasbourg","0-3",0,3,"1",1,3,-3,"D"
1937-07-01,1936,"FC Rouen","FC Antibes","2-0",2,0,"1",1,2,2,"H"
1937-07-01,1936,"Olympique Marseille","Olympique Lillois Lille","4-0",4,0,"1",1,4,4,"H"
1937-07-01,1936,"FC Metz","RC Roubaix","1-1",1,1,"1",1,2,0,"D"
1937-07-01,1936,"SC Fives Lille","RC Lens","2-1",2,1,"1",1,3,1,"H"
1937-07-01,1936,"Excelsior Roubaix","FC Sochaux","1-2",1,2,"1",1,3,-1,"D"
1937-07-01,1936,"FC Sete","FC Metz","4-1",4,1,"1",1,5,3,"H"
1937-07-01,1936,"RC Strasbourg","FC Rouen","3-3",3,3,"1",1,6,0,"D"
1937-07-01,1936,"RC Lens","US Valenciennes-Anzin","2-1",2,1,"1",1,3,1,"H"
1937-07-01,1936,"FC Sochaux","Olympique Marseille","1-2",1,2,"1",1,3,-1,"D"
1937-07-01,1936,"FC Antibes","Excelsior Roubaix","4-2",4,2,"1",1,6,2,"H"
1937-07-01,1936,"Red Star Olympique","SC Fives Lille","3-2",3,2,"1",1,5,1,"H"
1937-07-01,1936,"Olympique Lillois Lille","Racing Club de France","0-1",0,1,"1",1,1,-1,"D"
1937-07-01,1936,"RC Roubaix","AS Cannes","4-1",4,1,"1",1,5,3,"H"
1937-07-01,1936,"Red Star Olympique","US Valenciennes-Anzin","2-0",2,0,"1",1,2,2,"H"
1937-07-01,1936,"FC Metz","RC Lens","1-1",1,1,"1",1,2,0,"D"
1937-07-01,1936,"FC Sochaux","Racing Club de France","4-0",4,0,"1",1,4,4,"H"
1937-07-01,1936,"AS Cannes","FC Sete","3-4",3,4,"1",1,7,-1,"D"
1937-07-01,1936,"Olympique Marseille","FC Antibes","1-0",1,0,"1",1,1,1,"H"
1937-07-01,1936,"FC Rouen","Olympique Lillois Lille","0-0",0,0,"1",1,0,0,"D"
1937-07-01,1936,"SC Fives Lille","RC Roubaix","3-0",3,0,"1",1,3,3,"H"
1937-07-01,1936,"Excelsior Roubaix","RC Strasbourg","3-2",3,2,"1",1,5,1,"H"
1937-07-01,1936,"US Valenciennes-Anzin","FC Metz","5-2",5,2,"1",1,7,3,"H"
1937-07-01,1936,"RC Strasbourg","FC Sochaux","1-6",1,6,"1",1,7,-5,"D"
1937-07-01,1936,"RC Lens","FC Sete","0-2",0,2,"1",1,2,-2,"D"
1937-07-01,1936,"FC Rouen","Olympique Marseille","2-2",2,2,"1",1,4,0,"D"
1937-07-01,1936,"SC Fives Lille","AS Cannes","1-1",1,1,"1",1,2,0,"D"
1937-07-01,1936,"Racing Club de France","Excelsior Roubaix","5-1",5,1,"1",1,6,4,"H"
1937-07-01,1936,"FC Antibes","Olympique Lillois Lille","0-0",0,0,"1",1,0,0,"D"
1937-07-01,1936,"RC Roubaix","Red Star Olympique","0-0",0,0,"1",1,0,0,"D"
1937-07-01,1936,"US Valenciennes-Anzin","AS Cannes","0-1",0,1,"1",1,1,-1,"D"
1937-07-01,1936,"Racing Club de France","Olympique Marseille","3-3",3,3,"1",1,6,0,"D"
1937-07-01,1936,"FC Sete","Red Star Olympique","3-1",3,1,"1",1,4,2,"H"
1937-07-01,1936,"FC Metz","SC Fives Lille","0-0",0,0,"1",1,0,0,"D"
1937-07-01,1936,"Olympique Lillois Lille","FC Sochaux","0-0",0,0,"1",1,0,0,"D"
1937-07-01,1936,"FC Antibes","RC Strasbourg","1-2",1,2,"1",1,3,-1,"D"
1937-07-01,1936,"Excelsior Roubaix","FC Rouen","2-0",2,0,"1",1,2,2,"H"
1937-07-01,1936,"RC Lens","RC Roubaix","2-1",2,1,"1",1,3,1,"H"
1937-07-01,1936,"AS Cannes","FC Metz","4-0",4,0,"1",1,4,4,"H"
1937-07-01,1936,"Red Star Olympique","RC Lens","0-1",0,1,"1",1,1,-1,"D"
1937-07-01,1936,"FC Rouen","Racing Club de France","3-1",3,1,"1",1,4,2,"H"
1937-07-01,1936,"Olympique Marseille","Excelsior Roubaix","1-1",1,1,"1",1,2,0,"D"
1937-07-01,1936,"FC Sochaux","FC Antibes","1-0",1,0,"1",1,1,1,"H"
1937-07-01,1936,"RC Strasbourg","Olympique Lillois Lille","0-0",0,0,"1",1,0,0,"D"
1937-07-01,1936,"SC Fives Lille","US Valenciennes-Anzin","2-2",2,2,"1",1,4,0,"D"
1937-07-01,1936,"RC Roubaix","FC Sete","1-1",1,1,"1",1,2,0,"D"
1937-07-01,1936,"FC Sete","RC Strasbourg","3-0",3,0,"1",1,3,3,"H"
1937-07-01,1936,"Red Star Olympique","FC Sochaux","0-1",0,1,"1",1,1,-1,"D"
1937-07-01,1936,"AS Cannes","Racing Club de France","2-2",2,2,"1",1,4,0,"D"
1937-07-01,1936,"FC Metz","FC Rouen","1-1",1,1,"1",1,2,0,"D"
1937-07-01,1936,"RC Lens","FC Antibes","2-4",2,4,"1",1,6,-2,"D"
1937-07-01,1936,"US Valenciennes-Anzin","Excelsior Roubaix","1-1",1,1,"1",1,2,0,"D"
1937-07-01,1936,"RC Roubaix","Olympique Lillois Lille","3-0",3,0,"1",1,3,3,"H"
1937-07-01,1936,"SC Fives Lille","Olympique Marseille","2-1",2,1,"1",1,3,1,"H"
1937-07-01,1936,"Olympique Marseille","Red Star Olympique","1-0",1,0,"1",1,1,1,"H"
1937-07-01,1936,"FC Rouen","FC Sete","3-1",3,1,"1",1,4,2,"H"
1937-07-01,1936,"FC Sochaux","FC Metz","3-2",3,2,"1",1,5,1,"H"
1937-07-01,1936,"RC Strasbourg","RC Lens","2-2",2,2,"1",1,4,0,"D"
1937-07-01,1936,"Olympique Lillois Lille","AS Cannes","0-0",0,0,"1",1,0,0,"D"
1937-07-01,1936,"Racing Club de France","SC Fives Lille","1-1",1,1,"1",1,2,0,"D"
1937-07-01,1936,"FC Antibes","US Valenciennes-Anzin","0-0",0,0,"1",1,0,0,"D"
1937-07-01,1936,"Excelsior Roubaix","RC Roubaix","0-1",0,1,"1",1,1,-1,"D"
1937-07-01,1936,"Olympique Marseille","US Valenciennes-Anzin","1-1",1,1,"1",1,2,0,"D"
1937-07-01,1936,"FC Rouen","AS Cannes","1-0",1,0,"1",1,1,1,"H"
1937-07-01,1936,"Racing Club de France","RC Lens","1-3",1,3,"1",1,4,-2,"D"
1937-07-01,1936,"RC Strasbourg","SC Fives Lille","2-0",2,0,"1",1,2,2,"H"
1937-07-01,1936,"Excelsior Roubaix","FC Metz","2-4",2,4,"1",1,6,-2,"D"
1937-07-01,1936,"Olympique Lillois Lille","FC Sete","2-1",2,1,"1",1,3,1,"H"
1937-07-01,1936,"FC Sochaux","RC Roubaix","3-0",3,0,"1",1,3,3,"H"
1937-07-01,1936,"FC Antibes","Red Star Olympique","4-1",4,1,"1",1,5,3,"H"
1937-07-01,1936,"RC Lens","FC Rouen","1-1",1,1,"1",1,2,0,"D"
1937-07-01,1936,"US Valenciennes-Anzin","RC Strasbourg","1-2",1,2,"1",1,3,-1,"D"
1937-07-01,1936,"Red Star Olympique","Racing Club de France","2-2",2,2,"1",1,4,0,"D"
1937-07-01,1936,"FC Metz","Olympique Marseille","1-2",1,2,"1",1,3,-1,"D"
1937-07-01,1936,"FC Sete","FC Sochaux","0-1",0,1,"1",1,1,-1,"D"
1937-07-01,1936,"RC Roubaix","FC Antibes","2-1",2,1,"1",1,3,1,"H"
1937-07-01,1936,"SC Fives Lille","Olympique Lillois Lille","0-1",0,1,"1",1,1,-1,"D"
1937-07-01,1936,"AS Cannes","Excelsior Roubaix","2-1",2,1,"1",1,3,1,"H"
1937-07-01,1936,"FC Sochaux","RC Lens","4-0",4,0,"1",1,4,4,"H"
1937-07-01,1936,"FC Rouen","US Valenciennes-Anzin","4-1",4,1,"1",1,5,3,"H"
1937-07-01,1936,"Racing Club de France","FC Metz","2-2",2,2,"1",1,4,0,"D"
1937-07-01,1936,"FC Antibes","AS Cannes","2-0",2,0,"1",1,2,2,"H"
1937-07-01,1936,"Excelsior Roubaix","SC Fives Lille","3-2",3,2,"1",1,5,1,"H"
1937-07-01,1936,"RC Strasbourg","RC Roubaix","4-0",4,0,"1",1,4,4,"H"
1937-07-01,1936,"Olympique Lillois Lille","Red Star Olympique","4-1",4,1,"1",1,5,3,"H"
1937-07-01,1936,"Olympique Marseille","FC Sete","3-0",3,0,"1",1,3,3,"H"
1937-07-01,1936,"AS Cannes","FC Sochaux","0-1",0,1,"1",1,1,-1,"D"
1937-07-01,1936,"Red Star Olympique","RC Strasbourg","2-2",2,2,"1",1,4,0,"D"
1937-07-01,1936,"US Valenciennes-Anzin","Racing Club de France","1-3",1,3,"1",1,4,-2,"D"
1937-07-01,1936,"FC Metz","FC Antibes","1-1",1,1,"1",1,2,0,"D"
1937-07-01,1936,"RC Lens","Olympique Lillois Lille","2-1",2,1,"1",1,3,1,"H"
1937-07-01,1936,"FC Sete","Excelsior Roubaix","3-0",3,0,"1",1,3,3,"H"
1937-07-01,1936,"RC Roubaix","Olympique Marseille","1-3",1,3,"1",1,4,-2,"D"
1937-07-01,1936,"SC Fives Lille","FC Rouen","0-1",0,1,"1",1,1,-1,"D"
1937-07-01,1936,"RC Strasbourg","AS Cannes","1-0",1,0,"1",1,1,1,"H"
1937-07-01,1936,"Racing Club de France","FC Sete","0-2",0,2,"1",1,2,-2,"D"
1937-07-01,1936,"FC Sochaux","US Valenciennes-Anzin","6-1",6,1,"1",1,7,5,"H"
1937-07-01,1936,"Olympique Marseille","RC Lens","2-2",2,2,"1",1,4,0,"D"
1937-07-01,1936,"FC Antibes","SC Fives Lille","1-1",1,1,"1",1,2,0,"D"
1937-07-01,1936,"Excelsior Roubaix","Red Star Olympique","3-1",3,1,"1",1,4,2,"H"
1937-07-01,1936,"Olympique Lillois Lille","FC Metz","3-1",3,1,"1",1,4,2,"H"
1937-07-01,1936,"FC Rouen","RC Roubaix","2-0",2,0,"1",1,2,2,"H"
1937-07-01,1936,"AS Cannes","Olympique Marseille","1-1",1,1,"1",1,2,0,"D"
1937-07-01,1936,"RC Strasbourg","FC Metz","1-1",1,1,"1",1,2,0,"D"
1937-07-01,1936,"Red Star Olympique","FC Rouen","2-2",2,2,"1",1,4,0,"D"
1937-07-01,1936,"RC Lens","Excelsior Roubaix","2-2",2,2,"1",1,4,0,"D"
1937-07-01,1936,"US Valenciennes-Anzin","Olympique Lillois Lille","0-4",0,4,"1",1,4,-4,"D"
1937-07-01,1936,"SC Fives Lille","FC Sochaux","1-1",1,1,"1",1,2,0,"D"
1937-07-01,1936,"FC Sete","FC Antibes","0-0",0,0,"1",1,0,0,"D"
1937-07-01,1936,"RC Roubaix","Racing Club de France","2-1",2,1,"1",1,3,1,"H"
1937-07-01,1936,"AS Cannes","RC Lens","5-0",5,0,"1",1,5,5,"H"
1937-07-01,1936,"Olympique Marseille","RC Strasbourg","2-1",2,1,"1",1,3,1,"H"
1937-07-01,1936,"FC Rouen","FC Sochaux","1-3",1,3,"1",1,4,-2,"D"
1937-07-01,1936,"FC Metz","Red Star Olympique","3-0",3,0,"1",1,3,3,"H"
1937-07-01,1936,"US Valenciennes-Anzin","RC Roubaix","2-4",2,4,"1",1,6,-2,"D"
1937-07-01,1936,"Excelsior Roubaix","Olympique Lillois Lille","2-2",2,2,"1",1,4,0,"D"
1937-07-01,1936,"SC Fives Lille","FC Sete","1-2",1,2,"1",1,3,-1,"D"
1937-07-01,1936,"Racing Club de France","FC Antibes","1-2",1,2,"1",1,3,-1,"D"
1937-07-01,1936,"Red Star Olympique","AS Cannes","2-1",2,1,"1",1,3,1,"H"
1937-07-01,1936,"FC Sete","US Valenciennes-Anzin","3-0",3,0,"1",1,3,3,"H"
1937-07-01,1936,"RC Strasbourg","Racing Club de France","1-3",1,3,"1",1,4,-2,"D"
1937-07-01,1936,"FC Antibes","FC Rouen","0-1",0,1,"1",1,1,-1,"D"
1937-07-01,1936,"Olympique Lillois Lille","Olympique Marseille","1-1",1,1,"1",1,2,0,"D"
1937-07-01,1936,"RC Roubaix","FC Metz","2-3",2,3,"1",1,5,-1,"D"
1937-07-01,1936,"FC Sochaux","Excelsior Roubaix","1-1",1,1,"1",1,2,0,"D"
1937-07-01,1936,"RC Lens","SC Fives Lille","3-2",3,2,"1",1,5,1,"H"
1937-07-01,1936,"US Valenciennes-Anzin","RC Lens","1-3",1,3,"1",1,4,-2,"D"
1937-07-01,1936,"FC Rouen","RC Strasbourg","3-0",3,0,"1",1,3,3,"H"
1937-07-01,1936,"FC Metz","FC Sete","1-1",1,1,"1",1,2,0,"D"
1937-07-01,1936,"Olympique Marseille","FC Sochaux","2-0",2,0,"1",1,2,2,"H"
1937-07-01,1936,"Excelsior Roubaix","FC Antibes","2-1",2,1,"1",1,3,1,"H"
1937-07-01,1936,"SC Fives Lille","Red Star Olympique","3-0",3,0,"1",1,3,3,"H"
1937-07-01,1936,"Racing Club de France","Olympique Lillois Lille","1-0",1,0,"1",1,1,1,"H"
1937-07-01,1936,"AS Cannes","RC Roubaix","2-3",2,3,"1",1,5,-1,"D"
1937-07-01,1936,"FC Sete","AS Cannes","1-1",1,1,"1",1,2,0,"D"
1937-07-01,1936,"RC Lens","FC Metz","2-3",2,3,"1",1,5,-1,"D"
1937-07-01,1936,"Racing Club de France","FC Sochaux","0-4",0,4,"1",1,4,-4,"D"
1937-07-01,1936,"US Valenciennes-Anzin","Red Star Olympique","3-2",3,2,"1",1,5,1,"H"
1937-07-01,1936,"Olympique Lillois Lille","FC Rouen","4-0",4,0,"1",1,4,4,"H"
1937-07-01,1936,"FC Antibes","Olympique Marseille","0-3",0,3,"1",1,3,-3,"D"
1937-07-01,1936,"RC Strasbourg","Excelsior Roubaix","3-3",3,3,"1",1,6,0,"D"
1937-07-01,1936,"RC Roubaix","SC Fives Lille","0-0",0,0,"1",1,0,0,"D"
1937-07-01,1936,"FC Sete","RC Lens","3-1",3,1,"1",1,4,2,"H"
1937-07-01,1936,"Olympique Marseille","FC Rouen","1-1",1,1,"1",1,2,0,"D"
1937-07-01,1936,"FC Sochaux","RC Strasbourg","3-3",3,3,"1",1,6,0,"D"
1937-07-01,1936,"FC Metz","US Valenciennes-Anzin","1-0",1,0,"1",1,1,1,"H"
1937-07-01,1936,"Olympique Lillois Lille","FC Antibes","4-0",4,0,"1",1,4,4,"H"
1937-07-01,1936,"Excelsior Roubaix","Racing Club de France","3-2",3,2,"1",1,5,1,"H"
1937-07-01,1936,"AS Cannes","SC Fives Lille","1-1",1,1,"1",1,2,0,"D"
1937-07-01,1936,"Red Star Olympique","RC Roubaix","7-0",7,0,"1",1,7,7,"H"
1937-07-01,1936,"AS Cannes","US Valenciennes-Anzin","5-0",5,0,"1",1,5,5,"H"
1937-07-01,1936,"Red Star Olympique","FC Sete","1-4",1,4,"1",1,5,-3,"D"
1937-07-01,1936,"Olympique Marseille","Racing Club de France","2-1",2,1,"1",1,3,1,"H"
1937-07-01,1936,"FC Rouen","Excelsior Roubaix","1-3",1,3,"1",1,4,-2,"D"
1937-07-01,1936,"SC Fives Lille","FC Metz","3-0",3,0,"1",1,3,3,"H"
1937-07-01,1936,"FC Sochaux","Olympique Lillois Lille","2-0",2,0,"1",1,2,2,"H"
1937-07-01,1936,"RC Strasbourg","FC Antibes","3-0",3,0,"1",1,3,3,"H"
1937-07-01,1936,"RC Roubaix","RC Lens","3-1",3,1,"1",1,4,2,"H"
1937-07-01,1936,"FC Metz","AS Cannes","1-0",1,0,"1",1,1,1,"H"
1937-07-01,1936,"Racing Club de France","FC Rouen","2-1",2,1,"1",1,3,1,"H"
1937-07-01,1936,"RC Lens","Red Star Olympique","1-3",1,3,"1",1,4,-2,"D"
1937-07-01,1936,"Excelsior Roubaix","Olympique Marseille","4-2",4,2,"1",1,6,2,"H"
1937-07-01,1936,"Olympique Lillois Lille","RC Strasbourg","2-0",2,0,"1",1,2,2,"H"
1937-07-01,1936,"FC Sete","RC Roubaix","0-1",0,1,"1",1,1,-1,"D"
1937-07-01,1936,"FC Antibes","FC Sochaux","2-1",2,1,"1",1,3,1,"H"
1937-07-01,1936,"US Valenciennes-Anzin","SC Fives Lille","1-0",1,0,"1",1,1,1,"H"
1937-07-01,1936,"Racing Club de France","AS Cannes","3-1",3,1,"1",1,4,2,"H"
1937-07-01,1936,"RC Strasbourg","FC Sete","0-2",0,2,"1",1,2,-2,"D"
1937-07-01,1936,"FC Rouen","FC Metz","2-1",2,1,"1",1,3,1,"H"
1937-07-01,1936,"FC Sochaux","Red Star Olympique","3-1",3,1,"1",1,4,2,"H"
1937-07-01,1936,"Olympique Marseille","SC Fives Lille","1-1",1,1,"1",1,2,0,"D"
1937-07-01,1936,"FC Antibes","RC Lens","1-1",1,1,"1",1,2,0,"D"
1937-07-01,1936,"Olympique Lillois Lille","RC Roubaix","1-1",1,1,"1",1,2,0,"D"
1937-07-01,1936,"Excelsior Roubaix","US Valenciennes-Anzin","4-0",4,0,"1",1,4,4,"H"
1937-07-01,1936,"Red Star Olympique","Olympique Marseille","0-1",0,1,"1",1,1,-1,"D"
1937-07-01,1936,"RC Lens","RC Strasbourg","2-3",2,3,"1",1,5,-1,"D"
1937-07-01,1936,"FC Metz","FC Sochaux","2-2",2,2,"1",1,4,0,"D"
1937-07-01,1936,"FC Sete","FC Rouen","1-0",1,0,"1",1,1,1,"H"
1937-07-01,1936,"RC Roubaix","Excelsior Roubaix","2-1",2,1,"1",1,3,1,"H"
1937-07-01,1936,"SC Fives Lille","Racing Club de France","1-0",1,0,"1",1,1,1,"H"
1937-07-01,1936,"US Valenciennes-Anzin","FC Antibes","1-1",1,1,"1",1,2,0,"D"
1937-07-01,1936,"AS Cannes","Olympique Lillois Lille","3-1",3,1,"1",1,4,2,"H"
1937-07-01,1936,"AS Cannes","FC Rouen","6-1",6,1,"1",1,7,5,"H"
1937-07-01,1936,"US Valenciennes-Anzin","Olympique Marseille","1-2",1,2,"1",1,3,-1,"D"
1937-07-01,1936,"RC Lens","Racing Club de France","2-1",2,1,"1",1,3,1,"H"
1937-07-01,1936,"FC Metz","Excelsior Roubaix","1-2",1,2,"1",1,3,-1,"D"
1937-07-01,1936,"SC Fives Lille","RC Strasbourg","1-1",1,1,"1",1,2,0,"D"
1937-07-01,1936,"RC Roubaix","FC Sochaux","2-2",2,2,"1",1,4,0,"D"
1937-07-01,1936,"FC Sete","Olympique Lillois Lille","3-1",3,1,"1",1,4,2,"H"
1937-07-01,1936,"Red Star Olympique","FC Antibes","0-1",0,1,"1",1,1,-1,"D"
1937-07-01,1936,"Olympique Marseille","FC Metz","4-0",4,0,"1",1,4,4,"H"
1937-07-01,1936,"RC Strasbourg","US Valenciennes-Anzin","10-0",10,0,"1",1,10,10,"H"
1937-07-01,1936,"FC Rouen","RC Lens","3-1",3,1,"1",1,4,2,"H"
1937-07-01,1936,"Racing Club de France","Red Star Olympique","2-1",2,1,"1",1,3,1,"H"
1937-07-01,1936,"FC Sochaux","FC Sete","0-1",0,1,"1",1,1,-1,"D"
1937-07-01,1936,"Excelsior Roubaix","AS Cannes","2-2",2,2,"1",1,4,0,"D"
1937-07-01,1936,"FC Antibes","RC Roubaix","5-0",5,0,"1",1,5,5,"H"
1937-07-01,1936,"Olympique Lillois Lille","SC Fives Lille","2-1",2,1,"1",1,3,1,"H"
1937-07-01,1936,"FC Metz","Racing Club de France","4-4",4,4,"1",1,8,0,"D"
1937-07-01,1936,"RC Lens","FC Sochaux","0-2",0,2,"1",1,2,-2,"D"
1937-07-01,1936,"FC Sete","Olympique Marseille","1-1",1,1,"1",1,2,0,"D"
1937-07-01,1936,"US Valenciennes-Anzin","FC Rouen","1-9",1,9,"1",1,10,-8,"D"
1937-07-01,1936,"SC Fives Lille","Excelsior Roubaix","4-4",4,4,"1",1,8,0,"D"
1937-07-01,1936,"RC Roubaix","RC Strasbourg","0-2",0,2,"1",1,2,-2,"D"
1937-07-01,1936,"AS Cannes","FC Antibes","2-1",2,1,"1",1,3,1,"H"
1937-07-01,1936,"Red Star Olympique","Olympique Lillois Lille","3-2",3,2,"1",1,5,1,"H"
1937-07-01,1936,"FC Sochaux","AS Cannes","1-1",1,1,"1",1,2,0,"D"
1937-07-01,1936,"Racing Club de France","US Valenciennes-Anzin","0-3",0,3,"1",1,3,-3,"D"
1937-07-01,1936,"RC Strasbourg","Red Star Olympique","9-3",9,3,"1",1,12,6,"H"
1937-07-01,1936,"Olympique Lillois Lille","RC Lens","3-0",3,0,"1",1,3,3,"H"
1937-07-01,1936,"FC Antibes","FC Metz","2-0",2,0,"1",1,2,2,"H"
1937-07-01,1936,"Excelsior Roubaix","FC Sete","2-2",2,2,"1",1,4,0,"D"
1937-07-01,1936,"FC Rouen","SC Fives Lille","2-2",2,2,"1",1,4,0,"D"
1937-07-01,1936,"Olympique Marseille","RC Roubaix","5-1",5,1,"1",1,6,4,"H"
1938-09-04,1938,"FC Antibes","Olympique Lillois Lille","0-3",0,3,"1",1,3,-3,"D"
1938-09-04,1938,"Excelsior Roubaix","Le Havre AC","3-3",3,3,"1",1,6,0,"D"
1938-09-04,1938,"RC Strasbourg","FC Sete","1-3",1,3,"1",1,4,-2,"D"
1938-09-04,1938,"RC Lens","FC Metz","2-1",2,1,"1",1,3,1,"H"
1938-09-04,1938,"FC Sochaux","RC Roubaix","3-1",3,1,"1",1,4,2,"H"
1938-09-04,1938,"Olympique Marseille","Racing Club de France","5-2",5,2,"1",1,7,3,"H"
1938-09-04,1938,"FC Rouen","AS Cannes","2-1",2,1,"1",1,3,1,"H"
1938-09-04,1938,"SC Fives Lille","AS Saint-Etienne","3-2",3,2,"1",1,5,1,"H"
1938-09-11,1938,"AS Cannes","FC Sochaux","0-0",0,0,"1",1,0,0,"D"
1938-09-11,1938,"RC Roubaix","Olympique Marseille","1-0",1,0,"1",1,1,1,"H"
1938-09-11,1938,"Racing Club de France","SC Fives Lille","2-2",2,2,"1",1,4,0,"D"
1938-09-11,1938,"FC Metz","RC Strasbourg","2-1",2,1,"1",1,3,1,"H"
1938-09-11,1938,"FC Sete","Excelsior Roubaix","4-2",4,2,"1",1,6,2,"H"
1938-09-11,1938,"Le Havre AC","FC Antibes","2-0",2,0,"1",1,2,2,"H"
1938-09-11,1938,"Olympique Lillois Lille","RC Lens","2-0",2,0,"1",1,2,2,"H"
1938-09-11,1938,"AS Saint-Etienne","FC Rouen","2-1",2,1,"1",1,3,1,"H"
1938-09-18,1938,"FC Antibes","SC Fives Lille","0-3",0,3,"1",1,3,-3,"D"
1938-09-18,1938,"Excelsior Roubaix","FC Rouen","1-1",1,1,"1",1,2,0,"D"
1938-09-18,1938,"RC Strasbourg","FC Sochaux","2-0",2,0,"1",1,2,2,"H"
1938-09-18,1938,"RC Lens","Olympique Marseille","2-3",2,3,"1",1,5,-1,"D"
1938-09-18,1938,"FC Sete","FC Metz","6-3",6,3,"1",1,9,3,"H"
1938-09-18,1938,"Le Havre AC","Racing Club de France","2-1",2,1,"1",1,3,1,"H"
1938-09-18,1938,"Olympique Lillois Lille","RC Roubaix","2-1",2,1,"1",1,3,1,"H"
1938-09-18,1938,"AS Saint-Etienne","AS Cannes","2-0",2,0,"1",1,2,2,"H"
1938-09-25,1938,"Olympique Marseille","Excelsior Roubaix","4-2",4,2,"1",1,6,2,"H"
1938-09-25,1938,"FC Sochaux","FC Antibes","2-0",2,0,"1",1,2,2,"H"
1938-09-25,1938,"FC Rouen","RC Lens","3-0",3,0,"1",1,3,3,"H"
1938-09-25,1938,"SC Fives Lille","RC Strasbourg","2-0",2,0,"1",1,2,2,"H"
1938-09-25,1938,"AS Cannes","Le Havre AC","3-2",3,2,"1",1,5,1,"H"
1938-09-25,1938,"RC Roubaix","FC Sete","1-0",1,0,"1",1,1,1,"H"
1938-09-25,1938,"Racing Club de France","AS Saint-Etienne","1-1",1,1,"1",1,2,0,"D"
1938-09-25,1938,"FC Metz","Olympique Lillois Lille","0-1",0,1,"1",1,1,-1,"D"
1938-10-02,1938,"FC Antibes","FC Rouen","0-0",0,0,"1",1,0,0,"D"
1938-10-02,1938,"Excelsior Roubaix","FC Sochaux","3-2",3,2,"1",1,5,1,"H"
1938-10-02,1938,"RC Strasbourg","Olympique Marseille","1-0",1,0,"1",1,1,1,"H"
1938-10-02,1938,"RC Lens","SC Fives Lille","1-0",1,0,"1",1,1,1,"H"
1938-10-02,1938,"FC Sete","Racing Club de France","5-0",5,0,"1",1,5,5,"H"
1938-10-02,1938,"Le Havre AC","RC Roubaix","5-2",5,2,"1",1,7,3,"H"
1938-10-02,1938,"Olympique Lillois Lille","AS Cannes","0-0",0,0,"1",1,0,0,"D"
1938-10-02,1938,"AS Saint-Etienne","FC Metz","0-1",0,1,"1",1,1,-1,"D"
1938-10-09,1938,"RC Strasbourg","FC Rouen","5-1",5,1,"1",1,6,4,"H"
1938-10-09,1938,"Olympique Marseille","FC Antibes","5-2",5,2,"1",1,7,3,"H"
1938-10-09,1938,"FC Sochaux","RC Lens","0-2",0,2,"1",1,2,-2,"D"
1938-10-09,1938,"SC Fives Lille","Excelsior Roubaix","4-2",4,2,"1",1,6,2,"H"
1938-10-09,1938,"AS Cannes","FC Sete","3-2",3,2,"1",1,5,1,"H"
1938-10-09,1938,"RC Roubaix","AS Saint-Etienne","2-2",2,2,"1",1,4,0,"D"
1938-10-09,1938,"Racing Club de France","Olympique Lillois Lille","2-2",2,2,"1",1,4,0,"D"
1938-10-09,1938,"Le Havre AC","FC Metz","0-3",0,3,"1",1,3,-3,"D"
1938-10-16,1938,"Excelsior Roubaix","RC Strasbourg","6-1",6,1,"1",1,7,5,"H"
1938-10-16,1938,"RC Lens","FC Antibes","1-1",1,1,"1",1,2,0,"D"
1938-10-16,1938,"FC Rouen","FC Sochaux","1-0",1,0,"1",1,1,1,"H"
1938-10-16,1938,"SC Fives Lille","Olympique Marseille","0-0",0,0,"1",1,0,0,"D"
1938-10-16,1938,"AS Cannes","Racing Club de France","1-2",1,2,"1",1,3,-1,"D"
1938-10-16,1938,"FC Metz","RC Roubaix","1-0",1,0,"1",1,1,1,"H"
1938-10-16,1938,"FC Sete","Olympique Lillois Lille","2-2",2,2,"1",1,4,0,"D"
1938-10-16,1938,"AS Saint-Etienne","Le Havre AC","0-0",0,0,"1",1,0,0,"D"
1938-10-23,1938,"FC Antibes","RC Strasbourg","1-1",1,1,"1",1,2,0,"D"
1938-10-23,1938,"RC Lens","Excelsior Roubaix","2-2",2,2,"1",1,4,0,"D"
1938-10-23,1938,"FC Sochaux","SC Fives Lille","5-2",5,2,"1",1,7,3,"H"
1938-10-23,1938,"FC Rouen","Olympique Marseille","1-2",1,2,"1",1,3,-1,"D"
1938-10-23,1938,"RC Roubaix","Racing Club de France","0-3",0,3,"1",1,3,-3,"D"
1938-10-23,1938,"FC Metz","AS Cannes","2-1",2,1,"1",1,3,1,"H"
1938-10-23,1938,"FC Sete","AS Saint-Etienne","2-1",2,1,"1",1,3,1,"H"
1938-10-23,1938,"Olympique Lillois Lille","Le Havre AC","1-0",1,0,"1",1,1,1,"H"
1938-10-30,1938,"Excelsior Roubaix","FC Antibes","0-2",0,2,"1",1,2,-2,"D"
1938-10-30,1938,"RC Strasbourg","RC Lens","3-2",3,2,"1",1,5,1,"H"
1938-10-30,1938,"Olympique Marseille","FC Sochaux","1-0",1,0,"1",1,1,1,"H"
1938-10-30,1938,"SC Fives Lille","FC Rouen","1-0",1,0,"1",1,1,1,"H"
1938-10-30,1938,"AS Cannes","RC Roubaix","4-1",4,1,"1",1,5,3,"H"
1938-10-30,1938,"Racing Club de France","FC Metz","3-2",3,2,"1",1,5,1,"H"
1938-10-30,1938,"Le Havre AC","FC Sete","2-1",2,1,"1",1,3,1,"H"
1938-10-30,1938,"AS Saint-Etienne","Olympique Lillois Lille","2-0",2,0,"1",1,2,2,"H"
1938-11-06,1938,"AS Cannes","RC Lens","2-1",2,1,"1",1,3,1,"H"
1938-11-06,1938,"RC Roubaix","RC Strasbourg","2-0",2,0,"1",1,2,2,"H"
1938-11-06,1938,"Racing Club de France","Excelsior Roubaix","3-1",3,1,"1",1,4,2,"H"
1938-11-06,1938,"FC Metz","FC Antibes","6-0",6,0,"1",1,6,6,"H"
1938-11-06,1938,"FC Sete","SC Fives Lille","2-0",2,0,"1",1,2,2,"H"
1938-11-06,1938,"Le Havre AC","FC Rouen","1-1",1,1,"1",1,2,0,"D"
1938-11-06,1938,"AS Saint-Etienne","Olympique Marseille","1-0",1,0,"1",1,1,1,"H"
1938-11-06,1938,"Olympique Lillois Lille","FC Sochaux","2-0",2,0,"1",1,2,2,"H"
1938-11-11,1938,"FC Antibes","AS Cannes","0-0",0,0,"1",1,0,0,"D"
1938-11-11,1938,"Excelsior Roubaix","AS Saint-Etienne","1-0",1,0,"1",1,1,1,"H"
1938-11-11,1938,"RC Strasbourg","Olympique Lillois Lille","1-2",1,2,"1",1,3,-1,"D"
1938-11-11,1938,"RC Lens","Le Havre AC","4-2",4,2,"1",1,6,2,"H"
1938-11-11,1938,"Olympique Marseille","FC Sete","1-1",1,1,"1",1,2,0,"D"
1938-11-11,1938,"FC Sochaux","FC Metz","0-1",0,1,"1",1,1,-1,"D"
1938-11-11,1938,"FC Rouen","Racing Club de France","3-1",3,1,"1",1,4,2,"H"
1938-11-11,1938,"SC Fives Lille","RC Roubaix","1-3",1,3,"1",1,4,-2,"D"
1938-11-13,1938,"FC Antibes","FC Sete","0-2",0,2,"1",1,2,-2,"D"
1938-11-13,1938,"Excelsior Roubaix","FC Metz","3-1",3,1,"1",1,4,2,"H"
1938-11-13,1938,"RC Strasbourg","Racing Club de France","1-1",1,1,"1",1,2,0,"D"
1938-11-13,1938,"RC Lens","RC Roubaix","3-1",3,1,"1",1,4,2,"H"
1938-11-13,1938,"Olympique Marseille","AS Cannes","0-1",0,1,"1",1,1,-1,"D"
1938-11-13,1938,"FC Sochaux","AS Saint-Etienne","1-2",1,2,"1",1,3,-1,"D"
1938-11-13,1938,"FC Rouen","Olympique Lillois Lille","0-0",0,0,"1",1,0,0,"D"
1938-11-13,1938,"SC Fives Lille","Le Havre AC","7-3",7,3,"1",1,10,4,"H"
1938-11-20,1938,"AS Cannes","SC Fives Lille","1-5",1,5,"1",1,6,-4,"D"
1938-11-20,1938,"RC Roubaix","FC Rouen","1-2",1,2,"1",1,3,-1,"D"
1938-11-20,1938,"Racing Club de France","FC Sochaux","6-1",6,1,"1",1,7,5,"H"
1938-11-20,1938,"FC Metz","Olympique Marseille","5-1",5,1,"1",1,6,4,"H"
1938-11-20,1938,"FC Sete","RC Lens","2-2",2,2,"1",1,4,0,"D"
1938-11-20,1938,"Le Havre AC","RC Strasbourg","2-1",2,1,"1",1,3,1,"H"
1938-11-20,1938,"Olympique Lillois Lille","Excelsior Roubaix","4-3",4,3,"1",1,7,1,"H"
1938-11-20,1938,"AS Saint-Etienne","FC Antibes","1-0",1,0,"1",1,1,1,"H"
1938-12-11,1938,"FC Antibes","RC Roubaix","1-0",1,0,"1",1,1,1,"H"
1938-12-11,1938,"Excelsior Roubaix","AS Cannes","3-5",3,5,"1",1,8,-2,"D"
1938-12-11,1938,"RC Strasbourg","AS Saint-Etienne","1-1",1,1,"1",1,2,0,"D"
1938-12-11,1938,"RC Lens","Racing Club de France","1-1",1,1,"1",1,2,0,"D"
1938-12-11,1938,"Olympique Marseille","Le Havre AC","0-2",0,2,"1",1,2,-2,"D"
1938-12-11,1938,"FC Sochaux","FC Sete","1-1",1,1,"1",1,2,0,"D"
1938-12-11,1938,"FC Rouen","FC Metz","2-2",2,2,"1",1,4,0,"D"
1938-12-11,1938,"SC Fives Lille","Olympique Lillois Lille","3-1",3,1,"1",1,4,2,"H"
1938-12-25,1938,"AS Cannes","RC Strasbourg","1-1",1,1,"1",1,2,0,"D"
1938-12-25,1938,"RC Roubaix","Excelsior Roubaix","1-1",1,1,"1",1,2,0,"D"
1938-12-25,1938,"Racing Club de France","FC Antibes","3-0",3,0,"1",1,3,3,"H"
1938-12-25,1938,"FC Metz","SC Fives Lille","1-3",1,3,"1",1,4,-2,"D"
1938-12-25,1938,"FC Sete","FC Rouen","2-0",2,0,"1",1,2,2,"H"
1938-12-25,1938,"Le Havre AC","FC Sochaux","2-1",2,1,"1",1,3,1,"H"
1938-12-25,1938,"Olympique Lillois Lille","Olympique Marseille","0-1",0,1,"1",1,1,-1,"D"
1938-12-25,1938,"AS Saint-Etienne","RC Lens","1-1",1,1,"1",1,2,0,"D"
1939-01-01,1938,"Olympique Lillois Lille","FC Antibes","2-0",2,0,"1",1,2,2,"H"
1939-01-01,1938,"Le Havre AC","Excelsior Roubaix","1-3",1,3,"1",1,4,-2,"D"
1939-01-01,1938,"FC Sete","RC Strasbourg","2-0",2,0,"1",1,2,2,"H"
1939-01-01,1938,"FC Metz","RC Lens","1-1",1,1,"1",1,2,0,"D"
1939-01-01,1938,"Racing Club de France","Olympique Marseille","1-1",1,1,"1",1,2,0,"D"
1939-01-01,1938,"RC Roubaix","FC Sochaux","1-4",1,4,"1",1,5,-3,"D"
1939-01-01,1938,"AS Cannes","FC Rouen","2-0",2,0,"1",1,2,2,"H"
1939-01-01,1938,"AS Saint-Etienne","SC Fives Lille","2-0",2,0,"1",1,2,2,"H"
1939-01-15,1938,"FC Sochaux","AS Cannes","7-3",7,3,"1",1,10,4,"H"
1939-01-15,1938,"Olympique Marseille","RC Roubaix","6-0",6,0,"1",1,6,6,"H"
1939-01-15,1938,"SC Fives Lille","Racing Club de France","0-1",0,1,"1",1,1,-1,"D"
1939-01-15,1938,"RC Strasbourg","FC Metz","0-0",0,0,"1",1,0,0,"D"
1939-01-15,1938,"Excelsior Roubaix","FC Sete","2-3",2,3,"1",1,5,-1,"D"
1939-01-15,1938,"FC Antibes","Le Havre AC","1-0",1,0,"1",1,1,1,"H"
1939-01-15,1938,"RC Lens","Olympique Lillois Lille","3-1",3,1,"1",1,4,2,"H"
1939-01-15,1938,"FC Rouen","AS Saint-Etienne","0-2",0,2,"1",1,2,-2,"D"
1939-01-29,1938,"SC Fives Lille","FC Antibes","4-1",4,1,"1",1,5,3,"H"
1939-01-29,1938,"FC Rouen","Excelsior Roubaix","2-2",2,2,"1",1,4,0,"D"
1939-01-29,1938,"FC Sochaux","RC Strasbourg","2-0",2,0,"1",1,2,2,"H"
1939-01-29,1938,"Olympique Marseille","RC Lens","2-0",2,0,"1",1,2,2,"H"
1939-01-29,1938,"FC Metz","FC Sete","0-2",0,2,"1",1,2,-2,"D"
1939-01-29,1938,"Racing Club de France","Le Havre AC","3-0",3,0,"1",1,3,3,"H"
1939-01-29,1938,"RC Roubaix","Olympique Lillois Lille","0-0",0,0,"1",1,0,0,"D"
1939-01-29,1938,"AS Cannes","AS Saint-Etienne","1-2",1,2,"1",1,3,-1,"D"
1939-02-12,1938,"Excelsior Roubaix","Olympique Marseille","1-2",1,2,"1",1,3,-1,"D"
1939-02-12,1938,"FC Antibes","FC Sochaux","0-0",0,0,"1",1,0,0,"D"
1939-02-12,1938,"RC Lens","FC Rouen","0-2",0,2,"1",1,2,-2,"D"
1939-02-12,1938,"RC Strasbourg","SC Fives Lille","3-1",3,1,"1",1,4,2,"H"
1939-02-12,1938,"Le Havre AC","AS Cannes","3-0",3,0,"1",1,3,3,"H"
1939-02-12,1938,"FC Sete","RC Roubaix","3-1",3,1,"1",1,4,2,"H"
1939-02-12,1938,"AS Saint-Etienne","Racing Club de France","0-1",0,1,"1",1,1,-1,"D"
1939-02-12,1938,"Olympique Lillois Lille","FC Metz","3-2",3,2,"1",1,5,1,"H"
1939-02-26,1938,"FC Rouen","FC Antibes","0-1",0,1,"1",1,1,-1,"D"
1939-02-26,1938,"FC Sochaux","Excelsior Roubaix","8-0",8,0,"1",1,8,8,"H"
1939-02-26,1938,"Olympique Marseille","RC Strasbourg","1-0",1,0,"1",1,1,1,"H"
1939-02-26,1938,"SC Fives Lille","RC Lens","0-4",0,4,"1",1,4,-4,"D"
1939-02-26,1938,"Racing Club de France","FC Sete","3-0",3,0,"1",1,3,3,"H"
1939-02-26,1938,"RC Roubaix","Le Havre AC","1-1",1,1,"1",1,2,0,"D"
1939-02-26,1938,"AS Cannes","Olympique Lillois Lille","1-2",1,2,"1",1,3,-1,"D"
1939-02-26,1938,"FC Metz","AS Saint-Etienne","1-0",1,0,"1",1,1,1,"H"
1939-03-05,1938,"FC Rouen","RC Strasbourg","1-1",1,1,"1",1,2,0,"D"
1939-03-05,1938,"FC Antibes","Olympique Marseille","2-2",2,2,"1",1,4,0,"D"
1939-03-05,1938,"RC Lens","FC Sochaux","2-2",2,2,"1",1,4,0,"D"
1939-03-05,1938,"Excelsior Roubaix","SC Fives Lille","3-1",3,1,"1",1,4,2,"H"
1939-03-05,1938,"FC Sete","AS Cannes","3-0",3,0,"1",1,3,3,"H"
1939-03-05,1938,"Olympique Lillois Lille","Racing Club de France","0-2",0,2,"1",1,2,-2,"D"
1939-03-05,1938,"FC Metz","Le Havre AC","2-1",2,1,"1",1,3,1,"H"
1939-03-05,1938,"AS Saint-Etienne","RC Roubaix","5-0",5,0,"1",1,5,5,"H"
1939-03-12,1938,"RC Strasbourg","Excelsior Roubaix","3-1",3,1,"1",1,4,2,"H"
1939-03-12,1938,"FC Antibes","RC Lens","1-0",1,0,"1",1,1,1,"H"
1939-03-12,1938,"FC Sochaux","FC Rouen","2-0",2,0,"1",1,2,2,"H"
1939-03-12,1938,"Olympique Marseille","SC Fives Lille","2-0",2,0,"1",1,2,2,"H"
1939-03-12,1938,"Racing Club de France","AS Cannes","5-1",5,1,"1",1,6,4,"H"
1939-03-12,1938,"RC Roubaix","FC Metz","1-2",1,2,"1",1,3,-1,"D"
1939-03-12,1938,"Olympique Lillois Lille","FC Sete","1-0",1,0,"1",1,1,1,"H"
1939-03-12,1938,"Le Havre AC","AS Saint-Etienne","2-4",2,4,"1",1,6,-2,"D"
1939-03-19,1938,"RC Strasbourg","FC Antibes","2-1",2,1,"1",1,3,1,"H"
1939-03-19,1938,"Excelsior Roubaix","RC Lens","0-1",0,1,"1",1,1,-1,"D"
1939-03-19,1938,"SC Fives Lille","FC Sochaux","2-4",2,4,"1",1,6,-2,"D"
1939-03-19,1938,"Olympique Marseille","FC Rouen","1-0",1,0,"1",1,1,1,"H"
1939-03-19,1938,"Racing Club de France","RC Roubaix","1-1",1,1,"1",1,2,0,"D"
1939-03-19,1938,"AS Cannes","FC Metz","2-1",2,1,"1",1,3,1,"H"
1939-03-19,1938,"AS Saint-Etienne","FC Sete","3-1",3,1,"1",1,4,2,"H"
1939-03-19,1938,"Le Havre AC","Olympique Lillois Lille","1-0",1,0,"1",1,1,1,"H"
1939-03-26,1938,"FC Antibes","Excelsior Roubaix","3-0",3,0,"1",1,3,3,"H"
1939-03-26,1938,"RC Lens","RC Strasbourg","1-1",1,1,"1",1,2,0,"D"
1939-03-26,1938,"FC Sochaux","Olympique Marseille","2-0",2,0,"1",1,2,2,"H"
1939-03-26,1938,"FC Rouen","SC Fives Lille","2-3",2,3,"1",1,5,-1,"D"
1939-03-26,1938,"RC Roubaix","AS Cannes","1-1",1,1,"1",1,2,0,"D"
1939-03-26,1938,"FC Metz","Racing Club de France","3-0",3,0,"1",1,3,3,"H"
1939-03-26,1938,"FC Sete","Le Havre AC","3-2",3,2,"1",1,5,1,"H"
1939-03-26,1938,"Olympique Lillois Lille","AS Saint-Etienne","3-1",3,1,"1",1,4,2,"H"
1939-04-02,1938,"RC Lens","AS Cannes","6-2",6,2,"1",1,8,4,"H"
1939-04-02,1938,"RC Strasbourg","RC Roubaix","2-0",2,0,"1",1,2,2,"H"
1939-04-02,1938,"Excelsior Roubaix","Racing Club de France","6-2",6,2,"1",1,8,4,"H"
1939-04-02,1938,"FC Antibes","FC Metz","1-1",1,1,"1",1,2,0,"D"
1939-04-02,1938,"SC Fives Lille","FC Sete","1-3",1,3,"1",1,4,-2,"D"
1939-04-02,1938,"FC Rouen","Le Havre AC","1-4",1,4,"1",1,5,-3,"D"
1939-04-02,1938,"FC Sochaux","Olympique Lillois Lille","4-1",4,1,"1",1,5,3,"H"
1939-04-02,1938,"Olympique Marseille","AS Saint-Etienne","3-1",3,1,"1",1,4,2,"H"
1939-04-08,1938,"AS Cannes","FC Antibes","3-0",3,0,"1",1,3,3,"H"
1939-04-08,1938,"AS Saint-Etienne","Excelsior Roubaix","2-2",2,2,"1",1,4,0,"D"
1939-04-08,1938,"Olympique Lillois Lille","RC Strasbourg","0-1",0,1,"1",1,1,-1,"D"
1939-04-08,1938,"Le Havre AC","RC Lens","2-2",2,2,"1",1,4,0,"D"
1939-04-08,1938,"FC Sete","Olympique Marseille","1-2",1,2,"1",1,3,-1,"D"
1939-04-08,1938,"FC Metz","FC Sochaux","0-3",0,3,"1",1,3,-3,"D"
1939-04-08,1938,"Racing Club de France","FC Rouen","3-0",3,0,"1",1,3,3,"H"
1939-04-08,1938,"RC Roubaix","SC Fives Lille","3-3",3,3,"1",1,6,0,"D"
1939-04-10,1938,"FC Sete","FC Antibes","4-0",4,0,"1",1,4,4,"H"
1939-04-10,1938,"FC Metz","Excelsior Roubaix","1-1",1,1,"1",1,2,0,"D"
1939-04-10,1938,"Racing Club de France","RC Strasbourg","3-2",3,2,"1",1,5,1,"H"
1939-04-10,1938,"RC Roubaix","RC Lens","1-5",1,5,"1",1,6,-4,"D"
1939-04-10,1938,"AS Cannes","Olympique Marseille","2-4",2,4,"1",1,6,-2,"D"
1939-04-10,1938,"AS Saint-Etienne","FC Sochaux","2-1",2,1,"1",1,3,1,"H"
1939-04-10,1938,"Olympique Lillois Lille","FC Rouen","5-3",5,3,"1",1,8,2,"H"
1939-04-10,1938,"Le Havre AC","SC Fives Lille","0-0",0,0,"1",1,0,0,"D"
1939-04-16,1938,"SC Fives Lille","AS Cannes","3-1",3,1,"1",1,4,2,"H"
1939-04-16,1938,"FC Rouen","RC Roubaix","0-0",0,0,"1",1,0,0,"D"
1939-04-16,1938,"FC Sochaux","Racing Club de France","1-0",1,0,"1",1,1,1,"H"
1939-04-16,1938,"Olympique Marseille","FC Metz","5-1",5,1,"1",1,6,4,"H"
1939-04-16,1938,"RC Lens","FC Sete","1-2",1,2,"1",1,3,-1,"D"
1939-04-16,1938,"RC Strasbourg","Le Havre AC","3-1",3,1,"1",1,4,2,"H"
1939-04-16,1938,"Excelsior Roubaix","Olympique Lillois Lille","1-1",1,1,"1",1,2,0,"D"
1939-04-16,1938,"FC Antibes","AS Saint-Etienne","0-4",0,4,"1",1,4,-4,"D"
1939-04-30,1938,"RC Roubaix","FC Antibes","2-2",2,2,"1",1,4,0,"D"
1939-04-30,1938,"AS Cannes","Excelsior Roubaix","2-1",2,1,"1",1,3,1,"H"
1939-04-30,1938,"AS Saint-Etienne","RC Strasbourg","0-0",0,0,"1",1,0,0,"D"
1939-04-30,1938,"Racing Club de France","RC Lens","1-0",1,0,"1",1,1,1,"H"
1939-04-30,1938,"Le Havre AC","Olympique Marseille","2-0",2,0,"1",1,2,2,"H"
1939-04-30,1938,"FC Sete","FC Sochaux","2-1",2,1,"1",1,3,1,"H"
1939-04-30,1938,"FC Metz","FC Rouen","2-2",2,2,"1",1,4,0,"D"
1939-04-30,1938,"Olympique Lillois Lille","SC Fives Lille","1-2",1,2,"1",1,3,-1,"D"
1939-05-07,1938,"RC Strasbourg","AS Cannes","1-3",1,3,"1",1,4,-2,"D"
1939-05-07,1938,"Excelsior Roubaix","RC Roubaix","4-2",4,2,"1",1,6,2,"H"
1939-05-07,1938,"FC Antibes","Racing Club de France","1-1",1,1,"1",1,2,0,"D"
1939-05-07,1938,"SC Fives Lille","FC Metz","1-1",1,1,"1",1,2,0,"D"
1939-05-07,1938,"FC Rouen","FC Sete","0-1",0,1,"1",1,1,-1,"D"
1939-05-07,1938,"FC Sochaux","Le Havre AC","8-0",8,0,"1",1,8,8,"H"
1939-05-07,1938,"Olympique Marseille","Olympique Lillois Lille","2-0",2,0,"1",1,2,2,"H"
1939-05-07,1938,"RC Lens","AS Saint-Etienne","1-0",1,0,"1",1,1,1,"H"
1945-08-26,1945,"RC Lens","FC Sete","5-1",5,1,"1",1,6,4,"H"
1945-08-26,1945,"AS Saint-Etienne","RC Roubaix","1-3",1,3,"1",1,4,-2,"D"
1945-08-26,1945,"Lille OSC","AS Cannes","5-1",5,1,"1",1,6,4,"H"
1945-08-26,1945,"Stade Rennes","FC Rouen","2-0",2,0,"1",1,2,2,"H"
1945-08-26,1945,"Racing Club de France","Olympique Marseille","2-6",2,6,"1",1,8,-4,"D"
1945-08-26,1945,"Red Star Olympique","FC Metz","2-3",2,3,"1",1,5,-1,"D"
1945-08-26,1945,"Le Havre AC","Stade Reims","2-3",2,3,"1",1,5,-1,"D"
1945-08-26,1945,"FC Sochaux","Olympique Lyon","1-3",1,3,"1",1,4,-2,"D"
1945-08-26,1945,"Girondins Bordeaux","RC Strasbourg","4-3",4,3,"1",1,7,1,"H"
1945-09-02,1945,"RC Roubaix","FC Sochaux","2-2",2,2,"1",1,4,0,"D"
1945-09-02,1945,"FC Rouen","Racing Club de France","2-0",2,0,"1",1,2,2,"H"
1945-09-02,1945,"RC Strasbourg","Stade Rennes","1-1",1,1,"1",1,2,0,"D"
1945-09-02,1945,"Girondins Bordeaux","FC Sete","0-3",0,3,"1",1,3,-3,"D"
1945-09-02,1945,"Stade Reims","RC Lens","1-2",1,2,"1",1,3,-1,"D"
1945-09-02,1945,"Red Star Olympique","Le Havre AC","3-0",3,0,"1",1,3,3,"H"
1945-09-02,1945,"AS Saint-Etienne","Olympique Marseille","2-4",2,4,"1",1,6,-2,"D"
1945-09-02,1945,"AS Cannes","FC Metz","0-1",0,1,"1",1,1,-1,"D"
1945-09-02,1945,"Olympique Lyon","Lille OSC","1-2",1,2,"1",1,3,-1,"D"
1945-09-09,1945,"FC Sochaux","Olympique Marseille","1-0",1,0,"1",1,1,1,"H"
1945-09-09,1945,"RC Roubaix","Olympique Lyon","5-0",5,0,"1",1,5,5,"H"
1945-09-09,1945,"FC Metz","Lille OSC","0-3",0,3,"1",1,3,-3,"D"
1945-09-09,1945,"Le Havre AC","AS Cannes","1-2",1,2,"1",1,3,-1,"D"
1945-09-09,1945,"RC Lens","Red Star Olympique","1-1",1,1,"1",1,2,0,"D"
1945-09-09,1945,"Girondins Bordeaux","Stade Reims","5-1",5,1,"1",1,6,4,"H"
1945-09-09,1945,"Stade Rennes","FC Sete","3-3",3,3,"1",1,6,0,"D"
1945-09-09,1945,"Racing Club de France","RC Strasbourg","2-1",2,1,"1",1,3,1,"H"
1945-09-09,1945,"AS Saint-Etienne","FC Rouen","3-1",3,1,"1",1,4,2,"H"
1945-09-16,1945,"Lille OSC","Le Havre AC","1-0",1,0,"1",1,1,1,"H"
1945-09-16,1945,"Olympique Marseille","RC Roubaix","0-2",0,2,"1",1,2,-2,"D"
1945-09-16,1945,"FC Rouen","FC Sochaux","1-1",1,1,"1",1,2,0,"D"
1945-09-16,1945,"RC Strasbourg","AS Saint-Etienne","3-2",3,2,"1",1,5,1,"H"
1945-09-16,1945,"FC Sete","Racing Club de France","3-2",3,2,"1",1,5,1,"H"
1945-09-16,1945,"Stade Reims","Stade Rennes","5-0",5,0,"1",1,5,5,"H"
1945-09-16,1945,"Red Star Olympique","Girondins Bordeaux","4-2",4,2,"1",1,6,2,"H"
1945-09-16,1945,"AS Cannes","RC Lens","1-0",1,0,"1",1,1,1,"H"
1945-09-16,1945,"Olympique Lyon","FC Metz","2-0",2,0,"1",1,2,2,"H"
1945-09-23,1945,"FC Sochaux","RC Strasbourg","4-2",4,2,"1",1,6,2,"H"
1945-09-23,1945,"RC Roubaix","FC Rouen","0-0",0,0,"1",1,0,0,"D"
1945-09-23,1945,"Olympique Marseille","Olympique Lyon","1-1",1,1,"1",1,2,0,"D"
1945-09-23,1945,"Le Havre AC","FC Metz","3-0",3,0,"1",1,3,3,"H"
1945-09-23,1945,"RC Lens","Lille OSC","3-1",3,1,"1",1,4,2,"H"
1945-09-23,1945,"Girondins Bordeaux","AS Cannes","4-1",4,1,"1",1,5,3,"H"
1945-09-23,1945,"Stade Rennes","Red Star Olympique","1-0",1,0,"1",1,1,1,"H"
1945-09-23,1945,"Racing Club de France","Stade Reims","2-1",2,1,"1",1,3,1,"H"
1945-09-23,1945,"AS Saint-Etienne","FC Sete","6-2",6,2,"1",1,8,4,"H"
1945-09-30,1945,"Lille OSC","Girondins Bordeaux","5-0",5,0,"1",1,5,5,"H"
1945-09-30,1945,"FC Metz","RC Lens","2-3",2,3,"1",1,5,-1,"D"
1945-09-30,1945,"FC Rouen","Olympique Marseille","6-0",6,0,"1",1,6,6,"H"
1945-09-30,1945,"RC Strasbourg","RC Roubaix","2-1",2,1,"1",1,3,1,"H"
1945-09-30,1945,"FC Sete","FC Sochaux","4-0",4,0,"1",1,4,4,"H"
1945-09-30,1945,"Stade Reims","AS Saint-Etienne","1-3",1,3,"1",1,4,-2,"D"
1945-09-30,1945,"Red Star Olympique","Racing Club de France","0-1",0,1,"1",1,1,-1,"D"
1945-09-30,1945,"AS Cannes","Stade Rennes","2-2",2,2,"1",1,4,0,"D"
1945-09-30,1945,"Olympique Lyon","Le Havre AC","1-0",1,0,"1",1,1,1,"H"
1945-10-07,1945,"FC Sochaux","Stade Reims","1-1",1,1,"1",1,2,0,"D"
1945-10-07,1945,"RC Roubaix","FC Sete","3-1",3,1,"1",1,4,2,"H"
1945-10-07,1945,"Olympique Marseille","RC Strasbourg","5-0",5,0,"1",1,5,5,"H"
1945-10-07,1945,"FC Rouen","Olympique Lyon","2-1",2,1,"1",1,3,1,"H"
1945-10-07,1945,"RC Lens","Le Havre AC","7-1",7,1,"1",1,8,6,"H"
1945-10-07,1945,"Girondins Bordeaux","FC Metz","8-0",8,0,"1",1,8,8,"H"
1945-10-07,1945,"Stade Rennes","Lille OSC","1-4",1,4,"1",1,5,-3,"D"
1945-10-07,1945,"Racing Club de France","AS Cannes","0-3",0,3,"1",1,3,-3,"D"
1945-10-07,1945,"AS Saint-Etienne","Red Star Olympique","3-2",3,2,"1",1,5,1,"H"
1945-10-14,1945,"Lille OSC","Racing Club de France","0-1",0,1,"1",1,1,-1,"D"
1945-10-14,1945,"FC Metz","Stade Rennes","0-1",0,1,"1",1,1,-1,"D"
1945-10-14,1945,"Le Havre AC","Girondins Bordeaux","3-2",3,2,"1",1,5,1,"H"
1945-10-14,1945,"RC Strasbourg","FC Rouen","0-1",0,1,"1",1,1,-1,"D"
1945-10-14,1945,"FC Sete","Olympique Marseille","2-3",2,3,"1",1,5,-1,"D"
1945-10-14,1945,"Stade Reims","RC Roubaix","1-1",1,1,"1",1,2,0,"D"
1945-10-14,1945,"Red Star Olympique","FC Sochaux","4-1",4,1,"1",1,5,3,"H"
1945-10-14,1945,"AS Cannes","AS Saint-Etienne","1-4",1,4,"1",1,5,-3,"D"
1945-10-14,1945,"Olympique Lyon","RC Lens","2-0",2,0,"1",1,2,2,"H"
1945-10-21,1945,"FC Sochaux","AS Cannes","2-2",2,2,"1",1,4,0,"D"
1945-10-21,1945,"RC Roubaix","Red Star Olympique","3-5",3,5,"1",1,8,-2,"D"
1945-10-21,1945,"Olympique Marseille","Stade Reims","3-5",3,5,"1",1,8,-2,"D"
1945-10-21,1945,"FC Rouen","FC Sete","0-3",0,3,"1",1,3,-3,"D"
1945-10-21,1945,"RC Strasbourg","Olympique Lyon","3-2",3,2,"1",1,5,1,"H"
1945-10-21,1945,"Girondins Bordeaux","RC Lens","2-2",2,2,"1",1,4,0,"D"
1945-10-21,1945,"Stade Rennes","Le Havre AC","0-1",0,1,"1",1,1,-1,"D"
1945-10-21,1945,"Racing Club de France","FC Metz","2-0",2,0,"1",1,2,2,"H"
1945-10-21,1945,"AS Saint-Etienne","Lille OSC","3-1",3,1,"1",1,4,2,"H"
1945-10-28,1945,"Lille OSC","FC Sochaux","3-1",3,1,"1",1,4,2,"H"
1945-10-28,1945,"FC Metz","AS Saint-Etienne","0-3",0,3,"1",1,3,-3,"D"
1945-10-28,1945,"Le Havre AC","Racing Club de France","3-5",3,5,"1",1,8,-2,"D"
1945-10-28,1945,"RC Lens","Stade Rennes","2-2",2,2,"1",1,4,0,"D"
1945-10-28,1945,"FC Sete","RC Strasbourg","0-1",0,1,"1",1,1,-1,"D"
1945-10-28,1945,"Stade Reims","FC Rouen","4-1",4,1,"1",1,5,3,"H"
1945-10-28,1945,"Red Star Olympique","Olympique Marseille","2-2",2,2,"1",1,4,0,"D"
1945-10-28,1945,"AS Cannes","RC Roubaix","1-1",1,1,"1",1,2,0,"D"
1945-10-28,1945,"Olympique Lyon","Girondins Bordeaux","0-0",0,0,"1",1,0,0,"D"
1945-11-04,1945,"FC Sochaux","FC Metz","0-0",0,0,"1",1,0,0,"D"
1945-11-04,1945,"RC Roubaix","Lille OSC","1-1",1,1,"1",1,2,0,"D"
1945-11-04,1945,"Olympique Marseille","AS Cannes","6-1",6,1,"1",1,7,5,"H"
1945-11-04,1945,"FC Rouen","Red Star Olympique","1-1",1,1,"1",1,2,0,"D"
1945-11-04,1945,"RC Strasbourg","Stade Reims","3-1",3,1,"1",1,4,2,"H"
1945-11-04,1945,"FC Sete","Olympique Lyon","6-2",6,2,"1",1,8,4,"H"
1945-11-04,1945,"Stade Rennes","Girondins Bordeaux","4-2",4,2,"1",1,6,2,"H"
1945-11-04,1945,"Racing Club de France","RC Lens","2-0",2,0,"1",1,2,2,"H"
1945-11-04,1945,"AS Saint-Etienne","Le Havre AC","5-1",5,1,"1",1,6,4,"H"
1945-11-11,1945,"Girondins Bordeaux","Racing Club de France","3-1",3,1,"1",1,4,2,"H"
1945-11-11,1945,"AS Cannes","FC Rouen","3-1",3,1,"1",1,4,2,"H"
1945-11-11,1945,"Le Havre AC","FC Sochaux","1-0",1,0,"1",1,1,1,"H"
1945-11-11,1945,"RC Lens","AS Saint-Etienne","6-1",6,1,"1",1,7,5,"H"
1945-11-11,1945,"Lille OSC","Olympique Marseille","4-4",4,4,"1",1,8,0,"D"
1945-11-11,1945,"Olympique Lyon","Stade Rennes","3-5",3,5,"1",1,8,-2,"D"
1945-11-11,1945,"FC Metz","RC Roubaix","4-2",4,2,"1",1,6,2,"H"
1945-11-11,1945,"Red Star Olympique","RC Strasbourg","4-2",4,2,"1",1,6,2,"H"
1945-11-11,1945,"Stade Reims","FC Sete","2-1",2,1,"1",1,3,1,"H"
1945-11-18,1945,"Olympique Marseille","FC Metz","2-1",2,1,"1",1,3,1,"H"
1945-11-18,1945,"Racing Club de France","Stade Rennes","3-0",3,0,"1",1,3,3,"H"
1945-11-18,1945,"Stade Reims","Olympique Lyon","6-0",6,0,"1",1,6,6,"H"
1945-11-18,1945,"RC Roubaix","Le Havre AC","1-1",1,1,"1",1,2,0,"D"
1945-11-18,1945,"FC Rouen","Lille OSC","2-1",2,1,"1",1,3,1,"H"
1945-11-18,1945,"FC Sete","Red Star Olympique","4-0",4,0,"1",1,4,4,"H"
1945-11-18,1945,"FC Sochaux","RC Lens","0-3",0,3,"1",1,3,-3,"D"
1945-11-18,1945,"AS Saint-Etienne","Girondins Bordeaux","3-1",3,1,"1",1,4,2,"H"
1945-11-18,1945,"RC Strasbourg","AS Cannes","3-2",3,2,"1",1,5,1,"H"
1945-12-02,1945,"Lille OSC","RC Strasbourg","4-1",4,1,"1",1,5,3,"H"
1945-12-02,1945,"FC Metz","FC Rouen","0-0",0,0,"1",1,0,0,"D"
1945-12-02,1945,"Le Havre AC","Olympique Marseille","4-3",4,3,"1",1,7,1,"H"
1945-12-02,1945,"RC Lens","RC Roubaix","2-1",2,1,"1",1,3,1,"H"
1945-12-02,1945,"Girondins Bordeaux","FC Sochaux","3-2",3,2,"1",1,5,1,"H"
1945-12-02,1945,"Stade Rennes","AS Saint-Etienne","2-3",2,3,"1",1,5,-1,"D"
1945-12-02,1945,"Red Star Olympique","Stade Reims","0-3",0,3,"1",1,3,-3,"D"
1945-12-02,1945,"AS Cannes","FC Sete","2-1",2,1,"1",1,3,1,"H"
1945-12-02,1945,"Olympique Lyon","Racing Club de France","1-0",1,0,"1",1,1,1,"H"
1945-12-09,1945,"Olympique Marseille","RC Lens","4-1",4,1,"1",1,5,3,"H"
1945-12-09,1945,"Red Star Olympique","Olympique Lyon","2-2",2,2,"1",1,4,0,"D"
1945-12-09,1945,"Stade Reims","AS Cannes","2-4",2,4,"1",1,6,-2,"D"
1945-12-09,1945,"RC Roubaix","Girondins Bordeaux","3-1",3,1,"1",1,4,2,"H"
1945-12-09,1945,"FC Rouen","Le Havre AC","6-0",6,0,"1",1,6,6,"H"
1945-12-09,1945,"FC Sete","Lille OSC","1-2",1,2,"1",1,3,-1,"D"
1945-12-09,1945,"FC Sochaux","Stade Rennes","0-2",0,2,"1",1,2,-2,"D"
1945-12-09,1945,"AS Saint-Etienne","Racing Club de France","3-2",3,2,"1",1,5,1,"H"
1945-12-09,1945,"RC Strasbourg","FC Metz","0-2",0,2,"1",1,2,-2,"D"
1945-12-23,1945,"Girondins Bordeaux","Olympique Marseille","1-1",1,1,"1",1,2,0,"D"
1945-12-23,1945,"AS Cannes","Red Star Olympique","3-1",3,1,"1",1,4,2,"H"
1945-12-23,1945,"Le Havre AC","RC Strasbourg","3-0",3,0,"1",1,3,3,"H"
1945-12-23,1945,"RC Lens","FC Rouen","1-0",1,0,"1",1,1,1,"H"
1945-12-23,1945,"Lille OSC","Stade Reims","3-0",3,0,"1",1,3,3,"H"
1945-12-23,1945,"FC Metz","FC Sete","2-1",2,1,"1",1,3,1,"H"
1945-12-23,1945,"Racing Club de France","FC Sochaux","3-0",3,0,"1",1,3,3,"H"
1945-12-23,1945,"Stade Rennes","RC Roubaix","1-1",1,1,"1",1,2,0,"D"
1945-12-23,1945,"AS Saint-Etienne","Olympique Lyon","4-0",4,0,"1",1,4,4,"H"
1945-12-30,1945,"Olympique Lyon","AS Cannes","2-2",2,2,"1",1,4,0,"D"
1945-12-30,1945,"Olympique Marseille","Stade Rennes","2-2",2,2,"1",1,4,0,"D"
1945-12-30,1945,"Red Star Olympique","Lille OSC","2-2",2,2,"1",1,4,0,"D"
1945-12-30,1945,"Stade Reims","FC Metz","1-1",1,1,"1",1,2,0,"D"
1945-12-30,1945,"RC Roubaix","Racing Club de France","1-0",1,0,"1",1,1,1,"H"
1945-12-30,1945,"FC Rouen","Girondins Bordeaux","1-1",1,1,"1",1,2,0,"D"
1945-12-30,1945,"FC Sete","Le Havre AC","3-0",3,0,"1",1,3,3,"H"
1945-12-30,1945,"FC Sochaux","AS Saint-Etienne","4-4",4,4,"1",1,8,0,"D"
1945-12-30,1945,"RC Strasbourg","RC Lens","3-3",3,3,"1",1,6,0,"D"
1946-01-13,1945,"FC Sete","RC Lens","0-0",0,0,"1",1,0,0,"D"
1946-01-13,1945,"RC Roubaix","AS Saint-Etienne","3-2",3,2,"1",1,5,1,"H"
1946-01-13,1945,"AS Cannes","Lille OSC","2-1",2,1,"1",1,3,1,"H"
1946-01-13,1945,"FC Rouen","Stade Rennes","1-1",1,1,"1",1,2,0,"D"
1946-01-13,1945,"Olympique Marseille","Racing Club de France","0-0",0,0,"1",1,0,0,"D"
1946-01-13,1945,"FC Metz","Red Star Olympique Audonien","2-4",2,4,"1",1,6,-2,"D"
1946-01-13,1945,"Stade Reims","Le Havre AC","4-0",4,0,"1",1,4,4,"H"
1946-01-13,1945,"Olympique Lyon","FC Sochaux","3-4",3,4,"1",1,7,-1,"D"
1946-01-13,1945,"RC Strasbourg","Girondins Bordeaux","1-1",1,1,"1",1,2,0,"D"
1946-01-20,1945,"FC Sochaux","RC Roubaix","0-1",0,1,"1",1,1,-1,"D"
1946-01-20,1945,"Racing Club de France","FC Rouen","0-1",0,1,"1",1,1,-1,"D"
1946-01-20,1945,"Stade Rennes","RC Strasbourg","0-1",0,1,"1",1,1,-1,"D"
1946-01-20,1945,"FC Sete","Girondins Bordeaux","2-4",2,4,"1",1,6,-2,"D"
1946-01-20,1945,"RC Lens","Stade Reims","2-2",2,2,"1",1,4,0,"D"
1946-01-20,1945,"Le Havre AC","Red Star Olympique Audonien","0-1",0,1,"1",1,1,-1,"D"
1946-01-20,1945,"Olympique Marseille","AS Saint-Etienne","1-4",1,4,"1",1,5,-3,"D"
1946-01-20,1945,"FC Metz","AS Cannes","1-0",1,0,"1",1,1,1,"H"
1946-01-20,1945,"Lille OSC","Olympique Lyon","4-0",4,0,"1",1,4,4,"H"
1946-01-27,1945,"Olympique Marseille","FC Sochaux","3-1",3,1,"1",1,4,2,"H"
1946-01-27,1945,"Olympique Lyon","RC Roubaix","0-5",0,5,"1",1,5,-5,"D"
1946-01-27,1945,"Lille OSC","FC Metz","7-0",7,0,"1",1,7,7,"H"
1946-01-27,1945,"AS Cannes","Le Havre AC","3-2",3,2,"1",1,5,1,"H"
1946-01-27,1945,"Red Star Olympique Audonien","RC Lens","1-1",1,1,"1",1,2,0,"D"
1946-01-27,1945,"Stade Reims","Girondins Bordeaux","2-2",2,2,"1",1,4,0,"D"
1946-01-27,1945,"FC Sete","Stade Rennes","2-0",2,0,"1",1,2,2,"H"
1946-01-27,1945,"RC Strasbourg","Racing Club de France","4-1",4,1,"1",1,5,3,"H"
1946-01-27,1945,"FC Rouen","AS Saint-Etienne","2-1",2,1,"1",1,3,1,"H"
1946-02-10,1945,"Le Havre AC","Lille OSC","1-2",1,2,"1",1,3,-1,"D"
1946-02-10,1945,"RC Roubaix","Olympique Marseille","1-1",1,1,"1",1,2,0,"D"
1946-02-10,1945,"FC Sochaux","FC Rouen","2-0",2,0,"1",1,2,2,"H"
1946-02-10,1945,"AS Saint-Etienne","RC Strasbourg","0-0",0,0,"1",1,0,0,"D"
1946-02-10,1945,"Racing Club de France","FC Sete","4-1",4,1,"1",1,5,3,"H"
1946-02-10,1945,"Stade Rennes","Stade Reims","1-1",1,1,"1",1,2,0,"D"
1946-02-10,1945,"Girondins Bordeaux","Red Star Olympique Audonien","2-1",2,1,"1",1,3,1,"H"
1946-02-10,1945,"RC Lens","AS Cannes","2-1",2,1,"1",1,3,1,"H"
1946-02-10,1945,"FC Metz","Olympique Lyon","1-4",1,4,"1",1,5,-3,"D"
1946-02-17,1945,"RC Strasbourg","FC Sochaux","2-1",2,1,"1",1,3,1,"H"
1946-02-17,1945,"FC Rouen","RC Roubaix","2-1",2,1,"1",1,3,1,"H"
1946-02-17,1945,"Olympique Lyon","Olympique Marseille","1-1",1,1,"1",1,2,0,"D"
1946-02-17,1945,"FC Metz","Le Havre AC","2-2",2,2,"1",1,4,0,"D"
1946-02-17,1945,"Lille OSC","RC Lens","3-1",3,1,"1",1,4,2,"H"
1946-02-17,1945,"AS Cannes","Girondins Bordeaux","0-0",0,0,"1",1,0,0,"D"
1946-02-17,1945,"Red Star Olympique Audonien","Stade Rennes","0-4",0,4,"1",1,4,-4,"D"
1946-02-17,1945,"Stade Reims","Racing Club de France","1-0",1,0,"1",1,1,1,"H"
1946-02-17,1945,"FC Sete","AS Saint-Etienne","1-1",1,1,"1",1,2,0,"D"
1946-02-24,1945,"Girondins Bordeaux","Lille OSC","1-5",1,5,"1",1,6,-4,"D"
1946-02-24,1945,"RC Lens","FC Metz","5-3",5,3,"1",1,8,2,"H"
1946-02-24,1945,"Olympique Marseille","FC Rouen","2-3",2,3,"1",1,5,-1,"D"
1946-02-24,1945,"RC Roubaix","RC Strasbourg","1-1",1,1,"1",1,2,0,"D"
1946-02-24,1945,"FC Sochaux","FC Sete","1-3",1,3,"1",1,4,-2,"D"
1946-02-24,1945,"AS Saint-Etienne","Stade Reims","2-3",2,3,"1",1,5,-1,"D"
1946-02-24,1945,"Racing Club de France","Red Star Olympique Audonien","1-0",1,0,"1",1,1,1,"H"
1946-02-24,1945,"Stade Rennes","AS Cannes","0-2",0,2,"1",1,2,-2,"D"
1946-02-24,1945,"Le Havre AC","Olympique Lyon","0-0",0,0,"1",1,0,0,"D"
1946-03-10,1945,"Stade Reims","FC Sochaux","1-0",1,0,"1",1,1,1,"H"
1946-03-10,1945,"FC Sete","RC Roubaix","0-0",0,0,"1",1,0,0,"D"
1946-03-10,1945,"RC Strasbourg","Olympique Marseille","3-0",3,0,"1",1,3,3,"H"
1946-03-10,1945,"Olympique Lyon","FC Rouen","2-1",2,1,"1",1,3,1,"H"
1946-03-10,1945,"Le Havre AC","RC Lens","1-0",1,0,"1",1,1,1,"H"
1946-03-10,1945,"FC Metz","Girondins Bordeaux","2-0",2,0,"1",1,2,2,"H"
1946-03-10,1945,"Lille OSC","Stade Rennes","2-5",2,5,"1",1,7,-3,"D"
1946-03-10,1945,"AS Cannes","Racing Club de France","1-1",1,1,"1",1,2,0,"D"
1946-03-10,1945,"Red Star Olympique Audonien","AS Saint-Etienne","3-2",3,2,"1",1,5,1,"H"
1946-03-10,1946,"FC Sete","FC Metz","2-2",2,2,"1",1,4,0,"D"
1946-03-10,1946,"Lille OSC","FC Rouen","0-0",0,0,"1",1,0,0,"D"
1946-03-10,1946,"RC Strasbourg","Red Star Olympique Audonien","4-1",4,1,"1",1,5,3,"H"
1946-03-10,1946,"Toulouse FC","Stade Reims","0-2",0,2,"1",1,2,-2,"D"
1946-03-10,1946,"RC Lens","Le Havre AC","8-0",8,0,"1",1,8,8,"H"
1946-03-10,1946,"Stade Francais","Racing Club de France","2-2",2,2,"1",1,4,0,"D"
1946-03-10,1946,"Stade Rennes","Stade Olympique Montpellierain","2-1",2,1,"1",1,3,1,"H"
1946-03-10,1946,"AS Cannes","AS Nancy","2-1",2,1,"1",1,3,1,"H"
1946-03-10,1946,"Girondins Bordeaux","AS Saint-Etienne","3-1",3,1,"1",1,4,2,"H"
1946-03-10,1946,"Olympique Marseille","RC Roubaix","1-1",1,1,"1",1,2,0,"D"
1946-03-24,1945,"Racing Club de France","Lille OSC","2-1",2,1,"1",1,3,1,"H"
1946-03-24,1945,"Stade Rennes","FC Metz","1-0",1,0,"1",1,1,1,"H"
1946-03-24,1945,"Girondins Bordeaux","Le Havre AC","1-2",1,2,"1",1,3,-1,"D"
1946-03-24,1945,"FC Rouen","RC Strasbourg","5-0",5,0,"1",1,5,5,"H"
1946-03-24,1945,"Olympique Marseille","FC Sete","1-2",1,2,"1",1,3,-1,"D"
1946-03-24,1945,"RC Roubaix","Stade Reims","0-1",0,1,"1",1,1,-1,"D"
1946-03-24,1945,"FC Sochaux","Red Star Olympique Audonien","0-2",0,2,"1",1,2,-2,"D"
1946-03-24,1945,"AS Saint-Etienne","AS Cannes","2-1",2,1,"1",1,3,1,"H"
1946-03-24,1945,"RC Lens","Olympique Lyon","9-2",9,2,"1",1,11,7,"H"
1946-04-07,1945,"AS Cannes","FC Sochaux","4-1",4,1,"1",1,5,3,"H"
1946-04-07,1945,"Red Star Olympique Audonien","RC Roubaix","3-0",3,0,"1",1,3,3,"H"
1946-04-07,1945,"Stade Reims","Olympique Marseille","4-1",4,1,"1",1,5,3,"H"
1946-04-07,1945,"FC Sete","FC Rouen","4-1",4,1,"1",1,5,3,"H"
1946-04-07,1945,"Olympique Lyon","RC Strasbourg","3-2",3,2,"1",1,5,1,"H"
1946-04-07,1945,"RC Lens","Girondins Bordeaux","1-1",1,1,"1",1,2,0,"D"
1946-04-07,1945,"Le Havre AC","Stade Rennes","0-0",0,0,"1",1,0,0,"D"
1946-04-07,1945,"FC Metz","Racing Club de France","2-1",2,1,"1",1,3,1,"H"
1946-04-07,1945,"Lille OSC","AS Saint-Etienne","8-0",8,0,"1",1,8,8,"H"
1946-04-14,1945,"FC Sochaux","Lille OSC","0-0",0,0,"1",1,0,0,"D"
1946-04-14,1945,"AS Saint-Etienne","FC Metz","3-1",3,1,"1",1,4,2,"H"
1946-04-14,1945,"Racing Club de France","Le Havre AC","4-1",4,1,"1",1,5,3,"H"
1946-04-14,1945,"Stade Rennes","RC Lens","3-0",3,0,"1",1,3,3,"H"
1946-04-14,1945,"RC Strasbourg","FC Sete","1-1",1,1,"1",1,2,0,"D"
1946-04-14,1945,"FC Rouen","Stade Reims","1-0",1,0,"1",1,1,1,"H"
1946-04-14,1945,"Olympique Marseille","Red Star Olympique Audonien","2-1",2,1,"1",1,3,1,"H"
1946-04-14,1945,"RC Roubaix","AS Cannes","2-0",2,0,"1",1,2,2,"H"
1946-04-14,1945,"Girondins Bordeaux","Olympique Lyon","0-1",0,1,"1",1,1,-1,"D"
1946-04-21,1945,"FC Metz","FC Sochaux","2-0",2,0,"1",1,2,2,"H"
1946-04-21,1945,"Lille OSC","RC Roubaix","0-2",0,2,"1",1,2,-2,"D"
1946-04-21,1945,"AS Cannes","Olympique Marseille","0-2",0,2,"1",1,2,-2,"D"
1946-04-21,1945,"Red Star Olympique Audonien","FC Rouen","3-1",3,1,"1",1,4,2,"H"
1946-04-21,1945,"Stade Reims","RC Strasbourg","0-1",0,1,"1",1,1,-1,"D"
1946-04-21,1945,"Olympique Lyon","FC Sete","2-0",2,0,"1",1,2,2,"H"
1946-04-21,1945,"Girondins Bordeaux","Stade Rennes","4-1",4,1,"1",1,5,3,"H"
1946-04-21,1945,"RC Lens","Racing Club de France","2-3",2,3,"1",1,5,-1,"D"
1946-04-21,1945,"Le Havre AC","AS Saint-Etienne","0-2",0,2,"1",1,2,-2,"D"
1946-04-28,1945,"Racing Club de France","Girondins Bordeaux","2-2",2,2,"1",1,4,0,"D"
1946-04-28,1945,"FC Rouen","AS Cannes","1-1",1,1,"1",1,2,0,"D"
1946-04-28,1945,"FC Sochaux","Le Havre AC","2-4",2,4,"1",1,6,-2,"D"
1946-04-28,1945,"AS Saint-Etienne","RC Lens","2-1",2,1,"1",1,3,1,"H"
1946-04-28,1945,"Olympique Marseille","Lille OSC","2-2",2,2,"1",1,4,0,"D"
1946-04-28,1945,"Stade Rennes","Olympique Lyon","3-1",3,1,"1",1,4,2,"H"
1946-04-28,1945,"RC Roubaix","FC Metz","4-0",4,0,"1",1,4,4,"H"
1946-04-28,1945,"RC Strasbourg","Red Star Olympique Audonien","1-1",1,1,"1",1,2,0,"D"
1946-04-28,1945,"FC Sete","Stade Reims","1-1",1,1,"1",1,2,0,"D"
1946-05-05,1945,"FC Metz","Olympique Marseille","3-1",3,1,"1",1,4,2,"H"
1946-05-05,1945,"Stade Rennes","Racing Club de France","1-0",1,0,"1",1,1,1,"H"
1946-05-05,1945,"Olympique Lyon","Stade Reims","1-2",1,2,"1",1,3,-1,"D"
1946-05-05,1945,"Le Havre AC","RC Roubaix","4-1",4,1,"1",1,5,3,"H"
1946-05-05,1945,"Lille OSC","FC Rouen","2-2",2,2,"1",1,4,0,"D"
1946-05-05,1945,"Red Star Olympique Audonien","FC Sete","6-0",6,0,"1",1,6,6,"H"
1946-05-05,1945,"RC Lens","FC Sochaux","3-0",3,0,"1",1,3,3,"H"
1946-05-05,1945,"Girondins Bordeaux","AS Saint-Etienne","1-3",1,3,"1",1,4,-2,"D"
1946-05-05,1945,"AS Cannes","RC Strasbourg","3-1",3,1,"1",1,4,2,"H"
1946-05-12,1945,"RC Strasbourg","Lille OSC","0-1",0,1,"1",1,1,-1,"D"
1946-05-12,1945,"FC Rouen","FC Metz","4-1",4,1,"1",1,5,3,"H"
1946-05-12,1945,"Olympique Marseille","Le Havre AC","3-0",3,0,"1",1,3,3,"H"
1946-05-12,1945,"RC Roubaix","RC Lens","3-0",3,0,"1",1,3,3,"H"
1946-05-12,1945,"FC Sochaux","Girondins Bordeaux","0-3",0,3,"1",1,3,-3,"D"
1946-05-12,1945,"AS Saint-Etienne","Stade Rennes","4-2",4,2,"1",1,6,2,"H"
1946-05-12,1945,"Stade Reims","Red Star Olympique Audonien","4-0",4,0,"1",1,4,4,"H"
1946-05-12,1945,"FC Sete","AS Cannes","1-0",1,0,"1",1,1,1,"H"
1946-05-12,1945,"Racing Club de France","Olympique Lyon","1-3",1,3,"1",1,4,-2,"D"
1946-05-19,1945,"RC Lens","Olympique Marseille","3-1",3,1,"1",1,4,2,"H"
1946-05-19,1945,"Olympique Lyon","Red Star Olympique Audonien","2-2",2,2,"1",1,4,0,"D"
1946-05-19,1945,"AS Cannes","Stade Reims","1-1",1,1,"1",1,2,0,"D"
1946-05-19,1945,"Girondins Bordeaux","RC Roubaix","0-2",0,2,"1",1,2,-2,"D"
1946-05-19,1945,"Le Havre AC","FC Rouen","1-0",1,0,"1",1,1,1,"H"
1946-05-19,1945,"Lille OSC","FC Sete","5-2",5,2,"1",1,7,3,"H"
1946-05-19,1945,"Stade Rennes","FC Sochaux","5-1",5,1,"1",1,6,4,"H"
1946-05-19,1945,"Racing Club de France","AS Saint-Etienne","4-1",4,1,"1",1,5,3,"H"
1946-05-19,1945,"FC Metz","RC Strasbourg","1-3",1,3,"1",1,4,-2,"D"
1946-05-26,1945,"Olympique Marseille","Girondins Bordeaux","3-0",3,0,"1",1,3,3,"H"
1946-05-26,1945,"Red Star Olympique Audonien","AS Cannes","1-1",1,1,"1",1,2,0,"D"
1946-05-26,1945,"RC Strasbourg","Le Havre AC","0-2",0,2,"1",1,2,-2,"D"
1946-05-26,1945,"FC Rouen","RC Lens","2-1",2,1,"1",1,3,1,"H"
1946-05-26,1945,"Stade Reims","Lille OSC","1-1",1,1,"1",1,2,0,"D"
1946-05-26,1945,"FC Sete","FC Metz","3-1",3,1,"1",1,4,2,"H"
1946-05-26,1945,"FC Sochaux","Racing Club de France","2-4",2,4,"1",1,6,-2,"D"
1946-05-26,1945,"RC Roubaix","Stade Rennes","1-1",1,1,"1",1,2,0,"D"
1946-05-26,1945,"Olympique Lyon","AS Saint-Etienne","3-3",3,3,"1",1,6,0,"D"
1946-06-02,1945,"AS Cannes","Olympique Lyon","1-1",1,1,"1",1,2,0,"D"
1946-06-02,1945,"Stade Rennes","Olympique Marseille","0-0",0,0,"1",1,0,0,"D"
1946-06-02,1945,"Lille OSC","Red Star Olympique Audonien","3-1",3,1,"1",1,4,2,"H"
1946-06-02,1945,"FC Metz","Stade Reims","2-2",2,2,"1",1,4,0,"D"
1946-06-02,1945,"Racing Club de France","RC Roubaix","0-2",0,2,"1",1,2,-2,"D"
1946-06-02,1945,"Girondins Bordeaux","FC Rouen","4-1",4,1,"1",1,5,3,"H"
1946-06-02,1945,"Le Havre AC","FC Sete","4-1",4,1,"1",1,5,3,"H"
1946-06-02,1945,"AS Saint-Etienne","FC Sochaux","1-0",1,0,"1",1,1,1,"H"
1946-06-02,1945,"RC Lens","RC Strasbourg","0-4",0,4,"1",1,4,-4,"D"
1946-08-18,1946,"FC Metz","Red Star Olympique Audonien","8-0",8,0,"1",1,8,8,"H"
1946-08-18,1946,"Toulouse FC","Le Havre AC","5-0",5,0,"1",1,5,5,"H"
1946-08-18,1946,"RC Lens","Lille OSC","3-3",3,3,"1",1,6,0,"D"
1946-08-18,1946,"FC Rouen","FC Sete","6-1",6,1,"1",1,7,5,"H"
1946-08-18,1946,"Stade Francais","Olympique Marseille","4-1",4,1,"1",1,5,3,"H"
1946-08-18,1946,"RC Roubaix","AS Cannes-Grasse","1-0",1,0,"1",1,1,1,"H"
1946-08-18,1946,"AS Nancy","Stade Rennes","7-0",7,0,"1",1,7,7,"H"
1946-08-18,1946,"Stade Olympique Montpellierain","AS Saint-Etienne","3-1",3,1,"1",1,4,2,"H"
1946-08-18,1946,"Girondins Bordeaux","Racing Club de France","0-6",0,6,"1",1,6,-6,"D"
1946-08-18,1946,"RC Strasbourg","Stade Reims","3-0",3,0,"1",1,3,3,"H"
1946-08-25,1946,"FC Metz","FC Rouen","0-0",0,0,"1",1,0,0,"D"
1946-08-25,1946,"FC Sete","RC Lens","2-1",2,1,"1",1,3,1,"H"
1946-08-25,1946,"Lille OSC","Toulouse FC","1-1",1,1,"1",1,2,0,"D"
1946-08-25,1946,"Le Havre AC","RC Strasbourg","1-2",1,2,"1",1,3,-1,"D"
1946-08-25,1946,"Stade Reims","Red Star Olympique Audonien","1-0",1,0,"1",1,1,1,"H"
1946-08-25,1946,"Racing Club de France","Stade Olympique Montpellierain","2-3",2,3,"1",1,5,-1,"D"
1946-08-25,1946,"AS Saint-Etienne","AS Nancy","2-2",2,2,"1",1,4,0,"D"
1946-08-25,1946,"Stade Rennes","RC Roubaix","2-3",2,3,"1",1,5,-1,"D"
1946-08-25,1946,"AS Cannes-Grasse","Olympique Marseille","2-1",2,1,"1",1,3,1,"H"
1946-08-25,1946,"Girondins Bordeaux","Stade Francais","1-4",1,4,"1",1,5,-3,"D"
1946-09-01,1946,"Lille OSC","Stade Reims","5-0",5,0,"1",1,5,5,"H"
1946-09-01,1946,"RC Strasbourg","FC Sete","2-1",2,1,"1",1,3,1,"H"
1946-09-01,1946,"Toulouse FC","FC Metz","3-3",3,3,"1",1,6,0,"D"
1946-09-01,1946,"FC Rouen","RC Lens","3-1",3,1,"1",1,4,2,"H"
1946-09-01,1946,"Red Star Olympique Audonien","Le Havre AC","1-0",1,0,"1",1,1,1,"H"
1946-09-01,1946,"Racing Club de France","RC Roubaix","2-1",2,1,"1",1,3,1,"H"
1946-09-01,1946,"AS Saint-Etienne","AS Cannes-Grasse","4-3",4,3,"1",1,7,1,"H"
1946-09-01,1946,"Stade Rennes","Olympique Marseille","2-0",2,0,"1",1,2,2,"H"
1946-09-01,1946,"AS Nancy","Stade Francais","0-0",0,0,"1",1,0,0,"D"
1946-09-01,1946,"Stade Olympique Montpellierain","Girondins Bordeaux","0-0",0,0,"1",1,0,0,"D"
1946-09-08,1946,"FC Metz","Girondins Bordeaux","1-1",1,1,"1",1,2,0,"D"
1946-09-08,1946,"FC Sete","Stade Olympique Montpellierain","1-0",1,0,"1",1,1,1,"H"
1946-09-08,1946,"Lille OSC","AS Nancy","4-1",4,1,"1",1,5,3,"H"
1946-09-08,1946,"Le Havre AC","RC Roubaix","0-3",0,3,"1",1,3,-3,"D"
1946-09-08,1946,"Stade Reims","AS Cannes-Grasse","5-1",5,1,"1",1,6,4,"H"
1946-09-08,1946,"RC Strasbourg","Stade Rennes","3-2",3,2,"1",1,5,1,"H"
1946-09-08,1946,"Toulouse FC","AS Saint-Etienne","4-3",4,3,"1",1,7,1,"H"
1946-09-08,1946,"RC Lens","Racing Club de France","5-2",5,2,"1",1,7,3,"H"
1946-09-08,1946,"Red Star Olympique Audonien","Olympique Marseille","2-2",2,2,"1",1,4,0,"D"
1946-09-08,1946,"Stade Francais","FC Rouen","0-1",0,1,"1",1,1,-1,"D"
1946-09-12,1946,"Stade Francais","RC Lens","3-1",3,1,"1",1,4,2,"H"
1946-09-12,1946,"Racing Club de France","FC Sete","0-2",0,2,"1",1,2,-2,"D"
1946-09-12,1946,"AS Saint-Etienne","FC Metz","6-2",6,2,"1",1,8,4,"H"
1946-09-12,1946,"Stade Rennes","Stade Reims","2-3",2,3,"1",1,5,-1,"D"
1946-09-12,1946,"AS Cannes-Grasse","Le Havre AC","2-1",2,1,"1",1,3,1,"H"
1946-09-12,1946,"RC Roubaix","Lille OSC","1-0",1,0,"1",1,1,1,"H"
1946-09-12,1946,"AS Nancy","Toulouse FC","3-1",3,1,"1",1,4,2,"H"
1946-09-12,1946,"Stade Olympique Montpellierain","RC Strasbourg","0-1",0,1,"1",1,1,-1,"D"
1946-09-12,1946,"Girondins Bordeaux","Red Star Olympique Audonien","3-2",3,2,"1",1,5,1,"H"
1946-09-12,1946,"Olympique Marseille","FC Rouen","4-0",4,0,"1",1,4,4,"H"
1946-09-15,1946,"Stade Francais","Lille OSC","0-2",0,2,"1",1,2,-2,"D"
1946-09-15,1946,"Racing Club de France","Toulouse FC","8-2",8,2,"1",1,10,6,"H"
1946-09-15,1946,"AS Saint-Etienne","RC Strasbourg","1-1",1,1,"1",1,2,0,"D"
1946-09-15,1946,"Stade Rennes","Red Star Olympique Audonien","2-2",2,2,"1",1,4,0,"D"
1946-09-15,1946,"AS Cannes-Grasse","FC Rouen","3-1",3,1,"1",1,4,2,"H"
1946-09-15,1946,"RC Roubaix","RC Lens","5-2",5,2,"1",1,7,3,"H"
1946-09-15,1946,"AS Nancy","FC Sete","3-1",3,1,"1",1,4,2,"H"
1946-09-15,1946,"Stade Olympique Montpellierain","FC Metz","3-0",3,0,"1",1,3,3,"H"
1946-09-15,1946,"Girondins Bordeaux","Stade Reims","1-3",1,3,"1",1,4,-2,"D"
1946-09-15,1946,"Olympique Marseille","Le Havre AC","5-3",5,3,"1",1,8,2,"H"
1946-09-22,1946,"FC Metz","Stade Francais","1-1",1,1,"1",1,2,0,"D"
1946-09-22,1946,"FC Sete","Olympique Marseille","1-1",1,1,"1",1,2,0,"D"
1946-09-22,1946,"Lille OSC","Girondins Bordeaux","4-1",4,1,"1",1,5,3,"H"
1946-09-22,1946,"Le Havre AC","Stade Olympique Montpellierain","2-0",2,0,"1",1,2,2,"H"
1946-09-22,1946,"Stade Reims","AS Nancy","1-0",1,0,"1",1,1,1,"H"
1946-09-22,1946,"RC Strasbourg","RC Roubaix","1-1",1,1,"1",1,2,0,"D"
1946-09-22,1946,"RC Lens","Stade Rennes","5-1",5,1,"1",1,6,4,"H"
1946-09-22,1946,"FC Rouen","AS Saint-Etienne","3-0",3,0,"1",1,3,3,"H"
1946-09-22,1946,"Racing Club de France","Red Star Olympique Audonien","1-2",1,2,"1",1,3,-1,"D"
1946-09-22,1946,"AS Cannes-Grasse","Toulouse FC","3-2",3,2,"1",1,5,1,"H"
1946-09-26,1946,"FC Metz","AS Nancy","6-0",6,0,"1",1,6,6,"H"
1946-09-26,1946,"FC Sete","RC Roubaix","2-5",2,5,"1",1,7,-3,"D"
1946-09-26,1946,"Lille OSC","AS Cannes-Grasse","8-2",8,2,"1",1,10,6,"H"
1946-09-26,1946,"Le Havre AC","Stade Rennes","2-2",2,2,"1",1,4,0,"D"
1946-09-26,1946,"Stade Reims","AS Saint-Etienne","5-0",5,0,"1",1,5,5,"H"
1946-09-26,1946,"RC Strasbourg","Racing Club de France","8-1",8,1,"1",1,9,7,"H"
1946-09-26,1946,"Toulouse FC","Stade Francais","1-2",1,2,"1",1,3,-1,"D"
1946-09-26,1946,"RC Lens","Olympique Marseille","0-0",0,0,"1",1,0,0,"D"
1946-09-26,1946,"FC Rouen","Girondins Bordeaux","2-2",2,2,"1",1,4,0,"D"
1946-09-26,1946,"Red Star Olympique Audonien","Stade Olympique Montpellierain","1-1",1,1,"1",1,2,0,"D"
1946-09-29,1946,"FC Metz","Racing Club de France","5-0",5,0,"1",1,5,5,"H"
1946-09-29,1946,"FC Sete","Stade Francais","3-1",3,1,"1",1,4,2,"H"
1946-09-29,1946,"Lille OSC","Olympique Marseille","5-1",5,1,"1",1,6,4,"H"
1946-09-29,1946,"Le Havre AC","Girondins Bordeaux","1-0",1,0,"1",1,1,1,"H"
1946-09-29,1946,"Stade Reims","Stade Olympique Montpellierain","4-0",4,0,"1",1,4,4,"H"
1946-09-29,1946,"RC Strasbourg","AS Nancy","0-1",0,1,"1",1,1,-1,"D"
1946-09-29,1946,"Toulouse FC","RC Roubaix","1-2",1,2,"1",1,3,-1,"D"
1946-09-29,1946,"RC Lens","AS Cannes-Grasse","2-1",2,1,"1",1,3,1,"H"
1946-09-29,1946,"FC Rouen","Stade Rennes","1-1",1,1,"1",1,2,0,"D"
1946-09-29,1946,"Red Star Olympique Audonien","AS Saint-Etienne","0-0",0,0,"1",1,0,0,"D"
1946-10-06,1946,"Stade Francais","RC Strasbourg","2-4",2,4,"1",1,6,-2,"D"
1946-10-06,1946,"Racing Club de France","Stade Reims","0-3",0,3,"1",1,3,-3,"D"
1946-10-06,1946,"AS Saint-Etienne","Le Havre AC","2-0",2,0,"1",1,2,2,"H"
1946-10-06,1946,"Stade Rennes","Lille OSC","0-0",0,0,"1",1,0,0,"D"
1946-10-06,1946,"AS Cannes-Grasse","FC Sete","5-2",5,2,"1",1,7,3,"H"
1946-10-06,1946,"RC Roubaix","FC Metz","2-1",2,1,"1",1,3,1,"H"
1946-10-06,1946,"AS Nancy","Red Star Olympique Audonien","0-1",0,1,"1",1,1,-1,"D"
1946-10-06,1946,"Stade Olympique Montpellierain","FC Rouen","3-0",3,0,"1",1,3,3,"H"
1946-10-06,1946,"Girondins Bordeaux","RC Lens","3-2",3,2,"1",1,5,1,"H"
1946-10-06,1946,"Olympique Marseille","Toulouse FC","3-0",3,0,"1",1,3,3,"H"
1946-10-13,1946,"FC Metz","Stade Rennes","6-0",6,0,"1",1,6,6,"H"
1946-10-13,1946,"FC Sete","AS Saint-Etienne","2-1",2,1,"1",1,3,1,"H"
1946-10-13,1946,"Lille OSC","Racing Club de France","3-1",3,1,"1",1,4,2,"H"
1946-10-13,1946,"Le Havre AC","Stade Francais","2-3",2,3,"1",1,5,-1,"D"
1946-10-13,1946,"Stade Reims","Olympique Marseille","1-0",1,0,"1",1,1,1,"H"
1946-10-13,1946,"RC Strasbourg","Girondins Bordeaux","1-1",1,1,"1",1,2,0,"D"
1946-10-13,1946,"Toulouse FC","Stade Olympique Montpellierain","2-1",2,1,"1",1,3,1,"H"
1946-10-13,1946,"RC Lens","AS Nancy","2-3",2,3,"1",1,5,-1,"D"
1946-10-13,1946,"FC Rouen","RC Roubaix","0-1",0,1,"1",1,1,-1,"D"
1946-10-13,1946,"Red Star Olympique Audonien","AS Cannes-Grasse","2-0",2,0,"1",1,2,2,"H"
1946-10-17,1946,"Red Star Olympique Audonien","Stade Francais","2-0",2,0,"1",1,2,2,"H"
1946-10-17,1946,"Racing Club de France","FC Rouen","0-0",0,0,"1",1,0,0,"D"
1946-10-17,1946,"AS Saint-Etienne","RC Lens","4-1",4,1,"1",1,5,3,"H"
1946-10-17,1946,"Stade Rennes","Toulouse FC","3-0",3,0,"1",1,3,3,"H"
1946-10-17,1946,"AS Cannes-Grasse","RC Strasbourg","2-2",2,2,"1",1,4,0,"D"
1946-10-17,1946,"RC Roubaix","Stade Reims","1-1",1,1,"1",1,2,0,"D"
1946-10-17,1946,"AS Nancy","Le Havre AC","7-0",7,0,"1",1,7,7,"H"
1946-10-17,1946,"Stade Olympique Montpellierain","Lille OSC","0-1",0,1,"1",1,1,-1,"D"
1946-10-17,1946,"Girondins Bordeaux","FC Sete","4-3",4,3,"1",1,7,1,"H"
1946-10-17,1946,"Olympique Marseille","FC Metz","3-3",3,3,"1",1,6,0,"D"
1946-10-20,1946,"Stade Francais","Stade Reims","2-2",2,2,"1",1,4,0,"D"
1946-10-20,1946,"Racing Club de France","Le Havre AC","3-1",3,1,"1",1,4,2,"H"
1946-10-20,1946,"AS Saint-Etienne","Lille OSC","2-1",2,1,"1",1,3,1,"H"
1946-10-20,1946,"Stade Rennes","FC Sete","5-2",5,2,"1",1,7,3,"H"
1946-10-20,1946,"AS Cannes-Grasse","FC Metz","1-0",1,0,"1",1,1,1,"H"
1946-10-20,1946,"RC Roubaix","Red Star Olympique Audonien","2-0",2,0,"1",1,2,2,"H"
1946-10-20,1946,"AS Nancy","FC Rouen","0-0",0,0,"1",1,0,0,"D"
1946-10-20,1946,"Stade Olympique Montpellierain","RC Lens","2-1",2,1,"1",1,3,1,"H"
1946-10-20,1946,"Girondins Bordeaux","Toulouse FC","1-1",1,1,"1",1,2,0,"D"
1946-10-20,1946,"Olympique Marseille","RC Strasbourg","2-1",2,1,"1",1,3,1,"H"
1946-10-27,1946,"Lille OSC","RC Strasbourg","2-2",2,2,"1",1,4,0,"D"
1946-10-27,1946,"Le Havre AC","Stade Reims","1-0",1,0,"1",1,1,1,"H"
1946-10-27,1946,"Toulouse FC","FC Sete","5-1",5,1,"1",1,6,4,"H"
1946-10-27,1946,"RC Lens","FC Metz","5-1",5,1,"1",1,6,4,"H"
1946-10-27,1946,"FC Rouen","Red Star Olympique Audonien","3-0",3,0,"1",1,3,3,"H"
1946-10-27,1946,"Racing Club de France","AS Nancy","4-3",4,3,"1",1,7,1,"H"
1946-10-27,1946,"AS Saint-Etienne","RC Roubaix","2-0",2,0,"1",1,2,2,"H"
1946-10-27,1946,"Stade Rennes","AS Cannes-Grasse","2-1",2,1,"1",1,3,1,"H"
1946-10-27,1946,"Stade Olympique Montpellierain","Stade Francais","1-3",1,3,"1",1,4,-2,"D"
1946-10-27,1946,"Olympique Marseille","Girondins Bordeaux","0-0",0,0,"1",1,0,0,"D"
1946-11-03,1946,"FC Metz","Le Havre AC","2-3",2,3,"1",1,5,-1,"D"
1946-11-03,1946,"FC Sete","Lille OSC","2-1",2,1,"1",1,3,1,"H"
1946-11-03,1946,"Stade Reims","FC Rouen","3-0",3,0,"1",1,3,3,"H"
1946-11-03,1946,"RC Strasbourg","RC Lens","2-0",2,0,"1",1,2,2,"H"
1946-11-03,1946,"Red Star Olympique Audonien","Toulouse FC","2-1",2,1,"1",1,3,1,"H"
1946-11-03,1946,"Stade Francais","Stade Rennes","5-3",5,3,"1",1,8,2,"H"
1946-11-03,1946,"AS Saint-Etienne","Racing Club de France","0-3",0,3,"1",1,3,-3,"D"
1946-11-03,1946,"RC Roubaix","Stade Olympique Montpellierain","2-1",2,1,"1",1,3,1,"H"
1946-11-03,1946,"AS Nancy","Olympique Marseille","1-1",1,1,"1",1,2,0,"D"
1946-11-03,1946,"Girondins Bordeaux","AS Cannes-Grasse","1-4",1,4,"1",1,5,-3,"D"
1946-11-17,1946,"Le Havre AC","FC Sete","5-1",5,1,"1",1,6,4,"H"
1946-11-17,1946,"Stade Reims","FC Metz","0-1",0,1,"1",1,1,-1,"D"
1946-11-17,1946,"RC Lens","Toulouse FC","3-1",3,1,"1",1,4,2,"H"
1946-11-17,1946,"FC Rouen","RC Strasbourg","1-3",1,3,"1",1,4,-2,"D"
1946-11-17,1946,"Red Star Olympique Audonien","Lille OSC","5-1",5,1,"1",1,6,4,"H"
1946-11-17,1946,"Racing Club de France","Stade Rennes","2-3",2,3,"1",1,5,-1,"D"
1946-11-17,1946,"AS Saint-Etienne","Olympique Marseille","3-1",3,1,"1",1,4,2,"H"
1946-11-17,1946,"AS Cannes-Grasse","Stade Francais","1-0",1,0,"1",1,1,1,"H"
1946-11-17,1946,"RC Roubaix","Girondins Bordeaux","4-1",4,1,"1",1,5,3,"H"
1946-11-17,1946,"Stade Olympique Montpellierain","AS Nancy","4-1",4,1,"1",1,5,3,"H"
1946-11-24,1946,"FC Metz","Lille OSC","4-1",4,1,"1",1,5,3,"H"
1946-11-24,1946,"Le Havre AC","FC Rouen","4-1",4,1,"1",1,5,3,"H"
1946-11-24,1946,"Toulouse FC","RC Strasbourg","3-1",3,1,"1",1,4,2,"H"
1946-11-24,1946,"Red Star Olympique Audonien","FC Sete","1-1",1,1,"1",1,2,0,"D"
1946-11-24,1946,"Stade Reims","RC Lens","3-1",3,1,"1",1,4,2,"H"
1946-11-24,1946,"Stade Olympique Montpellierain","AS Cannes-Grasse","0-1",0,1,"1",1,1,-1,"D"
1946-11-24,1946,"Girondins Bordeaux","Stade Rennes","0-1",0,1,"1",1,1,-1,"D"
1946-11-24,1946,"Olympique Marseille","Racing Club de France","5-3",5,3,"1",1,8,2,"H"
1946-11-24,1946,"Stade Francais","AS Saint-Etienne","3-0",3,0,"1",1,3,3,"H"
1946-11-24,1946,"RC Roubaix","AS Nancy","1-1",1,1,"1",1,2,0,"D"
1946-12-01,1946,"FC Sete","Stade Reims","2-1",2,1,"1",1,3,1,"H"
1946-12-01,1946,"Lille OSC","Le Havre AC","3-0",3,0,"1",1,3,3,"H"
1946-12-01,1946,"RC Strasbourg","FC Metz","2-2",2,2,"1",1,4,0,"D"
1946-12-01,1946,"RC Lens","Red Star Olympique Audonien","2-0",2,0,"1",1,2,2,"H"
1946-12-01,1946,"FC Rouen","Toulouse FC","1-5",1,5,"1",1,6,-4,"D"
1946-12-01,1946,"Stade Francais","RC Roubaix","4-3",4,3,"1",1,7,1,"H"
1946-12-01,1946,"Stade Rennes","AS Saint-Etienne","2-1",2,1,"1",1,3,1,"H"
1946-12-01,1946,"AS Cannes-Grasse","Racing Club de France","1-0",1,0,"1",1,1,1,"H"
1946-12-01,1946,"AS Nancy","Girondins Bordeaux","2-4",2,4,"1",1,6,-2,"D"
1946-12-01,1946,"Olympique Marseille","Stade Olympique Montpellierain","2-1",2,1,"1",1,3,1,"H"
1946-12-08,1946,"FC Metz","FC Sete","1-1",1,1,"1",1,2,0,"D"
1946-12-08,1946,"Red Star Olympique Audonien","RC Strasbourg","0-2",0,2,"1",1,2,-2,"D"
1946-12-08,1946,"Stade Reims","Toulouse FC","3-1",3,1,"1",1,4,2,"H"
1946-12-08,1946,"Le Havre AC","RC Lens","0-2",0,2,"1",1,2,-2,"D"
1946-12-08,1946,"Racing Club de France","Stade Francais","4-2",4,2,"1",1,6,2,"H"
1946-12-08,1946,"Stade Olympique Montpellierain","Stade Rennes","1-0",1,0,"1",1,1,1,"H"
1946-12-08,1946,"AS Nancy","AS Cannes-Grasse","0-0",0,0,"1",1,0,0,"D"
1946-12-08,1946,"AS Saint-Etienne","Girondins Bordeaux","4-2",4,2,"1",1,6,2,"H"
1946-12-08,1946,"RC Roubaix","Olympique Marseille","2-0",2,0,"1",1,2,2,"H"
1946-12-08,1946,"FC Rouen","Lille OSC","0-3",0,3,"1",1,3,-3,"D"
1946-12-22,1946,"Le Havre AC","FC Metz","1-2",1,2,"1",1,3,-1,"D"
1946-12-22,1946,"Lille OSC","FC Sete","2-3",2,3,"1",1,5,-1,"D"
1946-12-22,1946,"FC Rouen","Stade Reims","1-0",1,0,"1",1,1,1,"H"
1946-12-22,1946,"RC Lens","RC Strasbourg","2-1",2,1,"1",1,3,1,"H"
1946-12-22,1946,"Toulouse FC","Red Star Olympique Audonien","0-4",0,4,"1",1,4,-4,"D"
1946-12-22,1946,"Stade Rennes","Stade Francais","0-1",0,1,"1",1,1,-1,"D"
1946-12-22,1946,"Racing Club de France","AS Saint-Etienne","3-4",3,4,"1",1,7,-1,"D"
1946-12-22,1946,"Stade Olympique Montpellierain","RC Roubaix","2-2",2,2,"1",1,4,0,"D"
1946-12-22,1946,"Olympique Marseille","AS Nancy","3-1",3,1,"1",1,4,2,"H"
1946-12-22,1946,"AS Cannes-Grasse","Girondins Bordeaux","2-0",2,0,"1",1,2,2,"H"
1946-12-29,1946,"RC Strasbourg","Lille OSC","1-2",1,2,"1",1,3,-1,"D"
1946-12-29,1946,"Stade Reims","Le Havre AC","3-1",3,1,"1",1,4,2,"H"
1946-12-29,1946,"FC Sete","Toulouse FC","1-0",1,0,"1",1,1,1,"H"
1946-12-29,1946,"FC Metz","RC Lens","2-1",2,1,"1",1,3,1,"H"
1946-12-29,1946,"Red Star Olympique Audonien","FC Rouen","4-1",4,1,"1",1,5,3,"H"
1946-12-29,1946,"AS Nancy","Racing Club de France","0-2",0,2,"1",1,2,-2,"D"
1946-12-29,1946,"RC Roubaix","AS Saint-Etienne","7-3",7,3,"1",1,10,4,"H"
1946-12-29,1946,"AS Cannes-Grasse","Stade Rennes","0-2",0,2,"1",1,2,-2,"D"
1946-12-29,1946,"Stade Francais","Stade Olympique Montpellierain","6-2",6,2,"1",1,8,4,"H"
1946-12-29,1946,"Girondins Bordeaux","Olympique Marseille","2-2",2,2,"1",1,4,0,"D"
1947-01-12,1946,"Red Star Olympique Audonien","FC Metz","3-1",3,1,"1",1,4,2,"H"
1947-01-12,1946,"Stade Reims","RC Strasbourg","3-0",3,0,"1",1,3,3,"H"
1947-01-12,1946,"Le Havre AC","Toulouse FC","0-2",0,2,"1",1,2,-2,"D"
1947-01-12,1946,"Lille OSC","RC Lens","1-1",1,1,"1",1,2,0,"D"
1947-01-12,1946,"FC Sete","FC Rouen","1-3",1,3,"1",1,4,-2,"D"
1947-01-12,1946,"Olympique Marseille","Stade Francais","0-1",0,1,"1",1,1,-1,"D"
1947-01-12,1946,"AS Cannes-Grasse","RC Roubaix","3-1",3,1,"1",1,4,2,"H"
1947-01-12,1946,"Stade Rennes","AS Nancy","3-1",3,1,"1",1,4,2,"H"
1947-01-12,1946,"AS Saint-Etienne","Stade Olympique Montpellierain","3-0",3,0,"1",1,3,3,"H"
1947-01-12,1946,"Racing Club de France","Girondins Bordeaux","0-1",0,1,"1",1,1,-1,"D"
1947-01-19,1946,"FC Sete","Le Havre AC","1-1",1,1,"1",1,2,0,"D"
1947-01-19,1946,"FC Metz","Stade Reims","2-2",2,2,"1",1,4,0,"D"
1947-01-19,1946,"Toulouse FC","RC Lens","2-0",2,0,"1",1,2,2,"H"
1947-01-19,1946,"RC Strasbourg","FC Rouen","2-1",2,1,"1",1,3,1,"H"
1947-01-19,1946,"Lille OSC","Red Star Olympique Audonien","3-0",3,0,"1",1,3,3,"H"
1947-01-19,1946,"Stade Rennes","Racing Club de France","2-2",2,2,"1",1,4,0,"D"
1947-01-19,1946,"Olympique Marseille","AS Saint-Etienne","2-0",2,0,"1",1,2,2,"H"
1947-01-19,1946,"Stade Francais","AS Cannes-Grasse","2-0",2,0,"1",1,2,2,"H"
1947-01-19,1946,"Girondins Bordeaux","RC Roubaix","1-3",1,3,"1",1,4,-2,"D"
1947-01-19,1946,"AS Nancy","Stade Olympique Montpellierain","3-1",3,1,"1",1,4,2,"H"
1947-01-26,1946,"FC Rouen","FC Metz","0-1",0,1,"1",1,1,-1,"D"
1947-01-26,1946,"RC Lens","FC Sete","1-1",1,1,"1",1,2,0,"D"
1947-01-26,1946,"Toulouse FC","Lille OSC","3-4",3,4,"1",1,7,-1,"D"
1947-01-26,1946,"RC Strasbourg","Le Havre AC","2-0",2,0,"1",1,2,2,"H"
1947-01-26,1946,"Red Star Olympique Audonien","Stade Reims","1-0",1,0,"1",1,1,1,"H"
1947-01-26,1946,"Stade Olympique Montpellierain","Racing Club de France","0-1",0,1,"1",1,1,-1,"D"
1947-01-26,1946,"AS Nancy","AS Saint-Etienne","1-1",1,1,"1",1,2,0,"D"
1947-01-26,1946,"RC Roubaix","Stade Rennes","2-3",2,3,"1",1,5,-1,"D"
1947-01-26,1946,"Olympique Marseille","AS Cannes-Grasse","4-1",4,1,"1",1,5,3,"H"
1947-01-26,1946,"Stade Francais","Girondins Bordeaux","0-1",0,1,"1",1,1,-1,"D"
1947-02-09,1946,"Stade Reims","FC Sete","3-0",3,0,"1",1,3,3,"H"
1947-02-09,1946,"Le Havre AC","Lille OSC","1-4",1,4,"1",1,5,-3,"D"
1947-02-09,1946,"FC Metz","RC Strasbourg","0-2",0,2,"1",1,2,-2,"D"
1947-02-09,1946,"Red Star Olympique Audonien","RC Lens","6-2",6,2,"1",1,8,4,"H"
1947-02-09,1946,"Toulouse FC","FC Rouen","3-2",3,2,"1",1,5,1,"H"
1947-02-09,1946,"RC Roubaix","Stade Francais","1-3",1,3,"1",1,4,-2,"D"
1947-02-09,1946,"AS Saint-Etienne","Stade Rennes","1-5",1,5,"1",1,6,-4,"D"
1947-02-09,1946,"Racing Club de France","AS Cannes-Grasse","4-0",4,0,"1",1,4,4,"H"
1947-02-09,1946,"Girondins Bordeaux","AS Nancy","1-1",1,1,"1",1,2,0,"D"
1947-02-09,1946,"Stade Olympique Montpellierain","Olympique Marseille","3-1",3,1,"1",1,4,2,"H"
1947-02-16,1946,"Stade Reims","Lille OSC","1-0",1,0,"1",1,1,1,"H"
1947-02-16,1946,"FC Sete","RC Strasbourg","1-2",1,2,"1",1,3,-1,"D"
1947-02-16,1946,"FC Metz","Toulouse FC","1-4",1,4,"1",1,5,-3,"D"
1947-02-16,1946,"RC Lens","FC Rouen","1-1",1,1,"1",1,2,0,"D"
1947-02-16,1946,"Le Havre AC","Red Star Olympique Audonien","0-0",0,0,"1",1,0,0,"D"
1947-02-16,1946,"RC Roubaix","Racing Club de France","2-1",2,1,"1",1,3,1,"H"
1947-02-16,1946,"AS Cannes-Grasse","AS Saint-Etienne","7-0",7,0,"1",1,7,7,"H"
1947-02-16,1946,"Olympique Marseille","Stade Rennes","1-0",1,0,"1",1,1,1,"H"
1947-02-16,1946,"Stade Francais","AS Nancy","1-0",1,0,"1",1,1,1,"H"
1947-02-16,1946,"Girondins Bordeaux","Stade Olympique Montpellierain","4-0",4,0,"1",1,4,4,"H"
1947-02-23,1946,"Lille OSC","FC Metz","5-3",5,3,"1",1,8,2,"H"
1947-02-23,1946,"FC Rouen","Le Havre AC","2-2",2,2,"1",1,4,0,"D"
1947-02-23,1946,"RC Strasbourg","Toulouse FC","1-3",1,3,"1",1,4,-2,"D"
1947-02-23,1946,"FC Sete","Red Star Olympique Audonien","1-1",1,1,"1",1,2,0,"D"
1947-02-23,1946,"RC Lens","Stade Reims","1-1",1,1,"1",1,2,0,"D"
1947-02-23,1946,"AS Cannes-Grasse","Stade Olympique Montpellierain","2-2",2,2,"1",1,4,0,"D"
1947-02-23,1946,"Stade Rennes","Girondins Bordeaux","3-2",3,2,"1",1,5,1,"H"
1947-02-23,1946,"Racing Club de France","Olympique Marseille","1-2",1,2,"1",1,3,-1,"D"
1947-02-23,1946,"AS Saint-Etienne","Stade Francais","1-1",1,1,"1",1,2,0,"D"
1947-02-23,1946,"AS Nancy","RC Roubaix","2-0",2,0,"1",1,2,2,"H"
1947-03-09,1946,"Stade Francais","FC Metz","0-0",0,0,"1",1,0,0,"D"
1947-03-09,1946,"Olympique Marseille","FC Sete","3-1",3,1,"1",1,4,2,"H"
1947-03-09,1946,"Girondins Bordeaux","Lille OSC","1-0",1,0,"1",1,1,1,"H"
1947-03-09,1946,"Stade Olympique Montpellierain","Le Havre AC","2-0",2,0,"1",1,2,2,"H"
1947-03-09,1946,"AS Nancy","Stade Reims","1-3",1,3,"1",1,4,-2,"D"
1947-03-09,1946,"RC Roubaix","RC Strasbourg","2-0",2,0,"1",1,2,2,"H"
1947-03-09,1946,"Stade Rennes","RC Lens","3-0",3,0,"1",1,3,3,"H"
1947-03-09,1946,"AS Saint-Etienne","FC Rouen","1-0",1,0,"1",1,1,1,"H"
1947-03-09,1946,"Red Star Olympique Audonien","Racing Club de France","1-3",1,3,"1",1,4,-2,"D"
1947-03-09,1946,"Toulouse FC","AS Cannes-Grasse","2-1",2,1,"1",1,3,1,"H"
1947-03-16,1946,"Lille OSC","Stade Francais","5-0",5,0,"1",1,5,5,"H"
1947-03-16,1946,"Toulouse FC","Racing Club de France","4-2",4,2,"1",1,6,2,"H"
1947-03-16,1946,"RC Strasbourg","AS Saint-Etienne","3-3",3,3,"1",1,6,0,"D"
1947-03-16,1946,"Red Star Olympique Audonien","Stade Rennes","1-1",1,1,"1",1,2,0,"D"
1947-03-16,1946,"FC Rouen","AS Cannes-Grasse","0-0",0,0,"1",1,0,0,"D"
1947-03-16,1946,"RC Lens","RC Roubaix","3-1",3,1,"1",1,4,2,"H"
1947-03-16,1946,"FC Sete","AS Nancy","2-2",2,2,"1",1,4,0,"D"
1947-03-16,1946,"FC Metz","Stade Olympique Montpellierain","7-2",7,2,"1",1,9,5,"H"
1947-03-16,1946,"Stade Reims","Girondins Bordeaux","3-1",3,1,"1",1,4,2,"H"
1947-03-16,1946,"Le Havre AC","Olympique Marseille","1-1",1,1,"1",1,2,0,"D"
1947-03-20,1946,"RC Lens","Stade Francais","0-1",0,1,"1",1,1,-1,"D"
1947-03-20,1946,"FC Sete","Racing Club de France","2-2",2,2,"1",1,4,0,"D"
1947-03-20,1946,"FC Metz","AS Saint-Etienne","4-4",4,4,"1",1,8,0,"D"
1947-03-20,1946,"Stade Reims","Stade Rennes","1-0",1,0,"1",1,1,1,"H"
1947-03-20,1946,"Le Havre AC","AS Cannes-Grasse","1-0",1,0,"1",1,1,1,"H"
1947-03-20,1946,"Lille OSC","RC Roubaix","0-1",0,1,"1",1,1,-1,"D"
1947-03-20,1946,"Toulouse FC","AS Nancy","2-1",2,1,"1",1,3,1,"H"
1947-03-20,1946,"RC Strasbourg","Stade Olympique Montpellierain","2-1",2,1,"1",1,3,1,"H"
1947-03-20,1946,"Red Star Olympique Audonien","Girondins Bordeaux","2-1",2,1,"1",1,3,1,"H"
1947-03-20,1946,"FC Rouen","Olympique Marseille","2-3",2,3,"1",1,5,-1,"D"
1947-04-03,1946,"AS Nancy","FC Metz","3-1",3,1,"1",1,4,2,"H"
1947-04-03,1946,"RC Roubaix","FC Sete","2-1",2,1,"1",1,3,1,"H"
1947-04-03,1946,"AS Cannes-Grasse","Lille OSC","0-2",0,2,"1",1,2,-2,"D"
1947-04-03,1946,"Stade Rennes","Le Havre AC","3-1",3,1,"1",1,4,2,"H"
1947-04-03,1946,"AS Saint-Etienne","Stade Reims","1-1",1,1,"1",1,2,0,"D"
1947-04-03,1946,"Racing Club de France","RC Strasbourg","2-3",2,3,"1",1,5,-1,"D"
1947-04-03,1946,"Stade Francais","Toulouse FC","5-1",5,1,"1",1,6,4,"H"
1947-04-03,1946,"Olympique Marseille","RC Lens","5-2",5,2,"1",1,7,3,"H"
1947-04-03,1946,"Girondins Bordeaux","FC Rouen","2-1",2,1,"1",1,3,1,"H"
1947-04-03,1946,"Stade Olympique Montpellierain","Red Star Olympique Audonien","4-4",4,4,"1",1,8,0,"D"
1947-04-06,1946,"Racing Club de France","FC Metz","3-3",3,3,"1",1,6,0,"D"
1947-04-06,1946,"Stade Francais","FC Sete","1-1",1,1,"1",1,2,0,"D"
1947-04-06,1946,"Olympique Marseille","Lille OSC","1-1",1,1,"1",1,2,0,"D"
1947-04-06,1946,"Girondins Bordeaux","Le Havre AC","1-2",1,2,"1",1,3,-1,"D"
1947-04-06,1946,"Stade Olympique Montpellierain","Stade Reims","2-0",2,0,"1",1,2,2,"H"
1947-04-06,1946,"AS Nancy","RC Strasbourg","1-0",1,0,"1",1,1,1,"H"
1947-04-06,1946,"RC Roubaix","Toulouse FC","1-0",1,0,"1",1,1,1,"H"
1947-04-06,1946,"AS Cannes-Grasse","RC Lens","2-0",2,0,"1",1,2,2,"H"
1947-04-06,1946,"Stade Rennes","FC Rouen","2-0",2,0,"1",1,2,2,"H"
1947-04-06,1946,"AS Saint-Etienne","Red Star Olympique Audonien","3-1",3,1,"1",1,4,2,"H"
1947-05-18,1946,"Girondins Bordeaux","FC Metz","4-3",4,3,"1",1,7,1,"H"
1947-05-18,1946,"Stade Olympique Montpellierain","FC Sete","3-2",3,2,"1",1,5,1,"H"
1947-05-18,1946,"AS Nancy","Lille OSC","3-1",3,1,"1",1,4,2,"H"
1947-05-18,1946,"RC Roubaix","Le Havre AC","1-0",1,0,"1",1,1,1,"H"
1947-05-18,1946,"AS Cannes-Grasse","Stade Reims","1-0",1,0,"1",1,1,1,"H"
1947-05-18,1946,"Stade Rennes","RC Strasbourg","1-6",1,6,"1",1,7,-5,"D"
1947-05-18,1946,"AS Saint-Etienne","Toulouse FC","4-2",4,2,"1",1,6,2,"H"
1947-05-18,1946,"Racing Club de France","RC Lens","1-3",1,3,"1",1,4,-2,"D"
1947-05-18,1946,"Olympique Marseille","Red Star Olympique Audonien","4-0",4,0,"1",1,4,4,"H"
1947-05-18,1946,"FC Rouen","Stade Francais","0-2",0,2,"1",1,2,-2,"D"
1947-08-24,1947,"Racing Club de France","Lille OSC","1-4",1,4,"1",1,5,-3,"D"
1947-08-24,1947,"FC Sete","Red Star Olympique Audonien","1-2",1,2,"1",1,3,-1,"D"
1947-08-24,1947,"RC Roubaix","AS Cannes-Grasse","3-1",3,1,"1",1,4,2,"H"
1947-08-24,1947,"Stade Francais","FC Sochaux","2-2",2,2,"1",1,4,0,"D"
1947-08-24,1947,"Olympique Ales","RC Strasbourg","0-2",0,2,"1",1,2,-2,"D"
1947-08-24,1947,"Olympique Marseille","Toulouse FC","3-2",3,2,"1",1,5,1,"H"
1947-08-24,1947,"Stade Reims","AS Nancy","5-0",5,0,"1",1,5,5,"H"
1947-08-24,1947,"Stade Rennes","AS Saint-Etienne","1-3",1,3,"1",1,4,-2,"D"
1947-08-24,1947,"FC Metz","Stade Olympique Montpellierain","1-0",1,0,"1",1,1,1,"H"
1947-08-31,1947,"Lille OSC","RC Roubaix","4-0",4,0,"1",1,4,4,"H"
1947-08-31,1947,"Stade Olympique Montpellierain","FC Sochaux","2-0",2,0,"1",1,2,2,"H"
1947-08-31,1947,"AS Cannes-Grasse","FC Metz","1-1",1,1,"1",1,2,0,"D"
1947-08-31,1947,"Red Star Olympique Audonien","Racing Club de France","1-3",1,3,"1",1,4,-2,"D"
1947-08-31,1947,"AS Saint-Etienne","Olympique Ales","3-3",3,3,"1",1,6,0,"D"
1947-08-31,1947,"Toulouse FC","Stade Francais","4-0",4,0,"1",1,4,4,"H"
1947-08-31,1947,"RC Strasbourg","FC Sete","3-1",3,1,"1",1,4,2,"H"
1947-08-31,1947,"Stade Reims","Stade Rennes","1-0",1,0,"1",1,1,1,"H"
1947-08-31,1947,"AS Nancy","Olympique Marseille","4-0",4,0,"1",1,4,4,"H"
1947-09-07,1947,"Racing Club de France","AS Saint-Etienne","2-2",2,2,"1",1,4,0,"D"
1947-09-07,1947,"FC Sete","Stade Rennes","2-0",2,0,"1",1,2,2,"H"
1947-09-07,1947,"RC Roubaix","RC Strasbourg","3-2",3,2,"1",1,5,1,"H"
1947-09-07,1947,"FC Sochaux","Lille OSC","1-2",1,2,"1",1,3,-1,"D"
1947-09-07,1947,"Toulouse FC","AS Cannes-Grasse","0-0",0,0,"1",1,0,0,"D"
1947-09-07,1947,"FC Metz","Red Star Olympique Audonien","2-0",2,0,"1",1,2,2,"H"
1947-09-07,1947,"Olympique Marseille","Stade Francais","5-1",5,1,"1",1,6,4,"H"
1947-09-07,1947,"AS Nancy","Stade Olympique Montpellierain","2-2",2,2,"1",1,4,0,"D"
1947-09-07,1947,"Olympique Ales","Stade Reims","0-1",0,1,"1",1,1,-1,"D"
1947-09-14,1947,"Stade Francais","AS Nancy","2-3",2,3,"1",1,5,-1,"D"
1947-09-14,1947,"Stade Reims","Olympique Marseille","3-0",3,0,"1",1,3,3,"H"
1947-09-14,1947,"RC Strasbourg","Racing Club de France","1-2",1,2,"1",1,3,-1,"D"
1947-09-14,1947,"AS Cannes-Grasse","FC Sochaux","3-0",3,0,"1",1,3,3,"H"
1947-09-14,1947,"AS Saint-Etienne","FC Sete","3-1",3,1,"1",1,4,2,"H"
1947-09-14,1947,"Red Star Olympique Audonien","RC Roubaix","1-1",1,1,"1",1,2,0,"D"
1947-09-14,1947,"Stade Rennes","Olympique Ales","4-1",4,1,"1",1,5,3,"H"
1947-09-14,1947,"Lille OSC","FC Metz","3-1",3,1,"1",1,4,2,"H"
1947-09-14,1947,"Stade Olympique Montpellierain","Toulouse FC","1-3",1,3,"1",1,4,-2,"D"
1947-09-18,1947,"RC Roubaix","AS Saint-Etienne","0-3",0,3,"1",1,3,-3,"D"
1947-09-18,1947,"Olympique Marseille","Stade Olympique Montpellierain","2-1",2,1,"1",1,3,1,"H"
1947-09-18,1947,"FC Metz","RC Strasbourg","4-1",4,1,"1",1,5,3,"H"
1947-09-18,1947,"Racing Club de France","Stade Rennes","2-4",2,4,"1",1,6,-2,"D"
1947-09-18,1947,"AS Nancy","AS Cannes-Grasse","1-1",1,1,"1",1,2,0,"D"
1947-09-18,1947,"FC Sete","Olympique Ales","2-3",2,3,"1",1,5,-1,"D"
1947-09-18,1947,"FC Sochaux","Red Star Olympique Audonien","0-1",0,1,"1",1,1,-1,"D"
1947-09-18,1947,"Toulouse FC","Lille OSC","1-4",1,4,"1",1,5,-3,"D"
1947-09-18,1947,"Stade Francais","Stade Reims","2-1",2,1,"1",1,3,1,"H"
1947-09-21,1947,"Olympique Ales","Racing Club de France","0-5",0,5,"1",1,5,-5,"D"
1947-09-21,1947,"AS Saint-Etienne","FC Metz","3-0",3,0,"1",1,3,3,"H"
1947-09-21,1947,"Stade Olympique Montpellierain","Stade Francais","6-2",6,2,"1",1,8,4,"H"
1947-09-21,1947,"Stade Reims","FC Sete","3-0",3,0,"1",1,3,3,"H"
1947-09-21,1947,"Red Star Olympique Audonien","Toulouse FC","1-2",1,2,"1",1,3,-1,"D"
1947-09-21,1947,"Stade Rennes","RC Roubaix","4-4",4,4,"1",1,8,0,"D"
1947-09-21,1947,"AS Cannes-Grasse","Olympique Marseille","0-2",0,2,"1",1,2,-2,"D"
1947-09-21,1947,"RC Strasbourg","FC Sochaux","2-2",2,2,"1",1,4,0,"D"
1947-09-21,1947,"Lille OSC","AS Nancy","4-1",4,1,"1",1,5,3,"H"
1947-09-28,1947,"Racing Club de France","FC Sete","7-1",7,1,"1",1,8,6,"H"
1947-09-28,1947,"FC Metz","Stade Rennes","6-1",6,1,"1",1,7,5,"H"
1947-09-28,1947,"Olympique Marseille","Lille OSC","4-1",4,1,"1",1,5,3,"H"
1947-09-28,1947,"FC Sochaux","AS Saint-Etienne","2-2",2,2,"1",1,4,0,"D"
1947-09-28,1947,"RC Roubaix","Olympique Ales","1-0",1,0,"1",1,1,1,"H"
1947-09-28,1947,"Stade Olympique Montpellierain","Stade Reims","2-3",2,3,"1",1,5,-1,"D"
1947-09-28,1947,"Toulouse FC","RC Strasbourg","0-3",0,3,"1",1,3,-3,"D"
1947-09-28,1947,"AS Nancy","Red Star Olympique Audonien","5-1",5,1,"1",1,6,4,"H"
1947-09-28,1947,"Stade Francais","AS Cannes-Grasse","1-4",1,4,"1",1,5,-3,"D"
1947-10-05,1947,"Red Star Olympique Audonien","Olympique Marseille","2-2",2,2,"1",1,4,0,"D"
1947-10-05,1947,"Lille OSC","Stade Francais","1-3",1,3,"1",1,4,-2,"D"
1947-10-05,1947,"Stade Rennes","FC Sochaux","0-3",0,3,"1",1,3,-3,"D"
1947-10-05,1947,"AS Saint-Etienne","Toulouse FC","4-2",4,2,"1",1,6,2,"H"
1947-10-05,1947,"FC Sete","RC Roubaix","1-5",1,5,"1",1,6,-4,"D"
1947-10-05,1947,"AS Cannes-Grasse","Stade Olympique Montpellierain","1-1",1,1,"1",1,2,0,"D"
1947-10-05,1947,"RC Strasbourg","AS Nancy","1-1",1,1,"1",1,2,0,"D"
1947-10-05,1947,"Racing Club de France","Stade Reims","2-1",2,1,"1",1,3,1,"H"
1947-10-05,1947,"Olympique Ales","FC Metz","3-0",3,0,"1",1,3,3,"H"
1947-10-12,1947,"RC Roubaix","Racing Club de France","5-2",5,2,"1",1,7,3,"H"
1947-10-12,1947,"Stade Olympique Montpellierain","Lille OSC","0-1",0,1,"1",1,1,-1,"D"
1947-10-12,1947,"FC Metz","FC Sete","4-2",4,2,"1",1,6,2,"H"
1947-10-12,1947,"FC Sochaux","Olympique Ales","2-0",2,0,"1",1,2,2,"H"
1947-10-12,1947,"Stade Reims","AS Cannes-Grasse","3-0",3,0,"1",1,3,3,"H"
1947-10-12,1947,"Toulouse FC","Stade Rennes","0-1",0,1,"1",1,1,-1,"D"
1947-10-12,1947,"Stade Francais","Red Star Olympique Audonien","4-0",4,0,"1",1,4,4,"H"
1947-10-12,1947,"Olympique Marseille","RC Strasbourg","1-0",1,0,"1",1,1,1,"H"
1947-10-12,1947,"AS Nancy","AS Saint-Etienne","4-0",4,0,"1",1,4,4,"H"
1947-10-26,1947,"Red Star Olympique Audonien","Stade Olympique Montpellierain","3-4",3,4,"1",1,7,-1,"D"
1947-10-26,1947,"AS Saint-Etienne","Olympique Marseille","3-2",3,2,"1",1,5,1,"H"
1947-10-26,1947,"Racing Club de France","FC Metz","4-2",4,2,"1",1,6,2,"H"
1947-10-26,1947,"Lille OSC","AS Cannes-Grasse","3-0",3,0,"1",1,3,3,"H"
1947-10-26,1947,"Stade Reims","RC Roubaix","1-1",1,1,"1",1,2,0,"D"
1947-10-26,1947,"FC Sete","FC Sochaux","1-5",1,5,"1",1,6,-4,"D"
1947-10-26,1947,"RC Strasbourg","Stade Francais","1-1",1,1,"1",1,2,0,"D"
1947-10-26,1947,"Stade Rennes","AS Nancy","0-0",0,0,"1",1,0,0,"D"
1947-10-26,1947,"Olympique Ales","Toulouse FC","3-2",3,2,"1",1,5,1,"H"
1947-11-02,1947,"Stade Francais","AS Saint-Etienne","2-1",2,1,"1",1,3,1,"H"
1947-11-02,1947,"Lille OSC","Stade Reims","0-0",0,0,"1",1,0,0,"D"
1947-11-02,1947,"Stade Olympique Montpellierain","RC Strasbourg","1-1",1,1,"1",1,2,0,"D"
1947-11-02,1947,"FC Metz","RC Roubaix","0-1",0,1,"1",1,1,-1,"D"
1947-11-02,1947,"FC Sochaux","Racing Club de France","3-2",3,2,"1",1,5,1,"H"
1947-11-02,1947,"Toulouse FC","FC Sete","2-1",2,1,"1",1,3,1,"H"
1947-11-02,1947,"AS Nancy","Olympique Ales","1-0",1,0,"1",1,1,1,"H"
1947-11-02,1947,"AS Cannes-Grasse","Red Star Olympique Audonien","1-0",1,0,"1",1,1,1,"H"
1947-11-02,1947,"Olympique Marseille","Stade Rennes","1-1",1,1,"1",1,2,0,"D"
1947-11-09,1947,"Racing Club de France","Toulouse FC","2-0",2,0,"1",1,2,2,"H"
1947-11-09,1947,"RC Roubaix","FC Sochaux","3-1",3,1,"1",1,4,2,"H"
1947-11-09,1947,"Stade Rennes","Stade Francais","0-3",0,3,"1",1,3,-3,"D"
1947-11-09,1947,"RC Strasbourg","AS Cannes-Grasse","8-2",8,2,"1",1,10,6,"H"
1947-11-09,1947,"FC Metz","Stade Reims","1-3",1,3,"1",1,4,-2,"D"
1947-11-09,1947,"FC Sete","AS Nancy","4-3",4,3,"1",1,7,1,"H"
1947-11-09,1947,"Olympique Ales","Olympique Marseille","2-3",2,3,"1",1,5,-1,"D"
1947-11-09,1947,"AS Saint-Etienne","Stade Olympique Montpellierain","2-2",2,2,"1",1,4,0,"D"
1947-11-09,1947,"Red Star Olympique Audonien","Lille OSC","1-2",1,2,"1",1,3,-1,"D"
1947-11-16,1947,"Stade Francais","Olympique Ales","3-1",3,1,"1",1,4,2,"H"
1947-11-16,1947,"Stade Reims","Red Star Olympique Audonien","1-0",1,0,"1",1,1,1,"H"
1947-11-16,1947,"Stade Olympique Montpellierain","Stade Rennes","2-2",2,2,"1",1,4,0,"D"
1947-11-16,1947,"Lille OSC","RC Strasbourg","1-1",1,1,"1",1,2,0,"D"
1947-11-16,1947,"Olympique Marseille","FC Sete","4-1",4,1,"1",1,5,3,"H"
1947-11-16,1947,"AS Nancy","Racing Club de France","1-3",1,3,"1",1,4,-2,"D"
1947-11-16,1947,"Toulouse FC","RC Roubaix","2-1",2,1,"1",1,3,1,"H"
1947-11-16,1947,"FC Sochaux","FC Metz","4-3",4,3,"1",1,7,1,"H"
1947-11-16,1947,"AS Cannes-Grasse","AS Saint-Etienne","0-3",0,3,"1",1,3,-3,"D"
1947-11-21,1947,"FC Metz","Olympique Marseille","0-1",0,1,"1",1,1,-1,"D"
1947-11-21,1947,"Racing Club de France","Stade Olympique Montpellierain","6-1",6,1,"1",1,7,5,"H"
1947-11-21,1947,"FC Sete","AS Cannes-Grasse","4-0",4,0,"1",1,4,4,"H"
1947-11-21,1947,"Stade Rennes","Red Star Olympique Audonien","1-0",1,0,"1",1,1,1,"H"
1947-11-21,1947,"FC Sochaux","AS Nancy","2-2",2,2,"1",1,4,0,"D"
1947-11-21,1947,"RC Roubaix","Stade Francais","1-0",1,0,"1",1,1,1,"H"
1947-11-21,1947,"Olympique Ales","Lille OSC","1-1",1,1,"1",1,2,0,"D"
1947-11-21,1947,"AS Saint-Etienne","RC Strasbourg","1-1",1,1,"1",1,2,0,"D"
1947-11-21,1947,"Toulouse FC","Stade Reims","1-3",1,3,"1",1,4,-2,"D"
1947-11-30,1947,"Stade Rennes","Lille OSC","4-2",4,2,"1",1,6,2,"H"
1947-11-30,1947,"RC Strasbourg","Stade Reims","2-2",2,2,"1",1,4,0,"D"
1947-11-30,1947,"Racing Club de France","Stade Francais","0-1",0,1,"1",1,1,-1,"D"
1947-11-30,1947,"FC Metz","AS Nancy","4-3",4,3,"1",1,7,1,"H"
1947-11-30,1947,"FC Sete","Stade Olympique Montpellierain","0-1",0,1,"1",1,1,-1,"D"
1947-11-30,1947,"Olympique Ales","AS Cannes-Grasse","2-1",2,1,"1",1,3,1,"H"
1947-11-30,1947,"AS Saint-Etienne","Red Star Olympique Audonien","4-1",4,1,"1",1,5,3,"H"
1947-11-30,1947,"FC Sochaux","Toulouse FC","4-0",4,0,"1",1,4,4,"H"
1947-11-30,1947,"RC Roubaix","Olympique Marseille","1-1",1,1,"1",1,2,0,"D"
1947-12-07,1947,"Red Star Olympique Audonien","RC Strasbourg","0-5",0,5,"1",1,5,-5,"D"
1947-12-07,1947,"AS Nancy","RC Roubaix","0-4",0,4,"1",1,4,-4,"D"
1947-12-07,1947,"Stade Olympique Montpellierain","Olympique Ales","1-3",1,3,"1",1,4,-2,"D"
1947-12-07,1947,"Lille OSC","AS Saint-Etienne","0-0",0,0,"1",1,0,0,"D"
1947-12-07,1947,"Stade Reims","FC Sochaux","4-0",4,0,"1",1,4,4,"H"
1947-12-07,1947,"Toulouse FC","FC Metz","4-3",4,3,"1",1,7,1,"H"
1947-12-07,1947,"Olympique Marseille","Racing Club de France","4-1",4,1,"1",1,5,3,"H"
1947-12-07,1947,"Stade Francais","FC Sete","4-1",4,1,"1",1,5,3,"H"
1947-12-07,1947,"AS Cannes-Grasse","Stade Rennes","5-2",5,2,"1",1,7,3,"H"
1947-12-25,1947,"Stade Reims","AS Saint-Etienne","6-0",6,0,"1",1,6,6,"H"
1947-12-25,1947,"Stade Olympique Montpellierain","RC Roubaix","1-1",1,1,"1",1,2,0,"D"
1947-12-25,1947,"RC Strasbourg","Stade Rennes","6-1",6,1,"1",1,7,5,"H"
1947-12-25,1947,"Olympique Marseille","FC Sochaux","3-1",3,1,"1",1,4,2,"H"
1947-12-25,1947,"Lille OSC","FC Sete","5-3",5,3,"1",1,8,2,"H"
1947-12-25,1947,"AS Nancy","Toulouse FC","0-0",0,0,"1",1,0,0,"D"
1947-12-25,1947,"Red Star Olympique Audonien","Olympique Ales","3-1",3,1,"1",1,4,2,"H"
1947-12-25,1947,"AS Cannes-Grasse","Racing Club de France","4-4",4,4,"1",1,8,0,"D"
1947-12-25,1947,"Stade Francais","FC Metz","7-1",7,1,"1",1,8,6,"H"
1947-12-28,1947,"Toulouse FC","Olympique Marseille","3-1",3,1,"1",1,4,2,"H"
1947-12-28,1947,"Lille OSC","Racing Club de France","2-1",2,1,"1",1,3,1,"H"
1947-12-28,1947,"FC Sochaux","Stade Francais","4-0",4,0,"1",1,4,4,"H"
1947-12-28,1947,"AS Nancy","Stade Reims","1-2",1,2,"1",1,3,-1,"D"
1947-12-28,1947,"Red Star Olympique Audonien","FC Sete","1-0",1,0,"1",1,1,1,"H"
1947-12-28,1947,"Stade Olympique Montpellierain","FC Metz","5-2",5,2,"1",1,7,3,"H"
1947-12-28,1947,"AS Saint-Etienne","Stade Rennes","1-0",1,0,"1",1,1,1,"H"
1947-12-28,1947,"AS Cannes-Grasse","RC Roubaix","1-1",1,1,"1",1,2,0,"D"
1947-12-28,1947,"RC Strasbourg","Olympique Ales","9-3",9,3,"1",1,12,6,"H"
1948-01-11,1947,"Stade Francais","Toulouse FC","2-1",2,1,"1",1,3,1,"H"
1948-01-11,1947,"Stade Rennes","Stade Reims","1-0",1,0,"1",1,1,1,"H"
1948-01-11,1947,"Olympique Marseille","AS Nancy","5-0",5,0,"1",1,5,5,"H"
1948-01-11,1947,"RC Roubaix","Lille OSC","1-5",1,5,"1",1,6,-4,"D"
1948-01-11,1947,"Olympique Ales","AS Saint-Etienne","2-2",2,2,"1",1,4,0,"D"
1948-01-11,1947,"Racing Club de France","Red Star Olympique Audonien","2-1",2,1,"1",1,3,1,"H"
1948-01-11,1947,"FC Sete","RC Strasbourg","3-2",3,2,"1",1,5,1,"H"
1948-01-11,1947,"FC Sochaux","Stade Olympique Montpellierain","1-0",1,0,"1",1,1,1,"H"
1948-01-11,1947,"FC Metz","AS Cannes-Grasse","1-1",1,1,"1",1,2,0,"D"
1948-01-18,1947,"Stade Francais","Olympique Marseille","1-1",1,1,"1",1,2,0,"D"
1948-01-18,1947,"AS Cannes-Grasse","Toulouse FC","1-0",1,0,"1",1,1,1,"H"
1948-01-18,1947,"Stade Reims","Olympique Ales","1-0",1,0,"1",1,1,1,"H"
1948-01-18,1947,"Lille OSC","FC Sochaux","6-1",6,1,"1",1,7,5,"H"
1948-01-18,1947,"AS Saint-Etienne","Racing Club de France","1-4",1,4,"1",1,5,-3,"D"
1948-01-18,1947,"RC Strasbourg","RC Roubaix","3-0",3,0,"1",1,3,3,"H"
1948-01-18,1947,"Stade Olympique Montpellierain","AS Nancy","3-1",3,1,"1",1,4,2,"H"
1948-01-18,1947,"Stade Rennes","FC Sete","3-0",3,0,"1",1,3,3,"H"
1948-01-18,1947,"Red Star Olympique Audonien","FC Metz","0-1",0,1,"1",1,1,-1,"D"
1948-01-25,1947,"AS Nancy","Stade Francais","0-0",0,0,"1",1,0,0,"D"
1948-01-25,1947,"Toulouse FC","Stade Olympique Montpellierain","4-2",4,2,"1",1,6,2,"H"
1948-01-25,1947,"FC Sochaux","AS Cannes-Grasse","5-1",5,1,"1",1,6,4,"H"
1948-01-25,1947,"FC Sete","AS Saint-Etienne","4-2",4,2,"1",1,6,2,"H"
1948-01-25,1947,"Olympique Ales","Stade Rennes","1-1",1,1,"1",1,2,0,"D"
1948-01-25,1947,"RC Roubaix","Red Star Olympique Audonien","1-0",1,0,"1",1,1,1,"H"
1948-01-25,1947,"FC Metz","Lille OSC","6-2",6,2,"1",1,8,4,"H"
1948-01-25,1947,"Olympique Marseille","Stade Reims","1-0",1,0,"1",1,1,1,"H"
1948-01-25,1947,"Racing Club de France","RC Strasbourg","4-2",4,2,"1",1,6,2,"H"
1948-02-08,1947,"AS Nancy","RC Strasbourg","3-0",3,0,"1",1,3,3,"H"
1948-02-08,1947,"Stade Reims","Racing Club de France","2-2",2,2,"1",1,4,0,"D"
1948-02-08,1947,"Stade Francais","Lille OSC","1-1",1,1,"1",1,2,0,"D"
1948-02-08,1947,"FC Metz","Olympique Ales","4-4",4,4,"1",1,8,0,"D"
1948-02-08,1947,"Toulouse FC","AS Saint-Etienne","0-2",0,2,"1",1,2,-2,"D"
1948-02-08,1947,"Olympique Marseille","Red Star Olympique Audonien","3-0",3,0,"1",1,3,3,"H"
1948-02-08,1947,"Stade Olympique Montpellierain","AS Cannes-Grasse","0-2",0,2,"1",1,2,-2,"D"
1948-02-08,1947,"FC Sochaux","Stade Rennes","2-0",2,0,"1",1,2,2,"H"
1948-02-08,1947,"RC Roubaix","FC Sete","2-4",2,4,"1",1,6,-2,"D"
1948-02-15,1947,"Stade Reims","Stade Olympique Montpellierain","1-0",1,0,"1",1,1,1,"H"
1948-02-15,1947,"Olympique Ales","RC Roubaix","1-1",1,1,"1",1,2,0,"D"
1948-02-15,1947,"Stade Rennes","FC Metz","0-2",0,2,"1",1,2,-2,"D"
1948-02-15,1947,"AS Saint-Etienne","FC Sochaux","2-1",2,1,"1",1,3,1,"H"
1948-02-15,1947,"RC Strasbourg","Toulouse FC","3-1",3,1,"1",1,4,2,"H"
1948-02-15,1947,"FC Sete","Racing Club de France","3-2",3,2,"1",1,5,1,"H"
1948-02-15,1947,"Red Star Olympique Audonien","AS Nancy","2-0",2,0,"1",1,2,2,"H"
1948-02-15,1947,"AS Cannes-Grasse","Stade Francais","2-0",2,0,"1",1,2,2,"H"
1948-02-15,1947,"Lille OSC","Olympique Marseille","3-0",3,0,"1",1,3,3,"H"
1948-02-22,1947,"Racing Club de France","Olympique Ales","0-0",0,0,"1",1,0,0,"D"
1948-02-22,1947,"RC Roubaix","Stade Rennes","1-2",1,2,"1",1,3,-1,"D"
1948-02-22,1947,"AS Nancy","Lille OSC","2-1",2,1,"1",1,3,1,"H"
1948-02-22,1947,"Toulouse FC","Red Star Olympique Audonien","2-1",2,1,"1",1,3,1,"H"
1948-02-22,1947,"FC Sochaux","RC Strasbourg","1-0",1,0,"1",1,1,1,"H"
1948-02-22,1947,"Olympique Marseille","AS Cannes-Grasse","2-1",2,1,"1",1,3,1,"H"
1948-03-04,1947,"Red Star Olympique Audonien","FC Sochaux","0-0",0,0,"1",1,0,0,"D"
1948-03-04,1947,"Stade Reims","Stade Francais","0-3",0,3,"1",1,3,-3,"D"
1948-03-04,1947,"AS Cannes-Grasse","AS Nancy","2-1",2,1,"1",1,3,1,"H"
1948-03-04,1947,"Olympique Ales","FC Sete","1-1",1,1,"1",1,2,0,"D"
1948-03-04,1947,"AS Saint-Etienne","RC Roubaix","1-2",1,2,"1",1,3,-1,"D"
1948-03-04,1947,"Lille OSC","Toulouse FC","3-0",3,0,"1",1,3,3,"H"
1948-03-04,1947,"Stade Rennes","Racing Club de France","2-0",2,0,"1",1,2,2,"H"
1948-03-04,1947,"RC Strasbourg","FC Metz","8-4",8,4,"1",1,12,4,"H"
1948-03-04,1947,"Stade Olympique Montpellierain","Olympique Marseille","1-0",1,0,"1",1,1,1,"H"
1948-03-07,1947,"AS Cannes-Grasse","Stade Reims","0-4",0,4,"1",1,4,-4,"D"
1948-03-07,1947,"RC Strasbourg","Olympique Marseille","1-1",1,1,"1",1,2,0,"D"
1948-03-07,1947,"Red Star Olympique Audonien","Stade Francais","0-7",0,7,"1",1,7,-7,"D"
1948-03-07,1947,"Olympique Ales","FC Sochaux","2-2",2,2,"1",1,4,0,"D"
1948-03-07,1947,"FC Sete","FC Metz","2-1",2,1,"1",1,3,1,"H"
1948-03-07,1947,"Lille OSC","Stade Olympique Montpellierain","4-1",4,1,"1",1,5,3,"H"
1948-03-07,1947,"Racing Club de France","RC Roubaix","2-1",2,1,"1",1,3,1,"H"
1948-03-07,1947,"Stade Rennes","Toulouse FC","2-0",2,0,"1",1,2,2,"H"
1948-03-07,1947,"AS Saint-Etienne","AS Nancy","2-0",2,0,"1",1,2,2,"H"
1948-03-11,1947,"FC Metz","AS Saint-Etienne","2-2",2,2,"1",1,4,0,"D"
1948-03-11,1947,"FC Sete","Stade Reims","4-2",4,2,"1",1,6,2,"H"
1948-03-11,1947,"Stade Francais","Stade Olympique Montpellierain","4-1",4,1,"1",1,5,3,"H"
1948-03-14,1947,"AS Cannes-Grasse","Lille OSC","0-2",0,2,"1",1,2,-2,"D"
1948-03-14,1947,"Olympique Marseille","AS Saint-Etienne","4-1",4,1,"1",1,5,3,"H"
1948-03-14,1947,"RC Roubaix","Stade Reims","2-1",2,1,"1",1,3,1,"H"
1948-03-14,1947,"FC Metz","Racing Club de France","2-1",2,1,"1",1,3,1,"H"
1948-03-14,1947,"FC Sochaux","FC Sete","2-2",2,2,"1",1,4,0,"D"
1948-03-14,1947,"Toulouse FC","Olympique Ales","2-0",2,0,"1",1,2,2,"H"
1948-03-14,1947,"Stade Francais","RC Strasbourg","2-2",2,2,"1",1,4,0,"D"
1948-03-14,1947,"AS Nancy","Stade Rennes","1-0",1,0,"1",1,1,1,"H"
1948-03-14,1947,"Stade Olympique Montpellierain","Red Star Olympique Audonien","0-0",0,0,"1",1,0,0,"D"
1948-03-26,1947,"Stade Rennes","Olympique Marseille","1-1",1,1,"1",1,2,0,"D"
1948-03-26,1947,"FC Sete","Toulouse FC","2-2",2,2,"1",1,4,0,"D"
1948-03-26,1947,"RC Roubaix","FC Metz","1-2",1,2,"1",1,3,-1,"D"
1948-03-26,1947,"AS Saint-Etienne","Stade Francais","1-1",1,1,"1",1,2,0,"D"
1948-03-26,1947,"Olympique Ales","AS Nancy","1-1",1,1,"1",1,2,0,"D"
1948-03-26,1947,"RC Strasbourg","Stade Olympique Montpellierain","0-1",0,1,"1",1,1,-1,"D"
1948-03-26,1947,"Red Star Olympique Audonien","AS Cannes-Grasse","3-2",3,2,"1",1,5,1,"H"
1948-03-26,1947,"Stade Reims","Lille OSC","2-2",2,2,"1",1,4,0,"D"
1948-03-26,1947,"Racing Club de France","FC Sochaux","2-1",2,1,"1",1,3,1,"H"
1948-03-28,1947,"Stade Reims","FC Metz","4-2",4,2,"1",1,6,2,"H"
1948-03-28,1947,"Stade Francais","Stade Rennes","3-1",3,1,"1",1,4,2,"H"
1948-03-28,1947,"Toulouse FC","Racing Club de France","1-0",1,0,"1",1,1,1,"H"
1948-03-28,1947,"Lille OSC","Red Star Olympique Audonien","2-0",2,0,"1",1,2,2,"H"
1948-03-28,1947,"Stade Olympique Montpellierain","AS Saint-Etienne","2-0",2,0,"1",1,2,2,"H"
1948-03-28,1947,"Olympique Marseille","Olympique Ales","8-0",8,0,"1",1,8,8,"H"
1948-03-28,1947,"FC Sochaux","RC Roubaix","5-1",5,1,"1",1,6,4,"H"
1948-03-28,1947,"AS Nancy","FC Sete","2-0",2,0,"1",1,2,2,"H"
1948-03-28,1947,"AS Cannes-Grasse","RC Strasbourg","2-2",2,2,"1",1,4,0,"D"
1948-04-11,1947,"Racing Club de France","AS Nancy","3-0",3,0,"1",1,3,3,"H"
1948-04-11,1947,"RC Roubaix","Toulouse FC","1-3",1,3,"1",1,4,-2,"D"
1948-04-11,1947,"AS Saint-Etienne","AS Cannes-Grasse","2-0",2,0,"1",1,2,2,"H"
1948-04-11,1947,"FC Sete","Olympique Marseille","1-3",1,3,"1",1,4,-2,"D"
1948-04-11,1947,"RC Strasbourg","Lille OSC","2-0",2,0,"1",1,2,2,"H"
1948-04-11,1947,"Stade Rennes","Stade Olympique Montpellierain","4-1",4,1,"1",1,5,3,"H"
1948-04-11,1947,"FC Metz","FC Sochaux","2-0",2,0,"1",1,2,2,"H"
1948-04-11,1947,"Red Star Olympique Audonien","Stade Reims","0-2",0,2,"1",1,2,-2,"D"
1948-04-11,1947,"Olympique Ales","Stade Francais","2-2",2,2,"1",1,4,0,"D"
1948-04-25,1947,"Stade Reims","RC Strasbourg","2-2",2,2,"1",1,4,0,"D"
1948-04-25,1947,"Toulouse FC","FC Sochaux","2-3",2,3,"1",1,5,-1,"D"
1948-04-25,1947,"Stade Francais","Racing Club de France","1-5",1,5,"1",1,6,-4,"D"
1948-04-25,1947,"Olympique Marseille","RC Roubaix","6-0",6,0,"1",1,6,6,"H"
1948-04-25,1947,"Stade Olympique Montpellierain","FC Sete","1-1",1,1,"1",1,2,0,"D"
1948-04-25,1947,"Lille OSC","Stade Rennes","1-1",1,1,"1",1,2,0,"D"
1948-04-25,1947,"AS Nancy","FC Metz","4-2",4,2,"1",1,6,2,"H"
1948-04-25,1947,"AS Cannes-Grasse","Olympique Ales","4-1",4,1,"1",1,5,3,"H"
1948-04-25,1947,"Red Star Olympique Audonien","AS Saint-Etienne","0-5",0,5,"1",1,5,-5,"D"
1948-05-02,1947,"FC Sochaux","Stade Reims","0-3",0,3,"1",1,3,-3,"D"
1948-05-02,1947,"FC Sete","Stade Francais","3-2",3,2,"1",1,5,1,"H"
1948-05-02,1947,"AS Saint-Etienne","Lille OSC","8-3",8,3,"1",1,11,5,"H"
1948-05-02,1947,"Racing Club de France","Olympique Marseille","1-1",1,1,"1",1,2,0,"D"
1948-05-02,1947,"Stade Rennes","AS Cannes-Grasse","0-0",0,0,"1",1,0,0,"D"
1948-05-02,1947,"FC Metz","Toulouse FC","1-0",1,0,"1",1,1,1,"H"
1948-05-02,1947,"Olympique Ales","Stade Olympique Montpellierain","3-0",3,0,"1",1,3,3,"H"
1948-05-02,1947,"RC Strasbourg","Red Star Olympique Audonien","3-1",3,1,"1",1,4,2,"H"
1948-05-02,1947,"RC Roubaix","AS Nancy","3-0",3,0,"1",1,3,3,"H"
1948-05-16,1947,"Stade Francais","RC Roubaix","0-2",0,2,"1",1,2,-2,"D"
1948-05-16,1947,"Lille OSC","Olympique Ales","5-2",5,2,"1",1,7,3,"H"
1948-05-16,1947,"Stade Reims","Toulouse FC","4-0",4,0,"1",1,4,4,"H"
1948-05-16,1947,"Olympique Marseille","FC Metz","6-3",6,3,"1",1,9,3,"H"
1948-05-16,1947,"RC Strasbourg","AS Saint-Etienne","2-0",2,0,"1",1,2,2,"H"
1948-05-16,1947,"Red Star Olympique Audonien","Stade Rennes","3-5",3,5,"1",1,8,-2,"D"
1948-05-16,1947,"AS Nancy","FC Sochaux","2-1",2,1,"1",1,3,1,"H"
1948-05-16,1947,"AS Cannes-Grasse","FC Sete","1-2",1,2,"1",1,3,-1,"D"
1948-05-16,1947,"Stade Olympique Montpellierain","Racing Club de France","6-0",6,0,"1",1,6,6,"H"
1948-05-30,1947,"FC Sochaux","Olympique Marseille","2-2",2,2,"1",1,4,0,"D"
1948-05-30,1947,"FC Sete","Lille OSC","1-2",1,2,"1",1,3,-1,"D"
1948-05-30,1947,"Racing Club de France","AS Cannes-Grasse","2-3",2,3,"1",1,5,-1,"D"
1948-05-30,1947,"AS Saint-Etienne","Stade Reims","3-2",3,2,"1",1,5,1,"H"
1948-05-30,1947,"Stade Rennes","RC Strasbourg","7-1",7,1,"1",1,8,6,"H"
1948-05-30,1947,"RC Roubaix","Stade Olympique Montpellierain","7-0",7,0,"1",1,7,7,"H"
1948-05-30,1947,"FC Metz","Stade Francais","0-1",0,1,"1",1,1,-1,"D"
1948-05-30,1947,"Olympique Ales","Red Star Olympique Audonien","3-1",3,1,"1",1,4,2,"H"
1948-05-30,1947,"Toulouse FC","AS Nancy","4-0",4,0,"1",1,4,4,"H"
1948-08-22,1948,"Olympique Marseille","SR Colmar","7-2",7,2,"1",1,9,5,"H"
1948-08-22,1948,"FC Metz","Stade Rennes","1-6",1,6,"1",1,7,-5,"D"
1948-08-22,1948,"FC Sochaux","Toulouse FC","3-0",3,0,"1",1,3,3,"H"
1948-08-22,1948,"RC Strasbourg","AS Nancy","4-2",4,2,"1",1,6,2,"H"
1948-08-22,1948,"AS Saint-Etienne","Stade Reims","2-3",2,3,"1",1,5,-1,"D"
1948-08-22,1948,"RC Roubaix","Stade Olympique Montpellierain","2-3",2,3,"1",1,5,-1,"D"
1948-08-22,1948,"AS Cannes-Grasse","Racing Club de France","2-1",2,1,"1",1,3,1,"H"
1948-08-22,1948,"FC Sete","Lille OSC","1-0",1,0,"1",1,1,1,"H"
1948-08-22,1948,"Stade Red Star","OGC Nice","1-1",1,1,"1",1,2,0,"D"
1948-08-29,1948,"Olympique Marseille","RC Roubaix","4-2",4,2,"1",1,6,2,"H"
1948-08-29,1948,"RC Strasbourg","FC Sochaux","0-3",0,3,"1",1,3,-3,"D"
1948-08-29,1948,"OGC Nice","FC Metz","5-2",5,2,"1",1,7,3,"H"
1948-08-29,1948,"SR Colmar","Stade Reims","3-3",3,3,"1",1,6,0,"D"
1948-08-29,1948,"Stade Red Star","FC Sete","2-2",2,2,"1",1,4,0,"D"
1948-08-29,1948,"Toulouse FC","Stade Rennes","2-1",2,1,"1",1,3,1,"H"
1948-08-29,1948,"Lille OSC","AS Saint-Etienne","5-0",5,0,"1",1,5,5,"H"
1948-08-29,1948,"Stade Olympique Montpellierain","Racing Club de France","0-4",0,4,"1",1,4,-4,"D"
1948-08-29,1948,"AS Nancy","AS Cannes-Grasse","1-0",1,0,"1",1,1,1,"H"
1948-09-04,1948,"Racing Club de France","Olympique Marseille","5-4",5,4,"1",1,9,1,"H"
1948-09-04,1948,"Stade Rennes","RC Strasbourg","1-1",1,1,"1",1,2,0,"D"
1948-09-04,1948,"AS Saint-Etienne","Stade Red Star","2-2",2,2,"1",1,4,0,"D"
1948-09-05,1948,"FC Sochaux","AS Cannes-Grasse","4-0",4,0,"1",1,4,4,"H"
1948-09-05,1948,"OGC Nice","Toulouse FC","2-1",2,1,"1",1,3,1,"H"
1948-09-05,1948,"Stade Reims","Lille OSC","2-4",2,4,"1",1,6,-2,"D"
1948-09-05,1948,"FC Sete","FC Metz","1-1",1,1,"1",1,2,0,"D"
1948-09-05,1948,"AS Nancy","Stade Olympique Montpellierain","1-0",1,0,"1",1,1,1,"H"
1948-09-05,1948,"RC Roubaix","SR Colmar","3-2",3,2,"1",1,5,1,"H"
1948-09-09,1948,"Stade Olympique Montpellierain","FC Sochaux","2-1",2,1,"1",1,3,1,"H"
1948-09-09,1948,"Olympique Marseille","AS Nancy","3-1",3,1,"1",1,4,2,"H"
1948-09-09,1948,"Toulouse FC","FC Sete","0-2",0,2,"1",1,2,-2,"D"
1948-09-09,1948,"SR Colmar","Lille OSC","2-2",2,2,"1",1,4,0,"D"
1948-09-09,1948,"RC Roubaix","Racing Club de France","2-2",2,2,"1",1,4,0,"D"
1948-09-09,1948,"RC Strasbourg","OGC Nice","3-1",3,1,"1",1,4,2,"H"
1948-09-09,1948,"Stade Red Star","Stade Reims","3-5",3,5,"1",1,8,-2,"D"
1948-09-09,1948,"AS Cannes-Grasse","Stade Rennes","1-1",1,1,"1",1,2,0,"D"
1948-09-09,1948,"FC Metz","AS Saint-Etienne","2-0",2,0,"1",1,2,2,"H"
1948-09-12,1948,"FC Sochaux","Olympique Marseille","1-1",1,1,"1",1,2,0,"D"
1948-09-12,1948,"Lille OSC","Stade Red Star","2-1",2,1,"1",1,3,1,"H"
1948-09-12,1948,"Stade Reims","FC Metz","6-1",6,1,"1",1,7,5,"H"
1948-09-12,1948,"OGC Nice","AS Cannes-Grasse","2-0",2,0,"1",1,2,2,"H"
1948-09-12,1948,"FC Sete","RC Strasbourg","0-1",0,1,"1",1,1,-1,"D"
1948-09-12,1948,"Stade Rennes","Stade Olympique Montpellierain","3-0",3,0,"1",1,3,3,"H"
1948-09-12,1948,"Racing Club de France","SR Colmar","3-3",3,3,"1",1,6,0,"D"
1948-09-12,1948,"AS Nancy","RC Roubaix","1-2",1,2,"1",1,3,-1,"D"
1948-09-12,1948,"AS Saint-Etienne","Toulouse FC","4-2",4,2,"1",1,6,2,"H"
1948-09-18,1948,"Stade Red Star","FC Metz","2-6",2,6,"1",1,8,-4,"D"
1948-09-19,1948,"OGC Nice","Olympique Marseille","0-5",0,5,"1",1,5,-5,"D"
1948-09-19,1948,"Stade Reims","RC Strasbourg","3-0",3,0,"1",1,3,3,"H"
1948-09-19,1948,"Stade Rennes","RC Roubaix","3-1",3,1,"1",1,4,2,"H"
1948-09-19,1948,"Lille OSC","Toulouse FC","1-1",1,1,"1",1,2,0,"D"
1948-09-19,1948,"FC Sochaux","Racing Club de France","1-2",1,2,"1",1,3,-1,"D"
1948-09-19,1948,"FC Sete","Stade Olympique Montpellierain","2-1",2,1,"1",1,3,1,"H"
1948-09-19,1948,"AS Saint-Etienne","AS Cannes-Grasse","3-1",3,1,"1",1,4,2,"H"
1948-09-19,1948,"AS Nancy","SR Colmar","1-2",1,2,"1",1,3,-1,"D"
1948-09-23,1948,"Olympique Marseille","Stade Rennes","1-3",1,3,"1",1,4,-2,"D"
1948-09-23,1948,"Racing Club de France","AS Nancy","5-1",5,1,"1",1,6,4,"H"
1948-09-23,1948,"AS Cannes-Grasse","FC Sete","0-2",0,2,"1",1,2,-2,"D"
1948-09-23,1948,"Toulouse FC","Stade Reims","2-0",2,0,"1",1,2,2,"H"
1948-09-23,1948,"FC Metz","Lille OSC","3-1",3,1,"1",1,4,2,"H"
1948-09-23,1948,"Stade Olympique Montpellierain","OGC Nice","1-1",1,1,"1",1,2,0,"D"
1948-09-23,1948,"RC Roubaix","FC Sochaux","5-1",5,1,"1",1,6,4,"H"
1948-09-23,1948,"SR Colmar","Stade Red Star","3-0",3,0,"1",1,3,3,"H"
1948-09-23,1948,"RC Strasbourg","AS Saint-Etienne","1-2",1,2,"1",1,3,-1,"D"
1948-09-26,1948,"Racing Club de France","Stade Rennes","2-3",2,3,"1",1,5,-1,"D"
1948-09-26,1948,"AS Cannes-Grasse","Stade Reims","1-3",1,3,"1",1,4,-2,"D"
1948-09-26,1948,"RC Strasbourg","Lille OSC","0-6",0,6,"1",1,6,-6,"D"
1948-09-26,1948,"SR Colmar","FC Metz","5-1",5,1,"1",1,6,4,"H"
1948-09-26,1948,"RC Roubaix","OGC Nice","2-1",2,1,"1",1,3,1,"H"
1948-09-26,1948,"Olympique Marseille","FC Sete","3-1",3,1,"1",1,4,2,"H"
1948-09-26,1948,"AS Nancy","FC Sochaux","2-2",2,2,"1",1,4,0,"D"
1948-09-26,1948,"Stade Olympique Montpellierain","AS Saint-Etienne","2-2",2,2,"1",1,4,0,"D"
1948-09-26,1948,"Toulouse FC","Stade Red Star","4-1",4,1,"1",1,5,3,"H"
1948-10-03,1948,"Stade Rennes","AS Nancy","4-0",4,0,"1",1,4,4,"H"
1948-10-03,1948,"Stade Reims","Stade Olympique Montpellierain","6-4",6,4,"1",1,10,2,"H"
1948-10-03,1948,"Lille OSC","AS Cannes-Grasse","2-0",2,0,"1",1,2,2,"H"
1948-10-03,1948,"AS Saint-Etienne","Olympique Marseille","4-1",4,1,"1",1,5,3,"H"
1948-10-03,1948,"FC Sete","RC Roubaix","0-0",0,0,"1",1,0,0,"D"
1948-10-03,1948,"FC Sochaux","SR Colmar","2-0",2,0,"1",1,2,2,"H"
1948-10-03,1948,"OGC Nice","Racing Club de France","3-0",3,0,"1",1,3,3,"H"
1948-10-03,1948,"FC Metz","Toulouse FC","2-1",2,1,"1",1,3,1,"H"
1948-10-03,1948,"Stade Red Star","RC Strasbourg","1-1",1,1,"1",1,2,0,"D"
1948-10-07,1948,"AS Nancy","Lille OSC","0-1",0,1,"1",1,1,-1,"D"
1948-10-07,1948,"Olympique Marseille","Toulouse FC","4-0",4,0,"1",1,4,4,"H"
1948-10-07,1948,"FC Sochaux","Stade Reims","3-0",3,0,"1",1,3,3,"H"
1948-10-07,1948,"Racing Club de France","Stade Red Star","4-0",4,0,"1",1,4,4,"H"
1948-10-07,1948,"OGC Nice","FC Sete","4-1",4,1,"1",1,5,3,"H"
1948-10-07,1948,"RC Roubaix","FC Metz","2-2",2,2,"1",1,4,0,"D"
1948-10-07,1948,"SR Colmar","AS Cannes-Grasse","1-1",1,1,"1",1,2,0,"D"
1948-10-07,1948,"Stade Olympique Montpellierain","RC Strasbourg","2-0",2,0,"1",1,2,2,"H"
1948-10-07,1948,"Stade Rennes","AS Saint-Etienne","1-3",1,3,"1",1,4,-2,"D"
1948-10-10,1948,"Lille OSC","FC Sochaux","3-1",3,1,"1",1,4,2,"H"
1948-10-10,1948,"RC Strasbourg","Olympique Marseille","1-2",1,2,"1",1,3,-1,"D"
1948-10-10,1948,"Stade Reims","Stade Rennes","4-2",4,2,"1",1,6,2,"H"
1948-10-10,1948,"FC Metz","Racing Club de France","1-2",1,2,"1",1,3,-1,"D"
1948-10-10,1948,"AS Saint-Etienne","OGC Nice","2-0",2,0,"1",1,2,2,"H"
1948-10-10,1948,"FC Sete","SR Colmar","3-4",3,4,"1",1,7,-1,"D"
1948-10-10,1948,"Toulouse FC","RC Roubaix","2-0",2,0,"1",1,2,2,"H"
1948-10-10,1948,"AS Cannes-Grasse","Stade Olympique Montpellierain","3-0",3,0,"1",1,3,3,"H"
1948-10-10,1948,"Stade Red Star","AS Nancy","3-3",3,3,"1",1,6,0,"D"
1948-10-24,1948,"Lille OSC","Olympique Marseille","2-2",2,2,"1",1,4,0,"D"
1948-10-24,1948,"Stade Reims","RC Roubaix","1-0",1,0,"1",1,1,1,"H"
1948-10-24,1948,"Stade Rennes","SR Colmar","2-0",2,0,"1",1,2,2,"H"
1948-10-24,1948,"AS Saint-Etienne","Racing Club de France","3-3",3,3,"1",1,6,0,"D"
1948-10-24,1948,"OGC Nice","FC Sochaux","5-4",5,4,"1",1,9,1,"H"
1948-10-24,1948,"FC Sete","AS Nancy","1-0",1,0,"1",1,1,1,"H"
1948-10-24,1948,"FC Metz","AS Cannes-Grasse","2-1",2,1,"1",1,3,1,"H"
1948-10-24,1948,"Toulouse FC","RC Strasbourg","5-1",5,1,"1",1,6,4,"H"
1948-10-24,1948,"Stade Red Star","Stade Olympique Montpellierain","3-0",3,0,"1",1,3,3,"H"
1948-10-31,1948,"Olympique Marseille","Stade Reims","3-4",3,4,"1",1,7,-1,"D"
1948-10-31,1948,"Stade Olympique Montpellierain","Lille OSC","2-1",2,1,"1",1,3,1,"H"
1948-10-31,1948,"Racing Club de France","FC Sete","5-1",5,1,"1",1,6,4,"H"
1948-10-31,1948,"FC Sochaux","Stade Rennes","3-1",3,1,"1",1,4,2,"H"
1948-10-31,1948,"RC Roubaix","AS Saint-Etienne","2-2",2,2,"1",1,4,0,"D"
1948-10-31,1948,"AS Nancy","OGC Nice","1-1",1,1,"1",1,2,0,"D"
1948-10-31,1948,"SR Colmar","Toulouse FC","2-0",2,0,"1",1,2,2,"H"
1948-10-31,1948,"RC Strasbourg","FC Metz","2-1",2,1,"1",1,3,1,"H"
1948-10-31,1948,"AS Cannes-Grasse","Stade Red Star","4-1",4,1,"1",1,5,3,"H"
1948-11-07,1948,"Stade Reims","AS Nancy","3-3",3,3,"1",1,6,0,"D"
1948-11-07,1948,"Lille OSC","Racing Club de France","2-3",2,3,"1",1,5,-1,"D"
1948-11-07,1948,"FC Metz","Olympique Marseille","1-4",1,4,"1",1,5,-3,"D"
1948-11-07,1948,"FC Sete","Stade Rennes","0-0",0,0,"1",1,0,0,"D"
1948-11-07,1948,"OGC Nice","SR Colmar","2-0",2,0,"1",1,2,2,"H"
1948-11-07,1948,"AS Saint-Etienne","FC Sochaux","1-1",1,1,"1",1,2,0,"D"
1948-11-07,1948,"Toulouse FC","Stade Olympique Montpellierain","4-1",4,1,"1",1,5,3,"H"
1948-11-07,1948,"Stade Red Star","RC Roubaix","1-1",1,1,"1",1,2,0,"D"
1948-11-07,1948,"RC Strasbourg","AS Cannes-Grasse","1-0",1,0,"1",1,1,1,"H"
1948-11-11,1948,"RC Roubaix","RC Strasbourg","1-0",1,0,"1",1,1,1,"H"
1948-11-11,1948,"FC Sete","AS Saint-Etienne","1-1",1,1,"1",1,2,0,"D"
1948-11-14,1948,"Racing Club de France","Stade Reims","3-1",3,1,"1",1,4,2,"H"
1948-11-14,1948,"Olympique Marseille","Stade Red Star","1-1",1,1,"1",1,2,0,"D"
1948-11-14,1948,"RC Roubaix","Lille OSC","1-4",1,4,"1",1,5,-3,"D"
1948-11-14,1948,"Stade Rennes","OGC Nice","2-0",2,0,"1",1,2,2,"H"
1948-11-14,1948,"AS Nancy","AS Saint-Etienne","4-2",4,2,"1",1,6,2,"H"
1948-11-14,1948,"FC Sochaux","FC Sete","7-0",7,0,"1",1,7,7,"H"
1948-11-14,1948,"SR Colmar","RC Strasbourg","2-1",2,1,"1",1,3,1,"H"
1948-11-14,1948,"AS Cannes-Grasse","Toulouse FC","2-1",2,1,"1",1,3,1,"H"
1948-11-14,1948,"Stade Olympique Montpellierain","FC Metz","4-1",4,1,"1",1,5,3,"H"
1948-11-21,1948,"Racing Club de France","Toulouse FC","5-0",5,0,"1",1,5,5,"H"
1948-11-21,1948,"Olympique Marseille","AS Cannes-Grasse","1-0",1,0,"1",1,1,1,"H"
1948-11-21,1948,"OGC Nice","Stade Reims","2-2",2,2,"1",1,4,0,"D"
1948-11-21,1948,"Stade Rennes","Lille OSC","1-1",1,1,"1",1,2,0,"D"
1948-11-21,1948,"FC Sochaux","Stade Red Star","0-2",0,2,"1",1,2,-2,"D"
1948-11-21,1948,"SR Colmar","Stade Olympique Montpellierain","1-3",1,3,"1",1,4,-2,"D"
1948-11-21,1948,"AS Nancy","FC Metz","2-1",2,1,"1",1,3,1,"H"
1948-11-28,1948,"RC Strasbourg","Racing Club de France","3-1",3,1,"1",1,4,2,"H"
1948-11-28,1948,"Stade Olympique Montpellierain","Olympique Marseille","1-2",1,2,"1",1,3,-1,"D"
1948-11-28,1948,"Stade Reims","FC Sete","2-0",2,0,"1",1,2,2,"H"
1948-11-28,1948,"Lille OSC","OGC Nice","4-1",4,1,"1",1,5,3,"H"
1948-11-28,1948,"Stade Red Star","Stade Rennes","0-0",0,0,"1",1,0,0,"D"
1948-11-28,1948,"AS Saint-Etienne","SR Colmar","5-2",5,2,"1",1,7,3,"H"
1948-11-28,1948,"FC Metz","FC Sochaux","4-1",4,1,"1",1,5,3,"H"
1948-11-28,1948,"Toulouse FC","AS Nancy","2-1",2,1,"1",1,3,1,"H"
1948-11-28,1948,"AS Cannes-Grasse","RC Roubaix","3-0",3,0,"1",1,3,3,"H"
1948-12-05,1948,"Racing Club de France","AS Cannes-Grasse","3-0",3,0,"1",1,3,3,"H"
1948-12-05,1948,"Lille OSC","FC Sete","6-1",6,1,"1",1,7,5,"H"
1948-12-05,1948,"SR Colmar","Olympique Marseille","1-1",1,1,"1",1,2,0,"D"
1948-12-05,1948,"Stade Rennes","FC Metz","4-3",4,3,"1",1,7,1,"H"
1948-12-05,1948,"Stade Reims","AS Saint-Etienne","2-3",2,3,"1",1,5,-1,"D"
1948-12-05,1948,"OGC Nice","Stade Red Star","2-2",2,2,"1",1,4,0,"D"
1948-12-05,1948,"Toulouse FC","FC Sochaux","3-0",3,0,"1",1,3,3,"H"
1948-12-05,1948,"Stade Olympique Montpellierain","RC Roubaix","4-1",4,1,"1",1,5,3,"H"
1948-12-05,1948,"AS Nancy","RC Strasbourg","3-3",3,3,"1",1,6,0,"D"
1948-12-19,1948,"RC Roubaix","Olympique Marseille","2-10",2,10,"1",1,12,-8,"D"
1948-12-19,1948,"Racing Club de France","Stade Olympique Montpellierain","1-1",1,1,"1",1,2,0,"D"
1948-12-19,1948,"AS Saint-Etienne","Lille OSC","2-2",2,2,"1",1,4,0,"D"
1948-12-19,1948,"Stade Rennes","Toulouse FC","2-0",2,0,"1",1,2,2,"H"
1948-12-19,1948,"Stade Reims","SR Colmar","1-2",1,2,"1",1,3,-1,"D"
1948-12-19,1948,"FC Metz","OGC Nice","2-2",2,2,"1",1,4,0,"D"
1948-12-19,1948,"FC Sochaux","RC Strasbourg","3-0",3,0,"1",1,3,3,"H"
1948-12-19,1948,"FC Sete","Stade Red Star","1-0",1,0,"1",1,1,1,"H"
1948-12-19,1948,"AS Cannes-Grasse","AS Nancy","4-1",4,1,"1",1,5,3,"H"
1948-12-25,1948,"Stade Red Star","AS Saint-Etienne","4-1",4,1,"1",1,5,3,"H"
1948-12-26,1948,"Olympique Marseille","Racing Club de France","3-0",3,0,"1",1,3,3,"H"
1948-12-26,1948,"Lille OSC","Stade Reims","2-1",2,1,"1",1,3,1,"H"
1948-12-26,1948,"RC Strasbourg","Stade Rennes","3-0",3,0,"1",1,3,3,"H"
1948-12-26,1948,"SR Colmar","RC Roubaix","5-0",5,0,"1",1,5,5,"H"
1948-12-26,1948,"AS Cannes-Grasse","FC Sochaux","1-1",1,1,"1",1,2,0,"D"
1948-12-26,1948,"Toulouse FC","OGC Nice","3-0",3,0,"1",1,3,3,"H"
1948-12-26,1948,"FC Metz","FC Sete","0-2",0,2,"1",1,2,-2,"D"
1948-12-26,1948,"Stade Olympique Montpellierain","AS Nancy","3-4",3,4,"1",1,7,-1,"D"
1949-01-02,1948,"Lille OSC","SR Colmar","8-0",8,0,"1",1,8,8,"H"
1949-01-02,1948,"AS Nancy","Olympique Marseille","3-2",3,2,"1",1,5,1,"H"
1949-01-02,1948,"Racing Club de France","RC Roubaix","1-1",1,1,"1",1,2,0,"D"
1949-01-02,1948,"Stade Rennes","AS Cannes-Grasse","1-0",1,0,"1",1,1,1,"H"
1949-01-02,1948,"Stade Reims","Stade Red Star","4-0",4,0,"1",1,4,4,"H"
1949-01-02,1948,"FC Sochaux","Stade Olympique Montpellierain","4-2",4,2,"1",1,6,2,"H"
1949-01-02,1948,"AS Saint-Etienne","FC Metz","3-1",3,1,"1",1,4,2,"H"
1949-01-02,1948,"OGC Nice","RC Strasbourg","1-0",1,0,"1",1,1,1,"H"
1949-01-02,1948,"FC Sete","Toulouse FC","0-0",0,0,"1",1,0,0,"D"
1949-01-16,1948,"Olympique Marseille","FC Sochaux","3-1",3,1,"1",1,4,2,"H"
1949-01-16,1948,"Stade Red Star","Lille OSC","1-0",1,0,"1",1,1,1,"H"
1949-01-16,1948,"FC Metz","Stade Reims","2-3",2,3,"1",1,5,-1,"D"
1949-01-16,1948,"Stade Olympique Montpellierain","Stade Rennes","2-1",2,1,"1",1,3,1,"H"
1949-01-16,1948,"Toulouse FC","AS Saint-Etienne","5-1",5,1,"1",1,6,4,"H"
1949-01-16,1948,"AS Cannes-Grasse","OGC Nice","1-2",1,2,"1",1,3,-1,"D"
1949-01-16,1948,"RC Strasbourg","FC Sete","0-0",0,0,"1",1,0,0,"D"
1949-01-16,1948,"RC Roubaix","AS Nancy","3-1",3,1,"1",1,4,2,"H"
1949-01-20,1948,"SR Colmar","Racing Club de France","3-0",3,0,"1",1,3,3,"H"
1949-01-23,1948,"Lille OSC","FC Metz","5-0",5,0,"1",1,5,5,"H"
1949-01-23,1948,"Stade Rennes","Olympique Marseille","6-1",6,1,"1",1,7,5,"H"
1949-01-23,1948,"Stade Reims","Toulouse FC","2-0",2,0,"1",1,2,2,"H"
1949-01-23,1948,"AS Nancy","Racing Club de France","3-1",3,1,"1",1,4,2,"H"
1949-01-23,1948,"AS Saint-Etienne","RC Strasbourg","5-1",5,1,"1",1,6,4,"H"
1949-01-23,1948,"OGC Nice","Stade Olympique Montpellierain","0-0",0,0,"1",1,0,0,"D"
1949-01-23,1948,"Stade Red Star","SR Colmar","5-2",5,2,"1",1,7,3,"H"
1949-01-23,1948,"FC Sete","AS Cannes-Grasse","1-0",1,0,"1",1,1,1,"H"
1949-01-23,1948,"FC Sochaux","RC Roubaix","5-1",5,1,"1",1,6,4,"H"
1949-02-06,1948,"Toulouse FC","Lille OSC","1-4",1,4,"1",1,5,-3,"D"
1949-02-06,1948,"Olympique Marseille","OGC Nice","2-2",2,2,"1",1,4,0,"D"
1949-02-06,1948,"RC Strasbourg","Stade Reims","1-4",1,4,"1",1,5,-3,"D"
1949-02-06,1948,"RC Roubaix","Stade Rennes","3-2",3,2,"1",1,5,1,"H"
1949-02-06,1948,"Racing Club de France","FC Sochaux","0-1",0,1,"1",1,1,-1,"D"
1949-02-06,1948,"AS Cannes-Grasse","AS Saint-Etienne","1-0",1,0,"1",1,1,1,"H"
1949-02-06,1948,"SR Colmar","AS Nancy","0-2",0,2,"1",1,2,-2,"D"
1949-02-06,1948,"Stade Olympique Montpellierain","FC Sete","1-0",1,0,"1",1,1,1,"H"
1949-02-06,1948,"FC Metz","Stade Red Star","2-3",2,3,"1",1,5,-1,"D"
1949-02-13,1948,"Lille OSC","RC Strasbourg","1-2",1,2,"1",1,3,-1,"D"
1949-02-13,1948,"Stade Reims","AS Cannes-Grasse","5-2",5,2,"1",1,7,3,"H"
1949-02-13,1948,"FC Sete","Olympique Marseille","1-1",1,1,"1",1,2,0,"D"
1949-02-13,1948,"Stade Rennes","Racing Club de France","0-0",0,0,"1",1,0,0,"D"
1949-02-13,1948,"OGC Nice","RC Roubaix","4-2",4,2,"1",1,6,2,"H"
1949-02-13,1948,"AS Saint-Etienne","Stade Olympique Montpellierain","0-4",0,4,"1",1,4,-4,"D"
1949-02-13,1948,"FC Sochaux","AS Nancy","3-2",3,2,"1",1,5,1,"H"
1949-02-13,1948,"Stade Red Star","Toulouse FC","3-1",3,1,"1",1,4,2,"H"
1949-02-13,1948,"FC Metz","SR Colmar","2-0",2,0,"1",1,2,2,"H"
1949-02-20,1948,"Racing Club de France","OGC Nice","1-1",1,1,"1",1,2,0,"D"
1949-02-20,1948,"SR Colmar","FC Sochaux","0-3",0,3,"1",1,3,-3,"D"
1949-02-20,1948,"Toulouse FC","FC Metz","1-0",1,0,"1",1,1,1,"H"
1949-02-20,1948,"RC Roubaix","FC Sete","2-1",2,1,"1",1,3,1,"H"
1949-02-20,1948,"RC Strasbourg","Stade Red Star","3-2",3,2,"1",1,5,1,"H"
1949-02-20,1948,"AS Cannes-Grasse","Lille OSC","1-6",1,6,"1",1,7,-5,"D"
1949-02-20,1948,"Stade Olympique Montpellierain","Stade Reims","0-1",0,1,"1",1,1,-1,"D"
1949-02-20,1948,"Olympique Marseille","AS Saint-Etienne","6-1",6,1,"1",1,7,5,"H"
1949-02-20,1948,"AS Nancy","Stade Rennes","1-2",1,2,"1",1,3,-1,"D"
1949-03-06,1948,"Lille OSC","Stade Olympique Montpellierain","5-0",5,0,"1",1,5,5,"H"
1949-03-06,1948,"Stade Reims","Olympique Marseille","2-0",2,0,"1",1,2,2,"H"
1949-03-06,1948,"Stade Rennes","FC Sochaux","1-0",1,0,"1",1,1,1,"H"
1949-03-06,1948,"FC Sete","Racing Club de France","0-2",0,2,"1",1,2,-2,"D"
1949-03-06,1948,"OGC Nice","AS Nancy","0-0",0,0,"1",1,0,0,"D"
1949-03-06,1948,"Toulouse FC","SR Colmar","7-0",7,0,"1",1,7,7,"H"
1949-03-06,1948,"Stade Red Star","AS Cannes-Grasse","6-3",6,3,"1",1,9,3,"H"
1949-03-06,1948,"FC Metz","RC Strasbourg","3-0",3,0,"1",1,3,3,"H"
1949-03-06,1948,"AS Saint-Etienne","RC Roubaix","6-0",6,0,"1",1,6,6,"H"
1949-03-13,1948,"RC Roubaix","Stade Reims","1-5",1,5,"1",1,6,-4,"D"
1949-03-13,1948,"Olympique Marseille","Lille OSC","2-1",2,1,"1",1,3,1,"H"
1949-03-13,1948,"SR Colmar","Stade Rennes","2-2",2,2,"1",1,4,0,"D"
1949-03-13,1948,"FC Sochaux","OGC Nice","2-0",2,0,"1",1,2,2,"H"
1949-03-13,1948,"Racing Club de France","AS Saint-Etienne","1-2",1,2,"1",1,3,-1,"D"
1949-03-13,1948,"RC Strasbourg","Toulouse FC","0-1",0,1,"1",1,1,-1,"D"
1949-03-13,1948,"Stade Olympique Montpellierain","Stade Red Star","6-1",6,1,"1",1,7,5,"H"
1949-03-13,1948,"AS Nancy","FC Sete","3-0",3,0,"1",1,3,3,"H"
1949-03-13,1948,"AS Cannes-Grasse","FC Metz","1-1",1,1,"1",1,2,0,"D"
1949-03-27,1948,"Stade Reims","Racing Club de France","1-0",1,0,"1",1,1,1,"H"
1949-03-27,1948,"Lille OSC","RC Roubaix","6-2",6,2,"1",1,8,4,"H"
1949-03-27,1948,"Stade Red Star","Olympique Marseille","1-0",1,0,"1",1,1,1,"H"
1949-03-27,1948,"OGC Nice","Stade Rennes","8-0",8,0,"1",1,8,8,"H"
1949-03-27,1948,"AS Saint-Etienne","AS Nancy","4-1",4,1,"1",1,5,3,"H"
1949-03-27,1948,"FC Sete","FC Sochaux","3-0",3,0,"1",1,3,3,"H"
1949-03-27,1948,"Toulouse FC","AS Cannes-Grasse","1-0",1,0,"1",1,1,1,"H"
1949-03-27,1948,"FC Metz","Stade Olympique Montpellierain","2-2",2,2,"1",1,4,0,"D"
1949-03-27,1948,"RC Strasbourg","SR Colmar","0-0",0,0,"1",1,0,0,"D"
1949-04-10,1948,"Stade Rennes","FC Sete","3-1",3,1,"1",1,4,2,"H"
1949-04-14,1948,"AS Nancy","Stade Reims","0-1",0,1,"1",1,1,-1,"D"
1949-04-14,1948,"Racing Club de France","Lille OSC","4-3",4,3,"1",1,7,1,"H"
1949-04-14,1948,"Olympique Marseille","FC Metz","4-2",4,2,"1",1,6,2,"H"
1949-04-14,1948,"AS Cannes-Grasse","RC Strasbourg","1-1",1,1,"1",1,2,0,"D"
1949-04-14,1948,"FC Sochaux","AS Saint-Etienne","6-0",6,0,"1",1,6,6,"H"
1949-04-14,1948,"SR Colmar","OGC Nice","1-2",1,2,"1",1,3,-1,"D"
1949-04-14,1948,"Stade Olympique Montpellierain","Toulouse FC","2-1",2,1,"1",1,3,1,"H"
1949-04-14,1948,"RC Roubaix","Stade Red Star","2-2",2,2,"1",1,4,0,"D"
1949-04-17,1948,"Stade Reims","FC Sochaux","2-2",2,2,"1",1,4,0,"D"
1949-04-17,1948,"Lille OSC","AS Nancy","4-0",4,0,"1",1,4,4,"H"
1949-04-17,1948,"Toulouse FC","Olympique Marseille","2-1",2,1,"1",1,3,1,"H"
1949-04-17,1948,"AS Saint-Etienne","Stade Rennes","1-1",1,1,"1",1,2,0,"D"
1949-04-17,1948,"FC Sete","OGC Nice","3-2",3,2,"1",1,5,1,"H"
1949-04-17,1948,"Stade Red Star","Racing Club de France","1-0",1,0,"1",1,1,1,"H"
1949-04-17,1948,"RC Strasbourg","Stade Olympique Montpellierain","3-0",3,0,"1",1,3,3,"H"
1949-04-17,1948,"AS Cannes-Grasse","SR Colmar","4-2",4,2,"1",1,6,2,"H"
1949-04-17,1948,"FC Metz","RC Roubaix","3-0",3,0,"1",1,3,3,"H"
1949-05-01,1948,"FC Sochaux","Lille OSC","1-3",1,3,"1",1,4,-2,"D"
1949-05-01,1948,"Stade Rennes","Stade Reims","1-0",1,0,"1",1,1,1,"H"
1949-05-01,1948,"Olympique Marseille","RC Strasbourg","5-0",5,0,"1",1,5,5,"H"
1949-05-01,1948,"OGC Nice","AS Saint-Etienne","1-0",1,0,"1",1,1,1,"H"
1949-05-01,1948,"Racing Club de France","FC Metz","2-2",2,2,"1",1,4,0,"D"
1949-05-01,1948,"RC Roubaix","Toulouse FC","3-1",3,1,"1",1,4,2,"H"
1949-05-01,1948,"AS Nancy","Stade Red Star","3-1",3,1,"1",1,4,2,"H"
1949-05-01,1948,"Stade Olympique Montpellierain","AS Cannes-Grasse","1-3",1,3,"1",1,4,-2,"D"
1949-05-01,1948,"SR Colmar","FC Sete","5-1",5,1,"1",1,6,4,"H"
1949-05-14,1948,"Stade Red Star","FC Sochaux","2-2",2,2,"1",1,4,0,"D"
1949-05-15,1948,"Stade Reims","OGC Nice","6-1",6,1,"1",1,7,5,"H"
1949-05-15,1948,"Lille OSC","Stade Rennes","3-0",3,0,"1",1,3,3,"H"
1949-05-15,1948,"AS Cannes-Grasse","Olympique Marseille","1-0",1,0,"1",1,1,1,"H"
1949-05-15,1948,"AS Saint-Etienne","FC Sete","0-0",0,0,"1",1,0,0,"D"
1949-05-15,1948,"Toulouse FC","Racing Club de France","2-1",2,1,"1",1,3,1,"H"
1949-05-15,1948,"Stade Olympique Montpellierain","SR Colmar","0-1",0,1,"1",1,1,-1,"D"
1949-05-15,1948,"RC Strasbourg","RC Roubaix","1-2",1,2,"1",1,3,-1,"D"
1949-05-15,1948,"FC Metz","AS Nancy","2-0",2,0,"1",1,2,2,"H"
1949-05-29,1948,"OGC Nice","Lille OSC","1-2",1,2,"1",1,3,-1,"D"
1949-05-29,1948,"Olympique Marseille","Stade Olympique Montpellierain","6-3",6,3,"1",1,9,3,"H"
1949-05-29,1948,"Stade Rennes","Stade Red Star","1-1",1,1,"1",1,2,0,"D"
1949-05-29,1948,"FC Sochaux","FC Metz","2-1",2,1,"1",1,3,1,"H"
1949-05-29,1948,"Racing Club de France","RC Strasbourg","4-2",4,2,"1",1,6,2,"H"
1949-05-29,1948,"SR Colmar","AS Saint-Etienne","3-1",3,1,"1",1,4,2,"H"
1949-05-29,1948,"AS Nancy","Toulouse FC","2-0",2,0,"1",1,2,2,"H"
1949-05-29,1948,"RC Roubaix","AS Cannes-Grasse","4-0",4,0,"1",1,4,4,"H"
1949-06-01,1948,"FC Sete","Stade Reims","1-2",1,2,"1",1,3,-1,"D"
1949-08-21,1949,"Olympique Marseille","Girondins Bordeaux","3-0",3,0,"1",1,3,3,"H"
1949-08-21,1949,"Stade Red Star","Stade Rennes","3-1",3,1,"1",1,4,2,"H"
1949-08-21,1949,"FC Sochaux","Racing Club de France","0-2",0,2,"1",1,2,-2,"D"
1949-08-21,1949,"AS Saint-Etienne","Lille OSC","3-4",3,4,"1",1,7,-1,"D"
1949-08-21,1949,"RC Strasbourg","Stade Reims","2-1",2,1,"1",1,3,1,"H"
1949-08-21,1949,"Stade Olympique Montpellierain","AS Nancy","2-1",2,1,"1",1,3,1,"H"
1949-08-21,1949,"RC Lens","OGC Nice","2-1",2,1,"1",1,3,1,"H"
1949-08-21,1949,"RC Roubaix","Toulouse FC","0-1",0,1,"1",1,1,-1,"D"
1949-08-21,1949,"FC Metz","FC Sete","1-1",1,1,"1",1,2,0,"D"
1949-08-28,1949,"Lille OSC","Stade Olympique Montpellierain","5-0",5,0,"1",1,5,5,"H"
1949-08-28,1949,"RC Lens","FC Metz","5-3",5,3,"1",1,8,2,"H"
1949-08-28,1949,"AS Nancy","Olympique Marseille","4-0",4,0,"1",1,4,4,"H"
1949-08-28,1949,"AS Saint-Etienne","Toulouse FC","3-0",3,0,"1",1,3,3,"H"
1949-08-28,1949,"Girondins Bordeaux","Stade Red Star","2-1",2,1,"1",1,3,1,"H"
1949-08-28,1949,"Racing Club de France","OGC Nice","1-2",1,2,"1",1,3,-1,"D"
1949-08-28,1949,"FC Sete","RC Roubaix","3-3",3,3,"1",1,6,0,"D"
1949-08-28,1949,"RC Strasbourg","FC Sochaux","0-1",0,1,"1",1,1,-1,"D"
1949-08-28,1949,"Stade Rennes","Stade Reims","1-1",1,1,"1",1,2,0,"D"
1949-09-03,1949,"Stade Red Star","AS Nancy","0-4",0,4,"1",1,4,-4,"D"
1949-09-04,1949,"Olympique Marseille","Lille OSC","2-3",2,3,"1",1,5,-1,"D"
1949-09-04,1949,"OGC Nice","RC Strasbourg","5-1",5,1,"1",1,6,4,"H"
1949-09-04,1949,"FC Metz","Racing Club de France","1-4",1,4,"1",1,5,-3,"D"
1949-09-04,1949,"RC Roubaix","RC Lens","1-0",1,0,"1",1,1,1,"H"
1949-09-04,1949,"Stade Reims","Girondins Bordeaux","0-2",0,2,"1",1,2,-2,"D"
1949-09-04,1949,"Toulouse FC","FC Sete","3-1",3,1,"1",1,4,2,"H"
1949-09-04,1949,"FC Sochaux","Stade Rennes","2-1",2,1,"1",1,3,1,"H"
1949-09-04,1949,"Stade Olympique Montpellierain","AS Saint-Etienne","1-1",1,1,"1",1,2,0,"D"
1949-09-11,1949,"AS Nancy","Lille OSC","0-1",0,1,"1",1,1,-1,"D"
1949-09-11,1949,"Girondins Bordeaux","Stade Olympique Montpellierain","7-0",7,0,"1",1,7,7,"H"
1949-09-11,1949,"Toulouse FC","FC Metz","8-2",8,2,"1",1,10,6,"H"
1949-09-11,1949,"RC Lens","FC Sochaux","1-2",1,2,"1",1,3,-1,"D"
1949-09-11,1949,"RC Roubaix","AS Saint-Etienne","2-0",2,0,"1",1,2,2,"H"
1949-09-11,1949,"FC Sete","OGC Nice","1-0",1,0,"1",1,1,1,"H"
1949-09-11,1949,"Racing Club de France","Stade Reims","2-4",2,4,"1",1,6,-2,"D"
1949-09-11,1949,"RC Strasbourg","Stade Red Star","3-1",3,1,"1",1,4,2,"H"
1949-09-11,1949,"Stade Rennes","Olympique Marseille","1-1",1,1,"1",1,2,0,"D"
1949-09-18,1949,"Lille OSC","Girondins Bordeaux","4-2",4,2,"1",1,6,2,"H"
1949-09-18,1949,"OGC Nice","Toulouse FC","0-5",0,5,"1",1,5,-5,"D"
1949-09-18,1949,"FC Sochaux","FC Sete","8-1",8,1,"1",1,9,7,"H"
1949-09-18,1949,"FC Metz","RC Roubaix","2-2",2,2,"1",1,4,0,"D"
1949-09-18,1949,"Stade Reims","RC Lens","5-0",5,0,"1",1,5,5,"H"
1949-09-18,1949,"Olympique Marseille","RC Strasbourg","2-2",2,2,"1",1,4,0,"D"
1949-09-18,1949,"Stade Red Star","Racing Club de France","2-1",2,1,"1",1,3,1,"H"
1949-09-18,1949,"Stade Olympique Montpellierain","Stade Rennes","5-6",5,6,"1",1,11,-1,"D"
1949-09-18,1949,"AS Saint-Etienne","AS Nancy","3-5",3,5,"1",1,8,-2,"D"
1949-09-22,1949,"Stade Rennes","Lille OSC","0-3",0,3,"1",1,3,-3,"D"
1949-09-22,1949,"Toulouse FC","FC Sochaux","0-0",0,0,"1",1,0,0,"D"
1949-09-22,1949,"Girondins Bordeaux","AS Nancy","5-0",5,0,"1",1,5,5,"H"
1949-09-22,1949,"RC Roubaix","OGC Nice","1-0",1,0,"1",1,1,1,"H"
1949-09-22,1949,"RC Strasbourg","Stade Olympique Montpellierain","2-1",2,1,"1",1,3,1,"H"
1949-09-22,1949,"Racing Club de France","Olympique Marseille","5-0",5,0,"1",1,5,5,"H"
1949-09-22,1949,"RC Lens","Stade Red Star","2-1",2,1,"1",1,3,1,"H"
1949-09-22,1949,"FC Sete","Stade Reims","3-1",3,1,"1",1,4,2,"H"
1949-09-22,1949,"FC Metz","AS Saint-Etienne","1-4",1,4,"1",1,5,-3,"D"
1949-09-24,1949,"Stade Red Star","FC Sete","4-0",4,0,"1",1,4,4,"H"
1949-09-25,1949,"Lille OSC","RC Strasbourg","7-1",7,1,"1",1,8,6,"H"
1949-09-25,1949,"Girondins Bordeaux","AS Saint-Etienne","5-2",5,2,"1",1,7,3,"H"
1949-09-25,1949,"FC Sochaux","RC Roubaix","1-1",1,1,"1",1,2,0,"D"
1949-09-25,1949,"Stade Reims","Toulouse FC","1-0",1,0,"1",1,1,1,"H"
1949-09-25,1949,"AS Nancy","Stade Rennes","3-1",3,1,"1",1,4,2,"H"
1949-09-25,1949,"Olympique Marseille","RC Lens","1-4",1,4,"1",1,5,-3,"D"
1949-09-25,1949,"Stade Olympique Montpellierain","Racing Club de France","3-1",3,1,"1",1,4,2,"H"
1949-09-25,1949,"OGC Nice","FC Metz","0-2",0,2,"1",1,2,-2,"D"
1949-10-02,1949,"Racing Club de France","Lille OSC","3-1",3,1,"1",1,4,2,"H"
1949-10-02,1949,"FC Metz","FC Sochaux","0-2",0,2,"1",1,2,-2,"D"
1949-10-02,1949,"Stade Rennes","Girondins Bordeaux","0-0",0,0,"1",1,0,0,"D"
1949-10-02,1949,"Toulouse FC","Stade Red Star","5-2",5,2,"1",1,7,3,"H"
1949-10-02,1949,"RC Roubaix","Stade Reims","1-1",1,1,"1",1,2,0,"D"
1949-10-02,1949,"RC Strasbourg","AS Nancy","3-0",3,0,"1",1,3,3,"H"
1949-10-02,1949,"AS Saint-Etienne","OGC Nice","2-0",2,0,"1",1,2,2,"H"
1949-10-02,1949,"FC Sete","Olympique Marseille","1-2",1,2,"1",1,3,-1,"D"
1949-10-02,1949,"RC Lens","Stade Olympique Montpellierain","3-0",3,0,"1",1,3,3,"H"
1949-10-16,1949,"Lille OSC","RC Lens","4-1",4,1,"1",1,5,3,"H"
1949-10-16,1949,"Girondins Bordeaux","RC Strasbourg","6-0",6,0,"1",1,6,6,"H"
1949-10-16,1949,"Olympique Marseille","Toulouse FC","2-2",2,2,"1",1,4,0,"D"
1949-10-16,1949,"OGC Nice","FC Sochaux","5-0",5,0,"1",1,5,5,"H"
1949-10-16,1949,"Stade Red Star","RC Roubaix","2-2",2,2,"1",1,4,0,"D"
1949-10-16,1949,"Stade Reims","FC Metz","6-2",6,2,"1",1,8,4,"H"
1949-10-16,1949,"AS Nancy","Racing Club de France","1-1",1,1,"1",1,2,0,"D"
1949-10-16,1949,"AS Saint-Etienne","Stade Rennes","2-2",2,2,"1",1,4,0,"D"
1949-10-16,1949,"Stade Olympique Montpellierain","FC Sete","3-2",3,2,"1",1,5,1,"H"
1949-10-23,1949,"FC Sete","Lille OSC","0-2",0,2,"1",1,2,-2,"D"
1949-10-23,1949,"Racing Club de France","Girondins Bordeaux","3-4",3,4,"1",1,7,-1,"D"
1949-10-23,1949,"Toulouse FC","Stade Olympique Montpellierain","3-1",3,1,"1",1,4,2,"H"
1949-10-23,1949,"FC Sochaux","AS Saint-Etienne","6-2",6,2,"1",1,8,4,"H"
1949-10-23,1949,"RC Roubaix","Olympique Marseille","1-1",1,1,"1",1,2,0,"D"
1949-10-23,1949,"RC Lens","AS Nancy","2-1",2,1,"1",1,3,1,"H"
1949-10-23,1949,"OGC Nice","Stade Reims","1-1",1,1,"1",1,2,0,"D"
1949-10-23,1949,"RC Strasbourg","Stade Rennes","2-3",2,3,"1",1,5,-1,"D"
1949-10-23,1949,"FC Metz","Stade Red Star","1-1",1,1,"1",1,2,0,"D"
1949-11-06,1949,"Stade Reims","FC Sochaux","5-3",5,3,"1",1,8,2,"H"
1949-11-06,1949,"Stade Olympique Montpellierain","RC Roubaix","0-1",0,1,"1",1,1,-1,"D"
1949-11-06,1949,"Stade Rennes","Racing Club de France","1-2",1,2,"1",1,3,-1,"D"
1949-11-06,1949,"AS Nancy","FC Sete","4-0",4,0,"1",1,4,4,"H"
1949-11-06,1949,"AS Saint-Etienne","RC Strasbourg","5-0",5,0,"1",1,5,5,"H"
1949-11-06,1949,"Olympique Marseille","FC Metz","4-0",4,0,"1",1,4,4,"H"
1949-11-06,1949,"Stade Red Star","OGC Nice","0-2",0,2,"1",1,2,-2,"D"
1949-11-06,1949,"Lille OSC","Toulouse FC","4-1",4,1,"1",1,5,3,"H"
1949-11-06,1949,"Girondins Bordeaux","RC Lens","5-1",5,1,"1",1,6,4,"H"
1949-11-20,1949,"RC Roubaix","Lille OSC","1-2",1,2,"1",1,3,-1,"D"
1949-11-20,1949,"FC Sete","Girondins Bordeaux","2-2",2,2,"1",1,4,0,"D"
1949-11-20,1949,"Toulouse FC","AS Nancy","2-0",2,0,"1",1,2,2,"H"
1949-11-20,1949,"Stade Reims","AS Saint-Etienne","0-0",0,0,"1",1,0,0,"D"
1949-11-20,1949,"FC Sochaux","Stade Red Star","1-2",1,2,"1",1,3,-1,"D"
1949-11-20,1949,"Racing Club de France","RC Strasbourg","3-0",3,0,"1",1,3,3,"H"
1949-11-20,1949,"RC Lens","Stade Rennes","3-3",3,3,"1",1,6,0,"D"
1949-11-20,1949,"OGC Nice","Olympique Marseille","6-4",6,4,"1",1,10,2,"H"
1949-11-20,1949,"FC Metz","Stade Olympique Montpellierain","5-2",5,2,"1",1,7,3,"H"
1949-11-27,1949,"Lille OSC","FC Metz","2-1",2,1,"1",1,3,1,"H"
1949-11-27,1949,"Girondins Bordeaux","Toulouse FC","1-2",1,2,"1",1,3,-1,"D"
1949-11-27,1949,"AS Nancy","RC Roubaix","2-2",2,2,"1",1,4,0,"D"
1949-11-27,1949,"AS Saint-Etienne","Racing Club de France","1-1",1,1,"1",1,2,0,"D"
1949-11-27,1949,"Stade Red Star","Stade Reims","2-0",2,0,"1",1,2,2,"H"
1949-11-27,1949,"Olympique Marseille","FC Sochaux","3-0",3,0,"1",1,3,3,"H"
1949-11-27,1949,"RC Strasbourg","RC Lens","3-2",3,2,"1",1,5,1,"H"
1949-11-27,1949,"Stade Olympique Montpellierain","OGC Nice","2-2",2,2,"1",1,4,0,"D"
1949-11-27,1949,"Stade Rennes","FC Sete","4-2",4,2,"1",1,6,2,"H"
1949-12-04,1949,"OGC Nice","Lille OSC","3-2",3,2,"1",1,5,1,"H"
1949-12-04,1949,"Toulouse FC","Stade Rennes","3-2",3,2,"1",1,5,1,"H"
1949-12-04,1949,"RC Roubaix","Girondins Bordeaux","0-0",0,0,"1",1,0,0,"D"
1949-12-04,1949,"Stade Reims","Olympique Marseille","2-0",2,0,"1",1,2,2,"H"
1949-12-04,1949,"RC Lens","Racing Club de France","0-0",0,0,"1",1,0,0,"D"
1949-12-04,1949,"FC Sochaux","Stade Olympique Montpellierain","2-2",2,2,"1",1,4,0,"D"
1949-12-04,1949,"Stade Red Star","AS Saint-Etienne","2-2",2,2,"1",1,4,0,"D"
1949-12-04,1949,"FC Metz","AS Nancy","3-0",3,0,"1",1,3,3,"H"
1949-12-04,1949,"FC Sete","RC Strasbourg","2-1",2,1,"1",1,3,1,"H"
1949-12-18,1949,"Stade Reims","Lille OSC","2-1",2,1,"1",1,3,1,"H"
1949-12-18,1949,"Toulouse FC","Racing Club de France","2-0",2,0,"1",1,2,2,"H"
1949-12-18,1949,"OGC Nice","Girondins Bordeaux","3-2",3,2,"1",1,5,1,"H"
1949-12-18,1949,"RC Roubaix","RC Strasbourg","2-0",2,0,"1",1,2,2,"H"
1949-12-18,1949,"FC Sochaux","AS Nancy","3-4",3,4,"1",1,7,-1,"D"
1949-12-18,1949,"Olympique Marseille","AS Saint-Etienne","2-0",2,0,"1",1,2,2,"H"
1949-12-18,1949,"FC Sete","RC Lens","3-1",3,1,"1",1,4,2,"H"
1949-12-18,1949,"Stade Red Star","Stade Olympique Montpellierain","1-2",1,2,"1",1,3,-1,"D"
1949-12-18,1949,"FC Metz","Stade Rennes","1-2",1,2,"1",1,3,-1,"D"
1949-12-25,1949,"Lille OSC","Stade Red Star","5-1",5,1,"1",1,6,4,"H"
1949-12-25,1949,"RC Lens","Toulouse FC","0-3",0,3,"1",1,3,-3,"D"
1949-12-25,1949,"Girondins Bordeaux","FC Sochaux","2-1",2,1,"1",1,3,1,"H"
1949-12-25,1949,"AS Nancy","Stade Reims","0-2",0,2,"1",1,2,-2,"D"
1949-12-25,1949,"Racing Club de France","RC Roubaix","1-1",1,1,"1",1,2,0,"D"
1949-12-25,1949,"Stade Rennes","OGC Nice","5-2",5,2,"1",1,7,3,"H"
1949-12-25,1949,"AS Saint-Etienne","FC Sete","1-0",1,0,"1",1,1,1,"H"
1949-12-25,1949,"Stade Olympique Montpellierain","Olympique Marseille","1-0",1,0,"1",1,1,1,"H"
1949-12-25,1949,"RC Strasbourg","FC Metz","2-1",2,1,"1",1,3,1,"H"
1950-01-01,1949,"Lille OSC","FC Sochaux","2-0",2,0,"1",1,2,2,"H"
1950-01-01,1949,"RC Strasbourg","Toulouse FC","4-1",4,1,"1",1,5,3,"H"
1950-01-01,1949,"Girondins Bordeaux","FC Metz","1-1",1,1,"1",1,2,0,"D"
1950-01-01,1949,"Stade Olympique Montpellierain","Stade Reims","0-1",0,1,"1",1,1,-1,"D"
1950-01-01,1949,"Stade Rennes","RC Roubaix","1-1",1,1,"1",1,2,0,"D"
1950-01-01,1949,"Racing Club de France","FC Sete","2-1",2,1,"1",1,3,1,"H"
1950-01-01,1949,"AS Saint-Etienne","RC Lens","2-0",2,0,"1",1,2,2,"H"
1950-01-01,1949,"AS Nancy","OGC Nice","2-2",2,2,"1",1,4,0,"D"
1950-01-02,1949,"Olympique Marseille","Stade Red Star","2-1",2,1,"1",1,3,1,"H"
1950-01-14,1949,"RC Roubaix","FC Sete","3-1",3,1,"1",1,4,2,"H"
1950-01-14,1949,"Olympique Marseille","AS Nancy","1-2",1,2,"1",1,3,-1,"D"
1950-01-15,1949,"Stade Olympique Montpellierain","Lille OSC","4-3",4,3,"1",1,7,1,"H"
1950-01-15,1949,"Toulouse FC","AS Saint-Etienne","2-0",2,0,"1",1,2,2,"H"
1950-01-15,1949,"Stade Red Star","Girondins Bordeaux","0-4",0,4,"1",1,4,-4,"D"
1950-01-15,1949,"Stade Reims","Stade Rennes","3-1",3,1,"1",1,4,2,"H"
1950-01-15,1949,"OGC Nice","Racing Club de France","1-4",1,4,"1",1,5,-3,"D"
1950-01-15,1949,"FC Sochaux","RC Strasbourg","0-0",0,0,"1",1,0,0,"D"
1950-01-15,1949,"FC Metz","RC Lens","1-1",1,1,"1",1,2,0,"D"
1950-01-22,1949,"Lille OSC","Olympique Marseille","1-2",1,2,"1",1,3,-1,"D"
1950-01-22,1949,"FC Sete","Toulouse FC","1-1",1,1,"1",1,2,0,"D"
1950-01-22,1949,"Girondins Bordeaux","Stade Reims","4-0",4,0,"1",1,4,4,"H"
1950-01-22,1949,"RC Lens","RC Roubaix","3-2",3,2,"1",1,5,1,"H"
1950-01-22,1949,"Racing Club de France","FC Metz","2-2",2,2,"1",1,4,0,"D"
1950-01-22,1949,"AS Saint-Etienne","Stade Olympique Montpellierain","5-1",5,1,"1",1,6,4,"H"
1950-01-22,1949,"AS Nancy","Stade Red Star","1-1",1,1,"1",1,2,0,"D"
1950-01-22,1949,"Stade Rennes","FC Sochaux","1-2",1,2,"1",1,3,-1,"D"
1950-01-22,1949,"RC Strasbourg","OGC Nice","0-0",0,0,"1",1,0,0,"D"
1950-01-29,1949,"Lille OSC","AS Nancy","2-1",2,1,"1",1,3,1,"H"
1950-01-29,1949,"FC Metz","Toulouse FC","1-4",1,4,"1",1,5,-3,"D"
1950-01-29,1949,"Stade Olympique Montpellierain","Girondins Bordeaux","0-1",0,1,"1",1,1,-1,"D"
1950-01-29,1949,"Stade Reims","Racing Club de France","3-2",3,2,"1",1,5,1,"H"
1950-01-29,1949,"OGC Nice","FC Sete","5-0",5,0,"1",1,5,5,"H"
1950-01-29,1949,"FC Sochaux","RC Lens","1-0",1,0,"1",1,1,1,"H"
1950-01-29,1949,"Olympique Marseille","Stade Rennes","3-1",3,1,"1",1,4,2,"H"
1950-01-29,1949,"Stade Red Star","RC Strasbourg","0-0",0,0,"1",1,0,0,"D"
1950-02-05,1949,"AS Saint-Etienne","RC Roubaix","0-0",0,0,"1",1,0,0,"D"
1950-02-12,1949,"Girondins Bordeaux","Lille OSC","1-1",1,1,"1",1,2,0,"D"
1950-02-12,1949,"Toulouse FC","OGC Nice","2-3",2,3,"1",1,5,-1,"D"
1950-02-12,1949,"RC Lens","Stade Reims","0-0",0,0,"1",1,0,0,"D"
1950-02-12,1949,"RC Roubaix","FC Metz","3-1",3,1,"1",1,4,2,"H"
1950-02-12,1949,"Racing Club de France","Stade Red Star","2-1",2,1,"1",1,3,1,"H"
1950-02-12,1949,"FC Sete","FC Sochaux","1-2",1,2,"1",1,3,-1,"D"
1950-02-12,1949,"RC Strasbourg","Olympique Marseille","1-1",1,1,"1",1,2,0,"D"
1950-02-12,1949,"AS Nancy","AS Saint-Etienne","2-1",2,1,"1",1,3,1,"H"
1950-02-12,1949,"Stade Rennes","Stade Olympique Montpellierain","5-1",5,1,"1",1,6,4,"H"
1950-02-16,1949,"Lille OSC","Stade Rennes","1-0",1,0,"1",1,1,1,"H"
1950-02-16,1949,"FC Sochaux","Toulouse FC","1-2",1,2,"1",1,3,-1,"D"
1950-02-16,1949,"AS Nancy","Girondins Bordeaux","0-0",0,0,"1",1,0,0,"D"
1950-02-16,1949,"Stade Reims","FC Sete","2-1",2,1,"1",1,3,1,"H"
1950-02-16,1949,"OGC Nice","RC Roubaix","3-2",3,2,"1",1,5,1,"H"
1950-02-16,1949,"Olympique Marseille","Racing Club de France","1-1",1,1,"1",1,2,0,"D"
1950-02-16,1949,"AS Saint-Etienne","FC Metz","1-3",1,3,"1",1,4,-2,"D"
1950-02-16,1949,"Stade Olympique Montpellierain","RC Strasbourg","3-0",3,0,"1",1,3,3,"H"
1950-02-16,1949,"Stade Red Star","RC Lens","4-3",4,3,"1",1,7,1,"H"
1950-02-19,1949,"RC Strasbourg","Lille OSC","2-1",2,1,"1",1,3,1,"H"
1950-02-19,1949,"Toulouse FC","Stade Reims","1-1",1,1,"1",1,2,0,"D"
1950-02-19,1949,"AS Saint-Etienne","Girondins Bordeaux","1-1",1,1,"1",1,2,0,"D"
1950-02-19,1949,"Racing Club de France","Stade Olympique Montpellierain","6-0",6,0,"1",1,6,6,"H"
1950-02-19,1949,"FC Metz","OGC Nice","0-3",0,3,"1",1,3,-3,"D"
1950-02-19,1949,"RC Roubaix","FC Sochaux","0-2",0,2,"1",1,2,-2,"D"
1950-02-19,1949,"RC Lens","Olympique Marseille","1-2",1,2,"1",1,3,-1,"D"
1950-02-19,1949,"Stade Rennes","AS Nancy","2-1",2,1,"1",1,3,1,"H"
1950-02-19,1949,"FC Sete","Stade Red Star","3-2",3,2,"1",1,5,1,"H"
1950-03-05,1949,"Lille OSC","Racing Club de France","2-2",2,2,"1",1,4,0,"D"
1950-03-05,1949,"Stade Red Star","Toulouse FC","1-3",1,3,"1",1,4,-2,"D"
1950-03-05,1949,"Girondins Bordeaux","Stade Rennes","2-1",2,1,"1",1,3,1,"H"
1950-03-05,1949,"Stade Reims","RC Roubaix","2-1",2,1,"1",1,3,1,"H"
1950-03-05,1949,"OGC Nice","AS Saint-Etienne","1-1",1,1,"1",1,2,0,"D"
1950-03-05,1949,"FC Sochaux","FC Metz","3-1",3,1,"1",1,4,2,"H"
1950-03-05,1949,"Olympique Marseille","FC Sete","3-4",3,4,"1",1,7,-1,"D"
1950-03-05,1949,"AS Nancy","RC Strasbourg","1-2",1,2,"1",1,3,-1,"D"
1950-03-05,1949,"Stade Olympique Montpellierain","RC Lens","4-2",4,2,"1",1,6,2,"H"
1950-03-12,1949,"Toulouse FC","Olympique Marseille","1-1",1,1,"1",1,2,0,"D"
1950-03-12,1949,"RC Strasbourg","Girondins Bordeaux","1-1",1,1,"1",1,2,0,"D"
1950-03-12,1949,"RC Lens","Lille OSC","1-0",1,0,"1",1,1,1,"H"
1950-03-12,1949,"FC Metz","Stade Reims","2-4",2,4,"1",1,6,-2,"D"
1950-03-12,1949,"Racing Club de France","AS Nancy","4-1",4,1,"1",1,5,3,"H"
1950-03-12,1949,"FC Sochaux","OGC Nice","0-3",0,3,"1",1,3,-3,"D"
1950-03-12,1949,"RC Roubaix","Stade Red Star","2-2",2,2,"1",1,4,0,"D"
1950-03-12,1949,"Stade Rennes","AS Saint-Etienne","3-1",3,1,"1",1,4,2,"H"
1950-03-12,1949,"FC Sete","Stade Olympique Montpellierain","2-0",2,0,"1",1,2,2,"H"
1950-03-19,1949,"Girondins Bordeaux","Olympique Marseille","3-1",3,1,"1",1,4,2,"H"
1950-03-19,1949,"Toulouse FC","RC Roubaix","1-1",1,1,"1",1,2,0,"D"
1950-03-19,1949,"OGC Nice","RC Lens","1-1",1,1,"1",1,2,0,"D"
1950-03-19,1949,"Stade Rennes","Stade Red Star","5-0",5,0,"1",1,5,5,"H"
1950-03-26,1949,"Girondins Bordeaux","Racing Club de France","4-0",4,0,"1",1,4,4,"H"
1950-03-26,1949,"Lille OSC","FC Sete","3-2",3,2,"1",1,5,1,"H"
1950-03-26,1949,"Stade Olympique Montpellierain","Toulouse FC","1-0",1,0,"1",1,1,1,"H"
1950-03-26,1949,"Stade Reims","OGC Nice","1-1",1,1,"1",1,2,0,"D"
1950-03-26,1949,"Olympique Marseille","RC Roubaix","2-0",2,0,"1",1,2,2,"H"
1950-03-26,1949,"AS Saint-Etienne","FC Sochaux","1-0",1,0,"1",1,1,1,"H"
1950-03-26,1949,"Stade Rennes","RC Strasbourg","1-1",1,1,"1",1,2,0,"D"
1950-03-26,1949,"AS Nancy","RC Lens","0-0",0,0,"1",1,0,0,"D"
1950-03-26,1949,"Stade Red Star","FC Metz","5-0",5,0,"1",1,5,5,"H"
1950-03-28,1949,"Racing Club de France","FC Sochaux","2-1",2,1,"1",1,3,1,"H"
1950-03-28,1949,"Lille OSC","AS Saint-Etienne","3-1",3,1,"1",1,4,2,"H"
1950-04-02,1949,"Stade Reims","RC Strasbourg","6-1",6,1,"1",1,7,5,"H"
1950-04-02,1949,"AS Nancy","Stade Olympique Montpellierain","2-1",2,1,"1",1,3,1,"H"
1950-04-02,1949,"FC Sete","FC Metz","4-1",4,1,"1",1,5,3,"H"
1950-04-06,1949,"AS Saint-Etienne","Stade Reims","1-2",1,2,"1",1,3,-1,"D"
1950-04-06,1949,"RC Strasbourg","Racing Club de France","2-0",2,0,"1",1,2,2,"H"
1950-04-09,1949,"RC Lens","Girondins Bordeaux","1-3",1,3,"1",1,4,-2,"D"
1950-04-09,1949,"FC Sochaux","Stade Reims","2-0",2,0,"1",1,2,2,"H"
1950-04-09,1949,"Toulouse FC","Lille OSC","2-0",2,0,"1",1,2,2,"H"
1950-04-09,1949,"OGC Nice","Stade Red Star","3-0",3,0,"1",1,3,3,"H"
1950-04-09,1949,"Racing Club de France","Stade Rennes","1-2",1,2,"1",1,3,-1,"D"
1950-04-09,1949,"RC Roubaix","Stade Olympique Montpellierain","4-0",4,0,"1",1,4,4,"H"
1950-04-09,1949,"FC Metz","Olympique Marseille","1-3",1,3,"1",1,4,-2,"D"
1950-04-09,1949,"RC Strasbourg","AS Saint-Etienne","1-3",1,3,"1",1,4,-2,"D"
1950-04-09,1949,"FC Sete","AS Nancy","4-0",4,0,"1",1,4,4,"H"
1950-04-15,1949,"Girondins Bordeaux","FC Sete","4-2",4,2,"1",1,6,2,"H"
1950-04-15,1949,"Stade Red Star","FC Sochaux","2-5",2,5,"1",1,7,-3,"D"
1950-04-16,1949,"Lille OSC","RC Roubaix","0-0",0,0,"1",1,0,0,"D"
1950-04-16,1949,"AS Nancy","Toulouse FC","2-1",2,1,"1",1,3,1,"H"
1950-04-16,1949,"Olympique Marseille","OGC Nice","1-0",1,0,"1",1,1,1,"H"
1950-04-16,1949,"Stade Rennes","RC Lens","1-1",1,1,"1",1,2,0,"D"
1950-04-16,1949,"Stade Olympique Montpellierain","FC Metz","5-2",5,2,"1",1,7,3,"H"
1950-04-23,1949,"Toulouse FC","Girondins Bordeaux","1-2",1,2,"1",1,3,-1,"D"
1950-04-23,1949,"FC Metz","Lille OSC","0-0",0,0,"1",1,0,0,"D"
1950-04-23,1949,"Stade Reims","Stade Red Star","0-3",0,3,"1",1,3,-3,"D"
1950-04-23,1949,"OGC Nice","Stade Olympique Montpellierain","1-0",1,0,"1",1,1,1,"H"
1950-04-23,1949,"Racing Club de France","AS Saint-Etienne","4-3",4,3,"1",1,7,1,"H"
1950-04-23,1949,"FC Sochaux","Olympique Marseille","4-0",4,0,"1",1,4,4,"H"
1950-04-23,1949,"FC Sete","Stade Rennes","0-1",0,1,"1",1,1,-1,"D"
1950-04-23,1949,"RC Roubaix","AS Nancy","0-1",0,1,"1",1,1,-1,"D"
1950-04-23,1949,"RC Lens","RC Strasbourg","1-2",1,2,"1",1,3,-1,"D"
1950-04-29,1949,"Girondins Bordeaux","RC Roubaix","4-2",4,2,"1",1,6,2,"H"
1950-04-30,1949,"Lille OSC","OGC Nice","4-1",4,1,"1",1,5,3,"H"
1950-04-30,1949,"Olympique Marseille","Stade Reims","2-2",2,2,"1",1,4,0,"D"
1950-04-30,1949,"Stade Rennes","Toulouse FC","0-0",0,0,"1",1,0,0,"D"
1950-04-30,1949,"Stade Olympique Montpellierain","FC Sochaux","1-4",1,4,"1",1,5,-3,"D"
1950-04-30,1949,"AS Nancy","FC Metz","7-2",7,2,"1",1,9,5,"H"
1950-04-30,1949,"RC Strasbourg","FC Sete","1-1",1,1,"1",1,2,0,"D"
1950-04-30,1949,"AS Saint-Etienne","Stade Red Star","2-0",2,0,"1",1,2,2,"H"
1950-05-01,1949,"Racing Club de France","RC Lens","1-2",1,2,"1",1,3,-1,"D"
1950-05-04,1949,"Lille OSC","Stade Reims","4-0",4,0,"1",1,4,4,"H"
1950-05-04,1949,"Racing Club de France","Toulouse FC","1-1",1,1,"1",1,2,0,"D"
1950-05-06,1949,"Stade Red Star","Olympique Marseille","1-1",1,1,"1",1,2,0,"D"
1950-05-06,1949,"RC Roubaix","Stade Rennes","2-2",2,2,"1",1,4,0,"D"
1950-05-07,1949,"FC Metz","Girondins Bordeaux","2-3",2,3,"1",1,5,-1,"D"
1950-05-07,1949,"FC Sochaux","Lille OSC","3-1",3,1,"1",1,4,2,"H"
1950-05-07,1949,"Stade Reims","Stade Olympique Montpellierain","2-1",2,1,"1",1,3,1,"H"
1950-05-07,1949,"Toulouse FC","RC Strasbourg","1-1",1,1,"1",1,2,0,"D"
1950-05-07,1949,"OGC Nice","AS Nancy","4-0",4,0,"1",1,4,4,"H"
1950-05-07,1949,"FC Sete","Racing Club de France","5-0",5,0,"1",1,5,5,"H"
1950-05-07,1949,"RC Lens","AS Saint-Etienne","2-4",2,4,"1",1,6,-2,"D"
1950-05-13,1949,"Girondins Bordeaux","OGC Nice","2-1",2,1,"1",1,3,1,"H"
1950-05-14,1949,"AS Nancy","FC Sochaux","0-0",0,0,"1",1,0,0,"D"
1950-05-14,1949,"Stade Rennes","FC Metz","3-1",3,1,"1",1,4,2,"H"
1950-05-14,1949,"RC Strasbourg","RC Roubaix","2-4",2,4,"1",1,6,-2,"D"
1950-05-14,1949,"AS Saint-Etienne","Olympique Marseille","2-0",2,0,"1",1,2,2,"H"
1950-05-14,1949,"RC Lens","FC Sete","2-3",2,3,"1",1,5,-1,"D"
1950-05-14,1949,"Stade Olympique Montpellierain","Stade Red Star","1-2",1,2,"1",1,3,-1,"D"
1950-05-20,1949,"Stade Red Star","Lille OSC","1-1",1,1,"1",1,2,0,"D"
1950-05-20,1949,"OGC Nice","Stade Rennes","2-1",2,1,"1",1,3,1,"H"
1950-05-21,1949,"FC Sochaux","Girondins Bordeaux","3-3",3,3,"1",1,6,0,"D"
1950-05-21,1949,"Stade Reims","AS Nancy","1-0",1,0,"1",1,1,1,"H"
1950-05-21,1949,"Toulouse FC","RC Lens","1-1",1,1,"1",1,2,0,"D"
1950-05-21,1949,"RC Roubaix","Racing Club de France","1-3",1,3,"1",1,4,-2,"D"
1950-05-21,1949,"Olympique Marseille","Stade Olympique Montpellierain","3-2",3,2,"1",1,5,1,"H"
1950-05-21,1949,"FC Sete","AS Saint-Etienne","2-0",2,0,"1",1,2,2,"H"
1950-05-21,1949,"FC Metz","RC Strasbourg","6-3",6,3,"1",1,9,3,"H"
1950-08-26,1950,"Girondins Bordeaux","OGC Nice","2-0",2,0,"1",1,2,2,"H"
1950-08-27,1950,"Stade Rennes","AS Saint-Etienne","6-0",6,0,"1",1,6,6,"H"
1950-08-27,1950,"FC Sete","Stade Reims","5-2",5,2,"1",1,7,3,"H"
1950-08-27,1950,"Racing Club de France","FC Sochaux","4-1",4,1,"1",1,5,3,"H"
1950-08-27,1950,"RC Lens","AS Nancy","0-2",0,2,"1",1,2,-2,"D"
1950-08-27,1950,"RC Strasbourg","Nimes Olympique","2-1",2,1,"1",1,3,1,"H"
1950-08-27,1950,"Le Havre AC","Olympique Marseille","1-0",1,0,"1",1,1,1,"H"
1950-08-27,1950,"Lille OSC","Stade Francais FC","1-1",1,1,"1",1,2,0,"D"
1950-08-27,1950,"Toulouse FC","RC Roubaix","1-1",1,1,"1",1,2,0,"D"
1950-09-03,1950,"OGC Nice","Stade Rennes","3-6",3,6,"1",1,9,-3,"D"
1950-09-03,1950,"RC Roubaix","Racing Club de France","1-4",1,4,"1",1,5,-3,"D"
1950-09-03,1950,"FC Sochaux","Lille OSC","0-4",0,4,"1",1,4,-4,"D"
1950-09-03,1950,"AS Nancy","FC Sete","2-2",2,2,"1",1,4,0,"D"
1950-09-03,1950,"Nimes Olympique","Girondins Bordeaux","2-2",2,2,"1",1,4,0,"D"
1950-09-03,1950,"Stade Francais FC","RC Strasbourg","0-0",0,0,"1",1,0,0,"D"
1950-09-03,1950,"Olympique Marseille","Toulouse FC","3-1",3,1,"1",1,4,2,"H"
1950-09-03,1950,"Stade Reims","Le Havre AC","2-0",2,0,"1",1,2,2,"H"
1950-09-03,1950,"AS Saint-Etienne","RC Lens","4-1",4,1,"1",1,5,3,"H"
1950-09-10,1950,"Stade Rennes","Toulouse FC","6-0",6,0,"1",1,6,6,"H"
1950-09-10,1950,"Girondins Bordeaux","Racing Club de France","0-3",0,3,"1",1,3,-3,"D"
1950-09-10,1950,"Lille OSC","Olympique Marseille","2-1",2,1,"1",1,3,1,"H"
1950-09-10,1950,"RC Strasbourg","RC Roubaix","3-1",3,1,"1",1,4,2,"H"
1950-09-10,1950,"FC Sete","FC Sochaux","1-1",1,1,"1",1,2,0,"D"
1950-09-10,1950,"Nimes Olympique","AS Nancy","3-0",3,0,"1",1,3,3,"H"
1950-09-10,1950,"Stade Francais FC","Stade Reims","1-1",1,1,"1",1,2,0,"D"
1950-09-10,1950,"OGC Nice","AS Saint-Etienne","0-0",0,0,"1",1,0,0,"D"
1950-09-10,1950,"RC Lens","Le Havre AC","2-1",2,1,"1",1,3,1,"H"
1950-09-17,1950,"Racing Club de France","Stade Rennes","4-2",4,2,"1",1,6,2,"H"
1950-09-17,1950,"Olympique Marseille","RC Strasbourg","2-2",2,2,"1",1,4,0,"D"
1950-09-17,1950,"Stade Reims","Lille OSC","4-3",4,3,"1",1,7,1,"H"
1950-09-17,1950,"AS Nancy","Stade Francais FC","2-1",2,1,"1",1,3,1,"H"
1950-09-17,1950,"Le Havre AC","FC Sete","1-0",1,0,"1",1,1,1,"H"
1950-09-17,1950,"AS Saint-Etienne","Nimes Olympique","1-1",1,1,"1",1,2,0,"D"
1950-09-17,1950,"RC Roubaix","Girondins Bordeaux","1-1",1,1,"1",1,2,0,"D"
1950-09-17,1950,"FC Sochaux","OGC Nice","3-2",3,2,"1",1,5,1,"H"
1950-09-17,1950,"Toulouse FC","RC Lens","3-2",3,2,"1",1,5,1,"H"
1950-09-21,1950,"Lille OSC","Racing Club de France","1-1",1,1,"1",1,2,0,"D"
1950-09-21,1950,"Stade Rennes","FC Sete","2-0",2,0,"1",1,2,2,"H"
1950-09-21,1950,"RC Strasbourg","Toulouse FC","6-1",6,1,"1",1,7,5,"H"
1950-09-21,1950,"OGC Nice","Stade Reims","1-2",1,2,"1",1,3,-1,"D"
1950-09-21,1950,"Nimes Olympique","Olympique Marseille","2-1",2,1,"1",1,3,1,"H"
1950-09-21,1950,"Girondins Bordeaux","Le Havre AC","0-1",0,1,"1",1,1,-1,"D"
1950-09-21,1950,"AS Saint-Etienne","AS Nancy","3-1",3,1,"1",1,4,2,"H"
1950-09-21,1950,"Stade Francais FC","RC Roubaix","1-0",1,0,"1",1,1,1,"H"
1950-09-21,1950,"RC Lens","FC Sochaux","3-1",3,1,"1",1,4,2,"H"
1950-09-24,1950,"RC Lens","Stade Rennes","1-2",1,2,"1",1,3,-1,"D"
1950-09-24,1950,"Racing Club de France","Stade Francais FC","1-1",1,1,"1",1,2,0,"D"
1950-09-24,1950,"Le Havre AC","RC Strasbourg","0-1",0,1,"1",1,1,-1,"D"
1950-09-24,1950,"Toulouse FC","Lille OSC","0-2",0,2,"1",1,2,-2,"D"
1950-09-24,1950,"Stade Reims","AS Saint-Etienne","0-0",0,0,"1",1,0,0,"D"
1950-09-24,1950,"RC Roubaix","Nimes Olympique","2-0",2,0,"1",1,2,2,"H"
1950-09-24,1950,"FC Sete","Girondins Bordeaux","1-0",1,0,"1",1,1,1,"H"
1950-09-24,1950,"FC Sochaux","AS Nancy","3-3",3,3,"1",1,6,0,"D"
1950-09-24,1950,"Olympique Marseille","OGC Nice","3-0",3,0,"1",1,3,3,"H"
1950-10-01,1950,"Racing Club de France","RC Strasbourg","2-4",2,4,"1",1,6,-2,"D"
1950-10-01,1950,"Le Havre AC","Stade Rennes","3-1",3,1,"1",1,4,2,"H"
1950-10-01,1950,"Stade Reims","Nimes Olympique","1-1",1,1,"1",1,2,0,"D"
1950-10-01,1950,"FC Sochaux","AS Saint-Etienne","0-2",0,2,"1",1,2,-2,"D"
1950-10-01,1950,"RC Roubaix","Lille OSC","3-0",3,0,"1",1,3,3,"H"
1950-10-01,1950,"FC Sete","RC Lens","1-1",1,1,"1",1,2,0,"D"
1950-10-01,1950,"Olympique Marseille","Stade Francais FC","0-0",0,0,"1",1,0,0,"D"
1950-10-01,1950,"Toulouse FC","Girondins Bordeaux","1-2",1,2,"1",1,3,-1,"D"
1950-10-01,1950,"AS Nancy","OGC Nice","1-2",1,2,"1",1,3,-1,"D"
1950-10-08,1950,"RC Strasbourg","FC Sete","1-0",1,0,"1",1,1,1,"H"
1950-10-08,1950,"Stade Rennes","FC Sochaux","2-1",2,1,"1",1,3,1,"H"
1950-10-08,1950,"AS Nancy","Stade Reims","0-2",0,2,"1",1,2,-2,"D"
1950-10-08,1950,"Nimes Olympique","Racing Club de France","4-2",4,2,"1",1,6,2,"H"
1950-10-08,1950,"Lille OSC","Le Havre AC","1-0",1,0,"1",1,1,1,"H"
1950-10-08,1950,"AS Saint-Etienne","Olympique Marseille","1-2",1,2,"1",1,3,-1,"D"
1950-10-08,1950,"Girondins Bordeaux","RC Lens","4-0",4,0,"1",1,4,4,"H"
1950-10-08,1950,"Stade Francais FC","Toulouse FC","1-2",1,2,"1",1,3,-1,"D"
1950-10-08,1950,"OGC Nice","RC Roubaix","3-0",3,0,"1",1,3,3,"H"
1950-10-15,1950,"RC Lens","RC Strasbourg","1-1",1,1,"1",1,2,0,"D"
1950-10-15,1950,"Stade Rennes","Girondins Bordeaux","4-2",4,2,"1",1,6,2,"H"
1950-10-15,1950,"FC Sete","Lille OSC","1-1",1,1,"1",1,2,0,"D"
1950-10-15,1950,"FC Sochaux","Stade Reims","2-0",2,0,"1",1,2,2,"H"
1950-10-15,1950,"Racing Club de France","OGC Nice","0-3",0,3,"1",1,3,-3,"D"
1950-10-15,1950,"Olympique Marseille","AS Nancy","2-1",2,1,"1",1,3,1,"H"
1950-10-15,1950,"Toulouse FC","Nimes Olympique","1-1",1,1,"1",1,2,0,"D"
1950-10-15,1950,"Le Havre AC","Stade Francais FC","3-0",3,0,"1",1,3,3,"H"
1950-10-15,1950,"RC Roubaix","AS Saint-Etienne","2-2",2,2,"1",1,4,0,"D"
1950-10-22,1950,"RC Strasbourg","Stade Rennes","1-0",1,0,"1",1,1,1,"H"
1950-10-22,1950,"Lille OSC","RC Lens","5-0",5,0,"1",1,5,5,"H"
1950-10-22,1950,"Nimes Olympique","Le Havre AC","2-3",2,3,"1",1,5,-1,"D"
1950-10-22,1950,"Stade Reims","Olympique Marseille","1-1",1,1,"1",1,2,0,"D"
1950-10-22,1950,"AS Saint-Etienne","Racing Club de France","2-1",2,1,"1",1,3,1,"H"
1950-10-22,1950,"Girondins Bordeaux","FC Sochaux","3-1",3,1,"1",1,4,2,"H"
1950-10-22,1950,"OGC Nice","Toulouse FC","2-1",2,1,"1",1,3,1,"H"
1950-10-22,1950,"Stade Francais FC","FC Sete","3-2",3,2,"1",1,5,1,"H"
1950-10-22,1950,"AS Nancy","RC Roubaix","2-1",2,1,"1",1,3,1,"H"
1950-10-29,1950,"RC Strasbourg","Lille OSC","1-0",1,0,"1",1,1,1,"H"
1950-10-29,1950,"Stade Rennes","Nimes Olympique","1-2",1,2,"1",1,3,-1,"D"
1950-10-29,1950,"Toulouse FC","Stade Reims","1-3",1,3,"1",1,4,-2,"D"
1950-10-29,1950,"Le Havre AC","AS Nancy","1-1",1,1,"1",1,2,0,"D"
1950-10-29,1950,"Girondins Bordeaux","Stade Francais FC","4-1",4,1,"1",1,5,3,"H"
1950-10-29,1950,"Racing Club de France","Olympique Marseille","1-1",1,1,"1",1,2,0,"D"
1950-10-29,1950,"FC Sete","AS Saint-Etienne","4-1",4,1,"1",1,5,3,"H"
1950-10-29,1950,"RC Lens","OGC Nice","2-0",2,0,"1",1,2,2,"H"
1950-10-29,1950,"RC Roubaix","FC Sochaux","1-2",1,2,"1",1,3,-1,"D"
1950-11-05,1950,"FC Sochaux","RC Strasbourg","5-0",5,0,"1",1,5,5,"H"
1950-11-05,1950,"Lille OSC","Girondins Bordeaux","3-0",3,0,"1",1,3,3,"H"
1950-11-05,1950,"Stade Reims","Racing Club de France","2-2",2,2,"1",1,4,0,"D"
1950-11-05,1950,"Stade Francais FC","Stade Rennes","6-0",6,0,"1",1,6,6,"H"
1950-11-05,1950,"Nimes Olympique","RC Lens","5-3",5,3,"1",1,8,2,"H"
1950-11-05,1950,"AS Saint-Etienne","Le Havre AC","1-0",1,0,"1",1,1,1,"H"
1950-11-05,1950,"Olympique Marseille","RC Roubaix","1-2",1,2,"1",1,3,-1,"D"
1950-11-05,1950,"OGC Nice","FC Sete","2-1",2,1,"1",1,3,1,"H"
1950-11-05,1950,"AS Nancy","Toulouse FC","0-3",0,3,"1",1,3,-3,"D"
1950-11-11,1950,"Racing Club de France","AS Nancy","2-0",2,0,"1",1,2,2,"H"
1950-11-12,1950,"Girondins Bordeaux","RC Strasbourg","3-0",3,0,"1",1,3,3,"H"
1950-11-12,1950,"Stade Rennes","Lille OSC","0-0",0,0,"1",1,0,0,"D"
1950-11-12,1950,"Le Havre AC","OGC Nice","4-1",4,1,"1",1,5,3,"H"
1950-11-12,1950,"FC Sete","Nimes Olympique","1-1",1,1,"1",1,2,0,"D"
1950-11-12,1950,"RC Roubaix","Stade Reims","2-1",2,1,"1",1,3,1,"H"
1950-11-12,1950,"Toulouse FC","AS Saint-Etienne","3-2",3,2,"1",1,5,1,"H"
1950-11-12,1950,"RC Lens","Stade Francais FC","5-0",5,0,"1",1,5,5,"H"
1950-11-19,1950,"RC Strasbourg","AS Saint-Etienne","2-6",2,6,"1",1,8,-4,"D"
1950-11-19,1950,"Le Havre AC","Racing Club de France","2-0",2,0,"1",1,2,2,"H"
1950-11-19,1950,"Stade Francais FC","Nimes Olympique","2-3",2,3,"1",1,5,-1,"D"
1950-11-19,1950,"Stade Rennes","Stade Reims","2-2",2,2,"1",1,4,0,"D"
1950-11-19,1950,"Lille OSC","OGC Nice","1-3",1,3,"1",1,4,-2,"D"
1950-11-19,1950,"Girondins Bordeaux","AS Nancy","3-1",3,1,"1",1,4,2,"H"
1950-11-19,1950,"FC Sete","RC Roubaix","2-0",2,0,"1",1,2,2,"H"
1950-11-19,1950,"RC Lens","Olympique Marseille","1-1",1,1,"1",1,2,0,"D"
1950-11-19,1950,"Toulouse FC","FC Sochaux","0-2",0,2,"1",1,2,-2,"D"
1950-11-23,1950,"FC Sochaux","Olympique Marseille","1-2",1,2,"1",1,3,-1,"D"
1950-11-26,1950,"RC Roubaix","Le Havre AC","2-3",2,3,"1",1,5,-1,"D"
1950-11-26,1950,"OGC Nice","RC Strasbourg","4-1",4,1,"1",1,5,3,"H"
1950-11-26,1950,"Nimes Olympique","Lille OSC","2-4",2,4,"1",1,6,-2,"D"
1950-11-26,1950,"Stade Reims","RC Lens","4-2",4,2,"1",1,6,2,"H"
1950-11-26,1950,"AS Saint-Etienne","Girondins Bordeaux","1-0",1,0,"1",1,1,1,"H"
1950-11-26,1950,"AS Nancy","Stade Rennes","3-2",3,2,"1",1,5,1,"H"
1950-11-26,1950,"Olympique Marseille","FC Sete","1-2",1,2,"1",1,3,-1,"D"
1950-11-26,1950,"Racing Club de France","Toulouse FC","1-1",1,1,"1",1,2,0,"D"
1950-11-26,1950,"FC Sochaux","Stade Francais FC","0-1",0,1,"1",1,1,-1,"D"
1950-12-03,1950,"RC Strasbourg","Stade Reims","0-1",0,1,"1",1,1,-1,"D"
1950-12-03,1950,"Lille OSC","AS Nancy","0-0",0,0,"1",1,0,0,"D"
1950-12-03,1950,"Stade Rennes","RC Roubaix","4-1",4,1,"1",1,5,3,"H"
1950-12-03,1950,"Nimes Olympique","OGC Nice","1-1",1,1,"1",1,2,0,"D"
1950-12-03,1950,"Stade Francais FC","AS Saint-Etienne","4-0",4,0,"1",1,4,4,"H"
1950-12-03,1950,"Girondins Bordeaux","Olympique Marseille","0-0",0,0,"1",1,0,0,"D"
1950-12-03,1950,"RC Lens","Racing Club de France","1-1",1,1,"1",1,2,0,"D"
1950-12-03,1950,"FC Sete","Toulouse FC","0-1",0,1,"1",1,1,-1,"D"
1950-12-05,1950,"Le Havre AC","FC Sochaux","3-1",3,1,"1",1,4,2,"H"
1950-12-17,1950,"Toulouse FC","Le Havre AC","2-0",2,0,"1",1,2,2,"H"
1950-12-17,1950,"Stade Reims","Girondins Bordeaux","2-3",2,3,"1",1,5,-1,"D"
1950-12-17,1950,"AS Saint-Etienne","Lille OSC","5-1",5,1,"1",1,6,4,"H"
1950-12-17,1950,"Olympique Marseille","Stade Rennes","1-1",1,1,"1",1,2,0,"D"
1950-12-17,1950,"AS Nancy","RC Strasbourg","2-1",2,1,"1",1,3,1,"H"
1950-12-17,1950,"Racing Club de France","FC Sete","3-2",3,2,"1",1,5,1,"H"
1950-12-17,1950,"OGC Nice","Stade Francais FC","5-1",5,1,"1",1,6,4,"H"
1950-12-17,1950,"FC Sochaux","Nimes Olympique","4-0",4,0,"1",1,4,4,"H"
1950-12-17,1950,"RC Roubaix","RC Lens","4-1",4,1,"1",1,5,3,"H"
1950-12-24,1950,"AS Saint-Etienne","Stade Rennes","3-0",3,0,"1",1,3,3,"H"
1950-12-24,1950,"Stade Reims","FC Sete","3-1",3,1,"1",1,4,2,"H"
1950-12-24,1950,"Stade Francais FC","Lille OSC","0-2",0,2,"1",1,2,-2,"D"
1950-12-24,1950,"Olympique Marseille","Le Havre AC","3-1",3,1,"1",1,4,2,"H"
1950-12-24,1950,"OGC Nice","Girondins Bordeaux","4-1",4,1,"1",1,5,3,"H"
1950-12-24,1950,"FC Sochaux","Racing Club de France","0-1",0,1,"1",1,1,-1,"D"
1950-12-24,1950,"Nimes Olympique","RC Strasbourg","1-0",1,0,"1",1,1,1,"H"
1950-12-24,1950,"AS Nancy","RC Lens","4-2",4,2,"1",1,6,2,"H"
1950-12-24,1950,"RC Roubaix","Toulouse FC","3-2",3,2,"1",1,5,1,"H"
1950-12-31,1950,"RC Lens","AS Saint-Etienne","2-3",2,3,"1",1,5,-1,"D"
1950-12-31,1950,"Lille OSC","FC Sochaux","2-1",2,1,"1",1,3,1,"H"
1950-12-31,1950,"Le Havre AC","Stade Reims","3-0",3,0,"1",1,3,3,"H"
1950-12-31,1950,"Stade Rennes","OGC Nice","3-1",3,1,"1",1,4,2,"H"
1950-12-31,1950,"Toulouse FC","Olympique Marseille","0-4",0,4,"1",1,4,-4,"D"
1950-12-31,1950,"Girondins Bordeaux","Nimes Olympique","2-1",2,1,"1",1,3,1,"H"
1950-12-31,1950,"RC Strasbourg","Stade Francais FC","2-1",2,1,"1",1,3,1,"H"
1950-12-31,1950,"Racing Club de France","RC Roubaix","1-2",1,2,"1",1,3,-1,"D"
1950-12-31,1950,"FC Sete","AS Nancy","2-1",2,1,"1",1,3,1,"H"
1951-01-07,1950,"AS Saint-Etienne","OGC Nice","3-2",3,2,"1",1,5,1,"H"
1951-01-07,1950,"Le Havre AC","RC Lens","4-1",4,1,"1",1,5,3,"H"
1951-01-07,1950,"Olympique Marseille","Lille OSC","1-1",1,1,"1",1,2,0,"D"
1951-01-07,1950,"Stade Reims","Stade Francais FC","2-0",2,0,"1",1,2,2,"H"
1951-01-07,1950,"Toulouse FC","Stade Rennes","0-1",0,1,"1",1,1,-1,"D"
1951-01-07,1950,"RC Roubaix","RC Strasbourg","0-1",0,1,"1",1,1,-1,"D"
1951-01-07,1950,"Racing Club de France","Girondins Bordeaux","1-0",1,0,"1",1,1,1,"H"
1951-01-07,1950,"AS Nancy","Nimes Olympique","3-0",3,0,"1",1,3,3,"H"
1951-01-07,1950,"FC Sochaux","FC Sete","1-0",1,0,"1",1,1,1,"H"
1951-01-21,1950,"FC Sete","Le Havre AC","1-2",1,2,"1",1,3,-1,"D"
1951-01-21,1950,"Nimes Olympique","AS Saint-Etienne","1-0",1,0,"1",1,1,1,"H"
1951-01-21,1950,"Lille OSC","Stade Reims","1-1",1,1,"1",1,2,0,"D"
1951-01-21,1950,"Stade Rennes","Racing Club de France","3-4",3,4,"1",1,7,-1,"D"
1951-01-21,1950,"RC Strasbourg","Olympique Marseille","2-2",2,2,"1",1,4,0,"D"
1951-01-21,1950,"OGC Nice","FC Sochaux","2-1",2,1,"1",1,3,1,"H"
1951-01-21,1950,"Girondins Bordeaux","RC Roubaix","2-2",2,2,"1",1,4,0,"D"
1951-01-21,1950,"Stade Francais FC","AS Nancy","1-4",1,4,"1",1,5,-3,"D"
1951-01-21,1950,"RC Lens","Toulouse FC","2-2",2,2,"1",1,4,0,"D"
1951-01-28,1950,"Le Havre AC","Girondins Bordeaux","2-2",2,2,"1",1,4,0,"D"
1951-01-28,1950,"Racing Club de France","Lille OSC","2-0",2,0,"1",1,2,2,"H"
1951-01-28,1950,"AS Nancy","AS Saint-Etienne","4-2",4,2,"1",1,6,2,"H"
1951-01-28,1950,"FC Sete","Stade Rennes","1-2",1,2,"1",1,3,-1,"D"
1951-01-28,1950,"Stade Reims","OGC Nice","2-4",2,4,"1",1,6,-2,"D"
1951-01-28,1950,"Olympique Marseille","Nimes Olympique","1-1",1,1,"1",1,2,0,"D"
1951-01-28,1950,"Toulouse FC","RC Strasbourg","1-0",1,0,"1",1,1,1,"H"
1951-01-28,1950,"RC Roubaix","Stade Francais FC","3-1",3,1,"1",1,4,2,"H"
1951-01-28,1950,"FC Sochaux","RC Lens","3-2",3,2,"1",1,5,1,"H"
1951-02-11,1950,"RC Strasbourg","Le Havre AC","1-4",1,4,"1",1,5,-3,"D"
1951-02-11,1950,"Stade Francais FC","Racing Club de France","0-3",0,3,"1",1,3,-3,"D"
1951-02-11,1950,"AS Saint-Etienne","Stade Reims","1-1",1,1,"1",1,2,0,"D"
1951-02-11,1950,"Stade Rennes","RC Lens","1-2",1,2,"1",1,3,-1,"D"
1951-02-11,1950,"OGC Nice","Olympique Marseille","2-2",2,2,"1",1,4,0,"D"
1951-02-11,1950,"Girondins Bordeaux","FC Sete","4-0",4,0,"1",1,4,4,"H"
1951-02-11,1950,"Lille OSC","Toulouse FC","1-2",1,2,"1",1,3,-1,"D"
1951-02-11,1950,"Nimes Olympique","RC Roubaix","2-1",2,1,"1",1,3,1,"H"
1951-02-11,1950,"AS Nancy","FC Sochaux","3-4",3,4,"1",1,7,-1,"D"
1951-02-18,1950,"Stade Rennes","Le Havre AC","0-4",0,4,"1",1,4,-4,"D"
1951-02-18,1950,"AS Saint-Etienne","FC Sochaux","3-0",3,0,"1",1,3,3,"H"
1951-02-18,1950,"RC Strasbourg","Racing Club de France","3-0",3,0,"1",1,3,3,"H"
1951-02-18,1950,"OGC Nice","AS Nancy","5-0",5,0,"1",1,5,5,"H"
1951-02-18,1950,"Stade Francais FC","Olympique Marseille","2-4",2,4,"1",1,6,-2,"D"
1951-02-18,1950,"Girondins Bordeaux","Toulouse FC","3-1",3,1,"1",1,4,2,"H"
1951-02-18,1950,"Nimes Olympique","Stade Reims","3-0",3,0,"1",1,3,3,"H"
1951-02-18,1950,"Lille OSC","RC Roubaix","0-1",0,1,"1",1,1,-1,"D"
1951-02-18,1950,"RC Lens","FC Sete","3-0",3,0,"1",1,3,3,"H"
1951-03-04,1950,"Le Havre AC","Lille OSC","0-1",0,1,"1",1,1,-1,"D"
1951-03-04,1950,"Olympique Marseille","AS Saint-Etienne","7-0",7,0,"1",1,7,7,"H"
1951-03-04,1950,"Racing Club de France","Nimes Olympique","0-2",0,2,"1",1,2,-2,"D"
1951-03-04,1950,"RC Roubaix","OGC Nice","0-0",0,0,"1",1,0,0,"D"
1951-03-04,1950,"RC Lens","Girondins Bordeaux","1-1",1,1,"1",1,2,0,"D"
1951-03-04,1950,"Stade Reims","AS Nancy","2-2",2,2,"1",1,4,0,"D"
1951-03-04,1950,"FC Sete","RC Strasbourg","2-1",2,1,"1",1,3,1,"H"
1951-03-04,1950,"FC Sochaux","Stade Rennes","2-2",2,2,"1",1,4,0,"D"
1951-03-04,1950,"Toulouse FC","Stade Francais FC","0-0",0,0,"1",1,0,0,"D"
1951-03-11,1950,"Stade Francais FC","Le Havre AC","1-0",1,0,"1",1,1,1,"H"
1951-03-11,1950,"Nimes Olympique","Toulouse FC","3-1",3,1,"1",1,4,2,"H"
1951-03-11,1950,"AS Saint-Etienne","RC Roubaix","3-0",3,0,"1",1,3,3,"H"
1951-03-11,1950,"OGC Nice","Racing Club de France","3-0",3,0,"1",1,3,3,"H"
1951-03-11,1950,"AS Nancy","Olympique Marseille","5-1",5,1,"1",1,6,4,"H"
1951-03-11,1950,"Girondins Bordeaux","Stade Rennes","1-1",1,1,"1",1,2,0,"D"
1951-03-11,1950,"Lille OSC","FC Sete","3-1",3,1,"1",1,4,2,"H"
1951-03-11,1950,"Stade Reims","FC Sochaux","3-1",3,1,"1",1,4,2,"H"
1951-03-11,1950,"RC Strasbourg","RC Lens","1-1",1,1,"1",1,2,0,"D"
1951-03-24,1950,"Racing Club de France","AS Saint-Etienne","2-2",2,2,"1",1,4,0,"D"
1951-03-24,1950,"Stade Rennes","RC Strasbourg","2-4",2,4,"1",1,6,-2,"D"
1951-03-24,1950,"RC Roubaix","AS Nancy","3-0",3,0,"1",1,3,3,"H"
1951-03-25,1950,"Le Havre AC","Nimes Olympique","2-4",2,4,"1",1,6,-2,"D"
1951-03-25,1950,"Toulouse FC","OGC Nice","0-1",0,1,"1",1,1,-1,"D"
1951-03-25,1950,"Olympique Marseille","Stade Reims","0-2",0,2,"1",1,2,-2,"D"
1951-03-25,1950,"FC Sochaux","Girondins Bordeaux","1-0",1,0,"1",1,1,1,"H"
1951-03-25,1950,"RC Lens","Lille OSC","2-1",2,1,"1",1,3,1,"H"
1951-03-25,1950,"FC Sete","Stade Francais FC","2-0",2,0,"1",1,2,2,"H"
1951-04-01,1950,"Nimes Olympique","Stade Rennes","3-0",3,0,"1",1,3,3,"H"
1951-04-01,1950,"OGC Nice","RC Lens","5-0",5,0,"1",1,5,5,"H"
1951-04-01,1950,"Stade Reims","Toulouse FC","4-1",4,1,"1",1,5,3,"H"
1951-04-01,1950,"AS Nancy","Le Havre AC","6-1",6,1,"1",1,7,5,"H"
1951-04-01,1950,"AS Saint-Etienne","FC Sete","0-2",0,2,"1",1,2,-2,"D"
1951-04-01,1950,"Olympique Marseille","Racing Club de France","4-2",4,2,"1",1,6,2,"H"
1951-04-01,1950,"Stade Francais FC","Girondins Bordeaux","1-2",1,2,"1",1,3,-1,"D"
1951-04-01,1950,"Lille OSC","RC Strasbourg","3-1",3,1,"1",1,4,2,"H"
1951-04-01,1950,"FC Sochaux","RC Roubaix","1-1",1,1,"1",1,2,0,"D"
1951-04-07,1950,"RC Roubaix","Olympique Marseille","1-1",1,1,"1",1,2,0,"D"
1951-04-08,1950,"RC Lens","Nimes Olympique","4-2",4,2,"1",1,6,2,"H"
1951-04-08,1950,"FC Sete","OGC Nice","2-1",2,1,"1",1,3,1,"H"
1951-04-08,1950,"Le Havre AC","AS Saint-Etienne","4-1",4,1,"1",1,5,3,"H"
1951-04-08,1950,"Racing Club de France","Stade Reims","0-0",0,0,"1",1,0,0,"D"
1951-04-08,1950,"Girondins Bordeaux","Lille OSC","1-3",1,3,"1",1,4,-2,"D"
1951-04-08,1950,"RC Strasbourg","FC Sochaux","2-0",2,0,"1",1,2,2,"H"
1951-04-08,1950,"Stade Rennes","Stade Francais FC","1-3",1,3,"1",1,4,-2,"D"
1951-04-08,1950,"Toulouse FC","AS Nancy","3-0",3,0,"1",1,3,3,"H"
1951-04-15,1950,"Lille OSC","Nimes Olympique","1-0",1,0,"1",1,1,1,"H"
1951-04-21,1950,"Stade Francais FC","RC Lens","2-2",2,2,"1",1,4,0,"D"
1951-04-22,1950,"Lille OSC","Stade Rennes","2-0",2,0,"1",1,2,2,"H"
1951-04-22,1950,"Nimes Olympique","FC Sete","1-0",1,0,"1",1,1,1,"H"
1951-04-22,1950,"Stade Reims","RC Roubaix","3-1",3,1,"1",1,4,2,"H"
1951-04-22,1950,"OGC Nice","Le Havre AC","0-0",0,0,"1",1,0,0,"D"
1951-04-22,1950,"AS Saint-Etienne","Toulouse FC","4-0",4,0,"1",1,4,4,"H"
1951-04-22,1950,"Olympique Marseille","FC Sochaux","0-0",0,0,"1",1,0,0,"D"
1951-04-22,1950,"RC Strasbourg","Girondins Bordeaux","0-2",0,2,"1",1,2,-2,"D"
1951-04-22,1950,"AS Nancy","Racing Club de France","0-1",0,1,"1",1,1,-1,"D"
1951-04-29,1950,"Nimes Olympique","Stade Francais FC","6-2",6,2,"1",1,8,4,"H"
1951-04-29,1950,"OGC Nice","Lille OSC","4-1",4,1,"1",1,5,3,"H"
1951-04-29,1950,"Racing Club de France","Le Havre AC","2-3",2,3,"1",1,5,-1,"D"
1951-04-29,1950,"Stade Reims","Stade Rennes","0-1",0,1,"1",1,1,-1,"D"
1951-04-29,1950,"Olympique Marseille","RC Lens","3-0",3,0,"1",1,3,3,"H"
1951-04-29,1950,"AS Saint-Etienne","RC Strasbourg","1-1",1,1,"1",1,2,0,"D"
1951-04-29,1950,"AS Nancy","Girondins Bordeaux","2-2",2,2,"1",1,4,0,"D"
1951-04-29,1950,"RC Roubaix","FC Sete","6-0",6,0,"1",1,6,6,"H"
1951-04-29,1950,"FC Sochaux","Toulouse FC","2-1",2,1,"1",1,3,1,"H"
1951-05-05,1950,"Stade Rennes","AS Nancy","3-5",3,5,"1",1,8,-2,"D"
1951-05-05,1950,"Stade Francais FC","FC Sochaux","0-3",0,3,"1",1,3,-3,"D"
1951-05-06,1950,"Le Havre AC","RC Roubaix","1-0",1,0,"1",1,1,1,"H"
1951-05-06,1950,"Girondins Bordeaux","AS Saint-Etienne","1-0",1,0,"1",1,1,1,"H"
1951-05-06,1950,"RC Lens","Stade Reims","2-1",2,1,"1",1,3,1,"H"
1951-05-06,1950,"FC Sete","Olympique Marseille","3-1",3,1,"1",1,4,2,"H"
1951-05-06,1950,"Toulouse FC","Racing Club de France","1-0",1,0,"1",1,1,1,"H"
1951-05-13,1950,"RC Strasbourg","OGC Nice","2-1",2,1,"1",1,3,1,"H"
1951-05-20,1950,"OGC Nice","Nimes Olympique","2-0",2,0,"1",1,2,2,"H"
1951-05-20,1950,"FC Sochaux","Le Havre AC","1-0",1,0,"1",1,1,1,"H"
1951-05-20,1950,"AS Nancy","Lille OSC","1-2",1,2,"1",1,3,-1,"D"
1951-05-20,1950,"Stade Reims","RC Strasbourg","3-1",3,1,"1",1,4,2,"H"
1951-05-20,1950,"Olympique Marseille","Girondins Bordeaux","3-3",3,3,"1",1,6,0,"D"
1951-05-20,1950,"AS Saint-Etienne","Stade Francais FC","3-0",3,0,"1",1,3,3,"H"
1951-05-20,1950,"Racing Club de France","RC Lens","1-3",1,3,"1",1,4,-2,"D"
1951-05-20,1950,"RC Roubaix","Stade Rennes","3-0",3,0,"1",1,3,3,"H"
1951-05-20,1950,"Toulouse FC","FC Sete","0-0",0,0,"1",1,0,0,"D"
1951-05-27,1950,"Stade Francais FC","OGC Nice","0-4",0,4,"1",1,4,-4,"D"
1951-05-27,1950,"Lille OSC","AS Saint-Etienne","4-3",4,3,"1",1,7,1,"H"
1951-05-27,1950,"Le Havre AC","Toulouse FC","2-2",2,2,"1",1,4,0,"D"
1951-05-27,1950,"Nimes Olympique","FC Sochaux","3-3",3,3,"1",1,6,0,"D"
1951-05-27,1950,"Girondins Bordeaux","Stade Reims","2-4",2,4,"1",1,6,-2,"D"
1951-05-27,1950,"Stade Rennes","Olympique Marseille","2-1",2,1,"1",1,3,1,"H"
1951-05-27,1950,"RC Strasbourg","AS Nancy","1-5",1,5,"1",1,6,-4,"D"
1951-05-27,1950,"RC Lens","RC Roubaix","4-4",4,4,"1",1,8,0,"D"
1951-05-27,1950,"FC Sete","Racing Club de France","5-1",5,1,"1",1,6,4,"H"
1951-08-26,1951,"AS Saint-Etienne","Racing Club de France","0-3",0,3,"1",1,3,-3,"D"
1951-08-26,1951,"RC Roubaix","Le Havre AC","3-1",3,1,"1",1,4,2,"H"
1951-08-26,1951,"FC Sochaux","OGC Nice","2-0",2,0,"1",1,2,2,"H"
1951-08-26,1951,"Stade Rennes","Olympique Marseille","1-2",1,2,"1",1,3,-1,"D"
1951-08-26,1951,"RC Lens","FC Metz","0-1",0,1,"1",1,1,-1,"D"
1951-08-26,1951,"Girondins Bordeaux","RC Strasbourg","1-1",1,1,"1",1,2,0,"D"
1951-08-26,1951,"AS Nancy","Stade Reims","1-1",1,1,"1",1,2,0,"D"
1951-08-26,1951,"Nimes Olympique","Olympique Lyon","0-0",0,0,"1",1,0,0,"D"
1951-08-26,1951,"FC Sete","Lille OSC","0-0",0,0,"1",1,0,0,"D"
1951-09-02,1951,"FC Sochaux","RC Roubaix","1-2",1,2,"1",1,3,-1,"D"
1951-09-02,1951,"Olympique Marseille","Nimes Olympique","3-1",3,1,"1",1,4,2,"H"
1951-09-02,1951,"Racing Club de France","FC Metz","1-2",1,2,"1",1,3,-1,"D"
1951-09-02,1951,"Lille OSC","Stade Rennes","9-1",9,1,"1",1,10,8,"H"
1951-09-02,1951,"Olympique Lyon","Le Havre AC","3-0",3,0,"1",1,3,3,"H"
1951-09-02,1951,"AS Nancy","AS Saint-Etienne","2-0",2,0,"1",1,2,2,"H"
1951-09-02,1951,"OGC Nice","Girondins Bordeaux","3-1",3,1,"1",1,4,2,"H"
1951-09-02,1951,"Stade Reims","RC Strasbourg","0-0",0,0,"1",1,0,0,"D"
1951-09-02,1951,"FC Sete","RC Lens","1-1",1,1,"1",1,2,0,"D"
1951-09-09,1951,"RC Roubaix","OGC Nice","3-0",3,0,"1",1,3,3,"H"
1951-09-09,1951,"FC Metz","Olympique Marseille","2-1",2,1,"1",1,3,1,"H"
1951-09-09,1951,"RC Strasbourg","Olympique Lyon","1-2",1,2,"1",1,3,-1,"D"
1951-09-09,1951,"Nimes Olympique","AS Nancy","1-2",1,2,"1",1,3,-1,"D"
1951-09-09,1951,"Le Havre AC","Racing Club de France","0-2",0,2,"1",1,2,-2,"D"
1951-09-09,1951,"Girondins Bordeaux","Lille OSC","6-0",6,0,"1",1,6,6,"H"
1951-09-09,1951,"RC Lens","FC Sochaux","3-1",3,1,"1",1,4,2,"H"
1951-09-09,1951,"AS Saint-Etienne","FC Sete","2-1",2,1,"1",1,3,1,"H"
1951-09-09,1951,"Stade Rennes","Stade Reims","2-0",2,0,"1",1,2,2,"H"
1951-09-13,1951,"FC Metz","Stade Rennes","4-0",4,0,"1",1,4,4,"H"
1951-09-13,1951,"Olympique Lyon","RC Roubaix","0-0",0,0,"1",1,0,0,"D"
1951-09-13,1951,"Racing Club de France","Girondins Bordeaux","1-0",1,0,"1",1,1,1,"H"
1951-09-13,1951,"Lille OSC","AS Saint-Etienne","5-1",5,1,"1",1,6,4,"H"
1951-09-13,1951,"Olympique Marseille","FC Sete","2-2",2,2,"1",1,4,0,"D"
1951-09-13,1951,"FC Sochaux","AS Nancy","3-1",3,1,"1",1,4,2,"H"
1951-09-13,1951,"Stade Reims","RC Lens","5-2",5,2,"1",1,7,3,"H"
1951-09-13,1951,"OGC Nice","Nimes Olympique","3-0",3,0,"1",1,3,3,"H"
1951-09-13,1951,"Le Havre AC","RC Strasbourg","5-1",5,1,"1",1,6,4,"H"
1951-09-16,1951,"AS Nancy","RC Roubaix","0-2",0,2,"1",1,2,-2,"D"
1951-09-16,1951,"Stade Reims","FC Metz","2-0",2,0,"1",1,2,2,"H"
1951-09-16,1951,"Olympique Lyon","Racing Club de France","1-1",1,1,"1",1,2,0,"D"
1951-09-16,1951,"FC Sochaux","Stade Rennes","5-1",5,1,"1",1,6,4,"H"
1951-09-16,1951,"OGC Nice","RC Strasbourg","2-1",2,1,"1",1,3,1,"H"
1951-09-16,1951,"Lille OSC","Le Havre AC","1-3",1,3,"1",1,4,-2,"D"
1951-09-16,1951,"FC Sete","Girondins Bordeaux","1-0",1,0,"1",1,1,1,"H"
1951-09-16,1951,"Olympique Marseille","AS Saint-Etienne","3-10",3,10,"1",1,13,-7,"D"
1951-09-16,1951,"Nimes Olympique","RC Lens","4-1",4,1,"1",1,5,3,"H"
1951-09-23,1951,"RC Roubaix","FC Sete","4-0",4,0,"1",1,4,4,"H"
1951-09-23,1951,"FC Metz","Olympique Lyon","2-0",2,0,"1",1,2,2,"H"
1951-09-23,1951,"Racing Club de France","Olympique Marseille","5-1",5,1,"1",1,6,4,"H"
1951-09-23,1951,"Stade Rennes","OGC Nice","0-3",0,3,"1",1,3,-3,"D"
1951-09-23,1951,"RC Strasbourg","Lille OSC","0-2",0,2,"1",1,2,-2,"D"
1951-09-23,1951,"Girondins Bordeaux","FC Sochaux","2-1",2,1,"1",1,3,1,"H"
1951-09-23,1951,"Le Havre AC","Stade Reims","4-2",4,2,"1",1,6,2,"H"
1951-09-23,1951,"RC Lens","AS Nancy","4-0",4,0,"1",1,4,4,"H"
1951-09-23,1951,"AS Saint-Etienne","Nimes Olympique","0-2",0,2,"1",1,2,-2,"D"
1951-09-30,1951,"RC Roubaix","Stade Reims","1-0",1,0,"1",1,1,1,"H"
1951-09-30,1951,"RC Strasbourg","FC Metz","1-2",1,2,"1",1,3,-1,"D"
1951-09-30,1951,"RC Lens","Lille OSC","0-2",0,2,"1",1,2,-2,"D"
1951-09-30,1951,"Stade Rennes","Racing Club de France","4-1",4,1,"1",1,5,3,"H"
1951-09-30,1951,"AS Saint-Etienne","OGC Nice","1-1",1,1,"1",1,2,0,"D"
1951-09-30,1951,"Le Havre AC","Olympique Marseille","2-0",2,0,"1",1,2,2,"H"
1951-09-30,1951,"Girondins Bordeaux","Olympique Lyon","6-1",6,1,"1",1,7,5,"H"
1951-09-30,1951,"Nimes Olympique","FC Sochaux","3-1",3,1,"1",1,4,2,"H"
1951-09-30,1951,"AS Nancy","FC Sete","2-2",2,2,"1",1,4,0,"D"
1951-10-07,1951,"Lille OSC","RC Roubaix","2-1",2,1,"1",1,3,1,"H"
1951-10-07,1951,"FC Metz","Le Havre AC","0-4",0,4,"1",1,4,-4,"D"
1951-10-07,1951,"Racing Club de France","RC Strasbourg","5-2",5,2,"1",1,7,3,"H"
1951-10-07,1951,"OGC Nice","RC Lens","3-2",3,2,"1",1,5,1,"H"
1951-10-07,1951,"FC Sete","Nimes Olympique","1-3",1,3,"1",1,4,-2,"D"
1951-10-07,1951,"Olympique Lyon","Stade Rennes","3-2",3,2,"1",1,5,1,"H"
1951-10-07,1951,"Stade Reims","Girondins Bordeaux","6-1",6,1,"1",1,7,5,"H"
1951-10-07,1951,"FC Sochaux","AS Saint-Etienne","1-1",1,1,"1",1,2,0,"D"
1951-10-07,1951,"Olympique Marseille","AS Nancy","3-2",3,2,"1",1,5,1,"H"
1951-10-18,1951,"RC Roubaix","Racing Club de France","3-2",3,2,"1",1,5,1,"H"
1951-10-18,1951,"AS Nancy","OGC Nice","1-1",1,1,"1",1,2,0,"D"
1951-10-18,1951,"Girondins Bordeaux","FC Metz","3-2",3,2,"1",1,5,1,"H"
1951-10-18,1951,"Nimes Olympique","Lille OSC","5-0",5,0,"1",1,5,5,"H"
1951-10-18,1951,"Stade Rennes","Le Havre AC","2-2",2,2,"1",1,4,0,"D"
1951-10-18,1951,"AS Saint-Etienne","Stade Reims","1-1",1,1,"1",1,2,0,"D"
1951-10-18,1951,"RC Lens","Olympique Lyon","4-2",4,2,"1",1,6,2,"H"
1951-10-18,1951,"FC Sete","FC Sochaux","3-1",3,1,"1",1,4,2,"H"
1951-10-18,1951,"RC Strasbourg","Olympique Marseille","1-1",1,1,"1",1,2,0,"D"
1951-10-21,1951,"Girondins Bordeaux","RC Roubaix","4-0",4,0,"1",1,4,4,"H"
1951-10-21,1951,"FC Metz","AS Nancy","4-2",4,2,"1",1,6,2,"H"
1951-10-21,1951,"Le Havre AC","Nimes Olympique","2-0",2,0,"1",1,2,2,"H"
1951-10-21,1951,"Lille OSC","Olympique Marseille","3-3",3,3,"1",1,6,0,"D"
1951-10-21,1951,"Stade Reims","OGC Nice","2-1",2,1,"1",1,3,1,"H"
1951-10-21,1951,"Racing Club de France","FC Sete","0-2",0,2,"1",1,2,-2,"D"
1951-10-21,1951,"AS Saint-Etienne","RC Strasbourg","5-0",5,0,"1",1,5,5,"H"
1951-10-21,1951,"FC Sochaux","Olympique Lyon","2-0",2,0,"1",1,2,2,"H"
1951-10-21,1951,"Stade Rennes","RC Lens","0-0",0,0,"1",1,0,0,"D"
1951-10-28,1951,"RC Roubaix","FC Metz","0-0",0,0,"1",1,0,0,"D"
1951-10-28,1951,"Le Havre AC","Girondins Bordeaux","0-0",0,0,"1",1,0,0,"D"
1951-10-28,1951,"AS Nancy","Lille OSC","0-2",0,2,"1",1,2,-2,"D"
1951-10-28,1951,"OGC Nice","FC Sete","2-1",2,1,"1",1,3,1,"H"
1951-10-28,1951,"Racing Club de France","RC Lens","3-1",3,1,"1",1,4,2,"H"
1951-10-28,1951,"Stade Reims","Nimes Olympique","1-0",1,0,"1",1,1,1,"H"
1951-10-28,1951,"Olympique Lyon","AS Saint-Etienne","4-2",4,2,"1",1,6,2,"H"
1951-10-28,1951,"Olympique Marseille","FC Sochaux","1-1",1,1,"1",1,2,0,"D"
1951-10-28,1951,"RC Strasbourg","Stade Rennes","1-2",1,2,"1",1,3,-1,"D"
1951-11-04,1951,"Olympique Marseille","RC Roubaix","1-1",1,1,"1",1,2,0,"D"
1951-11-04,1951,"OGC Nice","Olympique Lyon","6-1",6,1,"1",1,7,5,"H"
1951-11-04,1951,"Lille OSC","Stade Reims","1-0",1,0,"1",1,1,1,"H"
1951-11-04,1951,"FC Sete","FC Metz","1-0",1,0,"1",1,1,1,"H"
1951-11-04,1951,"AS Nancy","Le Havre AC","2-1",2,1,"1",1,3,1,"H"
1951-11-04,1951,"RC Lens","Girondins Bordeaux","0-0",0,0,"1",1,0,0,"D"
1951-11-04,1951,"FC Sochaux","Racing Club de France","1-0",1,0,"1",1,1,1,"H"
1951-11-04,1951,"Nimes Olympique","RC Strasbourg","2-1",2,1,"1",1,3,1,"H"
1951-11-04,1951,"AS Saint-Etienne","Stade Rennes","5-0",5,0,"1",1,5,5,"H"
1951-11-11,1951,"RC Roubaix","Nimes Olympique","1-2",1,2,"1",1,3,-1,"D"
1951-11-11,1951,"FC Metz","Lille OSC","2-1",2,1,"1",1,3,1,"H"
1951-11-11,1951,"Le Havre AC","OGC Nice","3-1",3,1,"1",1,4,2,"H"
1951-11-11,1951,"Girondins Bordeaux","AS Nancy","4-1",4,1,"1",1,5,3,"H"
1951-11-11,1951,"Racing Club de France","Stade Reims","5-2",5,2,"1",1,7,3,"H"
1951-11-11,1951,"RC Lens","AS Saint-Etienne","2-5",2,5,"1",1,7,-3,"D"
1951-11-11,1951,"RC Strasbourg","FC Sochaux","1-1",1,1,"1",1,2,0,"D"
1951-11-11,1951,"Stade Rennes","FC Sete","2-0",2,0,"1",1,2,2,"H"
1951-11-11,1951,"Olympique Lyon","Olympique Marseille","2-2",2,2,"1",1,4,0,"D"
1951-11-18,1951,"FC Sochaux","Le Havre AC","0-1",0,1,"1",1,1,-1,"D"
1951-11-18,1951,"Lille OSC","Racing Club de France","5-1",5,1,"1",1,6,4,"H"
1951-11-18,1951,"OGC Nice","FC Metz","2-0",2,0,"1",1,2,2,"H"
1951-11-18,1951,"Nimes Olympique","Girondins Bordeaux","2-3",2,3,"1",1,5,-1,"D"
1951-11-18,1951,"AS Saint-Etienne","RC Roubaix","1-0",1,0,"1",1,1,1,"H"
1951-11-18,1951,"Stade Reims","Olympique Lyon","1-0",1,0,"1",1,1,1,"H"
1951-11-18,1951,"Olympique Marseille","RC Lens","1-0",1,0,"1",1,1,1,"H"
1951-11-18,1951,"FC Sete","RC Strasbourg","0-0",0,0,"1",1,0,0,"D"
1951-11-18,1951,"AS Nancy","Stade Rennes","9-1",9,1,"1",1,10,8,"H"
1951-11-25,1951,"Olympique Lyon","Lille OSC","0-3",0,3,"1",1,3,-3,"D"
1951-11-25,1951,"Le Havre AC","FC Sete","3-2",3,2,"1",1,5,1,"H"
1951-11-25,1951,"Girondins Bordeaux","AS Saint-Etienne","9-0",9,0,"1",1,9,9,"H"
1951-11-25,1951,"FC Metz","FC Sochaux","3-1",3,1,"1",1,4,2,"H"
1951-11-25,1951,"Racing Club de France","OGC Nice","3-2",3,2,"1",1,5,1,"H"
1951-11-25,1951,"Stade Reims","Olympique Marseille","8-1",8,1,"1",1,9,7,"H"
1951-11-25,1951,"RC Roubaix","RC Lens","1-2",1,2,"1",1,3,-1,"D"
1951-11-25,1951,"Stade Rennes","Nimes Olympique","2-0",2,0,"1",1,2,2,"H"
1951-11-25,1951,"RC Strasbourg","AS Nancy","3-2",3,2,"1",1,5,1,"H"
1951-12-02,1951,"Girondins Bordeaux","Olympique Marseille","6-1",6,1,"1",1,7,5,"H"
1951-12-02,1951,"AS Saint-Etienne","Le Havre AC","1-1",1,1,"1",1,2,0,"D"
1951-12-02,1951,"OGC Nice","Lille OSC","3-1",3,1,"1",1,4,2,"H"
1951-12-02,1951,"Nimes Olympique","FC Metz","0-0",0,0,"1",1,0,0,"D"
1951-12-02,1951,"RC Roubaix","Stade Rennes","2-0",2,0,"1",1,2,2,"H"
1951-12-02,1951,"FC Sochaux","Stade Reims","4-1",4,1,"1",1,5,3,"H"
1951-12-02,1951,"AS Nancy","Racing Club de France","6-3",6,3,"1",1,9,3,"H"
1951-12-02,1951,"FC Sete","Olympique Lyon","0-2",0,2,"1",1,2,-2,"D"
1951-12-02,1951,"RC Lens","RC Strasbourg","5-1",5,1,"1",1,6,4,"H"
1951-12-09,1951,"Stade Rennes","Girondins Bordeaux","2-2",2,2,"1",1,4,0,"D"
1951-12-09,1951,"Lille OSC","FC Sochaux","7-3",7,3,"1",1,10,4,"H"
1951-12-09,1951,"Olympique Marseille","OGC Nice","2-4",2,4,"1",1,6,-2,"D"
1951-12-09,1951,"Le Havre AC","RC Lens","0-1",0,1,"1",1,1,-1,"D"
1951-12-09,1951,"FC Metz","AS Saint-Etienne","2-2",2,2,"1",1,4,0,"D"
1951-12-09,1951,"RC Strasbourg","RC Roubaix","2-2",2,2,"1",1,4,0,"D"
1951-12-09,1951,"Stade Reims","FC Sete","6-0",6,0,"1",1,6,6,"H"
1951-12-09,1951,"Racing Club de France","Nimes Olympique","1-2",1,2,"1",1,3,-1,"D"
1951-12-09,1951,"Olympique Lyon","AS Nancy","0-1",0,1,"1",1,1,-1,"D"
1951-12-16,1951,"RC Strasbourg","Girondins Bordeaux","2-5",2,5,"1",1,7,-3,"D"
1951-12-16,1951,"Lille OSC","FC Sete","6-1",6,1,"1",1,7,5,"H"
1951-12-16,1951,"Le Havre AC","RC Roubaix","2-0",2,0,"1",1,2,2,"H"
1951-12-16,1951,"OGC Nice","FC Sochaux","0-1",0,1,"1",1,1,-1,"D"
1951-12-16,1951,"FC Metz","RC Lens","1-1",1,1,"1",1,2,0,"D"
1951-12-16,1951,"Stade Reims","AS Nancy","0-0",0,0,"1",1,0,0,"D"
1951-12-16,1951,"Olympique Lyon","Nimes Olympique","4-3",4,3,"1",1,7,1,"H"
1951-12-16,1951,"Racing Club de France","AS Saint-Etienne","1-3",1,3,"1",1,4,-2,"D"
1951-12-16,1951,"Olympique Marseille","Stade Rennes","1-1",1,1,"1",1,2,0,"D"
1951-12-23,1951,"Stade Rennes","Lille OSC","2-2",2,2,"1",1,4,0,"D"
1951-12-23,1951,"Le Havre AC","Olympique Lyon","2-0",2,0,"1",1,2,2,"H"
1951-12-23,1951,"Girondins Bordeaux","OGC Nice","1-3",1,3,"1",1,4,-2,"D"
1951-12-23,1951,"FC Metz","Racing Club de France","2-2",2,2,"1",1,4,0,"D"
1951-12-23,1951,"RC Strasbourg","Stade Reims","2-3",2,3,"1",1,5,-1,"D"
1951-12-23,1951,"RC Roubaix","FC Sochaux","2-0",2,0,"1",1,2,2,"H"
1951-12-23,1951,"Nimes Olympique","Olympique Marseille","1-0",1,0,"1",1,1,1,"H"
1951-12-23,1951,"AS Saint-Etienne","AS Nancy","1-2",1,2,"1",1,3,-1,"D"
1951-12-23,1951,"RC Lens","FC Sete","4-2",4,2,"1",1,6,2,"H"
1951-12-30,1951,"Racing Club de France","Le Havre AC","2-6",2,6,"1",1,8,-4,"D"
1951-12-30,1951,"Lille OSC","Girondins Bordeaux","2-2",2,2,"1",1,4,0,"D"
1951-12-30,1951,"OGC Nice","RC Roubaix","2-1",2,1,"1",1,3,1,"H"
1951-12-30,1951,"Stade Reims","Stade Rennes","4-0",4,0,"1",1,4,4,"H"
1951-12-30,1951,"Olympique Marseille","FC Metz","4-0",4,0,"1",1,4,4,"H"
1951-12-30,1951,"AS Nancy","Nimes Olympique","0-0",0,0,"1",1,0,0,"D"
1951-12-30,1951,"FC Sochaux","RC Lens","3-1",3,1,"1",1,4,2,"H"
1951-12-30,1951,"FC Sete","AS Saint-Etienne","4-2",4,2,"1",1,6,2,"H"
1951-12-30,1951,"Olympique Lyon","RC Strasbourg","2-3",2,3,"1",1,5,-1,"D"
1952-01-06,1951,"RC Strasbourg","Le Havre AC","0-2",0,2,"1",1,2,-2,"D"
1952-01-06,1951,"AS Saint-Etienne","Lille OSC","1-3",1,3,"1",1,4,-2,"D"
1952-01-06,1951,"Nimes Olympique","OGC Nice","3-1",3,1,"1",1,4,2,"H"
1952-01-06,1951,"Stade Rennes","FC Metz","0-1",0,1,"1",1,1,-1,"D"
1952-01-06,1951,"RC Lens","Stade Reims","3-1",3,1,"1",1,4,2,"H"
1952-01-06,1951,"RC Roubaix","Olympique Lyon","3-0",3,0,"1",1,3,3,"H"
1952-01-06,1951,"AS Nancy","FC Sochaux","2-1",2,1,"1",1,3,1,"H"
1952-01-06,1951,"FC Sete","Olympique Marseille","2-0",2,0,"1",1,2,2,"H"
1952-01-20,1951,"Le Havre AC","Lille OSC","2-0",2,0,"1",1,2,2,"H"
1952-01-20,1951,"RC Strasbourg","OGC Nice","1-3",1,3,"1",1,4,-2,"D"
1952-01-20,1951,"Girondins Bordeaux","FC Sete","2-1",2,1,"1",1,3,1,"H"
1952-01-20,1951,"RC Roubaix","AS Nancy","2-1",2,1,"1",1,3,1,"H"
1952-01-20,1951,"FC Metz","Stade Reims","0-0",0,0,"1",1,0,0,"D"
1952-01-20,1951,"RC Lens","Nimes Olympique","0-1",0,1,"1",1,1,-1,"D"
1952-01-20,1951,"AS Saint-Etienne","Olympique Marseille","4-2",4,2,"1",1,6,2,"H"
1952-01-20,1951,"Racing Club de France","Olympique Lyon","4-0",4,0,"1",1,4,4,"H"
1952-01-20,1951,"Stade Rennes","FC Sochaux","5-1",5,1,"1",1,6,4,"H"
1952-01-27,1951,"Stade Reims","Le Havre AC","3-1",3,1,"1",1,4,2,"H"
1952-01-27,1951,"OGC Nice","Stade Rennes","3-0",3,0,"1",1,3,3,"H"
1952-01-27,1951,"Nimes Olympique","AS Saint-Etienne","5-1",5,1,"1",1,6,4,"H"
1952-01-27,1951,"Olympique Lyon","FC Metz","2-2",2,2,"1",1,4,0,"D"
1952-01-27,1951,"FC Sete","RC Roubaix","2-1",2,1,"1",1,3,1,"H"
1952-01-27,1951,"AS Nancy","RC Lens","3-2",3,2,"1",1,5,1,"H"
1952-01-27,1951,"Olympique Marseille","Racing Club de France","0-0",0,0,"1",1,0,0,"D"
1952-02-11,1951,"OGC Nice","AS Saint-Etienne","3-0",3,0,"1",1,3,3,"H"
1952-02-11,1951,"Lille OSC","RC Lens","5-0",5,0,"1",1,5,5,"H"
1952-02-11,1951,"Olympique Lyon","Girondins Bordeaux","0-1",0,1,"1",1,1,-1,"D"
1952-02-11,1951,"Stade Reims","RC Roubaix","2-1",2,1,"1",1,3,1,"H"
1952-02-11,1951,"FC Metz","RC Strasbourg","2-0",2,0,"1",1,2,2,"H"
1952-02-11,1951,"FC Sochaux","Nimes Olympique","2-0",2,0,"1",1,2,2,"H"
1952-02-11,1951,"Racing Club de France","Stade Rennes","1-5",1,5,"1",1,6,-4,"D"
1952-02-11,1951,"FC Sete","AS Nancy","0-0",0,0,"1",1,0,0,"D"
1952-02-14,1951,"Lille OSC","RC Strasbourg","3-1",3,1,"1",1,4,2,"H"
1952-02-14,1951,"FC Sochaux","Girondins Bordeaux","0-2",0,2,"1",1,2,-2,"D"
1952-02-17,1951,"RC Lens","OGC Nice","1-2",1,2,"1",1,3,-1,"D"
1952-02-17,1951,"Girondins Bordeaux","Stade Reims","2-0",2,0,"1",1,2,2,"H"
1952-02-17,1951,"RC Roubaix","Lille OSC","2-2",2,2,"1",1,4,0,"D"
1952-02-17,1951,"Le Havre AC","FC Metz","1-1",1,1,"1",1,2,0,"D"
1952-02-17,1951,"Nimes Olympique","FC Sete","1-2",1,2,"1",1,3,-1,"D"
1952-02-17,1951,"AS Nancy","Olympique Marseille","0-1",0,1,"1",1,1,-1,"D"
1952-02-17,1951,"RC Strasbourg","Racing Club de France","2-2",2,2,"1",1,4,0,"D"
1952-02-17,1951,"AS Saint-Etienne","FC Sochaux","4-1",4,1,"1",1,5,3,"H"
1952-02-17,1951,"Stade Rennes","Olympique Lyon","2-0",2,0,"1",1,2,2,"H"
1952-02-26,1951,"Girondins Bordeaux","Racing Club de France","3-0",3,0,"1",1,3,3,"H"
1952-02-27,1951,"Olympique Marseille","Le Havre AC","0-0",0,0,"1",1,0,0,"D"
1952-03-02,1951,"FC Metz","Girondins Bordeaux","2-1",2,1,"1",1,3,1,"H"
1952-03-02,1951,"Lille OSC","Nimes Olympique","2-1",2,1,"1",1,3,1,"H"
1952-03-02,1951,"OGC Nice","AS Nancy","1-1",1,1,"1",1,2,0,"D"
1952-03-02,1951,"Le Havre AC","Stade Rennes","1-2",1,2,"1",1,3,-1,"D"
1952-03-02,1951,"Stade Reims","AS Saint-Etienne","1-0",1,0,"1",1,1,1,"H"
1952-03-02,1951,"Racing Club de France","RC Roubaix","2-1",2,1,"1",1,3,1,"H"
1952-03-02,1951,"FC Sochaux","FC Sete","0-3",0,3,"1",1,3,-3,"D"
1952-03-02,1951,"Olympique Marseille","RC Strasbourg","2-1",2,1,"1",1,3,1,"H"
1952-03-02,1951,"Olympique Lyon","RC Lens","4-1",4,1,"1",1,5,3,"H"
1952-03-09,1951,"Olympique Marseille","Lille OSC","0-2",0,2,"1",1,2,-2,"D"
1952-03-09,1951,"OGC Nice","Stade Reims","2-1",2,1,"1",1,3,1,"H"
1952-03-09,1951,"RC Roubaix","Girondins Bordeaux","2-1",2,1,"1",1,3,1,"H"
1952-03-09,1951,"Nimes Olympique","Le Havre AC","2-0",2,0,"1",1,2,2,"H"
1952-03-09,1951,"AS Nancy","FC Metz","2-2",2,2,"1",1,4,0,"D"
1952-03-09,1951,"FC Sete","Racing Club de France","2-0",2,0,"1",1,2,2,"H"
1952-03-09,1951,"RC Strasbourg","AS Saint-Etienne","1-3",1,3,"1",1,4,-2,"D"
1952-03-09,1951,"RC Lens","Stade Rennes","3-0",3,0,"1",1,3,3,"H"
1952-03-09,1951,"Olympique Lyon","FC Sochaux","0-0",0,0,"1",1,0,0,"D"
1952-03-23,1951,"FC Sete","OGC Nice","1-1",1,1,"1",1,2,0,"D"
1952-03-23,1951,"Girondins Bordeaux","Le Havre AC","4-1",4,1,"1",1,5,3,"H"
1952-03-23,1951,"Lille OSC","AS Nancy","0-3",0,3,"1",1,3,-3,"D"
1952-03-23,1951,"FC Metz","RC Roubaix","3-0",3,0,"1",1,3,3,"H"
1952-03-23,1951,"Nimes Olympique","Stade Reims","2-0",2,0,"1",1,2,2,"H"
1952-03-23,1951,"AS Saint-Etienne","Olympique Lyon","1-0",1,0,"1",1,1,1,"H"
1952-03-23,1951,"RC Lens","Racing Club de France","3-1",3,1,"1",1,4,2,"H"
1952-03-23,1951,"Stade Rennes","RC Strasbourg","2-1",2,1,"1",1,3,1,"H"
1952-03-23,1951,"FC Sochaux","Olympique Marseille","1-1",1,1,"1",1,2,0,"D"
1952-03-29,1951,"Girondins Bordeaux","RC Lens","4-1",4,1,"1",1,5,3,"H"
1952-03-30,1951,"Olympique Lyon","OGC Nice","0-2",0,2,"1",1,2,-2,"D"
1952-03-30,1951,"Stade Reims","Lille OSC","1-0",1,0,"1",1,1,1,"H"
1952-03-30,1951,"FC Metz","FC Sete","3-1",3,1,"1",1,4,2,"H"
1952-03-30,1951,"Le Havre AC","AS Nancy","1-1",1,1,"1",1,2,0,"D"
1952-03-30,1951,"RC Strasbourg","Nimes Olympique","3-1",3,1,"1",1,4,2,"H"
1952-03-30,1951,"RC Roubaix","Olympique Marseille","5-2",5,2,"1",1,7,3,"H"
1952-03-30,1951,"Stade Rennes","AS Saint-Etienne","2-3",2,3,"1",1,5,-1,"D"
1952-03-30,1951,"Racing Club de France","FC Sochaux","0-4",0,4,"1",1,4,-4,"D"
1952-04-13,1951,"OGC Nice","Le Havre AC","0-1",0,1,"1",1,1,-1,"D"
1952-04-13,1951,"AS Nancy","Girondins Bordeaux","2-1",2,1,"1",1,3,1,"H"
1952-04-13,1951,"Lille OSC","FC Metz","3-2",3,2,"1",1,5,1,"H"
1952-04-13,1951,"Stade Reims","Racing Club de France","1-1",1,1,"1",1,2,0,"D"
1952-04-13,1951,"Nimes Olympique","RC Roubaix","3-3",3,3,"1",1,6,0,"D"
1952-04-13,1951,"AS Saint-Etienne","RC Lens","1-1",1,1,"1",1,2,0,"D"
1952-04-13,1951,"FC Sete","Stade Rennes","3-3",3,3,"1",1,6,0,"D"
1952-04-13,1951,"FC Sochaux","RC Strasbourg","0-1",0,1,"1",1,1,-1,"D"
1952-04-13,1951,"Olympique Marseille","Olympique Lyon","3-1",3,1,"1",1,4,2,"H"
1952-04-26,1951,"Le Havre AC","FC Sochaux","1-2",1,2,"1",1,3,-1,"D"
1952-04-27,1951,"FC Metz","OGC Nice","0-2",0,2,"1",1,2,-2,"D"
1952-04-27,1951,"Girondins Bordeaux","Nimes Olympique","4-2",4,2,"1",1,6,2,"H"
1952-04-27,1951,"Racing Club de France","Lille OSC","2-1",2,1,"1",1,3,1,"H"
1952-04-27,1951,"Olympique Lyon","Stade Reims","2-5",2,5,"1",1,7,-3,"D"
1952-04-27,1951,"RC Lens","Olympique Marseille","2-1",2,1,"1",1,3,1,"H"
1952-04-27,1951,"RC Roubaix","AS Saint-Etienne","1-2",1,2,"1",1,3,-1,"D"
1952-04-27,1951,"Stade Rennes","AS Nancy","1-1",1,1,"1",1,2,0,"D"
1952-04-27,1951,"RC Strasbourg","FC Sete","0-2",0,2,"1",1,2,-2,"D"
1952-05-11,1951,"OGC Nice","Racing Club de France","1-0",1,0,"1",1,1,1,"H"
1952-05-11,1951,"AS Saint-Etienne","Girondins Bordeaux","1-4",1,4,"1",1,5,-3,"D"
1952-05-11,1951,"Lille OSC","Olympique Lyon","3-0",3,0,"1",1,3,3,"H"
1952-05-11,1951,"Olympique Marseille","Stade Reims","1-3",1,3,"1",1,4,-2,"D"
1952-05-11,1951,"FC Sochaux","FC Metz","0-0",0,0,"1",1,0,0,"D"
1952-05-11,1951,"FC Sete","Le Havre AC","3-1",3,1,"1",1,4,2,"H"
1952-05-11,1951,"Nimes Olympique","Stade Rennes","7-0",7,0,"1",1,7,7,"H"
1952-05-11,1951,"RC Lens","RC Roubaix","0-0",0,0,"1",1,0,0,"D"
1952-05-11,1951,"AS Nancy","RC Strasbourg","2-2",2,2,"1",1,4,0,"D"
1952-05-18,1951,"Lille OSC","OGC Nice","6-0",6,0,"1",1,6,6,"H"
1952-05-18,1951,"Olympique Marseille","Girondins Bordeaux","6-0",6,0,"1",1,6,6,"H"
1952-05-18,1951,"Stade Reims","FC Sochaux","1-5",1,5,"1",1,6,-4,"D"
1952-05-18,1951,"FC Metz","Nimes Olympique","1-2",1,2,"1",1,3,-1,"D"
1952-05-18,1951,"Le Havre AC","AS Saint-Etienne","0-2",0,2,"1",1,2,-2,"D"
1952-05-18,1951,"Stade Rennes","RC Roubaix","2-2",2,2,"1",1,4,0,"D"
1952-05-18,1951,"Olympique Lyon","FC Sete","2-6",2,6,"1",1,8,-4,"D"
1952-05-18,1951,"Racing Club de France","AS Nancy","3-1",3,1,"1",1,4,2,"H"
1952-05-18,1951,"RC Strasbourg","RC Lens","1-2",1,2,"1",1,3,-1,"D"
1952-05-25,1951,"OGC Nice","Olympique Marseille","2-0",2,0,"1",1,2,2,"H"
1952-05-25,1951,"Girondins Bordeaux","Stade Rennes","3-2",3,2,"1",1,5,1,"H"
1952-05-25,1951,"FC Sochaux","Lille OSC","1-1",1,1,"1",1,2,0,"D"
1952-05-25,1951,"FC Sete","Stade Reims","2-0",2,0,"1",1,2,2,"H"
1952-05-25,1951,"AS Saint-Etienne","FC Metz","3-0",3,0,"1",1,3,3,"H"
1952-05-25,1951,"Nimes Olympique","Racing Club de France","2-2",2,2,"1",1,4,0,"D"
1952-05-25,1951,"RC Lens","Le Havre AC","1-1",1,1,"1",1,2,0,"D"
1952-05-25,1951,"RC Roubaix","RC Strasbourg","5-0",5,0,"1",1,5,5,"H"
1952-05-25,1951,"AS Nancy","Olympique Lyon","4-0",4,0,"1",1,4,4,"H"
1952-08-24,1952,"AS Saint-Etienne","Stade Reims","2-6",2,6,"1",1,8,-4,"D"
1952-08-24,1952,"Olympique Marseille","Stade Olympique Montpellierain","5-1",5,1,"1",1,6,4,"H"
1952-08-24,1952,"Le Havre AC","FC Metz","3-0",3,0,"1",1,3,3,"H"
1952-08-24,1952,"AS Nancy","Lille OSC","1-3",1,3,"1",1,4,-2,"D"
1952-08-24,1952,"Racing Club de France","Stade Rennes","2-0",2,0,"1",1,2,2,"H"
1952-08-24,1952,"Girondins Bordeaux","Stade Francais FC","2-1",2,1,"1",1,3,1,"H"
1952-08-24,1952,"RC Lens","Nimes Olympique","2-1",2,1,"1",1,3,1,"H"
1952-08-24,1952,"RC Roubaix","OGC Nice","2-2",2,2,"1",1,4,0,"D"
1952-08-24,1952,"FC Sete","FC Sochaux","0-0",0,0,"1",1,0,0,"D"
1952-08-31,1952,"Stade Reims","Le Havre AC","5-0",5,0,"1",1,5,5,"H"
1952-08-31,1952,"Stade Francais FC","Olympique Marseille","2-3",2,3,"1",1,5,-1,"D"
1952-08-31,1952,"FC Metz","Lille OSC","0-3",0,3,"1",1,3,-3,"D"
1952-08-31,1952,"FC Sochaux","Racing Club de France","3-3",3,3,"1",1,6,0,"D"
1952-08-31,1952,"OGC Nice","RC Lens","3-1",3,1,"1",1,4,2,"H"
1952-08-31,1952,"Nimes Olympique","FC Sete","3-1",3,1,"1",1,4,2,"H"
1952-08-31,1952,"RC Roubaix","AS Nancy","2-2",2,2,"1",1,4,0,"D"
1952-08-31,1952,"Stade Rennes","Girondins Bordeaux","1-0",1,0,"1",1,1,1,"H"
1952-08-31,1952,"Stade Olympique Montpellierain","AS Saint-Etienne","2-0",2,0,"1",1,2,2,"H"
1952-09-07,1952,"Lille OSC","Stade Reims","2-5",2,5,"1",1,7,-3,"D"
1952-09-07,1952,"Olympique Marseille","Stade Rennes","2-2",2,2,"1",1,4,0,"D"
1952-09-07,1952,"Girondins Bordeaux","FC Sochaux","4-1",4,1,"1",1,5,3,"H"
1952-09-07,1952,"RC Lens","RC Roubaix","1-3",1,3,"1",1,4,-2,"D"
1952-09-07,1952,"Racing Club de France","Nimes Olympique","1-2",1,2,"1",1,3,-1,"D"
1952-09-07,1952,"FC Sete","OGC Nice","1-0",1,0,"1",1,1,1,"H"
1952-09-07,1952,"Le Havre AC","Stade Olympique Montpellierain","1-1",1,1,"1",1,2,0,"D"
1952-09-07,1952,"FC Metz","AS Nancy","2-0",2,0,"1",1,2,2,"H"
1952-09-07,1952,"AS Saint-Etienne","Stade Francais FC","1-1",1,1,"1",1,2,0,"D"
1952-09-11,1952,"RC Lens","Lille OSC","0-3",0,3,"1",1,3,-3,"D"
1952-09-11,1952,"Girondins Bordeaux","Olympique Marseille","2-0",2,0,"1",1,2,2,"H"
1952-09-11,1952,"Nimes Olympique","Stade Olympique Montpellierain","4-2",4,2,"1",1,6,2,"H"
1952-09-11,1952,"RC Roubaix","FC Metz","1-0",1,0,"1",1,1,1,"H"
1952-09-11,1952,"Racing Club de France","AS Saint-Etienne","2-1",2,1,"1",1,3,1,"H"
1952-09-11,1952,"AS Nancy","Stade Rennes","1-2",1,2,"1",1,3,-1,"D"
1952-09-11,1952,"FC Sochaux","Stade Francais FC","1-3",1,3,"1",1,4,-2,"D"
1952-09-14,1952,"Stade Reims","RC Lens","5-0",5,0,"1",1,5,5,"H"
1952-09-14,1952,"Lille OSC","Racing Club de France","3-0",3,0,"1",1,3,3,"H"
1952-09-14,1952,"Stade Olympique Montpellierain","RC Roubaix","1-1",1,1,"1",1,2,0,"D"
1952-09-14,1952,"Stade Rennes","Nimes Olympique","2-0",2,0,"1",1,2,2,"H"
1952-09-14,1952,"AS Saint-Etienne","Olympique Marseille","2-2",2,2,"1",1,4,0,"D"
1952-09-14,1952,"Le Havre AC","Girondins Bordeaux","3-1",3,1,"1",1,4,2,"H"
1952-09-14,1952,"Stade Francais FC","OGC Nice","0-1",0,1,"1",1,1,-1,"D"
1952-09-14,1952,"FC Metz","FC Sete","0-1",0,1,"1",1,1,-1,"D"
1952-09-14,1952,"FC Sochaux","AS Nancy","1-0",1,0,"1",1,1,1,"H"
1952-09-18,1952,"OGC Nice","Stade Reims","0-4",0,4,"1",1,4,-4,"D"
1952-09-18,1952,"FC Sete","Le Havre AC","3-1",3,1,"1",1,4,2,"H"
1952-09-21,1952,"FC Sete","Stade Reims","2-1",2,1,"1",1,3,1,"H"
1952-09-21,1952,"Girondins Bordeaux","Lille OSC","1-5",1,5,"1",1,6,-4,"D"
1952-09-21,1952,"Olympique Marseille","Le Havre AC","3-1",3,1,"1",1,4,2,"H"
1952-09-21,1952,"Nimes Olympique","FC Sochaux","2-0",2,0,"1",1,2,2,"H"
1952-09-21,1952,"RC Roubaix","Stade Francais FC","0-0",0,0,"1",1,0,0,"D"
1952-09-21,1952,"OGC Nice","Stade Rennes","3-1",3,1,"1",1,4,2,"H"
1952-09-21,1952,"Racing Club de France","FC Metz","0-2",0,2,"1",1,2,-2,"D"
1952-09-21,1952,"RC Lens","Stade Olympique Montpellierain","2-1",2,1,"1",1,3,1,"H"
1952-09-21,1952,"AS Nancy","AS Saint-Etienne","3-2",3,2,"1",1,5,1,"H"
1952-09-27,1952,"Nimes Olympique","AS Nancy","2-1",2,1,"1",1,3,1,"H"
1952-09-28,1952,"Stade Reims","Racing Club de France","5-1",5,1,"1",1,6,4,"H"
1952-09-28,1952,"Lille OSC","Olympique Marseille","2-0",2,0,"1",1,2,2,"H"
1952-09-28,1952,"Stade Olympique Montpellierain","FC Sete","1-1",1,1,"1",1,2,0,"D"
1952-09-28,1952,"Stade Rennes","RC Roubaix","3-2",3,2,"1",1,5,1,"H"
1952-09-28,1952,"FC Metz","Girondins Bordeaux","0-2",0,2,"1",1,2,-2,"D"
1952-09-28,1952,"Le Havre AC","AS Saint-Etienne","3-0",3,0,"1",1,3,3,"H"
1952-09-28,1952,"FC Sochaux","OGC Nice","3-2",3,2,"1",1,5,1,"H"
1952-09-28,1952,"Stade Francais FC","RC Lens","1-1",1,1,"1",1,2,0,"D"
1952-10-05,1952,"AS Saint-Etienne","Girondins Bordeaux","1-1",1,1,"1",1,2,0,"D"
1952-10-09,1952,"Stade Reims","RC Roubaix","1-0",1,0,"1",1,1,1,"H"
1952-10-09,1952,"Lille OSC","FC Sete","5-0",5,0,"1",1,5,5,"H"
1952-10-09,1952,"Olympique Marseille","AS Nancy","4-3",4,3,"1",1,7,1,"H"
1952-10-09,1952,"Stade Francais FC","Nimes Olympique","4-2",4,2,"1",1,6,2,"H"
1952-10-09,1952,"Stade Rennes","FC Sochaux","1-1",1,1,"1",1,2,0,"D"
1952-10-09,1952,"Le Havre AC","Racing Club de France","4-1",4,1,"1",1,5,3,"H"
1952-10-09,1952,"Stade Olympique Montpellierain","OGC Nice","2-1",2,1,"1",1,3,1,"H"
1952-10-09,1952,"FC Metz","RC Lens","3-0",3,0,"1",1,3,3,"H"
1952-10-12,1952,"Girondins Bordeaux","Stade Reims","1-0",1,0,"1",1,1,1,"H"
1952-10-12,1952,"AS Saint-Etienne","Lille OSC","2-1",2,1,"1",1,3,1,"H"
1952-10-12,1952,"Olympique Marseille","FC Metz","3-0",3,0,"1",1,3,3,"H"
1952-10-12,1952,"AS Nancy","Le Havre AC","0-3",0,3,"1",1,3,-3,"D"
1952-10-12,1952,"FC Sete","Stade Francais FC","2-2",2,2,"1",1,4,0,"D"
1952-10-12,1952,"OGC Nice","Nimes Olympique","2-0",2,0,"1",1,2,2,"H"
1952-10-12,1952,"RC Lens","Stade Rennes","5-0",5,0,"1",1,5,5,"H"
1952-10-12,1952,"RC Roubaix","FC Sochaux","2-2",2,2,"1",1,4,0,"D"
1952-10-12,1952,"Racing Club de France","Stade Olympique Montpellierain","2-1",2,1,"1",1,3,1,"H"
1952-10-26,1952,"Stade Reims","Olympique Marseille","3-1",3,1,"1",1,4,2,"H"
1952-10-26,1952,"Lille OSC","Le Havre AC","3-1",3,1,"1",1,4,2,"H"
1952-10-26,1952,"Nimes Olympique","RC Roubaix","1-0",1,0,"1",1,1,1,"H"
1952-10-26,1952,"Stade Rennes","FC Sete","3-0",3,0,"1",1,3,3,"H"
1952-10-26,1952,"OGC Nice","AS Nancy","2-1",2,1,"1",1,3,1,"H"
1952-10-26,1952,"Stade Olympique Montpellierain","Girondins Bordeaux","4-1",4,1,"1",1,5,3,"H"
1952-10-26,1952,"Stade Francais FC","Racing Club de France","5-0",5,0,"1",1,5,5,"H"
1952-10-26,1952,"FC Sochaux","RC Lens","1-0",1,0,"1",1,1,1,"H"
1952-10-26,1952,"FC Metz","AS Saint-Etienne","5-0",5,0,"1",1,5,5,"H"
1952-11-02,1952,"Stade Reims","FC Sochaux","3-0",3,0,"1",1,3,3,"H"
1952-11-02,1952,"Lille OSC","OGC Nice","1-1",1,1,"1",1,2,0,"D"
1952-11-02,1952,"Olympique Marseille","FC Sete","3-3",3,3,"1",1,6,0,"D"
1952-11-02,1952,"Le Havre AC","RC Roubaix","2-0",2,0,"1",1,2,2,"H"
1952-11-02,1952,"Girondins Bordeaux","Racing Club de France","3-1",3,1,"1",1,4,2,"H"
1952-11-02,1952,"Stade Olympique Montpellierain","Stade Rennes","2-2",2,2,"1",1,4,0,"D"
1952-11-02,1952,"Stade Francais FC","AS Nancy","4-1",4,1,"1",1,5,3,"H"
1952-11-02,1952,"FC Metz","Nimes Olympique","2-0",2,0,"1",1,2,2,"H"
1952-11-02,1952,"AS Saint-Etienne","RC Lens","2-3",2,3,"1",1,5,-1,"D"
1952-11-09,1952,"RC Roubaix","Lille OSC","1-2",1,2,"1",1,3,-1,"D"
1952-11-09,1952,"Nimes Olympique","Stade Reims","1-0",1,0,"1",1,1,1,"H"
1952-11-09,1952,"Racing Club de France","Olympique Marseille","1-1",1,1,"1",1,2,0,"D"
1952-11-09,1952,"FC Sete","AS Saint-Etienne","5-0",5,0,"1",1,5,5,"H"
1952-11-09,1952,"Stade Rennes","Stade Francais FC","0-0",0,0,"1",1,0,0,"D"
1952-11-09,1952,"RC Lens","Le Havre AC","2-0",2,0,"1",1,2,2,"H"
1952-11-09,1952,"AS Nancy","Girondins Bordeaux","3-0",3,0,"1",1,3,3,"H"
1952-11-09,1952,"OGC Nice","FC Metz","1-2",1,2,"1",1,3,-1,"D"
1952-11-09,1952,"FC Sochaux","Stade Olympique Montpellierain","2-1",2,1,"1",1,3,1,"H"
1952-11-23,1952,"Stade Reims","FC Metz","2-1",2,1,"1",1,3,1,"H"
1952-11-23,1952,"Stade Olympique Montpellierain","Lille OSC","1-1",1,1,"1",1,2,0,"D"
1952-11-23,1952,"Girondins Bordeaux","Nimes Olympique","3-2",3,2,"1",1,5,1,"H"
1952-11-23,1952,"Stade Francais FC","Le Havre AC","2-2",2,2,"1",1,4,0,"D"
1952-11-23,1952,"FC Sochaux","Olympique Marseille","2-1",2,1,"1",1,3,1,"H"
1952-11-23,1952,"RC Roubaix","FC Sete","2-0",2,0,"1",1,2,2,"H"
1952-11-23,1952,"Stade Rennes","AS Saint-Etienne","0-1",0,1,"1",1,1,-1,"D"
1952-11-23,1952,"AS Nancy","RC Lens","1-3",1,3,"1",1,4,-2,"D"
1952-11-23,1952,"OGC Nice","Racing Club de France","1-2",1,2,"1",1,3,-1,"D"
1952-11-30,1952,"Stade Reims","Stade Olympique Montpellierain","3-2",3,2,"1",1,5,1,"H"
1952-11-30,1952,"Lille OSC","Stade Rennes","1-1",1,1,"1",1,2,0,"D"
1952-11-30,1952,"Girondins Bordeaux","RC Roubaix","4-2",4,2,"1",1,6,2,"H"
1952-11-30,1952,"Olympique Marseille","OGC Nice","3-1",3,1,"1",1,4,2,"H"
1952-11-30,1952,"Le Havre AC","FC Sochaux","2-2",2,2,"1",1,4,0,"D"
1952-11-30,1952,"FC Metz","Stade Francais FC","2-0",2,0,"1",1,2,2,"H"
1952-11-30,1952,"AS Saint-Etienne","Nimes Olympique","4-2",4,2,"1",1,6,2,"H"
1952-11-30,1952,"FC Sete","AS Nancy","1-2",1,2,"1",1,3,-1,"D"
1952-11-30,1952,"Racing Club de France","RC Lens","1-1",1,1,"1",1,2,0,"D"
1952-12-07,1952,"AS Nancy","Stade Reims","1-1",1,1,"1",1,2,0,"D"
1952-12-07,1952,"Stade Francais FC","Lille OSC","2-0",2,0,"1",1,2,2,"H"
1952-12-07,1952,"OGC Nice","Girondins Bordeaux","1-2",1,2,"1",1,3,-1,"D"
1952-12-07,1952,"Stade Rennes","Le Havre AC","2-0",2,0,"1",1,2,2,"H"
1952-12-07,1952,"FC Sochaux","AS Saint-Etienne","3-0",3,0,"1",1,3,3,"H"
1952-12-07,1952,"Nimes Olympique","Olympique Marseille","2-0",2,0,"1",1,2,2,"H"
1952-12-07,1952,"RC Lens","FC Sete","3-0",3,0,"1",1,3,3,"H"
1952-12-07,1952,"Stade Olympique Montpellierain","FC Metz","1-1",1,1,"1",1,2,0,"D"
1952-12-07,1952,"RC Roubaix","Racing Club de France","0-1",0,1,"1",1,1,-1,"D"
1952-12-14,1952,"Stade Reims","Stade Francais FC","1-2",1,2,"1",1,3,-1,"D"
1952-12-14,1952,"Lille OSC","FC Sochaux","3-1",3,1,"1",1,4,2,"H"
1952-12-14,1952,"Girondins Bordeaux","RC Lens","2-0",2,0,"1",1,2,2,"H"
1952-12-14,1952,"Olympique Marseille","RC Roubaix","4-2",4,2,"1",1,6,2,"H"
1952-12-14,1952,"FC Metz","Stade Rennes","2-1",2,1,"1",1,3,1,"H"
1952-12-14,1952,"Le Havre AC","Nimes Olympique","1-1",1,1,"1",1,2,0,"D"
1952-12-14,1952,"Racing Club de France","FC Sete","2-1",2,1,"1",1,3,1,"H"
1952-12-14,1952,"Stade Olympique Montpellierain","AS Nancy","0-1",0,1,"1",1,1,-1,"D"
1952-12-14,1952,"AS Saint-Etienne","OGC Nice","2-1",2,1,"1",1,3,1,"H"
1952-12-21,1952,"Stade Rennes","Stade Reims","0-1",0,1,"1",1,1,-1,"D"
1952-12-21,1952,"Nimes Olympique","Lille OSC","2-0",2,0,"1",1,2,2,"H"
1952-12-21,1952,"FC Sete","Girondins Bordeaux","2-0",2,0,"1",1,2,2,"H"
1952-12-21,1952,"RC Lens","Olympique Marseille","1-1",1,1,"1",1,2,0,"D"
1952-12-21,1952,"Stade Francais FC","Stade Olympique Montpellierain","2-4",2,4,"1",1,6,-2,"D"
1952-12-21,1952,"FC Sochaux","FC Metz","1-1",1,1,"1",1,2,0,"D"
1952-12-21,1952,"OGC Nice","Le Havre AC","0-2",0,2,"1",1,2,-2,"D"
1952-12-21,1952,"AS Nancy","Racing Club de France","1-0",1,0,"1",1,1,1,"H"
1952-12-21,1952,"RC Roubaix","AS Saint-Etienne","2-0",2,0,"1",1,2,2,"H"
1952-12-28,1952,"Stade Reims","AS Saint-Etienne","2-0",2,0,"1",1,2,2,"H"
1952-12-28,1952,"Lille OSC","AS Nancy","6-2",6,2,"1",1,8,4,"H"
1952-12-28,1952,"Stade Francais FC","Girondins Bordeaux","0-2",0,2,"1",1,2,-2,"D"
1952-12-28,1952,"FC Metz","Le Havre AC","6-1",6,1,"1",1,7,5,"H"
1952-12-28,1952,"Nimes Olympique","RC Lens","0-0",0,0,"1",1,0,0,"D"
1952-12-28,1952,"FC Sochaux","FC Sete","4-2",4,2,"1",1,6,2,"H"
1952-12-28,1952,"Stade Olympique Montpellierain","Olympique Marseille","2-1",2,1,"1",1,3,1,"H"
1952-12-28,1952,"Stade Rennes","Racing Club de France","1-0",1,0,"1",1,1,1,"H"
1952-12-28,1952,"OGC Nice","RC Roubaix","4-1",4,1,"1",1,5,3,"H"
1953-01-04,1952,"Le Havre AC","Stade Reims","3-4",3,4,"1",1,7,-1,"D"
1953-01-04,1952,"Lille OSC","FC Metz","1-2",1,2,"1",1,3,-1,"D"
1953-01-04,1952,"Girondins Bordeaux","Stade Rennes","7-0",7,0,"1",1,7,7,"H"
1953-01-04,1952,"FC Sete","Nimes Olympique","1-1",1,1,"1",1,2,0,"D"
1953-01-04,1952,"RC Lens","OGC Nice","2-0",2,0,"1",1,2,2,"H"
1953-01-04,1952,"AS Saint-Etienne","Stade Olympique Montpellierain","2-0",2,0,"1",1,2,2,"H"
1953-01-04,1952,"AS Nancy","RC Roubaix","1-0",1,0,"1",1,1,1,"H"
1953-01-11,1952,"Stade Reims","Lille OSC","1-1",1,1,"1",1,2,0,"D"
1953-01-11,1952,"FC Sochaux","Girondins Bordeaux","8-2",8,2,"1",1,10,6,"H"
1953-01-11,1952,"Nimes Olympique","Racing Club de France","4-2",4,2,"1",1,6,2,"H"
1953-01-11,1952,"AS Nancy","FC Metz","1-0",1,0,"1",1,1,1,"H"
1953-01-11,1952,"RC Roubaix","RC Lens","0-1",0,1,"1",1,1,-1,"D"
1953-01-11,1952,"Stade Rennes","Olympique Marseille","3-1",3,1,"1",1,4,2,"H"
1953-01-11,1952,"Stade Francais FC","AS Saint-Etienne","2-1",2,1,"1",1,3,1,"H"
1953-01-11,1952,"Stade Olympique Montpellierain","Le Havre AC","2-1",2,1,"1",1,3,1,"H"
1953-01-11,1952,"OGC Nice","FC Sete","3-2",3,2,"1",1,5,1,"H"
1953-01-25,1952,"Stade Reims","OGC Nice","3-1",3,1,"1",1,4,2,"H"
1953-01-25,1952,"Lille OSC","RC Lens","0-0",0,0,"1",1,0,0,"D"
1953-01-25,1952,"Stade Olympique Montpellierain","Nimes Olympique","2-5",2,5,"1",1,7,-3,"D"
1953-01-25,1952,"Olympique Marseille","Girondins Bordeaux","3-0",3,0,"1",1,3,3,"H"
1953-01-25,1952,"Stade Francais FC","FC Sochaux","1-2",1,2,"1",1,3,-1,"D"
1953-01-25,1952,"FC Metz","RC Roubaix","1-1",1,1,"1",1,2,0,"D"
1953-01-25,1952,"Stade Rennes","AS Nancy","0-1",0,1,"1",1,1,-1,"D"
1953-01-25,1952,"Le Havre AC","FC Sete","2-0",2,0,"1",1,2,2,"H"
1953-01-25,1952,"AS Saint-Etienne","Racing Club de France","3-1",3,1,"1",1,4,2,"H"
1953-01-29,1952,"Olympique Marseille","Stade Francais FC","1-0",1,0,"1",1,1,1,"H"
1953-01-31,1952,"Girondins Bordeaux","Le Havre AC","6-0",6,0,"1",1,6,6,"H"
1953-02-01,1952,"RC Lens","Stade Reims","1-3",1,3,"1",1,4,-2,"D"
1953-02-01,1952,"Racing Club de France","Lille OSC","1-0",1,0,"1",1,1,1,"H"
1953-02-01,1952,"Nimes Olympique","Stade Rennes","2-0",2,0,"1",1,2,2,"H"
1953-02-01,1952,"AS Nancy","FC Sochaux","1-2",1,2,"1",1,3,-1,"D"
1953-02-01,1952,"Olympique Marseille","AS Saint-Etienne","1-0",1,0,"1",1,1,1,"H"
1953-02-01,1952,"FC Sete","FC Metz","0-0",0,0,"1",1,0,0,"D"
1953-02-01,1952,"OGC Nice","Stade Francais FC","2-1",2,1,"1",1,3,1,"H"
1953-02-01,1952,"RC Roubaix","Stade Olympique Montpellierain","1-0",1,0,"1",1,1,1,"H"
1953-02-12,1952,"Racing Club de France","FC Sochaux","2-1",2,1,"1",1,3,1,"H"
1953-02-15,1952,"Stade Reims","FC Sete","2-0",2,0,"1",1,2,2,"H"
1953-02-15,1952,"Lille OSC","Girondins Bordeaux","0-0",0,0,"1",1,0,0,"D"
1953-02-15,1952,"FC Sochaux","Nimes Olympique","1-1",1,1,"1",1,2,0,"D"
1953-02-15,1952,"Le Havre AC","Olympique Marseille","2-1",2,1,"1",1,3,1,"H"
1953-02-15,1952,"FC Metz","Racing Club de France","0-2",0,2,"1",1,2,-2,"D"
1953-02-15,1952,"Stade Olympique Montpellierain","RC Lens","2-1",2,1,"1",1,3,1,"H"
1953-02-15,1952,"Stade Rennes","OGC Nice","0-0",0,0,"1",1,0,0,"D"
1953-02-15,1952,"Stade Francais FC","RC Roubaix","1-3",1,3,"1",1,4,-2,"D"
1953-02-15,1952,"AS Saint-Etienne","AS Nancy","6-0",6,0,"1",1,6,6,"H"
1953-02-22,1952,"Racing Club de France","Stade Reims","1-3",1,3,"1",1,4,-2,"D"
1953-02-22,1952,"Girondins Bordeaux","FC Metz","4-0",4,0,"1",1,4,4,"H"
1953-02-22,1952,"Olympique Marseille","Lille OSC","3-0",3,0,"1",1,3,3,"H"
1953-02-22,1952,"AS Nancy","Nimes Olympique","2-0",2,0,"1",1,2,2,"H"
1953-02-22,1952,"OGC Nice","FC Sochaux","5-3",5,3,"1",1,8,2,"H"
1953-02-22,1952,"RC Lens","Stade Francais FC","1-1",1,1,"1",1,2,0,"D"
1953-02-22,1952,"AS Saint-Etienne","Le Havre AC","1-0",1,0,"1",1,1,1,"H"
1953-02-22,1952,"RC Roubaix","Stade Rennes","3-2",3,2,"1",1,5,1,"H"
1953-02-22,1952,"FC Sete","Stade Olympique Montpellierain","1-0",1,0,"1",1,1,1,"H"
1953-03-08,1952,"RC Roubaix","Stade Reims","1-1",1,1,"1",1,2,0,"D"
1953-03-08,1952,"Girondins Bordeaux","AS Saint-Etienne","0-0",0,0,"1",1,0,0,"D"
1953-03-08,1952,"Nimes Olympique","Stade Francais FC","0-0",0,0,"1",1,0,0,"D"
1953-03-08,1952,"FC Sochaux","Stade Rennes","2-0",2,0,"1",1,2,2,"H"
1953-03-08,1952,"FC Sete","Lille OSC","3-1",3,1,"1",1,4,2,"H"
1953-03-08,1952,"AS Nancy","Olympique Marseille","1-0",1,0,"1",1,1,1,"H"
1953-03-08,1952,"RC Lens","FC Metz","3-1",3,1,"1",1,4,2,"H"
1953-03-08,1952,"Racing Club de France","Le Havre AC","1-1",1,1,"1",1,2,0,"D"
1953-03-08,1952,"OGC Nice","Stade Olympique Montpellierain","0-0",0,0,"1",1,0,0,"D"
1953-03-15,1952,"Stade Reims","Girondins Bordeaux","2-3",2,3,"1",1,5,-1,"D"
1953-03-15,1952,"Nimes Olympique","OGC Nice","1-0",1,0,"1",1,1,1,"H"
1953-03-15,1952,"FC Sochaux","RC Roubaix","3-1",3,1,"1",1,4,2,"H"
1953-03-15,1952,"FC Metz","Olympique Marseille","1-3",1,3,"1",1,4,-2,"D"
1953-03-15,1952,"Lille OSC","AS Saint-Etienne","0-2",0,2,"1",1,2,-2,"D"
1953-03-15,1952,"Stade Rennes","RC Lens","3-2",3,2,"1",1,5,1,"H"
1953-03-15,1952,"Stade Francais FC","FC Sete","2-0",2,0,"1",1,2,2,"H"
1953-03-15,1952,"Le Havre AC","AS Nancy","0-1",0,1,"1",1,1,-1,"D"
1953-03-15,1952,"Stade Olympique Montpellierain","Racing Club de France","0-1",0,1,"1",1,1,-1,"D"
1953-03-22,1952,"Olympique Marseille","Stade Reims","2-1",2,1,"1",1,3,1,"H"
1953-03-22,1952,"Girondins Bordeaux","Stade Olympique Montpellierain","6-0",6,0,"1",1,6,6,"H"
1953-03-22,1952,"RC Roubaix","Nimes Olympique","2-4",2,4,"1",1,6,-2,"D"
1953-03-22,1952,"RC Lens","FC Sochaux","5-1",5,1,"1",1,6,4,"H"
1953-03-22,1952,"Le Havre AC","Lille OSC","0-1",0,1,"1",1,1,-1,"D"
1953-03-22,1952,"AS Nancy","OGC Nice","2-1",2,1,"1",1,3,1,"H"
1953-03-22,1952,"Racing Club de France","Stade Francais FC","2-2",2,2,"1",1,4,0,"D"
1953-03-22,1952,"AS Saint-Etienne","FC Metz","2-2",2,2,"1",1,4,0,"D"
1953-03-22,1952,"FC Sete","Stade Rennes","2-0",2,0,"1",1,2,2,"H"
1953-04-05,1952,"FC Sochaux","Stade Reims","1-0",1,0,"1",1,1,1,"H"
1953-04-05,1952,"Racing Club de France","Girondins Bordeaux","3-3",3,3,"1",1,6,0,"D"
1953-04-05,1952,"Nimes Olympique","FC Metz","2-1",2,1,"1",1,3,1,"H"
1953-04-05,1952,"OGC Nice","Lille OSC","0-0",0,0,"1",1,0,0,"D"
1953-04-05,1952,"FC Sete","Olympique Marseille","2-0",2,0,"1",1,2,2,"H"
1953-04-05,1952,"RC Lens","AS Saint-Etienne","1-2",1,2,"1",1,3,-1,"D"
1953-04-05,1952,"AS Nancy","Stade Francais FC","5-1",5,1,"1",1,6,4,"H"
1953-04-05,1952,"RC Roubaix","Le Havre AC","0-0",0,0,"1",1,0,0,"D"
1953-04-05,1952,"Stade Rennes","Stade Olympique Montpellierain","0-1",0,1,"1",1,1,-1,"D"
1953-04-12,1952,"Stade Reims","Nimes Olympique","2-0",2,0,"1",1,2,2,"H"
1953-04-12,1952,"Girondins Bordeaux","AS Nancy","4-1",4,1,"1",1,5,3,"H"
1953-04-12,1952,"Stade Olympique Montpellierain","FC Sochaux","2-3",2,3,"1",1,5,-1,"D"
1953-04-12,1952,"Lille OSC","RC Roubaix","2-1",2,1,"1",1,3,1,"H"
1953-04-12,1952,"Olympique Marseille","Racing Club de France","3-0",3,0,"1",1,3,3,"H"
1953-04-12,1952,"Le Havre AC","RC Lens","1-0",1,0,"1",1,1,1,"H"
1953-04-12,1952,"Stade Francais FC","Stade Rennes","2-0",2,0,"1",1,2,2,"H"
1953-04-12,1952,"FC Metz","OGC Nice","2-0",2,0,"1",1,2,2,"H"
1953-04-12,1952,"AS Saint-Etienne","FC Sete","2-2",2,2,"1",1,4,0,"D"
1953-04-19,1952,"FC Metz","Stade Reims","0-0",0,0,"1",1,0,0,"D"
1953-04-19,1952,"Nimes Olympique","Girondins Bordeaux","5-1",5,1,"1",1,6,4,"H"
1953-04-19,1952,"Olympique Marseille","FC Sochaux","1-6",1,6,"1",1,7,-5,"D"
1953-04-19,1952,"Lille OSC","Stade Olympique Montpellierain","2-2",2,2,"1",1,4,0,"D"
1953-04-19,1952,"RC Lens","AS Nancy","4-1",4,1,"1",1,5,3,"H"
1953-04-19,1952,"Le Havre AC","Stade Francais FC","1-3",1,3,"1",1,4,-2,"D"
1953-04-19,1952,"FC Sete","RC Roubaix","1-0",1,0,"1",1,1,1,"H"
1953-04-19,1952,"AS Saint-Etienne","Stade Rennes","1-0",1,0,"1",1,1,1,"H"
1953-04-19,1952,"Racing Club de France","OGC Nice","1-3",1,3,"1",1,4,-2,"D"
1953-05-03,1952,"Stade Olympique Montpellierain","Stade Reims","2-6",2,6,"1",1,8,-4,"D"
1953-05-03,1952,"FC Sochaux","Le Havre AC","3-2",3,2,"1",1,5,1,"H"
1953-05-03,1952,"RC Roubaix","Girondins Bordeaux","3-1",3,1,"1",1,4,2,"H"
1953-05-03,1952,"Nimes Olympique","AS Saint-Etienne","0-0",0,0,"1",1,0,0,"D"
1953-05-03,1952,"Stade Rennes","Lille OSC","1-1",1,1,"1",1,2,0,"D"
1953-05-03,1952,"OGC Nice","Olympique Marseille","3-1",3,1,"1",1,4,2,"H"
1953-05-03,1952,"RC Lens","Racing Club de France","2-1",2,1,"1",1,3,1,"H"
1953-05-03,1952,"Stade Francais FC","FC Metz","2-1",2,1,"1",1,3,1,"H"
1953-05-03,1952,"AS Nancy","FC Sete","0-1",0,1,"1",1,1,-1,"D"
1953-05-10,1952,"Stade Reims","AS Nancy","0-2",0,2,"1",1,2,-2,"D"
1953-05-10,1952,"AS Saint-Etienne","FC Sochaux","1-3",1,3,"1",1,4,-2,"D"
1953-05-10,1952,"Girondins Bordeaux","OGC Nice","7-3",7,3,"1",1,10,4,"H"
1953-05-10,1952,"Olympique Marseille","Nimes Olympique","4-1",4,1,"1",1,5,3,"H"
1953-05-10,1952,"Lille OSC","Stade Francais FC","2-1",2,1,"1",1,3,1,"H"
1953-05-10,1952,"FC Sete","RC Lens","2-0",2,0,"1",1,2,2,"H"
1953-05-10,1952,"FC Metz","Stade Olympique Montpellierain","1-1",1,1,"1",1,2,0,"D"
1953-05-10,1952,"Le Havre AC","Stade Rennes","1-1",1,1,"1",1,2,0,"D"
1953-05-10,1952,"Racing Club de France","RC Roubaix","0-2",0,2,"1",1,2,-2,"D"
1953-05-17,1952,"Stade Francais FC","Stade Reims","1-5",1,5,"1",1,6,-4,"D"
1953-05-17,1952,"FC Sochaux","Lille OSC","3-3",3,3,"1",1,6,0,"D"
1953-05-17,1952,"RC Lens","Girondins Bordeaux","1-1",1,1,"1",1,2,0,"D"
1953-05-17,1952,"Nimes Olympique","Le Havre AC","7-1",7,1,"1",1,8,6,"H"
1953-05-17,1952,"RC Roubaix","Olympique Marseille","0-0",0,0,"1",1,0,0,"D"
1953-05-17,1952,"FC Sete","Racing Club de France","0-1",0,1,"1",1,1,-1,"D"
1953-05-17,1952,"AS Nancy","Stade Olympique Montpellierain","3-0",3,0,"1",1,3,3,"H"
1953-05-17,1952,"Stade Rennes","FC Metz","4-2",4,2,"1",1,6,2,"H"
1953-05-17,1952,"OGC Nice","AS Saint-Etienne","2-0",2,0,"1",1,2,2,"H"
1953-05-24,1952,"Stade Reims","Stade Rennes","5-1",5,1,"1",1,6,4,"H"
1953-05-24,1952,"FC Metz","FC Sochaux","1-2",1,2,"1",1,3,-1,"D"
1953-05-24,1952,"Girondins Bordeaux","FC Sete","3-0",3,0,"1",1,3,3,"H"
1953-05-24,1952,"Lille OSC","Nimes Olympique","3-2",3,2,"1",1,5,1,"H"
1953-05-24,1952,"Olympique Marseille","RC Lens","1-1",1,1,"1",1,2,0,"D"
1953-05-24,1952,"Racing Club de France","AS Nancy","1-2",1,2,"1",1,3,-1,"D"
1953-05-24,1952,"Stade Olympique Montpellierain","Stade Francais FC","0-3",0,3,"1",1,3,-3,"D"
1953-05-24,1952,"AS Saint-Etienne","RC Roubaix","1-1",1,1,"1",1,2,0,"D"
1953-05-24,1952,"Le Havre AC","OGC Nice","2-0",2,0,"1",1,2,2,"H"
1953-08-23,1953,"Olympique Marseille","Nimes Olympique","0-4",0,4,"1",1,4,-4,"D"
1953-08-23,1953,"Le Havre AC","AS Saint-Etienne","2-0",2,0,"1",1,2,2,"H"
1953-08-23,1953,"RC Lens","OGC Nice","2-3",2,3,"1",1,5,-1,"D"
1953-08-23,1953,"AS Monaco","Toulouse FC","2-3",2,3,"1",1,5,-1,"D"
1953-08-23,1953,"RC Strasbourg","Lille OSC","2-1",2,1,"1",1,3,1,"H"
1953-08-23,1953,"FC Metz","Stade Reims","0-1",0,1,"1",1,1,-1,"D"
1953-08-23,1953,"FC Sete","AS Nancy","1-0",1,0,"1",1,1,1,"H"
1953-08-23,1953,"FC Sochaux","Girondins Bordeaux","1-1",1,1,"1",1,2,0,"D"
1953-08-23,1953,"RC Roubaix","Stade Francais FC","1-1",1,1,"1",1,2,0,"D"
1953-08-29,1953,"Stade Francais FC","Olympique Marseille","1-1",1,1,"1",1,2,0,"D"
1953-08-30,1953,"Nimes Olympique","FC Sete","5-2",5,2,"1",1,7,3,"H"
1953-08-30,1953,"Stade Reims","FC Sochaux","4-1",4,1,"1",1,5,3,"H"
1953-08-30,1953,"OGC Nice","RC Roubaix","3-1",3,1,"1",1,4,2,"H"
1953-08-30,1953,"Girondins Bordeaux","RC Strasbourg","5-2",5,2,"1",1,7,3,"H"
1953-08-30,1953,"RC Lens","Toulouse FC","1-1",1,1,"1",1,2,0,"D"
1953-08-30,1953,"Lille OSC","Le Havre AC","2-1",2,1,"1",1,3,1,"H"
1953-08-30,1953,"AS Nancy","FC Metz","2-1",2,1,"1",1,3,1,"H"
1953-08-30,1953,"AS Saint-Etienne","AS Monaco","1-1",1,1,"1",1,2,0,"D"
1953-09-06,1953,"Stade Reims","Nimes Olympique","2-1",2,1,"1",1,3,1,"H"
1953-09-06,1953,"Girondins Bordeaux","Stade Francais FC","3-2",3,2,"1",1,5,1,"H"
1953-09-06,1953,"Toulouse FC","AS Nancy","3-2",3,2,"1",1,5,1,"H"
1953-09-06,1953,"RC Strasbourg","FC Sete","4-0",4,0,"1",1,4,4,"H"
1953-09-06,1953,"Lille OSC","OGC Nice","3-1",3,1,"1",1,4,2,"H"
1953-09-06,1953,"Le Havre AC","Olympique Marseille","1-0",1,0,"1",1,1,1,"H"
1953-09-06,1953,"AS Saint-Etienne","RC Lens","5-2",5,2,"1",1,7,3,"H"
1953-09-06,1953,"AS Monaco","RC Roubaix","0-2",0,2,"1",1,2,-2,"D"
1953-09-06,1953,"FC Metz","FC Sochaux","1-1",1,1,"1",1,2,0,"D"
1953-09-10,1953,"RC Roubaix","Girondins Bordeaux","0-2",0,2,"1",1,2,-2,"D"
1953-09-10,1953,"RC Lens","Stade Reims","0-0",0,0,"1",1,0,0,"D"
1953-09-10,1953,"Stade Francais FC","Nimes Olympique","1-3",1,3,"1",1,4,-2,"D"
1953-09-10,1953,"RC Strasbourg","Toulouse FC","2-0",2,0,"1",1,2,2,"H"
1953-09-10,1953,"FC Sochaux","Le Havre AC","0-1",0,1,"1",1,1,-1,"D"
1953-09-10,1953,"OGC Nice","AS Nancy","2-1",2,1,"1",1,3,1,"H"
1953-09-10,1953,"FC Sete","AS Saint-Etienne","1-2",1,2,"1",1,3,-1,"D"
1953-09-10,1953,"Olympique Marseille","Lille OSC","1-1",1,1,"1",1,2,0,"D"
1953-09-10,1953,"FC Metz","AS Monaco","1-0",1,0,"1",1,1,1,"H"
1953-09-13,1953,"Girondins Bordeaux","FC Metz","3-0",3,0,"1",1,3,3,"H"
1953-09-13,1953,"FC Sete","Stade Reims","0-2",0,2,"1",1,2,-2,"D"
1953-09-13,1953,"Nimes Olympique","RC Roubaix","1-0",1,0,"1",1,1,1,"H"
1953-09-13,1953,"Toulouse FC","OGC Nice","4-1",4,1,"1",1,5,3,"H"
1953-09-13,1953,"AS Saint-Etienne","RC Strasbourg","1-0",1,0,"1",1,1,1,"H"
1953-09-13,1953,"Lille OSC","FC Sochaux","0-0",0,0,"1",1,0,0,"D"
1953-09-13,1953,"AS Monaco","Le Havre AC","4-1",4,1,"1",1,5,3,"H"
1953-09-13,1953,"Stade Francais FC","RC Lens","5-2",5,2,"1",1,7,3,"H"
1953-09-13,1953,"AS Nancy","Olympique Marseille","2-1",2,1,"1",1,3,1,"H"
1953-09-27,1953,"FC Sete","Girondins Bordeaux","0-2",0,2,"1",1,2,-2,"D"
1953-09-27,1953,"Olympique Marseille","Stade Reims","0-2",0,2,"1",1,2,-2,"D"
1953-09-27,1953,"FC Sochaux","AS Saint-Etienne","1-2",1,2,"1",1,3,-1,"D"
1953-09-27,1953,"RC Lens","Nimes Olympique","4-1",4,1,"1",1,5,3,"H"
1953-09-27,1953,"RC Strasbourg","AS Monaco","3-0",3,0,"1",1,3,3,"H"
1953-09-27,1953,"Le Havre AC","Toulouse FC","1-1",1,1,"1",1,2,0,"D"
1953-09-27,1953,"FC Metz","Lille OSC","2-2",2,2,"1",1,4,0,"D"
1953-09-27,1953,"OGC Nice","Stade Francais FC","1-1",1,1,"1",1,2,0,"D"
1953-09-27,1953,"RC Roubaix","AS Nancy","4-2",4,2,"1",1,6,2,"H"
1953-10-04,1953,"Toulouse FC","Stade Francais FC","2-1",2,1,"1",1,3,1,"H"
1953-10-04,1953,"Le Havre AC","RC Strasbourg","1-2",1,2,"1",1,3,-1,"D"
1953-10-04,1953,"Lille OSC","FC Sete","3-1",3,1,"1",1,4,2,"H"
1953-10-08,1953,"Girondins Bordeaux","Olympique Marseille","3-0",3,0,"1",1,3,3,"H"
1953-10-08,1953,"Stade Reims","RC Roubaix","2-2",2,2,"1",1,4,0,"D"
1953-10-08,1953,"AS Saint-Etienne","FC Metz","3-2",3,2,"1",1,5,1,"H"
1953-10-08,1953,"Nimes Olympique","OGC Nice","1-1",1,1,"1",1,2,0,"D"
1953-10-08,1953,"AS Nancy","RC Lens","3-1",3,1,"1",1,4,2,"H"
1953-10-08,1953,"AS Monaco","FC Sochaux","0-0",0,0,"1",1,0,0,"D"
1953-10-11,1953,"OGC Nice","Girondins Bordeaux","3-4",3,4,"1",1,7,-1,"D"
1953-10-11,1953,"Stade Francais FC","Stade Reims","1-2",1,2,"1",1,3,-1,"D"
1953-10-11,1953,"RC Roubaix","AS Saint-Etienne","0-1",0,1,"1",1,1,-1,"D"
1953-10-11,1953,"FC Sochaux","Toulouse FC","1-3",1,3,"1",1,4,-2,"D"
1953-10-11,1953,"Nimes Olympique","AS Nancy","1-0",1,0,"1",1,1,1,"H"
1953-10-11,1953,"RC Lens","Lille OSC","0-2",0,2,"1",1,2,-2,"D"
1953-10-11,1953,"FC Metz","RC Strasbourg","2-1",2,1,"1",1,3,1,"H"
1953-10-11,1953,"FC Sete","Le Havre AC","4-4",4,4,"1",1,8,0,"D"
1953-10-11,1953,"Olympique Marseille","AS Monaco","5-1",5,1,"1",1,6,4,"H"
1953-10-25,1953,"Girondins Bordeaux","AS Monaco","4-3",4,3,"1",1,7,1,"H"
1953-10-25,1953,"Stade Reims","Le Havre AC","4-2",4,2,"1",1,6,2,"H"
1953-10-25,1953,"Toulouse FC","RC Roubaix","3-1",3,1,"1",1,4,2,"H"
1953-10-25,1953,"Nimes Olympique","FC Sochaux","4-1",4,1,"1",1,5,3,"H"
1953-10-25,1953,"Lille OSC","AS Saint-Etienne","1-0",1,0,"1",1,1,1,"H"
1953-10-25,1953,"AS Nancy","RC Strasbourg","0-0",0,0,"1",1,0,0,"D"
1953-10-25,1953,"OGC Nice","FC Sete","5-0",5,0,"1",1,5,5,"H"
1953-10-25,1953,"Stade Francais FC","FC Metz","2-1",2,1,"1",1,3,1,"H"
1953-10-25,1953,"RC Lens","Olympique Marseille","4-1",4,1,"1",1,5,3,"H"
1953-11-01,1953,"Le Havre AC","Girondins Bordeaux","2-3",2,3,"1",1,5,-1,"D"
1953-11-01,1953,"FC Sochaux","AS Nancy","7-1",7,1,"1",1,8,6,"H"
1953-11-01,1953,"RC Strasbourg","Stade Reims","2-4",2,4,"1",1,6,-2,"D"
1953-11-01,1953,"AS Saint-Etienne","Toulouse FC","1-1",1,1,"1",1,2,0,"D"
1953-11-01,1953,"AS Monaco","Lille OSC","0-1",0,1,"1",1,1,-1,"D"
1953-11-01,1953,"FC Metz","Nimes Olympique","2-0",2,0,"1",1,2,2,"H"
1953-11-01,1953,"Olympique Marseille","OGC Nice","0-0",0,0,"1",1,0,0,"D"
1953-11-01,1953,"RC Roubaix","RC Lens","0-4",0,4,"1",1,4,-4,"D"
1953-11-01,1953,"FC Sete","Stade Francais FC","0-0",0,0,"1",1,0,0,"D"
1953-11-08,1953,"Girondins Bordeaux","AS Nancy","1-0",1,0,"1",1,1,1,"H"
1953-11-08,1953,"Stade Reims","Toulouse FC","1-1",1,1,"1",1,2,0,"D"
1953-11-08,1953,"Lille OSC","Nimes Olympique","0-0",0,0,"1",1,0,0,"D"
1953-11-08,1953,"AS Saint-Etienne","Stade Francais FC","2-1",2,1,"1",1,3,1,"H"
1953-11-08,1953,"AS Monaco","OGC Nice","0-3",0,3,"1",1,3,-3,"D"
1953-11-08,1953,"RC Strasbourg","RC Roubaix","4-2",4,2,"1",1,6,2,"H"
1953-11-08,1953,"Le Havre AC","RC Lens","1-2",1,2,"1",1,3,-1,"D"
1953-11-08,1953,"FC Metz","FC Sete","1-0",1,0,"1",1,1,1,"H"
1953-11-08,1953,"FC Sochaux","Olympique Marseille","1-1",1,1,"1",1,2,0,"D"
1953-11-15,1953,"Nimes Olympique","Girondins Bordeaux","2-0",2,0,"1",1,2,2,"H"
1953-11-15,1953,"AS Nancy","Stade Reims","1-0",1,0,"1",1,1,1,"H"
1953-11-15,1953,"Toulouse FC","FC Metz","0-0",0,0,"1",1,0,0,"D"
1953-11-15,1953,"Stade Francais FC","Lille OSC","0-0",0,0,"1",1,0,0,"D"
1953-11-15,1953,"OGC Nice","AS Saint-Etienne","5-2",5,2,"1",1,7,3,"H"
1953-11-15,1953,"Olympique Marseille","RC Strasbourg","5-1",5,1,"1",1,6,4,"H"
1953-11-15,1953,"RC Lens","AS Monaco","0-0",0,0,"1",1,0,0,"D"
1953-11-15,1953,"FC Sete","FC Sochaux","0-0",0,0,"1",1,0,0,"D"
1953-11-15,1953,"RC Roubaix","Le Havre AC","3-1",3,1,"1",1,4,2,"H"
1953-11-22,1953,"Girondins Bordeaux","Lille OSC","1-3",1,3,"1",1,4,-2,"D"
1953-11-22,1953,"Stade Reims","AS Saint-Etienne","0-1",0,1,"1",1,1,-1,"D"
1953-11-22,1953,"Nimes Olympique","Le Havre AC","2-0",2,0,"1",1,2,2,"H"
1953-11-22,1953,"Toulouse FC","Olympique Marseille","2-2",2,2,"1",1,4,0,"D"
1953-11-22,1953,"OGC Nice","FC Sochaux","4-1",4,1,"1",1,5,3,"H"
1953-11-22,1953,"Stade Francais FC","RC Strasbourg","0-1",0,1,"1",1,1,-1,"D"
1953-11-22,1953,"RC Lens","FC Metz","4-0",4,0,"1",1,4,4,"H"
1953-11-22,1953,"RC Roubaix","FC Sete","1-0",1,0,"1",1,1,1,"H"
1953-11-22,1953,"AS Nancy","AS Monaco","1-1",1,1,"1",1,2,0,"D"
1953-11-29,1953,"AS Saint-Etienne","Girondins Bordeaux","2-0",2,0,"1",1,2,2,"H"
1953-11-29,1953,"Lille OSC","Toulouse FC","1-0",1,0,"1",1,1,1,"H"
1953-11-29,1953,"AS Monaco","Stade Reims","2-1",2,1,"1",1,3,1,"H"
1953-11-29,1953,"FC Metz","OGC Nice","0-0",0,0,"1",1,0,0,"D"
1953-11-29,1953,"RC Strasbourg","Nimes Olympique","2-1",2,1,"1",1,3,1,"H"
1953-11-29,1953,"FC Sete","RC Lens","3-1",3,1,"1",1,4,2,"H"
1953-11-29,1953,"Olympique Marseille","RC Roubaix","3-2",3,2,"1",1,5,1,"H"
1953-11-29,1953,"Le Havre AC","AS Nancy","2-2",2,2,"1",1,4,0,"D"
1953-11-29,1953,"FC Sochaux","Stade Francais FC","4-0",4,0,"1",1,4,4,"H"
1953-12-06,1953,"Lille OSC","RC Roubaix","2-0",2,0,"1",1,2,2,"H"
1953-12-06,1953,"Stade Reims","OGC Nice","4-3",4,3,"1",1,7,1,"H"
1953-12-06,1953,"Girondins Bordeaux","RC Lens","1-2",1,2,"1",1,3,-1,"D"
1953-12-06,1953,"AS Saint-Etienne","Olympique Marseille","0-0",0,0,"1",1,0,0,"D"
1953-12-06,1953,"Toulouse FC","Nimes Olympique","1-0",1,0,"1",1,1,1,"H"
1953-12-06,1953,"RC Strasbourg","FC Sochaux","1-0",1,0,"1",1,1,1,"H"
1953-12-06,1953,"AS Nancy","Stade Francais FC","0-0",0,0,"1",1,0,0,"D"
1953-12-06,1953,"Le Havre AC","FC Metz","3-1",3,1,"1",1,4,2,"H"
1953-12-06,1953,"AS Monaco","FC Sete","2-1",2,1,"1",1,3,1,"H"
1953-12-13,1953,"Lille OSC","Stade Reims","0-1",0,1,"1",1,1,-1,"D"
1953-12-13,1953,"AS Saint-Etienne","AS Nancy","3-1",3,1,"1",1,4,2,"H"
1953-12-13,1953,"Girondins Bordeaux","Toulouse FC","0-0",0,0,"1",1,0,0,"D"
1953-12-13,1953,"RC Strasbourg","OGC Nice","2-2",2,2,"1",1,4,0,"D"
1953-12-13,1953,"AS Monaco","Nimes Olympique","2-0",2,0,"1",1,2,2,"H"
1953-12-13,1953,"FC Sochaux","RC Lens","1-1",1,1,"1",1,2,0,"D"
1953-12-13,1953,"FC Metz","RC Roubaix","4-2",4,2,"1",1,6,2,"H"
1953-12-13,1953,"Le Havre AC","Stade Francais FC","1-3",1,3,"1",1,4,-2,"D"
1953-12-13,1953,"FC Sete","Olympique Marseille","2-1",2,1,"1",1,3,1,"H"
1953-12-20,1953,"Stade Reims","Girondins Bordeaux","1-2",1,2,"1",1,3,-1,"D"
1953-12-20,1953,"AS Nancy","Lille OSC","1-1",1,1,"1",1,2,0,"D"
1953-12-20,1953,"Toulouse FC","FC Sete","2-0",2,0,"1",1,2,2,"H"
1953-12-20,1953,"Nimes Olympique","AS Saint-Etienne","1-0",1,0,"1",1,1,1,"H"
1953-12-20,1953,"OGC Nice","Le Havre AC","4-0",4,0,"1",1,4,4,"H"
1953-12-20,1953,"RC Lens","RC Strasbourg","3-1",3,1,"1",1,4,2,"H"
1953-12-20,1953,"Olympique Marseille","FC Metz","1-1",1,1,"1",1,2,0,"D"
1953-12-20,1953,"Stade Francais FC","AS Monaco","0-4",0,4,"1",1,4,-4,"D"
1953-12-20,1953,"RC Roubaix","FC Sochaux","1-1",1,1,"1",1,2,0,"D"
1953-12-27,1953,"Stade Reims","FC Sete","2-0",2,0,"1",1,2,2,"H"
1953-12-27,1953,"FC Metz","Girondins Bordeaux","2-2",2,2,"1",1,4,0,"D"
1953-12-27,1953,"OGC Nice","Toulouse FC","0-2",0,2,"1",1,2,-2,"D"
1953-12-27,1953,"FC Sochaux","Lille OSC","2-2",2,2,"1",1,4,0,"D"
1953-12-27,1953,"RC Strasbourg","AS Saint-Etienne","2-1",2,1,"1",1,3,1,"H"
1953-12-27,1953,"RC Roubaix","Nimes Olympique","4-2",4,2,"1",1,6,2,"H"
1953-12-27,1953,"RC Lens","Stade Francais FC","1-2",1,2,"1",1,3,-1,"D"
1953-12-27,1953,"Le Havre AC","AS Monaco","1-2",1,2,"1",1,3,-1,"D"
1953-12-27,1953,"Olympique Marseille","AS Nancy","0-1",0,1,"1",1,1,-1,"D"
1954-01-03,1953,"Girondins Bordeaux","FC Sochaux","7-1",7,1,"1",1,8,6,"H"
1954-01-03,1953,"Stade Reims","FC Metz","3-1",3,1,"1",1,4,2,"H"
1954-01-03,1953,"Lille OSC","RC Strasbourg","3-0",3,0,"1",1,3,3,"H"
1954-01-03,1953,"Toulouse FC","AS Monaco","1-1",1,1,"1",1,2,0,"D"
1954-01-03,1953,"OGC Nice","RC Lens","6-1",6,1,"1",1,7,5,"H"
1954-01-03,1953,"AS Saint-Etienne","Le Havre AC","0-1",0,1,"1",1,1,-1,"D"
1954-01-03,1953,"Nimes Olympique","Olympique Marseille","2-1",2,1,"1",1,3,1,"H"
1954-01-03,1953,"AS Nancy","FC Sete","3-1",3,1,"1",1,4,2,"H"
1954-01-03,1953,"Stade Francais FC","RC Roubaix","1-1",1,1,"1",1,2,0,"D"
1954-01-10,1953,"RC Strasbourg","Girondins Bordeaux","1-2",1,2,"1",1,3,-1,"D"
1954-01-10,1953,"FC Sochaux","Stade Reims","1-3",1,3,"1",1,4,-2,"D"
1954-01-10,1953,"Le Havre AC","Lille OSC","1-1",1,1,"1",1,2,0,"D"
1954-01-10,1953,"Toulouse FC","RC Lens","1-1",1,1,"1",1,2,0,"D"
1954-01-10,1953,"AS Monaco","AS Saint-Etienne","1-1",1,1,"1",1,2,0,"D"
1954-01-10,1953,"RC Roubaix","OGC Nice","3-2",3,2,"1",1,5,1,"H"
1954-01-10,1953,"FC Sete","Nimes Olympique","2-1",2,1,"1",1,3,1,"H"
1954-01-10,1953,"FC Metz","AS Nancy","2-4",2,4,"1",1,6,-2,"D"
1954-01-10,1953,"Olympique Marseille","Stade Francais FC","3-1",3,1,"1",1,4,2,"H"
1954-01-24,1953,"Stade Francais FC","Girondins Bordeaux","0-1",0,1,"1",1,1,-1,"D"
1954-01-24,1953,"Nimes Olympique","Stade Reims","1-1",1,1,"1",1,2,0,"D"
1954-01-24,1953,"OGC Nice","Lille OSC","3-0",3,0,"1",1,3,3,"H"
1954-01-24,1953,"AS Nancy","Toulouse FC","4-2",4,2,"1",1,6,2,"H"
1954-01-24,1953,"RC Lens","AS Saint-Etienne","2-0",2,0,"1",1,2,2,"H"
1954-01-24,1953,"FC Sete","RC Strasbourg","0-0",0,0,"1",1,0,0,"D"
1954-01-24,1953,"RC Roubaix","AS Monaco","2-0",2,0,"1",1,2,2,"H"
1954-01-24,1953,"Olympique Marseille","Le Havre AC","5-1",5,1,"1",1,6,4,"H"
1954-01-24,1953,"FC Sochaux","FC Metz","3-0",3,0,"1",1,3,3,"H"
1954-01-31,1953,"Girondins Bordeaux","OGC Nice","4-1",4,1,"1",1,5,3,"H"
1954-01-31,1953,"Stade Reims","Stade Francais FC","1-3",1,3,"1",1,4,-2,"D"
1954-01-31,1953,"Lille OSC","RC Lens","1-0",1,0,"1",1,1,1,"H"
1954-01-31,1953,"Toulouse FC","FC Sochaux","2-2",2,2,"1",1,4,0,"D"
1954-01-31,1953,"AS Saint-Etienne","RC Roubaix","2-1",2,1,"1",1,3,1,"H"
1954-01-31,1953,"RC Strasbourg","FC Metz","2-2",2,2,"1",1,4,0,"D"
1954-01-31,1953,"AS Nancy","Nimes Olympique","4-2",4,2,"1",1,6,2,"H"
1954-01-31,1953,"AS Monaco","Olympique Marseille","1-1",1,1,"1",1,2,0,"D"
1954-01-31,1953,"Le Havre AC","FC Sete","10-0",10,0,"1",1,10,10,"H"
1954-02-07,1953,"Girondins Bordeaux","FC Sete","1-0",1,0,"1",1,1,1,"H"
1954-02-07,1953,"Stade Reims","Olympique Marseille","6-0",6,0,"1",1,6,6,"H"
1954-02-07,1953,"Lille OSC","FC Metz","2-2",2,2,"1",1,4,0,"D"
1954-02-07,1953,"Stade Francais FC","OGC Nice","1-1",1,1,"1",1,2,0,"D"
1954-02-07,1953,"AS Saint-Etienne","FC Sochaux","2-4",2,4,"1",1,6,-2,"D"
1954-02-07,1953,"Nimes Olympique","RC Lens","3-1",3,1,"1",1,4,2,"H"
1954-02-07,1953,"AS Nancy","RC Roubaix","2-1",2,1,"1",1,3,1,"H"
1954-02-07,1953,"AS Monaco","RC Strasbourg","4-2",4,2,"1",1,6,2,"H"
1954-02-21,1953,"Olympique Marseille","Girondins Bordeaux","3-2",3,2,"1",1,5,1,"H"
1954-02-21,1953,"RC Roubaix","Stade Reims","2-2",2,2,"1",1,4,0,"D"
1954-02-21,1953,"FC Sete","Lille OSC","0-1",0,1,"1",1,1,-1,"D"
1954-02-21,1953,"Stade Francais FC","Toulouse FC","0-0",0,0,"1",1,0,0,"D"
1954-02-21,1953,"OGC Nice","Nimes Olympique","1-1",1,1,"1",1,2,0,"D"
1954-02-21,1953,"RC Strasbourg","Le Havre AC","4-0",4,0,"1",1,4,4,"H"
1954-02-21,1953,"FC Metz","AS Saint-Etienne","5-1",5,1,"1",1,6,4,"H"
1954-02-21,1953,"RC Lens","AS Nancy","3-2",3,2,"1",1,5,1,"H"
1954-02-21,1953,"FC Sochaux","AS Monaco","1-0",1,0,"1",1,1,1,"H"
1954-02-28,1953,"Girondins Bordeaux","RC Roubaix","5-0",5,0,"1",1,5,5,"H"
1954-02-28,1953,"Lille OSC","Olympique Marseille","4-0",4,0,"1",1,4,4,"H"
1954-02-28,1953,"Stade Reims","RC Lens","0-0",0,0,"1",1,0,0,"D"
1954-02-28,1953,"Toulouse FC","RC Strasbourg","3-1",3,1,"1",1,4,2,"H"
1954-02-28,1953,"AS Nancy","OGC Nice","1-5",1,5,"1",1,6,-4,"D"
1954-02-28,1953,"AS Saint-Etienne","FC Sete","6-3",6,3,"1",1,9,3,"H"
1954-02-28,1953,"Nimes Olympique","Stade Francais FC","1-0",1,0,"1",1,1,1,"H"
1954-02-28,1953,"AS Monaco","FC Metz","2-0",2,0,"1",1,2,2,"H"
1954-02-28,1953,"Le Havre AC","FC Sochaux","2-1",2,1,"1",1,3,1,"H"
1954-03-11,1953,"Girondins Bordeaux","Nimes Olympique","2-1",2,1,"1",1,3,1,"H"
1954-03-11,1953,"Stade Reims","AS Nancy","4-1",4,1,"1",1,5,3,"H"
1954-03-11,1953,"Lille OSC","Stade Francais FC","1-1",1,1,"1",1,2,0,"D"
1954-03-11,1953,"FC Metz","Toulouse FC","2-2",2,2,"1",1,4,0,"D"
1954-03-11,1953,"AS Saint-Etienne","OGC Nice","2-1",2,1,"1",1,3,1,"H"
1954-03-11,1953,"RC Strasbourg","Olympique Marseille","2-1",2,1,"1",1,3,1,"H"
1954-03-11,1953,"AS Monaco","RC Lens","0-1",0,1,"1",1,1,-1,"D"
1954-03-11,1953,"FC Sochaux","FC Sete","2-2",2,2,"1",1,4,0,"D"
1954-03-11,1953,"Le Havre AC","RC Roubaix","3-1",3,1,"1",1,4,2,"H"
1954-03-14,1953,"AS Monaco","Girondins Bordeaux","1-2",1,2,"1",1,3,-1,"D"
1954-03-14,1953,"Le Havre AC","Stade Reims","0-0",0,0,"1",1,0,0,"D"
1954-03-14,1953,"AS Saint-Etienne","Lille OSC","0-0",0,0,"1",1,0,0,"D"
1954-03-14,1953,"RC Roubaix","Toulouse FC","4-1",4,1,"1",1,5,3,"H"
1954-03-14,1953,"FC Sete","OGC Nice","1-1",1,1,"1",1,2,0,"D"
1954-03-14,1953,"RC Strasbourg","AS Nancy","1-2",1,2,"1",1,3,-1,"D"
1954-03-14,1953,"FC Sochaux","Nimes Olympique","2-1",2,1,"1",1,3,1,"H"
1954-03-14,1953,"Olympique Marseille","RC Lens","2-0",2,0,"1",1,2,2,"H"
1954-03-14,1953,"FC Metz","Stade Francais FC","1-0",1,0,"1",1,1,1,"H"
1954-03-21,1953,"Girondins Bordeaux","Le Havre AC","1-4",1,4,"1",1,5,-3,"D"
1954-03-21,1953,"Stade Reims","RC Strasbourg","2-2",2,2,"1",1,4,0,"D"
1954-03-21,1953,"Lille OSC","AS Monaco","0-0",0,0,"1",1,0,0,"D"
1954-03-21,1953,"Toulouse FC","AS Saint-Etienne","1-1",1,1,"1",1,2,0,"D"
1954-03-21,1953,"OGC Nice","Olympique Marseille","2-4",2,4,"1",1,6,-2,"D"
1954-03-21,1953,"Nimes Olympique","FC Metz","2-1",2,1,"1",1,3,1,"H"
1954-03-21,1953,"RC Lens","RC Roubaix","4-1",4,1,"1",1,5,3,"H"
1954-03-21,1953,"AS Nancy","FC Sochaux","2-3",2,3,"1",1,5,-1,"D"
1954-03-21,1953,"Stade Francais FC","FC Sete","2-2",2,2,"1",1,4,0,"D"
1954-03-25,1953,"Toulouse FC","Le Havre AC","5-1",5,1,"1",1,6,4,"H"
1954-04-04,1953,"AS Nancy","Girondins Bordeaux","2-2",2,2,"1",1,4,0,"D"
1954-04-04,1953,"Toulouse FC","Stade Reims","1-3",1,3,"1",1,4,-2,"D"
1954-04-04,1953,"Nimes Olympique","Lille OSC","1-1",1,1,"1",1,2,0,"D"
1954-04-04,1953,"Stade Francais FC","AS Saint-Etienne","1-2",1,2,"1",1,3,-1,"D"
1954-04-04,1953,"OGC Nice","AS Monaco","1-2",1,2,"1",1,3,-1,"D"
1954-04-04,1953,"RC Lens","Le Havre AC","3-1",3,1,"1",1,4,2,"H"
1954-04-04,1953,"RC Roubaix","RC Strasbourg","0-0",0,0,"1",1,0,0,"D"
1954-04-04,1953,"Olympique Marseille","FC Sochaux","0-0",0,0,"1",1,0,0,"D"
1954-04-04,1953,"FC Sete","FC Metz","4-1",4,1,"1",1,5,3,"H"
1954-04-15,1953,"RC Lens","Girondins Bordeaux","1-1",1,1,"1",1,2,0,"D"
1954-04-15,1953,"OGC Nice","Stade Reims","1-1",1,1,"1",1,2,0,"D"
1954-04-15,1953,"RC Roubaix","Lille OSC","0-3",0,3,"1",1,3,-3,"D"
1954-04-15,1953,"Nimes Olympique","Toulouse FC","0-1",0,1,"1",1,1,-1,"D"
1954-04-15,1953,"Olympique Marseille","AS Saint-Etienne","3-1",3,1,"1",1,4,2,"H"
1954-04-15,1953,"FC Sochaux","RC Strasbourg","7-1",7,1,"1",1,8,6,"H"
1954-04-15,1953,"Stade Francais FC","AS Nancy","4-0",4,0,"1",1,4,4,"H"
1954-04-15,1953,"FC Sete","AS Monaco","1-1",1,1,"1",1,2,0,"D"
1954-04-15,1953,"FC Metz","Le Havre AC","2-1",2,1,"1",1,3,1,"H"
1954-04-18,1953,"AS Saint-Etienne","Stade Reims","0-1",0,1,"1",1,1,-1,"D"
1954-04-18,1953,"Lille OSC","Girondins Bordeaux","1-0",1,0,"1",1,1,1,"H"
1954-04-18,1953,"Olympique Marseille","Toulouse FC","0-1",0,1,"1",1,1,-1,"D"
1954-04-18,1953,"Le Havre AC","Nimes Olympique","0-1",0,1,"1",1,1,-1,"D"
1954-04-18,1953,"FC Metz","RC Lens","1-1",1,1,"1",1,2,0,"D"
1954-04-18,1953,"RC Strasbourg","Stade Francais FC","2-0",2,0,"1",1,2,2,"H"
1954-04-18,1953,"FC Sochaux","OGC Nice","4-1",4,1,"1",1,5,3,"H"
1954-04-18,1953,"AS Monaco","AS Nancy","2-0",2,0,"1",1,2,2,"H"
1954-04-18,1953,"FC Sete","RC Roubaix","4-0",4,0,"1",1,4,4,"H"
1954-05-02,1953,"Stade Reims","AS Monaco","2-1",2,1,"1",1,3,1,"H"
1954-05-02,1953,"Girondins Bordeaux","AS Saint-Etienne","1-0",1,0,"1",1,1,1,"H"
1954-05-02,1953,"Toulouse FC","Lille OSC","1-0",1,0,"1",1,1,1,"H"
1954-05-02,1953,"Nimes Olympique","RC Strasbourg","1-2",1,2,"1",1,3,-1,"D"
1954-05-02,1953,"RC Lens","FC Sete","2-2",2,2,"1",1,4,0,"D"
1954-05-02,1953,"OGC Nice","FC Metz","0-1",0,1,"1",1,1,-1,"D"
1954-05-02,1953,"Stade Francais FC","FC Sochaux","4-1",4,1,"1",1,5,3,"H"
1954-05-02,1953,"AS Nancy","Le Havre AC","3-0",3,0,"1",1,3,3,"H"
1954-05-02,1953,"RC Roubaix","Olympique Marseille","1-0",1,0,"1",1,1,1,"H"
1954-05-09,1953,"Stade Reims","Lille OSC","0-3",0,3,"1",1,3,-3,"D"
1954-05-09,1953,"Toulouse FC","Girondins Bordeaux","3-1",3,1,"1",1,4,2,"H"
1954-05-09,1953,"AS Nancy","AS Saint-Etienne","0-1",0,1,"1",1,1,-1,"D"
1954-05-09,1953,"RC Lens","FC Sochaux","2-0",2,0,"1",1,2,2,"H"
1954-05-09,1953,"OGC Nice","RC Strasbourg","4-3",4,3,"1",1,7,1,"H"
1954-05-09,1953,"Nimes Olympique","AS Monaco","1-3",1,3,"1",1,4,-2,"D"
1954-05-09,1953,"Olympique Marseille","FC Sete","2-0",2,0,"1",1,2,2,"H"
1954-05-09,1953,"RC Roubaix","FC Metz","3-0",3,0,"1",1,3,3,"H"
1954-05-09,1953,"Stade Francais FC","Le Havre AC","1-2",1,2,"1",1,3,-1,"D"
1954-05-16,1953,"Lille OSC","AS Nancy","3-0",3,0,"1",1,3,3,"H"
1954-05-16,1953,"Girondins Bordeaux","Stade Reims","0-0",0,0,"1",1,0,0,"D"
1954-05-16,1953,"FC Sete","Toulouse FC","1-1",1,1,"1",1,2,0,"D"
1954-05-16,1953,"AS Saint-Etienne","Nimes Olympique","2-1",2,1,"1",1,3,1,"H"
1954-05-16,1953,"RC Strasbourg","RC Lens","5-2",5,2,"1",1,7,3,"H"
1954-05-16,1953,"Le Havre AC","OGC Nice","2-2",2,2,"1",1,4,0,"D"
1954-05-16,1953,"AS Monaco","Stade Francais FC","1-4",1,4,"1",1,5,-3,"D"
1954-05-16,1953,"FC Sochaux","RC Roubaix","0-1",0,1,"1",1,1,-1,"D"
1954-05-16,1953,"FC Metz","Olympique Marseille","3-2",3,2,"1",1,5,1,"H"
1954-08-22,1954,"Lille OSC","Racing Club de France","6-0",6,0,"1",1,6,6,"H"
1954-08-22,1954,"Stade Reims","AS Monaco","3-1",3,1,"1",1,4,2,"H"
1954-08-22,1954,"Girondins Bordeaux","RC Lens","2-1",2,1,"1",1,3,1,"H"
1954-08-22,1954,"AS Saint-Etienne","Nimes Olympique","4-2",4,2,"1",1,6,2,"H"
1954-08-22,1954,"OGC Nice","Olympique Lyon","7-3",7,3,"1",1,10,4,"H"
1954-08-22,1954,"AS Nancy","RC Strasbourg","1-5",1,5,"1",1,6,-4,"D"
1954-08-22,1954,"Olympique Marseille","FC Sochaux","3-0",3,0,"1",1,3,3,"H"
1954-08-22,1954,"AS Troyes-Savinienne","FC Metz","0-1",0,1,"1",1,1,-1,"D"
1954-08-22,1954,"Toulouse FC","RC Roubaix","6-2",6,2,"1",1,8,4,"H"
1954-08-28,1954,"Racing Club de France","Olympique Marseille","3-3",3,3,"1",1,6,0,"D"
1954-08-29,1954,"RC Strasbourg","AS Troyes-Savinienne","4-0",4,0,"1",1,4,4,"H"
1954-08-29,1954,"Nimes Olympique","Lille OSC","0-1",0,1,"1",1,1,-1,"D"
1954-08-29,1954,"AS Saint-Etienne","AS Nancy","2-0",2,0,"1",1,2,2,"H"
1954-08-29,1954,"FC Metz","Girondins Bordeaux","1-0",1,0,"1",1,1,1,"H"
1954-08-29,1954,"AS Monaco","Toulouse FC","1-1",1,1,"1",1,2,0,"D"
1954-08-29,1954,"RC Lens","Stade Reims","0-0",0,0,"1",1,0,0,"D"
1954-08-29,1954,"FC Sochaux","Olympique Lyon","2-0",2,0,"1",1,2,2,"H"
1954-08-29,1954,"RC Roubaix","OGC Nice","4-2",4,2,"1",1,6,2,"H"
1954-09-04,1954,"AS Nancy","Nimes Olympique","3-1",3,1,"1",1,4,2,"H"
1954-09-05,1954,"Lille OSC","AS Monaco","3-1",3,1,"1",1,4,2,"H"
1954-09-05,1954,"Stade Reims","AS Saint-Etienne","2-4",2,4,"1",1,6,-2,"D"
1954-09-05,1954,"OGC Nice","FC Metz","2-3",2,3,"1",1,5,-1,"D"
1954-09-05,1954,"Toulouse FC","RC Strasbourg","4-1",4,1,"1",1,5,3,"H"
1954-09-05,1954,"Girondins Bordeaux","FC Sochaux","1-2",1,2,"1",1,3,-1,"D"
1954-09-05,1954,"Olympique Lyon","RC Lens","1-1",1,1,"1",1,2,0,"D"
1954-09-05,1954,"AS Troyes-Savinienne","Racing Club de France","3-1",3,1,"1",1,4,2,"H"
1954-09-05,1954,"Olympique Marseille","RC Roubaix","5-2",5,2,"1",1,7,3,"H"
1954-09-09,1954,"Olympique Marseille","AS Saint-Etienne","4-0",4,0,"1",1,4,4,"H"
1954-09-09,1954,"Toulouse FC","AS Nancy","3-1",3,1,"1",1,4,2,"H"
1954-09-09,1954,"Lille OSC","RC Lens","3-3",3,3,"1",1,6,0,"D"
1954-09-09,1954,"FC Sochaux","Racing Club de France","3-2",3,2,"1",1,5,1,"H"
1954-09-09,1954,"Olympique Lyon","RC Strasbourg","2-1",2,1,"1",1,3,1,"H"
1954-09-09,1954,"OGC Nice","Nimes Olympique","1-0",1,0,"1",1,1,1,"H"
1954-09-09,1954,"Girondins Bordeaux","AS Monaco","4-1",4,1,"1",1,5,3,"H"
1954-09-09,1954,"AS Troyes-Savinienne","Stade Reims","2-2",2,2,"1",1,4,0,"D"
1954-09-09,1954,"FC Metz","RC Roubaix","0-0",0,0,"1",1,0,0,"D"
1954-09-12,1954,"AS Monaco","Olympique Marseille","1-2",1,2,"1",1,3,-1,"D"
1954-09-12,1954,"AS Saint-Etienne","Toulouse FC","2-3",2,3,"1",1,5,-1,"D"
1954-09-12,1954,"FC Metz","FC Sochaux","1-0",1,0,"1",1,1,1,"H"
1954-09-12,1954,"Stade Reims","Lille OSC","4-2",4,2,"1",1,6,2,"H"
1954-09-12,1954,"RC Strasbourg","OGC Nice","7-1",7,1,"1",1,8,6,"H"
1954-09-12,1954,"Racing Club de France","Girondins Bordeaux","2-0",2,0,"1",1,2,2,"H"
1954-09-12,1954,"RC Lens","AS Nancy","1-1",1,1,"1",1,2,0,"D"
1954-09-12,1954,"Nimes Olympique","AS Troyes-Savinienne","1-0",1,0,"1",1,1,1,"H"
1954-09-12,1954,"RC Roubaix","Olympique Lyon","2-1",2,1,"1",1,3,1,"H"
1954-09-19,1954,"Olympique Marseille","RC Strasbourg","2-0",2,0,"1",1,2,2,"H"
1954-09-19,1954,"Toulouse FC","Nimes Olympique","2-0",2,0,"1",1,2,2,"H"
1954-09-19,1954,"Olympique Lyon","FC Metz","4-2",4,2,"1",1,6,2,"H"
1954-09-19,1954,"AS Nancy","Stade Reims","2-4",2,4,"1",1,6,-2,"D"
1954-09-19,1954,"Lille OSC","AS Saint-Etienne","0-1",0,1,"1",1,1,-1,"D"
1954-09-19,1954,"FC Sochaux","RC Lens","1-1",1,1,"1",1,2,0,"D"
1954-09-19,1954,"OGC Nice","Racing Club de France","3-2",3,2,"1",1,5,1,"H"
1954-09-19,1954,"AS Troyes-Savinienne","AS Monaco","1-1",1,1,"1",1,2,0,"D"
1954-09-19,1954,"Girondins Bordeaux","RC Roubaix","5-1",5,1,"1",1,6,4,"H"
1954-09-26,1954,"FC Metz","Toulouse FC","1-5",1,5,"1",1,6,-4,"D"
1954-09-26,1954,"Olympique Lyon","Olympique Marseille","3-0",3,0,"1",1,3,3,"H"
1954-09-26,1954,"RC Strasbourg","Stade Reims","1-1",1,1,"1",1,2,0,"D"
1954-09-26,1954,"Girondins Bordeaux","OGC Nice","7-2",7,2,"1",1,9,5,"H"
1954-09-26,1954,"AS Monaco","AS Saint-Etienne","2-0",2,0,"1",1,2,2,"H"
1954-09-26,1954,"FC Sochaux","AS Troyes-Savinienne","0-0",0,0,"1",1,0,0,"D"
1954-09-26,1954,"RC Lens","Nimes Olympique","3-1",3,1,"1",1,4,2,"H"
1954-09-26,1954,"Racing Club de France","AS Nancy","0-0",0,0,"1",1,0,0,"D"
1954-09-26,1954,"RC Roubaix","Lille OSC","3-1",3,1,"1",1,4,2,"H"
1954-09-30,1954,"Stade Reims","Toulouse FC","2-1",2,1,"1",1,3,1,"H"
1954-09-30,1954,"Nimes Olympique","Olympique Marseille","2-2",2,2,"1",1,4,0,"D"
1954-09-30,1954,"RC Lens","FC Metz","2-3",2,3,"1",1,5,-1,"D"
1954-09-30,1954,"RC Strasbourg","Girondins Bordeaux","1-1",1,1,"1",1,2,0,"D"
1954-09-30,1954,"AS Saint-Etienne","AS Troyes-Savinienne","0-2",0,2,"1",1,2,-2,"D"
1954-09-30,1954,"AS Nancy","Lille OSC","1-0",1,0,"1",1,1,1,"H"
1954-09-30,1954,"Racing Club de France","Olympique Lyon","5-0",5,0,"1",1,5,5,"H"
1954-09-30,1954,"AS Monaco","OGC Nice","1-1",1,1,"1",1,2,0,"D"
1954-09-30,1954,"RC Roubaix","FC Sochaux","2-0",2,0,"1",1,2,2,"H"
1954-10-03,1954,"Toulouse FC","FC Sochaux","2-1",2,1,"1",1,3,1,"H"
1954-10-03,1954,"Olympique Marseille","Girondins Bordeaux","3-1",3,1,"1",1,4,2,"H"
1954-10-03,1954,"Stade Reims","Racing Club de France","0-3",0,3,"1",1,3,-3,"D"
1954-10-03,1954,"Lille OSC","FC Metz","4-2",4,2,"1",1,6,2,"H"
1954-10-03,1954,"AS Saint-Etienne","RC Strasbourg","5-1",5,1,"1",1,6,4,"H"
1954-10-03,1954,"OGC Nice","RC Lens","1-2",1,2,"1",1,3,-1,"D"
1954-10-03,1954,"AS Troyes-Savinienne","Olympique Lyon","2-2",2,2,"1",1,4,0,"D"
1954-10-03,1954,"Nimes Olympique","AS Monaco","2-0",2,0,"1",1,2,2,"H"
1954-10-03,1954,"AS Nancy","RC Roubaix","4-0",4,0,"1",1,4,4,"H"
1954-10-10,1954,"Toulouse FC","Lille OSC","2-1",2,1,"1",1,3,1,"H"
1954-10-10,1954,"Olympique Marseille","Stade Reims","1-3",1,3,"1",1,4,-2,"D"
1954-10-10,1954,"Girondins Bordeaux","Nimes Olympique","3-1",3,1,"1",1,4,2,"H"
1954-10-10,1954,"FC Metz","Racing Club de France","1-4",1,4,"1",1,5,-3,"D"
1954-10-10,1954,"FC Sochaux","RC Strasbourg","1-2",1,2,"1",1,3,-1,"D"
1954-10-10,1954,"OGC Nice","AS Saint-Etienne","2-0",2,0,"1",1,2,2,"H"
1954-10-10,1954,"AS Troyes-Savinienne","AS Nancy","2-1",2,1,"1",1,3,1,"H"
1954-10-10,1954,"Olympique Lyon","AS Monaco","0-2",0,2,"1",1,2,-2,"D"
1954-10-10,1954,"RC Roubaix","RC Lens","2-2",2,2,"1",1,4,0,"D"
1954-10-24,1954,"Racing Club de France","Toulouse FC","2-0",2,0,"1",1,2,2,"H"
1954-10-24,1954,"Nimes Olympique","Stade Reims","0-2",0,2,"1",1,2,-2,"D"
1954-10-24,1954,"FC Metz","Olympique Marseille","2-1",2,1,"1",1,3,1,"H"
1954-10-24,1954,"RC Strasbourg","Lille OSC","2-1",2,1,"1",1,3,1,"H"
1954-10-24,1954,"RC Lens","AS Saint-Etienne","2-1",2,1,"1",1,3,1,"H"
1954-10-24,1954,"Olympique Lyon","Girondins Bordeaux","3-1",3,1,"1",1,4,2,"H"
1954-10-24,1954,"FC Sochaux","OGC Nice","4-1",4,1,"1",1,5,3,"H"
1954-10-24,1954,"AS Monaco","AS Nancy","0-2",0,2,"1",1,2,-2,"D"
1954-10-24,1954,"RC Roubaix","AS Troyes-Savinienne","1-6",1,6,"1",1,7,-5,"D"
1954-10-31,1954,"Toulouse FC","Girondins Bordeaux","1-1",1,1,"1",1,2,0,"D"
1954-10-31,1954,"Stade Reims","FC Metz","6-0",6,0,"1",1,6,6,"H"
1954-10-31,1954,"Olympique Marseille","RC Lens","4-0",4,0,"1",1,4,4,"H"
1954-10-31,1954,"Nimes Olympique","Racing Club de France","2-0",2,0,"1",1,2,2,"H"
1954-10-31,1954,"AS Troyes-Savinienne","OGC Nice","3-4",3,4,"1",1,7,-1,"D"
1954-10-31,1954,"AS Monaco","RC Strasbourg","4-0",4,0,"1",1,4,4,"H"
1954-10-31,1954,"Lille OSC","Olympique Lyon","3-1",3,1,"1",1,4,2,"H"
1954-10-31,1954,"AS Nancy","FC Sochaux","2-2",2,2,"1",1,4,0,"D"
1954-10-31,1954,"AS Saint-Etienne","RC Roubaix","5-1",5,1,"1",1,6,4,"H"
1954-11-07,1954,"Olympique Lyon","Toulouse FC","3-2",3,2,"1",1,5,1,"H"
1954-11-07,1954,"OGC Nice","Olympique Marseille","0-0",0,0,"1",1,0,0,"D"
1954-11-07,1954,"Girondins Bordeaux","AS Troyes-Savinienne","3-1",3,1,"1",1,4,2,"H"
1954-11-07,1954,"Racing Club de France","AS Saint-Etienne","4-0",4,0,"1",1,4,4,"H"
1954-11-07,1954,"RC Strasbourg","Nimes Olympique","3-2",3,2,"1",1,5,1,"H"
1954-11-07,1954,"RC Lens","AS Monaco","2-0",2,0,"1",1,2,2,"H"
1954-11-07,1954,"FC Metz","AS Nancy","0-0",0,0,"1",1,0,0,"D"
1954-11-07,1954,"FC Sochaux","Lille OSC","1-2",1,2,"1",1,3,-1,"D"
1954-11-07,1954,"RC Roubaix","Stade Reims","2-1",2,1,"1",1,3,1,"H"
1954-11-14,1954,"Toulouse FC","Olympique Marseille","1-0",1,0,"1",1,1,1,"H"
1954-11-14,1954,"Stade Reims","Olympique Lyon","3-1",3,1,"1",1,4,2,"H"
1954-11-14,1954,"RC Strasbourg","Racing Club de France","3-1",3,1,"1",1,4,2,"H"
1954-11-14,1954,"AS Nancy","Girondins Bordeaux","1-1",1,1,"1",1,2,0,"D"
1954-11-14,1954,"AS Troyes-Savinienne","RC Lens","2-1",2,1,"1",1,3,1,"H"
1954-11-14,1954,"AS Saint-Etienne","FC Sochaux","3-1",3,1,"1",1,4,2,"H"
1954-11-14,1954,"Lille OSC","OGC Nice","1-3",1,3,"1",1,4,-2,"D"
1954-11-14,1954,"Nimes Olympique","FC Metz","2-0",2,0,"1",1,2,2,"H"
1954-11-14,1954,"AS Monaco","RC Roubaix","1-0",1,0,"1",1,1,1,"H"
1954-11-21,1954,"OGC Nice","Toulouse FC","5-0",5,0,"1",1,5,5,"H"
1954-11-21,1954,"Olympique Marseille","AS Troyes-Savinienne","3-0",3,0,"1",1,3,3,"H"
1954-11-21,1954,"FC Sochaux","Stade Reims","4-1",4,1,"1",1,5,3,"H"
1954-11-21,1954,"Girondins Bordeaux","Lille OSC","4-2",4,2,"1",1,6,2,"H"
1954-11-21,1954,"RC Lens","RC Strasbourg","2-1",2,1,"1",1,3,1,"H"
1954-11-21,1954,"FC Metz","AS Saint-Etienne","0-2",0,2,"1",1,2,-2,"D"
1954-11-21,1954,"Racing Club de France","AS Monaco","1-2",1,2,"1",1,3,-1,"D"
1954-11-21,1954,"Olympique Lyon","AS Nancy","2-1",2,1,"1",1,3,1,"H"
1954-11-21,1954,"RC Roubaix","Nimes Olympique","1-5",1,5,"1",1,6,-4,"D"
1954-11-28,1954,"Stade Reims","Girondins Bordeaux","3-0",3,0,"1",1,3,3,"H"
1954-11-28,1954,"Toulouse FC","AS Troyes-Savinienne","1-1",1,1,"1",1,2,0,"D"
1954-11-28,1954,"Lille OSC","Olympique Marseille","2-1",2,1,"1",1,3,1,"H"
1954-11-28,1954,"RC Strasbourg","RC Roubaix","3-0",3,0,"1",1,3,3,"H"
1954-11-28,1954,"AS Saint-Etienne","Olympique Lyon","4-2",4,2,"1",1,6,2,"H"
1954-11-28,1954,"Racing Club de France","RC Lens","1-1",1,1,"1",1,2,0,"D"
1954-11-28,1954,"AS Nancy","OGC Nice","4-1",4,1,"1",1,5,3,"H"
1954-11-28,1954,"Nimes Olympique","FC Sochaux","2-1",2,1,"1",1,3,1,"H"
1954-11-28,1954,"AS Monaco","FC Metz","5-0",5,0,"1",1,5,5,"H"
1954-12-05,1954,"OGC Nice","Stade Reims","3-3",3,3,"1",1,6,0,"D"
1954-12-05,1954,"RC Lens","Toulouse FC","1-1",1,1,"1",1,2,0,"D"
1954-12-05,1954,"Olympique Marseille","AS Nancy","2-2",2,2,"1",1,4,0,"D"
1954-12-05,1954,"Girondins Bordeaux","AS Saint-Etienne","2-1",2,1,"1",1,3,1,"H"
1954-12-05,1954,"FC Metz","RC Strasbourg","3-3",3,3,"1",1,6,0,"D"
1954-12-05,1954,"AS Troyes-Savinienne","Lille OSC","1-0",1,0,"1",1,1,1,"H"
1954-12-05,1954,"RC Roubaix","Racing Club de France","3-3",3,3,"1",1,6,0,"D"
1954-12-05,1954,"FC Sochaux","AS Monaco","5-2",5,2,"1",1,7,3,"H"
1954-12-05,1954,"Olympique Lyon","Nimes Olympique","2-2",2,2,"1",1,4,0,"D"
1954-12-12,1954,"AS Monaco","Stade Reims","1-2",1,2,"1",1,3,-1,"D"
1954-12-12,1954,"RC Roubaix","Toulouse FC","2-2",2,2,"1",1,4,0,"D"
1954-12-12,1954,"RC Strasbourg","AS Nancy","4-0",4,0,"1",1,4,4,"H"
1954-12-12,1954,"RC Lens","Girondins Bordeaux","1-3",1,3,"1",1,4,-2,"D"
1954-12-12,1954,"FC Sochaux","Olympique Marseille","4-0",4,0,"1",1,4,4,"H"
1954-12-12,1954,"Olympique Lyon","OGC Nice","3-4",3,4,"1",1,7,-1,"D"
1954-12-12,1954,"Nimes Olympique","AS Saint-Etienne","1-0",1,0,"1",1,1,1,"H"
1954-12-12,1954,"Racing Club de France","Lille OSC","1-3",1,3,"1",1,4,-2,"D"
1954-12-12,1954,"FC Metz","AS Troyes-Savinienne","4-2",4,2,"1",1,6,2,"H"
1954-12-19,1954,"Stade Reims","RC Lens","4-2",4,2,"1",1,6,2,"H"
1954-12-19,1954,"Toulouse FC","AS Monaco","3-2",3,2,"1",1,5,1,"H"
1954-12-19,1954,"Girondins Bordeaux","FC Metz","2-0",2,0,"1",1,2,2,"H"
1954-12-19,1954,"Olympique Marseille","Racing Club de France","3-1",3,1,"1",1,4,2,"H"
1954-12-19,1954,"AS Troyes-Savinienne","RC Strasbourg","2-1",2,1,"1",1,3,1,"H"
1954-12-19,1954,"OGC Nice","RC Roubaix","5-2",5,2,"1",1,7,3,"H"
1954-12-19,1954,"Lille OSC","Nimes Olympique","6-1",6,1,"1",1,7,5,"H"
1954-12-19,1954,"AS Nancy","AS Saint-Etienne","2-1",2,1,"1",1,3,1,"H"
1954-12-19,1954,"Olympique Lyon","FC Sochaux","3-2",3,2,"1",1,5,1,"H"
1954-12-26,1954,"AS Saint-Etienne","Stade Reims","0-2",0,2,"1",1,2,-2,"D"
1954-12-26,1954,"RC Strasbourg","Toulouse FC","2-0",2,0,"1",1,2,2,"H"
1954-12-26,1954,"FC Sochaux","Girondins Bordeaux","3-2",3,2,"1",1,5,1,"H"
1954-12-26,1954,"RC Roubaix","Olympique Marseille","1-1",1,1,"1",1,2,0,"D"
1954-12-26,1954,"FC Metz","OGC Nice","4-0",4,0,"1",1,4,4,"H"
1954-12-26,1954,"AS Monaco","Lille OSC","1-1",1,1,"1",1,2,0,"D"
1954-12-26,1954,"RC Lens","Olympique Lyon","1-0",1,0,"1",1,1,1,"H"
1954-12-26,1954,"Racing Club de France","AS Troyes-Savinienne","4-1",4,1,"1",1,5,3,"H"
1954-12-26,1954,"Nimes Olympique","AS Nancy","1-0",1,0,"1",1,1,1,"H"
1955-01-02,1954,"Stade Reims","AS Troyes-Savinienne","3-0",3,0,"1",1,3,3,"H"
1955-01-02,1954,"AS Nancy","Toulouse FC","0-1",0,1,"1",1,1,-1,"D"
1955-01-02,1954,"RC Strasbourg","Olympique Lyon","1-1",1,1,"1",1,2,0,"D"
1955-01-02,1954,"AS Monaco","Girondins Bordeaux","1-0",1,0,"1",1,1,1,"H"
1955-01-02,1954,"RC Lens","Lille OSC","2-1",2,1,"1",1,3,1,"H"
1955-01-02,1954,"AS Saint-Etienne","Olympique Marseille","3-0",3,0,"1",1,3,3,"H"
1955-01-02,1954,"Racing Club de France","FC Sochaux","0-3",0,3,"1",1,3,-3,"D"
1955-01-02,1954,"Nimes Olympique","OGC Nice","6-2",6,2,"1",1,8,4,"H"
1955-01-02,1954,"RC Roubaix","FC Metz","0-2",0,2,"1",1,2,-2,"D"
1955-01-09,1954,"Lille OSC","Stade Reims","3-2",3,2,"1",1,5,1,"H"
1955-01-09,1954,"Toulouse FC","AS Saint-Etienne","2-0",2,0,"1",1,2,2,"H"
1955-01-09,1954,"Olympique Marseille","AS Monaco","1-1",1,1,"1",1,2,0,"D"
1955-01-09,1954,"OGC Nice","RC Strasbourg","2-1",2,1,"1",1,3,1,"H"
1955-01-09,1954,"Girondins Bordeaux","Racing Club de France","0-0",0,0,"1",1,0,0,"D"
1955-01-09,1954,"FC Sochaux","FC Metz","1-0",1,0,"1",1,1,1,"H"
1955-01-09,1954,"AS Troyes-Savinienne","Nimes Olympique","0-0",0,0,"1",1,0,0,"D"
1955-01-09,1954,"Olympique Lyon","RC Roubaix","4-2",4,2,"1",1,6,2,"H"
1955-01-16,1954,"Stade Reims","AS Nancy","5-2",5,2,"1",1,7,3,"H"
1955-01-16,1954,"Nimes Olympique","Toulouse FC","0-0",0,0,"1",1,0,0,"D"
1955-01-16,1954,"RC Strasbourg","Olympique Marseille","4-1",4,1,"1",1,5,3,"H"
1955-01-16,1954,"RC Roubaix","Girondins Bordeaux","3-0",3,0,"1",1,3,3,"H"
1955-01-16,1954,"RC Lens","FC Sochaux","6-2",6,2,"1",1,8,4,"H"
1955-01-16,1954,"AS Saint-Etienne","Lille OSC","2-2",2,2,"1",1,4,0,"D"
1955-01-16,1954,"Racing Club de France","OGC Nice","3-1",3,1,"1",1,4,2,"H"
1955-01-16,1954,"AS Monaco","AS Troyes-Savinienne","1-2",1,2,"1",1,3,-1,"D"
1955-01-20,1954,"AS Nancy","RC Lens","1-3",1,3,"1",1,4,-2,"D"
1955-01-23,1954,"Girondins Bordeaux","RC Strasbourg","0-1",0,1,"1",1,1,-1,"D"
1955-01-23,1954,"FC Metz","RC Lens","1-1",1,1,"1",1,2,0,"D"
1955-01-23,1954,"FC Sochaux","RC Roubaix","5-0",5,0,"1",1,5,5,"H"
1955-01-23,1954,"Olympique Marseille","Nimes Olympique","0-1",0,1,"1",1,1,-1,"D"
1955-01-23,1954,"OGC Nice","AS Monaco","1-1",1,1,"1",1,2,0,"D"
1955-01-23,1954,"Lille OSC","AS Nancy","2-5",2,5,"1",1,7,-3,"D"
1955-01-23,1954,"Olympique Lyon","Racing Club de France","2-2",2,2,"1",1,4,0,"D"
1955-01-30,1954,"Stade Reims","RC Strasbourg","1-2",1,2,"1",1,3,-1,"D"
1955-01-30,1954,"Toulouse FC","FC Metz","6-2",6,2,"1",1,8,4,"H"
1955-01-30,1954,"Nimes Olympique","RC Lens","1-0",1,0,"1",1,1,1,"H"
1955-01-30,1954,"Olympique Marseille","Olympique Lyon","1-0",1,0,"1",1,1,1,"H"
1955-01-30,1954,"Lille OSC","RC Roubaix","4-0",4,0,"1",1,4,4,"H"
1955-01-30,1954,"AS Troyes-Savinienne","FC Sochaux","2-0",2,0,"1",1,2,2,"H"
1955-01-30,1954,"OGC Nice","Girondins Bordeaux","1-1",1,1,"1",1,2,0,"D"
1955-01-30,1954,"AS Nancy","Racing Club de France","1-0",1,0,"1",1,1,1,"H"
1955-01-30,1954,"AS Saint-Etienne","AS Monaco","0-0",0,0,"1",1,0,0,"D"
1955-02-03,1954,"Toulouse FC","Stade Reims","1-1",1,1,"1",1,2,0,"D"
1955-02-13,1954,"Racing Club de France","Stade Reims","2-5",2,5,"1",1,7,-3,"D"
1955-02-13,1954,"FC Sochaux","Toulouse FC","1-0",1,0,"1",1,1,1,"H"
1955-02-13,1954,"RC Strasbourg","AS Saint-Etienne","5-0",5,0,"1",1,5,5,"H"
1955-02-13,1954,"RC Lens","OGC Nice","2-2",2,2,"1",1,4,0,"D"
1955-02-13,1954,"Girondins Bordeaux","Olympique Marseille","2-1",2,1,"1",1,3,1,"H"
1955-02-13,1954,"FC Metz","Lille OSC","0-0",0,0,"1",1,0,0,"D"
1955-02-13,1954,"AS Monaco","Nimes Olympique","1-0",1,0,"1",1,1,1,"H"
1955-02-13,1954,"Olympique Lyon","AS Troyes-Savinienne","1-0",1,0,"1",1,1,1,"H"
1955-02-13,1954,"RC Roubaix","AS Nancy","2-1",2,1,"1",1,3,1,"H"
1955-02-17,1954,"FC Metz","Olympique Lyon","1-2",1,2,"1",1,3,-1,"D"
1955-02-20,1954,"Stade Reims","Olympique Marseille","2-0",2,0,"1",1,2,2,"H"
1955-02-20,1954,"Lille OSC","Toulouse FC","1-1",1,1,"1",1,2,0,"D"
1955-02-20,1954,"RC Strasbourg","FC Sochaux","2-5",2,5,"1",1,7,-3,"D"
1955-02-20,1954,"RC Lens","RC Roubaix","4-3",4,3,"1",1,7,1,"H"
1955-02-20,1954,"Nimes Olympique","Girondins Bordeaux","2-0",2,0,"1",1,2,2,"H"
1955-02-20,1954,"AS Monaco","Olympique Lyon","0-0",0,0,"1",1,0,0,"D"
1955-02-20,1954,"AS Saint-Etienne","OGC Nice","4-2",4,2,"1",1,6,2,"H"
1955-02-20,1954,"Racing Club de France","FC Metz","4-0",4,0,"1",1,4,4,"H"
1955-02-20,1954,"AS Nancy","AS Troyes-Savinienne","4-1",4,1,"1",1,5,3,"H"
1955-02-27,1954,"Stade Reims","Nimes Olympique","4-1",4,1,"1",1,5,3,"H"
1955-02-27,1954,"Toulouse FC","Racing Club de France","0-1",0,1,"1",1,1,-1,"D"
1955-02-27,1954,"Lille OSC","RC Strasbourg","0-0",0,0,"1",1,0,0,"D"
1955-02-27,1954,"AS Saint-Etienne","RC Lens","1-1",1,1,"1",1,2,0,"D"
1955-02-27,1954,"OGC Nice","FC Sochaux","4-0",4,0,"1",1,4,4,"H"
1955-02-27,1954,"Girondins Bordeaux","Olympique Lyon","3-1",3,1,"1",1,4,2,"H"
1955-02-27,1954,"Olympique Marseille","FC Metz","1-1",1,1,"1",1,2,0,"D"
1955-02-27,1954,"AS Nancy","AS Monaco","0-0",0,0,"1",1,0,0,"D"
1955-02-27,1954,"AS Troyes-Savinienne","RC Roubaix","2-5",2,5,"1",1,7,-3,"D"
1955-03-03,1954,"AS Troyes-Savinienne","AS Saint-Etienne","0-3",0,3,"1",1,3,-3,"D"
1955-03-13,1954,"FC Metz","Stade Reims","1-0",1,0,"1",1,1,1,"H"
1955-03-13,1954,"RC Strasbourg","AS Monaco","5-0",5,0,"1",1,5,5,"H"
1955-03-13,1954,"RC Lens","Olympique Marseille","1-0",1,0,"1",1,1,1,"H"
1955-03-13,1954,"FC Sochaux","AS Nancy","3-2",3,2,"1",1,5,1,"H"
1955-03-13,1954,"OGC Nice","AS Troyes-Savinienne","5-1",5,1,"1",1,6,4,"H"
1955-03-13,1954,"RC Roubaix","AS Saint-Etienne","1-4",1,4,"1",1,5,-3,"D"
1955-03-13,1954,"Olympique Lyon","Lille OSC","2-1",2,1,"1",1,3,1,"H"
1955-03-13,1954,"Racing Club de France","Nimes Olympique","1-0",1,0,"1",1,1,1,"H"
1955-03-20,1954,"Stade Reims","RC Roubaix","0-2",0,2,"1",1,2,-2,"D"
1955-03-20,1954,"Toulouse FC","Olympique Lyon","1-0",1,0,"1",1,1,1,"H"
1955-03-20,1954,"Nimes Olympique","RC Strasbourg","2-1",2,1,"1",1,3,1,"H"
1955-03-20,1954,"AS Monaco","RC Lens","6-0",6,0,"1",1,6,6,"H"
1955-03-20,1954,"Lille OSC","FC Sochaux","0-0",0,0,"1",1,0,0,"D"
1955-03-20,1954,"AS Troyes-Savinienne","Girondins Bordeaux","1-3",1,3,"1",1,4,-2,"D"
1955-03-20,1954,"AS Saint-Etienne","Racing Club de France","0-1",0,1,"1",1,1,-1,"D"
1955-03-20,1954,"Olympique Marseille","OGC Nice","2-0",2,0,"1",1,2,2,"H"
1955-03-20,1954,"AS Nancy","FC Metz","7-0",7,0,"1",1,7,7,"H"
1955-04-03,1954,"Girondins Bordeaux","Toulouse FC","1-1",1,1,"1",1,2,0,"D"
1955-04-10,1954,"Olympique Lyon","Stade Reims","1-1",1,1,"1",1,2,0,"D"
1955-04-10,1954,"Olympique Marseille","Toulouse FC","4-0",4,0,"1",1,4,4,"H"
1955-04-10,1954,"Racing Club de France","RC Strasbourg","4-2",4,2,"1",1,6,2,"H"
1955-04-10,1954,"RC Lens","AS Troyes-Savinienne","2-0",2,0,"1",1,2,2,"H"
1955-04-10,1954,"FC Sochaux","AS Saint-Etienne","0-0",0,0,"1",1,0,0,"D"
1955-04-10,1954,"Girondins Bordeaux","AS Nancy","2-3",2,3,"1",1,5,-1,"D"
1955-04-10,1954,"OGC Nice","Lille OSC","2-1",2,1,"1",1,3,1,"H"
1955-04-10,1954,"FC Metz","Nimes Olympique","1-0",1,0,"1",1,1,1,"H"
1955-04-10,1954,"RC Roubaix","AS Monaco","0-1",0,1,"1",1,1,-1,"D"
1955-04-24,1954,"Stade Reims","FC Sochaux","3-1",3,1,"1",1,4,2,"H"
1955-04-24,1954,"RC Strasbourg","RC Lens","2-2",2,2,"1",1,4,0,"D"
1955-04-24,1954,"Lille OSC","Girondins Bordeaux","2-2",2,2,"1",1,4,0,"D"
1955-04-24,1954,"AS Monaco","Racing Club de France","1-1",1,1,"1",1,2,0,"D"
1955-04-24,1954,"AS Saint-Etienne","FC Metz","2-0",2,0,"1",1,2,2,"H"
1955-04-24,1954,"Nimes Olympique","RC Roubaix","3-0",3,0,"1",1,3,3,"H"
1955-04-24,1954,"AS Troyes-Savinienne","Olympique Marseille","4-2",4,2,"1",1,6,2,"H"
1955-04-24,1954,"AS Nancy","Olympique Lyon","0-1",0,1,"1",1,1,-1,"D"
1955-05-01,1954,"Girondins Bordeaux","Stade Reims","5-0",5,0,"1",1,5,5,"H"
1955-05-01,1954,"RC Lens","Racing Club de France","3-1",3,1,"1",1,4,2,"H"
1955-05-01,1954,"AS Troyes-Savinienne","Toulouse FC","2-1",2,1,"1",1,3,1,"H"
1955-05-01,1954,"RC Roubaix","RC Strasbourg","1-0",1,0,"1",1,1,1,"H"
1955-05-01,1954,"FC Sochaux","Nimes Olympique","6-2",6,2,"1",1,8,4,"H"
1955-05-01,1954,"Olympique Marseille","Lille OSC","5-1",5,1,"1",1,6,4,"H"
1955-05-01,1954,"Olympique Lyon","AS Saint-Etienne","1-1",1,1,"1",1,2,0,"D"
1955-05-01,1954,"OGC Nice","AS Nancy","2-2",2,2,"1",1,4,0,"D"
1955-05-01,1954,"FC Metz","AS Monaco","2-1",2,1,"1",1,3,1,"H"
1955-05-19,1954,"Toulouse FC","OGC Nice","1-1",1,1,"1",1,2,0,"D"
1955-05-21,1954,"AS Monaco","FC Sochaux","0-0",0,0,"1",1,0,0,"D"
1955-05-22,1954,"Stade Reims","OGC Nice","3-2",3,2,"1",1,5,1,"H"
1955-05-22,1954,"Toulouse FC","RC Lens","2-0",2,0,"1",1,2,2,"H"
1955-05-22,1954,"RC Strasbourg","FC Metz","3-3",3,3,"1",1,6,0,"D"
1955-05-22,1954,"Lille OSC","AS Troyes-Savinienne","1-2",1,2,"1",1,3,-1,"D"
1955-05-22,1954,"AS Saint-Etienne","Girondins Bordeaux","3-1",3,1,"1",1,4,2,"H"
1955-05-22,1954,"Racing Club de France","RC Roubaix","2-2",2,2,"1",1,4,0,"D"
1955-05-22,1954,"AS Nancy","Olympique Marseille","3-0",3,0,"1",1,3,3,"H"
1955-05-22,1954,"Nimes Olympique","Olympique Lyon","2-2",2,2,"1",1,4,0,"D"
1955-08-21,1955,"Nimes Olympique","Racing Club de France","1-5",1,5,"1",1,6,-4,"D"
1955-08-21,1955,"AS Saint-Etienne","Stade Reims","3-1",3,1,"1",1,4,2,"H"
1955-08-21,1955,"FC Metz","FC Sochaux","3-1",3,1,"1",1,4,2,"H"
1955-08-21,1955,"AS Troyes-Savinienne","Toulouse FC","0-2",0,2,"1",1,2,-2,"D"
1955-08-21,1955,"Lille OSC","AS Monaco","2-0",2,0,"1",1,2,2,"H"
1955-08-21,1955,"OGC Nice","RC Strasbourg","2-1",2,1,"1",1,3,1,"H"
1955-08-21,1955,"Girondins Bordeaux","AS Nancy","3-3",3,3,"1",1,6,0,"D"
1955-08-21,1955,"Olympique Marseille","RC Lens","2-2",2,2,"1",1,4,0,"D"
1955-08-21,1955,"UA Sedan-Torcy","Olympique Lyon","2-2",2,2,"1",1,4,0,"D"
1955-08-28,1955,"Racing Club de France","Girondins Bordeaux","3-0",3,0,"1",1,3,3,"H"
1955-08-28,1955,"AS Monaco","AS Saint-Etienne","2-3",2,3,"1",1,5,-1,"D"
1955-08-28,1955,"Olympique Lyon","OGC Nice","2-4",2,4,"1",1,6,-2,"D"
1955-08-28,1955,"AS Nancy","FC Metz","1-2",1,2,"1",1,3,-1,"D"
1955-08-28,1955,"RC Lens","Nimes Olympique","3-1",3,1,"1",1,4,2,"H"
1955-08-28,1955,"Toulouse FC","UA Sedan-Torcy","1-1",1,1,"1",1,2,0,"D"
1955-08-28,1955,"FC Sochaux","AS Troyes-Savinienne","5-1",5,1,"1",1,6,4,"H"
1955-08-28,1955,"RC Strasbourg","Lille OSC","3-1",3,1,"1",1,4,2,"H"
1955-08-28,1955,"Stade Reims","Olympique Marseille","1-1",1,1,"1",1,2,0,"D"
1955-09-04,1955,"AS Saint-Etienne","AS Troyes-Savinienne","4-0",4,0,"1",1,4,4,"H"
1955-09-04,1955,"Stade Reims","OGC Nice","1-3",1,3,"1",1,4,-2,"D"
1955-09-04,1955,"RC Lens","RC Strasbourg","1-0",1,0,"1",1,1,1,"H"
1955-09-04,1955,"AS Nancy","Toulouse FC","1-2",1,2,"1",1,3,-1,"D"
1955-09-04,1955,"Olympique Marseille","FC Metz","4-0",4,0,"1",1,4,4,"H"
1955-09-04,1955,"AS Monaco","UA Sedan-Torcy","0-2",0,2,"1",1,2,-2,"D"
1955-09-04,1955,"FC Sochaux","Lille OSC","3-3",3,3,"1",1,6,0,"D"
1955-09-04,1955,"Nimes Olympique","Girondins Bordeaux","3-0",3,0,"1",1,3,3,"H"
1955-09-04,1955,"Racing Club de France","Olympique Lyon","1-2",1,2,"1",1,3,-1,"D"
1955-09-11,1955,"OGC Nice","RC Lens","5-2",5,2,"1",1,7,3,"H"
1955-09-11,1955,"RC Strasbourg","Racing Club de France","1-4",1,4,"1",1,5,-3,"D"
1955-09-11,1955,"FC Metz","AS Saint-Etienne","5-2",5,2,"1",1,7,3,"H"
1955-09-11,1955,"Toulouse FC","FC Sochaux","0-1",0,1,"1",1,1,-1,"D"
1955-09-11,1955,"UA Sedan-Torcy","Stade Reims","1-1",1,1,"1",1,2,0,"D"
1955-09-11,1955,"Lille OSC","Nimes Olympique","3-2",3,2,"1",1,5,1,"H"
1955-09-11,1955,"Olympique Lyon","AS Nancy","2-0",2,0,"1",1,2,2,"H"
1955-09-11,1955,"Girondins Bordeaux","Olympique Marseille","1-0",1,0,"1",1,1,1,"H"
1955-09-11,1955,"AS Troyes-Savinienne","AS Monaco","2-5",2,5,"1",1,7,-3,"D"
1955-09-18,1955,"OGC Nice","Lille OSC","7-1",7,1,"1",1,8,6,"H"
1955-09-18,1955,"Racing Club de France","Olympique Marseille","4-0",4,0,"1",1,4,4,"H"
1955-09-18,1955,"Toulouse FC","FC Metz","4-1",4,1,"1",1,5,3,"H"
1955-09-18,1955,"RC Lens","AS Saint-Etienne","2-2",2,2,"1",1,4,0,"D"
1955-09-18,1955,"Olympique Lyon","AS Troyes-Savinienne","3-0",3,0,"1",1,3,3,"H"
1955-09-18,1955,"FC Sochaux","Girondins Bordeaux","2-4",2,4,"1",1,6,-2,"D"
1955-09-18,1955,"RC Strasbourg","UA Sedan-Torcy","3-0",3,0,"1",1,3,3,"H"
1955-09-18,1955,"Stade Reims","AS Monaco","0-2",0,2,"1",1,2,-2,"D"
1955-09-18,1955,"AS Nancy","Nimes Olympique","3-1",3,1,"1",1,4,2,"H"
1955-09-25,1955,"UA Sedan-Torcy","OGC Nice","0-1",0,1,"1",1,1,-1,"D"
1955-09-25,1955,"Girondins Bordeaux","Toulouse FC","3-4",3,4,"1",1,7,-1,"D"
1955-09-25,1955,"AS Saint-Etienne","Racing Club de France","3-2",3,2,"1",1,5,1,"H"
1955-09-25,1955,"FC Metz","Olympique Lyon","1-1",1,1,"1",1,2,0,"D"
1955-09-25,1955,"FC Sochaux","Nimes Olympique","1-0",1,0,"1",1,1,1,"H"
1955-09-25,1955,"AS Monaco","RC Lens","5-2",5,2,"1",1,7,3,"H"
1955-09-25,1955,"Lille OSC","Stade Reims","2-2",2,2,"1",1,4,0,"D"
1955-09-25,1955,"Olympique Marseille","AS Nancy","1-2",1,2,"1",1,3,-1,"D"
1955-09-25,1955,"AS Troyes-Savinienne","RC Strasbourg","3-0",3,0,"1",1,3,3,"H"
1955-10-02,1955,"Nimes Olympique","OGC Nice","1-1",1,1,"1",1,2,0,"D"
1955-10-02,1955,"Racing Club de France","Lille OSC","2-1",2,1,"1",1,3,1,"H"
1955-10-02,1955,"AS Saint-Etienne","Olympique Lyon","0-1",0,1,"1",1,1,-1,"D"
1955-10-02,1955,"AS Monaco","Toulouse FC","1-0",1,0,"1",1,1,1,"H"
1955-10-02,1955,"FC Metz","AS Troyes-Savinienne","2-1",2,1,"1",1,3,1,"H"
1955-10-02,1955,"RC Lens","AS Nancy","3-2",3,2,"1",1,5,1,"H"
1955-10-02,1955,"Stade Reims","FC Sochaux","3-0",3,0,"1",1,3,3,"H"
1955-10-02,1955,"Girondins Bordeaux","UA Sedan-Torcy","2-1",2,1,"1",1,3,1,"H"
1955-10-02,1955,"Olympique Marseille","RC Strasbourg","3-1",3,1,"1",1,4,2,"H"
1955-10-12,1955,"AS Troyes-Savinienne","Girondins Bordeaux","1-1",1,1,"1",1,2,0,"D"
1955-10-13,1955,"OGC Nice","Olympique Marseille","1-2",1,2,"1",1,3,-1,"D"
1955-10-13,1955,"AS Nancy","Racing Club de France","2-3",2,3,"1",1,5,-1,"D"
1955-10-13,1955,"Olympique Lyon","AS Monaco","1-1",1,1,"1",1,2,0,"D"
1955-10-13,1955,"Toulouse FC","Stade Reims","0-2",0,2,"1",1,2,-2,"D"
1955-10-13,1955,"RC Strasbourg","AS Saint-Etienne","5-2",5,2,"1",1,7,3,"H"
1955-10-13,1955,"FC Sochaux","RC Lens","3-1",3,1,"1",1,4,2,"H"
1955-10-13,1955,"Lille OSC","FC Metz","4-1",4,1,"1",1,5,3,"H"
1955-10-13,1955,"UA Sedan-Torcy","Nimes Olympique","2-1",2,1,"1",1,3,1,"H"
1955-10-16,1955,"OGC Nice","Toulouse FC","1-0",1,0,"1",1,1,1,"H"
1955-10-16,1955,"FC Metz","Racing Club de France","1-3",1,3,"1",1,4,-2,"D"
1955-10-16,1955,"RC Strasbourg","Olympique Lyon","1-2",1,2,"1",1,3,-1,"D"
1955-10-16,1955,"Lille OSC","AS Saint-Etienne","0-2",0,2,"1",1,2,-2,"D"
1955-10-16,1955,"Olympique Marseille","AS Monaco","1-1",1,1,"1",1,2,0,"D"
1955-10-16,1955,"Girondins Bordeaux","RC Lens","1-2",1,2,"1",1,3,-1,"D"
1955-10-16,1955,"UA Sedan-Torcy","FC Sochaux","2-1",2,1,"1",1,3,1,"H"
1955-10-16,1955,"Nimes Olympique","Stade Reims","2-2",2,2,"1",1,4,0,"D"
1955-10-16,1955,"AS Troyes-Savinienne","AS Nancy","4-4",4,4,"1",1,8,0,"D"
1955-10-30,1955,"FC Sochaux","OGC Nice","0-0",0,0,"1",1,0,0,"D"
1955-10-30,1955,"Racing Club de France","AS Troyes-Savinienne","1-1",1,1,"1",1,2,0,"D"
1955-10-30,1955,"Olympique Lyon","Lille OSC","2-1",2,1,"1",1,3,1,"H"
1955-10-30,1955,"AS Saint-Etienne","Olympique Marseille","3-1",3,1,"1",1,4,2,"H"
1955-10-30,1955,"AS Monaco","Nimes Olympique","1-0",1,0,"1",1,1,1,"H"
1955-10-30,1955,"Toulouse FC","RC Strasbourg","4-4",4,4,"1",1,8,0,"D"
1955-10-30,1955,"Stade Reims","Girondins Bordeaux","3-0",3,0,"1",1,3,3,"H"
1955-10-30,1955,"AS Nancy","UA Sedan-Torcy","4-2",4,2,"1",1,6,2,"H"
1955-10-30,1955,"RC Lens","FC Metz","4-1",4,1,"1",1,5,3,"H"
1955-11-01,1955,"FC Metz","OGC Nice","2-0",2,0,"1",1,2,2,"H"
1955-11-01,1955,"Stade Reims","Racing Club de France","2-1",2,1,"1",1,3,1,"H"
1955-11-01,1955,"AS Saint-Etienne","FC Sochaux","0-0",0,0,"1",1,0,0,"D"
1955-11-01,1955,"RC Lens","Lille OSC","1-0",1,0,"1",1,1,1,"H"
1955-11-01,1955,"AS Monaco","AS Nancy","2-2",2,2,"1",1,4,0,"D"
1955-11-01,1955,"Olympique Marseille","Toulouse FC","3-0",3,0,"1",1,3,3,"H"
1955-11-01,1955,"Girondins Bordeaux","RC Strasbourg","3-0",3,0,"1",1,3,3,"H"
1955-11-01,1955,"AS Troyes-Savinienne","UA Sedan-Torcy","2-1",2,1,"1",1,3,1,"H"
1955-11-06,1955,"OGC Nice","Girondins Bordeaux","2-0",2,0,"1",1,2,2,"H"
1955-11-06,1955,"Olympique Lyon","Olympique Marseille","1-1",1,1,"1",1,2,0,"D"
1955-11-06,1955,"Racing Club de France","RC Lens","0-1",0,1,"1",1,1,-1,"D"
1955-11-06,1955,"Toulouse FC","AS Saint-Etienne","2-2",2,2,"1",1,4,0,"D"
1955-11-06,1955,"AS Nancy","Stade Reims","1-4",1,4,"1",1,5,-3,"D"
1955-11-06,1955,"FC Sochaux","AS Monaco","3-1",3,1,"1",1,4,2,"H"
1955-11-06,1955,"UA Sedan-Torcy","FC Metz","4-2",4,2,"1",1,6,2,"H"
1955-11-06,1955,"Lille OSC","AS Troyes-Savinienne","4-0",4,0,"1",1,4,4,"H"
1955-11-06,1955,"RC Strasbourg","Nimes Olympique","2-1",2,1,"1",1,3,1,"H"
1955-11-12,1955,"Girondins Bordeaux","FC Metz","2-1",2,1,"1",1,3,1,"H"
1955-11-13,1955,"AS Saint-Etienne","OGC Nice","3-3",3,3,"1",1,6,0,"D"
1955-11-13,1955,"RC Lens","Toulouse FC","1-0",1,0,"1",1,1,1,"H"
1955-11-13,1955,"Stade Reims","Olympique Lyon","3-0",3,0,"1",1,3,3,"H"
1955-11-13,1955,"Racing Club de France","FC Sochaux","2-5",2,5,"1",1,7,-3,"D"
1955-11-13,1955,"AS Monaco","RC Strasbourg","0-0",0,0,"1",1,0,0,"D"
1955-11-13,1955,"Olympique Marseille","UA Sedan-Torcy","2-2",2,2,"1",1,4,0,"D"
1955-11-13,1955,"AS Nancy","Lille OSC","3-1",3,1,"1",1,4,2,"H"
1955-11-13,1955,"Nimes Olympique","AS Troyes-Savinienne","5-2",5,2,"1",1,7,3,"H"
1955-11-20,1955,"Olympique Lyon","RC Lens","0-1",0,1,"1",1,1,-1,"D"
1955-11-20,1955,"AS Monaco","OGC Nice","4-2",4,2,"1",1,6,2,"H"
1955-11-20,1955,"RC Strasbourg","Stade Reims","0-1",0,1,"1",1,1,-1,"D"
1955-11-20,1955,"Toulouse FC","Racing Club de France","0-0",0,0,"1",1,0,0,"D"
1955-11-20,1955,"FC Sochaux","AS Nancy","0-0",0,0,"1",1,0,0,"D"
1955-11-20,1955,"UA Sedan-Torcy","AS Saint-Etienne","3-0",3,0,"1",1,3,3,"H"
1955-11-20,1955,"AS Troyes-Savinienne","Olympique Marseille","0-1",0,1,"1",1,1,-1,"D"
1955-11-20,1955,"Lille OSC","Girondins Bordeaux","2-1",2,1,"1",1,3,1,"H"
1955-11-20,1955,"FC Metz","Nimes Olympique","2-2",2,2,"1",1,4,0,"D"
1955-11-24,1955,"Nimes Olympique","Olympique Lyon","2-1",2,1,"1",1,3,1,"H"
1955-11-27,1955,"OGC Nice","AS Troyes-Savinienne","2-0",2,0,"1",1,2,2,"H"
1955-11-27,1955,"Stade Reims","RC Lens","3-0",3,0,"1",1,3,3,"H"
1955-11-27,1955,"Racing Club de France","AS Monaco","2-1",2,1,"1",1,3,1,"H"
1955-11-27,1955,"Olympique Marseille","FC Sochaux","1-0",1,0,"1",1,1,1,"H"
1955-11-27,1955,"AS Saint-Etienne","AS Nancy","1-1",1,1,"1",1,2,0,"D"
1955-11-27,1955,"Lille OSC","UA Sedan-Torcy","0-1",0,1,"1",1,1,-1,"D"
1955-11-27,1955,"Girondins Bordeaux","Olympique Lyon","2-0",2,0,"1",1,2,2,"H"
1955-11-27,1955,"FC Metz","RC Strasbourg","2-2",2,2,"1",1,4,0,"D"
1955-11-27,1955,"Nimes Olympique","Toulouse FC","2-1",2,1,"1",1,3,1,"H"
1955-12-04,1955,"Stade Reims","AS Troyes-Savinienne","2-1",2,1,"1",1,3,1,"H"
1955-12-04,1955,"RC Lens","UA Sedan-Torcy","4-0",4,0,"1",1,4,4,"H"
1955-12-04,1955,"Racing Club de France","OGC Nice","4-2",4,2,"1",1,6,2,"H"
1955-12-04,1955,"Olympique Marseille","Nimes Olympique","2-0",2,0,"1",1,2,2,"H"
1955-12-04,1955,"AS Saint-Etienne","Girondins Bordeaux","3-0",3,0,"1",1,3,3,"H"
1955-12-04,1955,"AS Monaco","FC Metz","4-0",4,0,"1",1,4,4,"H"
1955-12-04,1955,"FC Sochaux","Olympique Lyon","1-2",1,2,"1",1,3,-1,"D"
1955-12-04,1955,"AS Nancy","RC Strasbourg","3-1",3,1,"1",1,4,2,"H"
1955-12-04,1955,"Toulouse FC","Lille OSC","4-2",4,2,"1",1,6,2,"H"
1955-12-11,1955,"OGC Nice","AS Nancy","3-0",3,0,"1",1,3,3,"H"
1955-12-11,1955,"FC Metz","Stade Reims","1-1",1,1,"1",1,2,0,"D"
1955-12-11,1955,"AS Troyes-Savinienne","RC Lens","3-0",3,0,"1",1,3,3,"H"
1955-12-11,1955,"Lille OSC","Olympique Marseille","0-3",0,3,"1",1,3,-3,"D"
1955-12-11,1955,"UA Sedan-Torcy","Racing Club de France","3-0",3,0,"1",1,3,3,"H"
1955-12-11,1955,"Girondins Bordeaux","AS Monaco","0-2",0,2,"1",1,2,-2,"D"
1955-12-11,1955,"Nimes Olympique","AS Saint-Etienne","1-1",1,1,"1",1,2,0,"D"
1955-12-11,1955,"Olympique Lyon","Toulouse FC","2-2",2,2,"1",1,4,0,"D"
1955-12-11,1955,"RC Strasbourg","FC Sochaux","1-0",1,0,"1",1,1,1,"H"
1955-12-18,1955,"OGC Nice","AS Saint-Etienne","2-1",2,1,"1",1,3,1,"H"
1955-12-18,1955,"Olympique Lyon","Stade Reims","2-1",2,1,"1",1,3,1,"H"
1955-12-18,1955,"Toulouse FC","RC Lens","4-2",4,2,"1",1,6,2,"H"
1955-12-18,1955,"FC Sochaux","Racing Club de France","1-1",1,1,"1",1,2,0,"D"
1955-12-18,1955,"UA Sedan-Torcy","Olympique Marseille","2-1",2,1,"1",1,3,1,"H"
1955-12-18,1955,"RC Strasbourg","AS Monaco","2-1",2,1,"1",1,3,1,"H"
1955-12-18,1955,"Lille OSC","AS Nancy","1-2",1,2,"1",1,3,-1,"D"
1955-12-18,1955,"FC Metz","Girondins Bordeaux","1-1",1,1,"1",1,2,0,"D"
1955-12-18,1955,"AS Troyes-Savinienne","Nimes Olympique","4-2",4,2,"1",1,6,2,"H"
1956-01-01,1955,"Toulouse FC","OGC Nice","1-1",1,1,"1",1,2,0,"D"
1956-01-01,1955,"Stade Reims","Nimes Olympique","1-1",1,1,"1",1,2,0,"D"
1956-01-01,1955,"RC Lens","Girondins Bordeaux","2-0",2,0,"1",1,2,2,"H"
1956-01-01,1955,"Olympique Lyon","RC Strasbourg","2-0",2,0,"1",1,2,2,"H"
1956-01-01,1955,"AS Monaco","Olympique Marseille","3-0",3,0,"1",1,3,3,"H"
1956-01-01,1955,"AS Saint-Etienne","Lille OSC","4-1",4,1,"1",1,5,3,"H"
1956-01-01,1955,"FC Sochaux","UA Sedan-Torcy","0-2",0,2,"1",1,2,-2,"D"
1956-01-01,1955,"Racing Club de France","FC Metz","1-2",1,2,"1",1,3,-1,"D"
1956-01-01,1955,"AS Nancy","AS Troyes-Savinienne","1-0",1,0,"1",1,1,1,"H"
1956-01-15,1955,"OGC Nice","FC Sochaux","1-2",1,2,"1",1,3,-1,"D"
1956-01-15,1955,"Girondins Bordeaux","Stade Reims","2-3",2,3,"1",1,5,-1,"D"
1956-01-15,1955,"FC Metz","RC Lens","2-3",2,3,"1",1,5,-1,"D"
1956-01-15,1955,"UA Sedan-Torcy","AS Nancy","1-0",1,0,"1",1,1,1,"H"
1956-01-15,1955,"AS Troyes-Savinienne","Racing Club de France","0-2",0,2,"1",1,2,-2,"D"
1956-01-15,1955,"Olympique Marseille","AS Saint-Etienne","2-2",2,2,"1",1,4,0,"D"
1956-01-15,1955,"Lille OSC","Olympique Lyon","4-1",4,1,"1",1,5,3,"H"
1956-01-15,1955,"Nimes Olympique","AS Monaco","6-2",6,2,"1",1,8,4,"H"
1956-01-15,1955,"RC Strasbourg","Toulouse FC","1-2",1,2,"1",1,3,-1,"D"
1956-01-22,1955,"OGC Nice","Nimes Olympique","2-1",2,1,"1",1,3,1,"H"
1956-01-22,1955,"FC Sochaux","Stade Reims","4-3",4,3,"1",1,7,1,"H"
1956-01-22,1955,"AS Nancy","RC Lens","1-0",1,0,"1",1,1,1,"H"
1956-01-22,1955,"UA Sedan-Torcy","Girondins Bordeaux","1-1",1,1,"1",1,2,0,"D"
1956-01-22,1955,"Olympique Lyon","AS Saint-Etienne","2-1",2,1,"1",1,3,1,"H"
1956-01-22,1955,"Lille OSC","Racing Club de France","6-1",6,1,"1",1,7,5,"H"
1956-01-22,1955,"Toulouse FC","AS Monaco","3-1",3,1,"1",1,4,2,"H"
1956-01-22,1955,"RC Strasbourg","Olympique Marseille","5-0",5,0,"1",1,5,5,"H"
1956-01-22,1955,"AS Troyes-Savinienne","FC Metz","1-1",1,1,"1",1,2,0,"D"
1956-01-29,1955,"Olympique Marseille","OGC Nice","0-0",0,0,"1",1,0,0,"D"
1956-01-29,1955,"RC Lens","FC Sochaux","2-1",2,1,"1",1,3,1,"H"
1956-01-29,1955,"Stade Reims","Toulouse FC","0-1",0,1,"1",1,1,-1,"D"
1956-01-29,1955,"AS Saint-Etienne","RC Strasbourg","3-1",3,1,"1",1,4,2,"H"
1956-01-29,1955,"Nimes Olympique","UA Sedan-Torcy","6-2",6,2,"1",1,8,4,"H"
1956-01-29,1955,"AS Monaco","Olympique Lyon","2-1",2,1,"1",1,3,1,"H"
1956-01-29,1955,"Racing Club de France","AS Nancy","3-4",3,4,"1",1,7,-1,"D"
1956-01-29,1955,"FC Metz","Lille OSC","2-0",2,0,"1",1,2,2,"H"
1956-01-29,1955,"Girondins Bordeaux","AS Troyes-Savinienne","2-2",2,2,"1",1,4,0,"D"
1956-02-12,1955,"AS Troyes-Savinienne","OGC Nice","2-2",2,2,"1",1,4,0,"D"
1956-02-12,1955,"RC Lens","Stade Reims","4-1",4,1,"1",1,5,3,"H"
1956-02-12,1955,"Olympique Lyon","Girondins Bordeaux","5-2",5,2,"1",1,7,3,"H"
1956-02-12,1955,"AS Nancy","AS Saint-Etienne","2-2",2,2,"1",1,4,0,"D"
1956-02-12,1955,"UA Sedan-Torcy","Lille OSC","2-1",2,1,"1",1,3,1,"H"
1956-02-12,1955,"AS Monaco","Racing Club de France","0-0",0,0,"1",1,0,0,"D"
1956-02-12,1955,"Toulouse FC","Nimes Olympique","2-2",2,2,"1",1,4,0,"D"
1956-02-12,1955,"FC Sochaux","Olympique Marseille","3-1",3,1,"1",1,4,2,"H"
1956-02-12,1955,"RC Strasbourg","FC Metz","3-1",3,1,"1",1,4,2,"H"
1956-03-11,1955,"OGC Nice","UA Sedan-Torcy","3-2",3,2,"1",1,5,1,"H"
1956-03-11,1955,"RC Lens","AS Monaco","1-2",1,2,"1",1,3,-1,"D"
1956-03-11,1955,"Olympique Lyon","FC Metz","2-1",2,1,"1",1,3,1,"H"
1956-03-11,1955,"Stade Reims","Lille OSC","1-1",1,1,"1",1,2,0,"D"
1956-03-11,1955,"Toulouse FC","Girondins Bordeaux","2-1",2,1,"1",1,3,1,"H"
1956-03-11,1955,"Racing Club de France","AS Saint-Etienne","3-0",3,0,"1",1,3,3,"H"
1956-03-11,1955,"Nimes Olympique","FC Sochaux","1-0",1,0,"1",1,1,1,"H"
1956-03-11,1955,"RC Strasbourg","AS Troyes-Savinienne","2-1",2,1,"1",1,3,1,"H"
1956-03-11,1955,"AS Nancy","Olympique Marseille","0-0",0,0,"1",1,0,0,"D"
1956-03-18,1955,"Lille OSC","OGC Nice","2-1",2,1,"1",1,3,1,"H"
1956-03-18,1955,"AS Troyes-Savinienne","Olympique Lyon","1-3",1,3,"1",1,4,-2,"D"
1956-03-18,1955,"AS Saint-Etienne","RC Lens","0-0",0,0,"1",1,0,0,"D"
1956-03-18,1955,"AS Monaco","Stade Reims","2-1",2,1,"1",1,3,1,"H"
1956-03-18,1955,"Olympique Marseille","Racing Club de France","1-4",1,4,"1",1,5,-3,"D"
1956-03-18,1955,"FC Metz","Toulouse FC","1-0",1,0,"1",1,1,1,"H"
1956-03-18,1955,"UA Sedan-Torcy","RC Strasbourg","5-2",5,2,"1",1,7,3,"H"
1956-03-18,1955,"Girondins Bordeaux","FC Sochaux","0-1",0,1,"1",1,1,-1,"D"
1956-03-18,1955,"Nimes Olympique","AS Nancy","6-1",6,1,"1",1,7,5,"H"
1956-04-02,1955,"OGC Nice","Olympique Lyon","2-0",2,0,"1",1,2,2,"H"
1956-04-02,1955,"Nimes Olympique","RC Lens","3-1",3,1,"1",1,4,2,"H"
1956-04-02,1955,"Girondins Bordeaux","Racing Club de France","1-4",1,4,"1",1,5,-3,"D"
1956-04-02,1955,"AS Saint-Etienne","AS Monaco","1-0",1,0,"1",1,1,1,"H"
1956-04-02,1955,"UA Sedan-Torcy","Toulouse FC","1-1",1,1,"1",1,2,0,"D"
1956-04-02,1955,"Olympique Marseille","Stade Reims","1-0",1,0,"1",1,1,1,"H"
1956-04-02,1955,"AS Troyes-Savinienne","FC Sochaux","1-1",1,1,"1",1,2,0,"D"
1956-04-02,1955,"FC Metz","AS Nancy","2-0",2,0,"1",1,2,2,"H"
1956-04-02,1955,"Lille OSC","RC Strasbourg","4-0",4,0,"1",1,4,4,"H"
1956-04-15,1955,"RC Strasbourg","OGC Nice","1-0",1,0,"1",1,1,1,"H"
1956-04-15,1955,"RC Lens","Olympique Marseille","4-0",4,0,"1",1,4,4,"H"
1956-04-15,1955,"Racing Club de France","Nimes Olympique","3-2",3,2,"1",1,5,1,"H"
1956-04-15,1955,"Olympique Lyon","UA Sedan-Torcy","0-0",0,0,"1",1,0,0,"D"
1956-04-15,1955,"AS Monaco","Lille OSC","2-0",2,0,"1",1,2,2,"H"
1956-04-15,1955,"Stade Reims","AS Saint-Etienne","1-2",1,2,"1",1,3,-1,"D"
1956-04-15,1955,"Toulouse FC","AS Troyes-Savinienne","2-1",2,1,"1",1,3,1,"H"
1956-04-15,1955,"AS Nancy","Girondins Bordeaux","1-0",1,0,"1",1,1,1,"H"
1956-04-15,1955,"FC Sochaux","FC Metz","0-1",0,1,"1",1,1,-1,"D"
1956-04-22,1955,"OGC Nice","AS Monaco","1-1",1,1,"1",1,2,0,"D"
1956-04-22,1955,"RC Lens","Olympique Lyon","1-0",1,0,"1",1,1,1,"H"
1956-04-22,1955,"Racing Club de France","Toulouse FC","3-0",3,0,"1",1,3,3,"H"
1956-04-22,1955,"AS Saint-Etienne","UA Sedan-Torcy","3-2",3,2,"1",1,5,1,"H"
1956-04-22,1955,"Stade Reims","RC Strasbourg","6-2",6,2,"1",1,8,4,"H"
1956-04-22,1955,"AS Nancy","FC Sochaux","0-1",0,1,"1",1,1,-1,"D"
1956-04-22,1955,"Olympique Marseille","AS Troyes-Savinienne","3-0",3,0,"1",1,3,3,"H"
1956-04-22,1955,"Nimes Olympique","FC Metz","0-0",0,0,"1",1,0,0,"D"
1956-04-22,1955,"Girondins Bordeaux","Lille OSC","2-1",2,1,"1",1,3,1,"H"
1956-04-29,1955,"OGC Nice","Stade Reims","1-0",1,0,"1",1,1,1,"H"
1956-04-29,1955,"RC Strasbourg","RC Lens","1-0",1,0,"1",1,1,1,"H"
1956-04-29,1955,"Olympique Lyon","Racing Club de France","3-1",3,1,"1",1,4,2,"H"
1956-04-29,1955,"AS Troyes-Savinienne","AS Saint-Etienne","1-1",1,1,"1",1,2,0,"D"
1956-04-29,1955,"UA Sedan-Torcy","AS Monaco","2-1",2,1,"1",1,3,1,"H"
1956-04-29,1955,"Toulouse FC","AS Nancy","1-0",1,0,"1",1,1,1,"H"
1956-04-29,1955,"Lille OSC","FC Sochaux","1-2",1,2,"1",1,3,-1,"D"
1956-04-29,1955,"FC Metz","Olympique Marseille","2-3",2,3,"1",1,5,-1,"D"
1956-04-29,1955,"Girondins Bordeaux","Nimes Olympique","2-1",2,1,"1",1,3,1,"H"
1956-05-01,1955,"OGC Nice","Racing Club de France","2-0",2,0,"1",1,2,2,"H"
1956-05-01,1955,"Olympique Lyon","FC Sochaux","3-1",3,1,"1",1,4,2,"H"
1956-05-01,1955,"UA Sedan-Torcy","RC Lens","1-0",1,0,"1",1,1,1,"H"
1956-05-01,1955,"FC Metz","AS Monaco","1-2",1,2,"1",1,3,-1,"D"
1956-05-01,1955,"Girondins Bordeaux","AS Saint-Etienne","4-3",4,3,"1",1,7,1,"H"
1956-05-01,1955,"Lille OSC","Toulouse FC","1-2",1,2,"1",1,3,-1,"D"
1956-05-01,1955,"AS Troyes-Savinienne","Stade Reims","2-3",2,3,"1",1,5,-1,"D"
1956-05-01,1955,"Nimes Olympique","Olympique Marseille","1-1",1,1,"1",1,2,0,"D"
1956-05-01,1955,"RC Strasbourg","AS Nancy","4-0",4,0,"1",1,4,4,"H"
1956-05-10,1955,"RC Lens","OGC Nice","4-0",4,0,"1",1,4,4,"H"
1956-05-10,1955,"AS Saint-Etienne","FC Metz","5-0",5,0,"1",1,5,5,"H"
1956-05-10,1955,"AS Nancy","Olympique Lyon","2-0",2,0,"1",1,2,2,"H"
1956-05-10,1955,"Stade Reims","UA Sedan-Torcy","1-1",1,1,"1",1,2,0,"D"
1956-05-10,1955,"Racing Club de France","RC Strasbourg","2-2",2,2,"1",1,4,0,"D"
1956-05-10,1955,"AS Monaco","AS Troyes-Savinienne","1-1",1,1,"1",1,2,0,"D"
1956-05-10,1955,"FC Sochaux","Toulouse FC","0-0",0,0,"1",1,0,0,"D"
1956-05-10,1955,"Olympique Marseille","Girondins Bordeaux","3-0",3,0,"1",1,3,3,"H"
1956-05-10,1955,"Nimes Olympique","Lille OSC","2-0",2,0,"1",1,2,2,"H"
1956-05-13,1955,"OGC Nice","FC Metz","1-0",1,0,"1",1,1,1,"H"
1956-05-13,1955,"FC Sochaux","AS Saint-Etienne","2-3",2,3,"1",1,5,-1,"D"
1956-05-13,1955,"Lille OSC","RC Lens","1-1",1,1,"1",1,2,0,"D"
1956-05-13,1955,"Racing Club de France","Stade Reims","2-1",2,1,"1",1,3,1,"H"
1956-05-13,1955,"AS Nancy","AS Monaco","1-3",1,3,"1",1,4,-2,"D"
1956-05-13,1955,"Olympique Lyon","Nimes Olympique","0-0",0,0,"1",1,0,0,"D"
1956-05-13,1955,"UA Sedan-Torcy","AS Troyes-Savinienne","1-3",1,3,"1",1,4,-2,"D"
1956-05-13,1955,"Toulouse FC","Olympique Marseille","2-3",2,3,"1",1,5,-1,"D"
1956-05-13,1955,"RC Strasbourg","Girondins Bordeaux","1-1",1,1,"1",1,2,0,"D"
1956-05-20,1955,"Girondins Bordeaux","OGC Nice","1-2",1,2,"1",1,3,-1,"D"
1956-05-20,1955,"RC Lens","Racing Club de France","7-3",7,3,"1",1,10,4,"H"
1956-05-20,1955,"AS Monaco","FC Sochaux","4-0",4,0,"1",1,4,4,"H"
1956-05-20,1955,"AS Saint-Etienne","Toulouse FC","0-0",0,0,"1",1,0,0,"D"
1956-05-20,1955,"Olympique Marseille","Olympique Lyon","5-1",5,1,"1",1,6,4,"H"
1956-05-20,1955,"FC Metz","UA Sedan-Torcy","3-1",3,1,"1",1,4,2,"H"
1956-05-20,1955,"Stade Reims","AS Nancy","1-2",1,2,"1",1,3,-1,"D"
1956-05-20,1955,"Nimes Olympique","RC Strasbourg","4-0",4,0,"1",1,4,4,"H"
1956-05-20,1955,"AS Troyes-Savinienne","Lille OSC","1-6",1,6,"1",1,7,-5,"D"
1956-06-03,1955,"AS Nancy","OGC Nice","2-0",2,0,"1",1,2,2,"H"
1956-06-03,1955,"RC Lens","AS Troyes-Savinienne","3-1",3,1,"1",1,4,2,"H"
1956-06-03,1955,"AS Monaco","Girondins Bordeaux","4-2",4,2,"1",1,6,2,"H"
1956-06-03,1955,"AS Saint-Etienne","Nimes Olympique","3-1",3,1,"1",1,4,2,"H"
1956-06-03,1955,"Racing Club de France","UA Sedan-Torcy","4-0",4,0,"1",1,4,4,"H"
1956-06-03,1955,"Olympique Marseille","Lille OSC","2-1",2,1,"1",1,3,1,"H"
1956-06-03,1955,"Toulouse FC","Olympique Lyon","2-1",2,1,"1",1,3,1,"H"
1956-06-03,1955,"Stade Reims","FC Metz","5-2",5,2,"1",1,7,3,"H"
1956-06-03,1955,"FC Sochaux","RC Strasbourg","2-2",2,2,"1",1,4,0,"D"
1956-08-19,1956,"FC Metz","RC Lens","1-5",1,5,"1",1,6,-4,"D"
1956-08-19,1956,"FC Sochaux","Stade Reims","2-0",2,0,"1",1,2,2,"H"
1956-08-19,1956,"RC Strasbourg","Stade Rennes","2-0",2,0,"1",1,2,2,"H"
1956-08-19,1956,"Olympique Marseille","AS Monaco","2-0",2,0,"1",1,2,2,"H"
1956-08-19,1956,"Toulouse FC","Racing Club de France","3-3",3,3,"1",1,6,0,"D"
1956-08-19,1956,"OGC Nice","AS Saint-Etienne","2-2",2,2,"1",1,4,0,"D"
1956-08-19,1956,"Angers SCO","Nimes Olympique","1-1",1,1,"1",1,2,0,"D"
1956-08-19,1956,"Olympique Lyon","UA Sedan-Torcy","1-1",1,1,"1",1,2,0,"D"
1956-08-19,1956,"US Valenciennes-Anzin","AS Nancy","0-0",0,0,"1",1,0,0,"D"
1956-08-26,1956,"RC Lens","RC Strasbourg","0-2",0,2,"1",1,2,-2,"D"
1956-08-26,1956,"Racing Club de France","Angers SCO","6-2",6,2,"1",1,8,4,"H"
1956-08-26,1956,"AS Saint-Etienne","Olympique Marseille","6-3",6,3,"1",1,9,3,"H"
1956-08-26,1956,"Nimes Olympique","Toulouse FC","0-1",0,1,"1",1,1,-1,"D"
1956-08-26,1956,"UA Sedan-Torcy","FC Sochaux","1-0",1,0,"1",1,1,1,"H"
1956-08-26,1956,"Stade Rennes","US Valenciennes-Anzin","3-0",3,0,"1",1,3,3,"H"
1956-08-26,1956,"Stade Reims","OGC Nice","3-1",3,1,"1",1,4,2,"H"
1956-08-26,1956,"AS Nancy","Olympique Lyon","2-2",2,2,"1",1,4,0,"D"
1956-08-26,1956,"AS Monaco","FC Metz","2-1",2,1,"1",1,3,1,"H"
1956-09-02,1956,"AS Saint-Etienne","RC Lens","3-1",3,1,"1",1,4,2,"H"
1956-09-02,1956,"Toulouse FC","UA Sedan-Torcy","2-3",2,3,"1",1,5,-1,"D"
1956-09-02,1956,"FC Metz","Racing Club de France","2-2",2,2,"1",1,4,0,"D"
1956-09-02,1956,"Stade Reims","AS Monaco","5-1",5,1,"1",1,6,4,"H"
1956-09-02,1956,"US Valenciennes-Anzin","Olympique Lyon","1-2",1,2,"1",1,3,-1,"D"
1956-09-02,1956,"Olympique Marseille","Stade Rennes","1-0",1,0,"1",1,1,1,"H"
1956-09-02,1956,"RC Strasbourg","Nimes Olympique","0-4",0,4,"1",1,4,-4,"D"
1956-09-02,1956,"OGC Nice","FC Sochaux","4-2",4,2,"1",1,6,2,"H"
1956-09-02,1956,"Angers SCO","AS Nancy","3-0",3,0,"1",1,3,3,"H"
1956-09-09,1956,"AS Nancy","AS Saint-Etienne","1-7",1,7,"1",1,8,-6,"D"
1956-09-09,1956,"Olympique Lyon","Stade Reims","0-3",0,3,"1",1,3,-3,"D"
1956-09-09,1956,"RC Strasbourg","US Valenciennes-Anzin","6-0",6,0,"1",1,6,6,"H"
1956-09-09,1956,"UA Sedan-Torcy","Olympique Marseille","1-1",1,1,"1",1,2,0,"D"
1956-09-09,1956,"Nimes Olympique","AS Monaco","3-1",3,1,"1",1,4,2,"H"
1956-09-09,1956,"Stade Rennes","Racing Club de France","2-2",2,2,"1",1,4,0,"D"
1956-09-09,1956,"RC Lens","OGC Nice","6-1",6,1,"1",1,7,5,"H"
1956-09-09,1956,"FC Sochaux","Angers SCO","0-0",0,0,"1",1,0,0,"D"
1956-09-09,1956,"Toulouse FC","FC Metz","1-2",1,2,"1",1,3,-1,"D"
1956-09-16,1956,"UA Sedan-Torcy","AS Saint-Etienne","2-6",2,6,"1",1,8,-4,"D"
1956-09-16,1956,"Stade Reims","Nimes Olympique","2-0",2,0,"1",1,2,2,"H"
1956-09-16,1956,"Racing Club de France","RC Lens","5-0",5,0,"1",1,5,5,"H"
1956-09-16,1956,"Olympique Marseille","OGC Nice","3-1",3,1,"1",1,4,2,"H"
1956-09-16,1956,"Olympique Lyon","RC Strasbourg","3-1",3,1,"1",1,4,2,"H"
1956-09-16,1956,"Angers SCO","Stade Rennes","2-0",2,0,"1",1,2,2,"H"
1956-09-16,1956,"FC Metz","FC Sochaux","1-3",1,3,"1",1,4,-2,"D"
1956-09-16,1956,"AS Monaco","AS Nancy","0-2",0,2,"1",1,2,-2,"D"
1956-09-16,1956,"US Valenciennes-Anzin","Toulouse FC","1-0",1,0,"1",1,1,1,"H"
1956-09-23,1956,"AS Saint-Etienne","FC Metz","2-0",2,0,"1",1,2,2,"H"
1956-09-23,1956,"UA Sedan-Torcy","Stade Reims","0-4",0,4,"1",1,4,-4,"D"
1956-09-23,1956,"OGC Nice","Racing Club de France","1-1",1,1,"1",1,2,0,"D"
1956-09-23,1956,"US Valenciennes-Anzin","Olympique Marseille","2-2",2,2,"1",1,4,0,"D"
1956-09-23,1956,"Angers SCO","Olympique Lyon","0-2",0,2,"1",1,2,-2,"D"
1956-09-23,1956,"AS Nancy","RC Strasbourg","3-3",3,3,"1",1,6,0,"D"
1956-09-23,1956,"Nimes Olympique","Stade Rennes","2-1",2,1,"1",1,3,1,"H"
1956-09-23,1956,"FC Sochaux","RC Lens","2-2",2,2,"1",1,4,0,"D"
1956-09-23,1956,"Toulouse FC","AS Monaco","3-0",3,0,"1",1,3,3,"H"
1956-09-30,1956,"Stade Reims","AS Saint-Etienne","4-5",4,5,"1",1,9,-1,"D"
1956-09-30,1956,"Racing Club de France","AS Nancy","6-1",6,1,"1",1,7,5,"H"
1956-09-30,1956,"Olympique Lyon","Nimes Olympique","4-1",4,1,"1",1,5,3,"H"
1956-09-30,1956,"RC Strasbourg","Toulouse FC","0-0",0,0,"1",1,0,0,"D"
1956-09-30,1956,"Olympique Marseille","FC Sochaux","2-3",2,3,"1",1,5,-1,"D"
1956-09-30,1956,"FC Metz","Angers SCO","0-1",0,1,"1",1,1,-1,"D"
1956-09-30,1956,"Stade Rennes","OGC Nice","2-3",2,3,"1",1,5,-1,"D"
1956-09-30,1956,"AS Monaco","US Valenciennes-Anzin","6-0",6,0,"1",1,6,6,"H"
1956-10-14,1956,"AS Saint-Etienne","Angers SCO","3-0",3,0,"1",1,3,3,"H"
1956-10-14,1956,"US Valenciennes-Anzin","Racing Club de France","3-1",3,1,"1",1,4,2,"H"
1956-10-14,1956,"Toulouse FC","Stade Reims","4-0",4,0,"1",1,4,4,"H"
1956-10-14,1956,"OGC Nice","Olympique Lyon","1-0",1,0,"1",1,1,1,"H"
1956-10-14,1956,"FC Sochaux","AS Monaco","1-1",1,1,"1",1,2,0,"D"
1956-10-14,1956,"Olympique Marseille","FC Metz","3-3",3,3,"1",1,6,0,"D"
1956-10-14,1956,"UA Sedan-Torcy","RC Strasbourg","3-1",3,1,"1",1,4,2,"H"
1956-10-14,1956,"Stade Rennes","RC Lens","1-4",1,4,"1",1,5,-3,"D"
1956-10-14,1956,"AS Nancy","Nimes Olympique","1-0",1,0,"1",1,1,1,"H"
1956-10-28,1956,"Olympique Lyon","AS Saint-Etienne","1-3",1,3,"1",1,4,-2,"D"
1956-10-28,1956,"Racing Club de France","RC Strasbourg","2-0",2,0,"1",1,2,2,"H"
1956-10-28,1956,"Stade Reims","AS Nancy","4-1",4,1,"1",1,5,3,"H"
1956-10-28,1956,"FC Sochaux","Stade Rennes","3-1",3,1,"1",1,4,2,"H"
1956-10-28,1956,"Angers SCO","Toulouse FC","2-5",2,5,"1",1,7,-3,"D"
1956-10-28,1956,"Nimes Olympique","Olympique Marseille","2-0",2,0,"1",1,2,2,"H"
1956-10-28,1956,"RC Lens","US Valenciennes-Anzin","0-0",0,0,"1",1,0,0,"D"
1956-10-28,1956,"AS Monaco","OGC Nice","2-1",2,1,"1",1,3,1,"H"
1956-10-28,1956,"FC Metz","UA Sedan-Torcy","3-1",3,1,"1",1,4,2,"H"
1956-11-01,1956,"RC Lens","UA Sedan-Torcy","1-0",1,0,"1",1,1,1,"H"
1956-11-04,1956,"Racing Club de France","AS Saint-Etienne","1-2",1,2,"1",1,3,-1,"D"
1956-11-04,1956,"Stade Reims","Olympique Marseille","1-1",1,1,"1",1,2,0,"D"
1956-11-04,1956,"AS Nancy","FC Sochaux","1-3",1,3,"1",1,4,-2,"D"
1956-11-04,1956,"Olympique Lyon","Toulouse FC","1-3",1,3,"1",1,4,-2,"D"
1956-11-04,1956,"RC Lens","AS Monaco","3-1",3,1,"1",1,4,2,"H"
1956-11-04,1956,"Nimes Olympique","UA Sedan-Torcy","2-1",2,1,"1",1,3,1,"H"
1956-11-04,1956,"RC Strasbourg","Angers SCO","0-2",0,2,"1",1,2,-2,"D"
1956-11-04,1956,"OGC Nice","US Valenciennes-Anzin","2-2",2,2,"1",1,4,0,"D"
1956-11-04,1956,"Stade Rennes","FC Metz","1-0",1,0,"1",1,1,1,"H"
1956-11-18,1956,"AS Saint-Etienne","RC Strasbourg","2-2",2,2,"1",1,4,0,"D"
1956-11-18,1956,"Toulouse FC","Stade Rennes","6-0",6,0,"1",1,6,6,"H"
1956-11-18,1956,"FC Sochaux","Racing Club de France","3-5",3,5,"1",1,8,-2,"D"
1956-11-18,1956,"Angers SCO","Stade Reims","2-2",2,2,"1",1,4,0,"D"
1956-11-18,1956,"Olympique Marseille","RC Lens","1-4",1,4,"1",1,5,-3,"D"
1956-11-18,1956,"US Valenciennes-Anzin","Nimes Olympique","0-0",0,0,"1",1,0,0,"D"
1956-11-18,1956,"FC Metz","OGC Nice","3-3",3,3,"1",1,6,0,"D"
1956-11-18,1956,"UA Sedan-Torcy","AS Nancy","1-1",1,1,"1",1,2,0,"D"
1956-11-19,1956,"AS Monaco","Olympique Lyon","2-0",2,0,"1",1,2,2,"H"
1956-11-25,1956,"AS Saint-Etienne","FC Sochaux","6-0",6,0,"1",1,6,6,"H"
1956-11-25,1956,"RC Lens","Olympique Lyon","3-1",3,1,"1",1,4,2,"H"
1956-11-25,1956,"AS Nancy","Toulouse FC","1-1",1,1,"1",1,2,0,"D"
1956-11-25,1956,"Stade Reims","US Valenciennes-Anzin","1-1",1,1,"1",1,2,0,"D"
1956-11-25,1956,"Racing Club de France","Olympique Marseille","1-3",1,3,"1",1,4,-2,"D"
1956-11-25,1956,"Nimes Olympique","FC Metz","1-1",1,1,"1",1,2,0,"D"
1956-11-25,1956,"OGC Nice","Angers SCO","1-1",1,1,"1",1,2,0,"D"
1956-11-25,1956,"RC Strasbourg","AS Monaco","2-4",2,4,"1",1,6,-2,"D"
1956-11-25,1956,"Stade Rennes","UA Sedan-Torcy","2-0",2,0,"1",1,2,2,"H"
1956-12-02,1956,"Stade Rennes","AS Saint-Etienne","1-0",1,0,"1",1,1,1,"H"
1956-12-02,1956,"AS Nancy","RC Lens","0-2",0,2,"1",1,2,-2,"D"
1956-12-02,1956,"RC Strasbourg","Stade Reims","1-3",1,3,"1",1,4,-2,"D"
1956-12-02,1956,"Toulouse FC","Olympique Marseille","0-1",0,1,"1",1,1,-1,"D"
1956-12-02,1956,"Nimes Olympique","Racing Club de France","4-2",4,2,"1",1,6,2,"H"
1956-12-02,1956,"US Valenciennes-Anzin","FC Sochaux","3-1",3,1,"1",1,4,2,"H"
1956-12-02,1956,"AS Monaco","Angers SCO","1-1",1,1,"1",1,2,0,"D"
1956-12-02,1956,"Olympique Lyon","FC Metz","1-0",1,0,"1",1,1,1,"H"
1956-12-02,1956,"UA Sedan-Torcy","OGC Nice","3-3",3,3,"1",1,6,0,"D"
1956-12-09,1956,"AS Saint-Etienne","AS Monaco","0-1",0,1,"1",1,1,-1,"D"
1956-12-09,1956,"RC Lens","Nimes Olympique","4-0",4,0,"1",1,4,4,"H"
1956-12-09,1956,"Stade Reims","Stade Rennes","3-1",3,1,"1",1,4,2,"H"
1956-12-09,1956,"Olympique Marseille","Olympique Lyon","3-2",3,2,"1",1,5,1,"H"
1956-12-09,1956,"OGC Nice","Toulouse FC","1-0",1,0,"1",1,1,1,"H"
1956-12-09,1956,"FC Sochaux","RC Strasbourg","6-0",6,0,"1",1,6,6,"H"
1956-12-09,1956,"Angers SCO","US Valenciennes-Anzin","2-0",2,0,"1",1,2,2,"H"
1956-12-09,1956,"Racing Club de France","UA Sedan-Torcy","1-2",1,2,"1",1,3,-1,"D"
1956-12-09,1956,"FC Metz","AS Nancy","1-1",1,1,"1",1,2,0,"D"
1956-12-16,1956,"US Valenciennes-Anzin","AS Saint-Etienne","1-1",1,1,"1",1,2,0,"D"
1956-12-16,1956,"RC Lens","Toulouse FC","4-1",4,1,"1",1,5,3,"H"
1956-12-16,1956,"Stade Reims","Racing Club de France","2-4",2,4,"1",1,6,-2,"D"
1956-12-16,1956,"Olympique Lyon","FC Sochaux","0-1",0,1,"1",1,1,-1,"D"
1956-12-16,1956,"Nimes Olympique","OGC Nice","3-2",3,2,"1",1,5,1,"H"
1956-12-16,1956,"Angers SCO","Olympique Marseille","2-2",2,2,"1",1,4,0,"D"
1956-12-16,1956,"AS Monaco","UA Sedan-Torcy","2-1",2,1,"1",1,3,1,"H"
1956-12-16,1956,"AS Nancy","Stade Rennes","4-0",4,0,"1",1,4,4,"H"
1956-12-16,1956,"RC Strasbourg","FC Metz","1-0",1,0,"1",1,1,1,"H"
1956-12-23,1956,"AS Saint-Etienne","Toulouse FC","0-0",0,0,"1",1,0,0,"D"
1956-12-23,1956,"RC Lens","Angers SCO","0-3",0,3,"1",1,3,-3,"D"
1956-12-23,1956,"FC Metz","Stade Reims","2-5",2,5,"1",1,7,-3,"D"
1956-12-23,1956,"FC Sochaux","Nimes Olympique","3-1",3,1,"1",1,4,2,"H"
1956-12-23,1956,"Olympique Marseille","RC Strasbourg","3-1",3,1,"1",1,4,2,"H"
1956-12-23,1956,"Racing Club de France","AS Monaco","2-1",2,1,"1",1,3,1,"H"
1956-12-23,1956,"OGC Nice","AS Nancy","3-2",3,2,"1",1,5,1,"H"
1956-12-23,1956,"UA Sedan-Torcy","US Valenciennes-Anzin","3-0",3,0,"1",1,3,3,"H"
1956-12-23,1956,"Stade Rennes","Olympique Lyon","2-1",2,1,"1",1,3,1,"H"
1956-12-25,1956,"AS Saint-Etienne","Nimes Olympique","4-0",4,0,"1",1,4,4,"H"
1956-12-25,1956,"RC Lens","Stade Reims","2-1",2,1,"1",1,3,1,"H"
1956-12-25,1956,"Olympique Marseille","AS Nancy","3-1",3,1,"1",1,4,2,"H"
1956-12-25,1956,"FC Sochaux","Toulouse FC","1-3",1,3,"1",1,4,-2,"D"
1956-12-25,1956,"UA Sedan-Torcy","Angers SCO","1-1",1,1,"1",1,2,0,"D"
1956-12-25,1956,"Racing Club de France","Olympique Lyon","1-2",1,2,"1",1,3,-1,"D"
1956-12-25,1956,"Stade Rennes","AS Monaco","0-1",0,1,"1",1,1,-1,"D"
1956-12-25,1956,"OGC Nice","RC Strasbourg","1-0",1,0,"1",1,1,1,"H"
1956-12-25,1956,"FC Metz","US Valenciennes-Anzin","2-2",2,2,"1",1,4,0,"D"
1956-12-30,1956,"Toulouse FC","AS Saint-Etienne","3-0",3,0,"1",1,3,3,"H"
1956-12-30,1956,"Angers SCO","RC Lens","1-0",1,0,"1",1,1,1,"H"
1956-12-30,1956,"Stade Reims","FC Metz","2-1",2,1,"1",1,3,1,"H"
1956-12-30,1956,"AS Monaco","Olympique Marseille","1-0",1,0,"1",1,1,1,"H"
1956-12-30,1956,"AS Nancy","Racing Club de France","2-5",2,5,"1",1,7,-3,"D"
1956-12-30,1956,"Nimes Olympique","FC Sochaux","3-0",3,0,"1",1,3,3,"H"
1956-12-30,1956,"US Valenciennes-Anzin","OGC Nice","2-1",2,1,"1",1,3,1,"H"
1956-12-30,1956,"Olympique Lyon","Stade Rennes","2-0",2,0,"1",1,2,2,"H"
1956-12-30,1956,"RC Strasbourg","UA Sedan-Torcy","0-0",0,0,"1",1,0,0,"D"
1957-01-01,1956,"Nimes Olympique","AS Saint-Etienne","0-0",0,0,"1",1,0,0,"D"
1957-01-01,1956,"Stade Reims","RC Lens","3-2",3,2,"1",1,5,1,"H"
1957-01-01,1956,"Toulouse FC","FC Sochaux","2-0",2,0,"1",1,2,2,"H"
1957-01-01,1956,"AS Monaco","Stade Rennes","4-0",4,0,"1",1,4,4,"H"
1957-01-01,1956,"Olympique Lyon","Olympique Marseille","2-0",2,0,"1",1,2,2,"H"
1957-01-01,1956,"RC Strasbourg","Racing Club de France","2-1",2,1,"1",1,3,1,"H"
1957-01-01,1956,"US Valenciennes-Anzin","FC Metz","1-1",1,1,"1",1,2,0,"D"
1957-01-01,1956,"AS Nancy","UA Sedan-Torcy","3-2",3,2,"1",1,5,1,"H"
1957-01-06,1956,"AS Saint-Etienne","AS Nancy","6-1",6,1,"1",1,7,5,"H"
1957-01-06,1956,"Toulouse FC","RC Lens","1-2",1,2,"1",1,3,-1,"D"
1957-01-06,1956,"Racing Club de France","Stade Reims","4-2",4,2,"1",1,6,2,"H"
1957-01-06,1956,"FC Metz","AS Monaco","1-2",1,2,"1",1,3,-1,"D"
1957-01-06,1956,"Olympique Marseille","Angers SCO","0-0",0,0,"1",1,0,0,"D"
1957-01-06,1956,"FC Sochaux","US Valenciennes-Anzin","4-0",4,0,"1",1,4,4,"H"
1957-01-06,1956,"OGC Nice","Nimes Olympique","5-2",5,2,"1",1,7,3,"H"
1957-01-06,1956,"UA Sedan-Torcy","Olympique Lyon","2-2",2,2,"1",1,4,0,"D"
1957-01-06,1956,"Stade Rennes","RC Strasbourg","2-1",2,1,"1",1,3,1,"H"
1957-01-17,1956,"Angers SCO","OGC Nice","0-1",0,1,"1",1,1,-1,"D"
1957-01-20,1956,"RC Lens","AS Saint-Etienne","0-2",0,2,"1",1,2,-2,"D"
1957-01-20,1956,"Stade Reims","FC Sochaux","1-0",1,0,"1",1,1,1,"H"
1957-01-20,1956,"AS Monaco","Toulouse FC","1-1",1,1,"1",1,2,0,"D"
1957-01-20,1956,"Racing Club de France","Stade Rennes","3-0",3,0,"1",1,3,3,"H"
1957-01-20,1956,"Olympique Marseille","Nimes Olympique","3-1",3,1,"1",1,4,2,"H"
1957-01-20,1956,"Angers SCO","UA Sedan-Torcy","0-0",0,0,"1",1,0,0,"D"
1957-01-20,1956,"RC Strasbourg","OGC Nice","2-2",2,2,"1",1,4,0,"D"
1957-01-20,1956,"Olympique Lyon","US Valenciennes-Anzin","1-0",1,0,"1",1,1,1,"H"
1957-01-20,1956,"AS Nancy","FC Metz","0-2",0,2,"1",1,2,-2,"D"
1957-01-27,1956,"AS Saint-Etienne","Racing Club de France","3-1",3,1,"1",1,4,2,"H"
1957-01-27,1956,"US Valenciennes-Anzin","Stade Reims","1-5",1,5,"1",1,6,-4,"D"
1957-01-27,1956,"AS Monaco","RC Lens","1-2",1,2,"1",1,3,-1,"D"
1957-01-27,1956,"OGC Nice","Olympique Marseille","1-3",1,3,"1",1,4,-2,"D"
1957-01-27,1956,"Toulouse FC","Angers SCO","5-0",5,0,"1",1,5,5,"H"
1957-01-27,1956,"Nimes Olympique","Olympique Lyon","2-0",2,0,"1",1,2,2,"H"
1957-01-27,1956,"Stade Rennes","AS Nancy","0-3",0,3,"1",1,3,-3,"D"
1957-01-27,1956,"FC Metz","RC Strasbourg","2-0",2,0,"1",1,2,2,"H"
1957-02-10,1956,"AS Saint-Etienne","Olympique Lyon","3-2",3,2,"1",1,5,1,"H"
1957-02-10,1956,"Olympique Marseille","Stade Reims","1-2",1,2,"1",1,3,-1,"D"
1957-02-10,1956,"RC Lens","FC Sochaux","3-1",3,1,"1",1,4,2,"H"
1957-02-10,1956,"UA Sedan-Torcy","Stade Rennes","1-1",1,1,"1",1,2,0,"D"
1957-02-10,1956,"Toulouse FC","US Valenciennes-Anzin","4-0",4,0,"1",1,4,4,"H"
1957-02-10,1956,"Racing Club de France","FC Metz","4-1",4,1,"1",1,5,3,"H"
1957-02-10,1956,"Nimes Olympique","RC Strasbourg","4-1",4,1,"1",1,5,3,"H"
1957-02-10,1956,"AS Nancy","OGC Nice","4-2",4,2,"1",1,6,2,"H"
1957-02-17,1956,"AS Monaco","AS Saint-Etienne","3-1",3,1,"1",1,4,2,"H"
1957-02-17,1956,"Stade Reims","Toulouse FC","2-0",2,0,"1",1,2,2,"H"
1957-02-17,1956,"RC Strasbourg","RC Lens","1-4",1,4,"1",1,5,-3,"D"
1957-02-17,1956,"Olympique Lyon","Racing Club de France","1-2",1,2,"1",1,3,-1,"D"
1957-02-17,1956,"Stade Rennes","Olympique Marseille","1-1",1,1,"1",1,2,0,"D"
1957-02-17,1956,"OGC Nice","UA Sedan-Torcy","1-0",1,0,"1",1,1,1,"H"
1957-02-17,1956,"FC Metz","Nimes Olympique","3-1",3,1,"1",1,4,2,"H"
1957-02-17,1956,"FC Sochaux","AS Nancy","3-1",3,1,"1",1,4,2,"H"
1957-02-17,1956,"US Valenciennes-Anzin","Angers SCO","1-0",1,0,"1",1,1,1,"H"
1957-02-24,1956,"AS Saint-Etienne","Stade Reims","0-0",0,0,"1",1,0,0,"D"
1957-02-24,1956,"RC Lens","AS Nancy","3-1",3,1,"1",1,4,2,"H"
1957-02-24,1956,"Racing Club de France","OGC Nice","3-2",3,2,"1",1,5,1,"H"
1957-02-24,1956,"AS Monaco","Nimes Olympique","4-1",4,1,"1",1,5,3,"H"
1957-02-24,1956,"Olympique Marseille","US Valenciennes-Anzin","4-1",4,1,"1",1,5,3,"H"
1957-02-24,1956,"UA Sedan-Torcy","Toulouse FC","1-1",1,1,"1",1,2,0,"D"
1957-02-24,1956,"RC Strasbourg","FC Sochaux","3-2",3,2,"1",1,5,1,"H"
1957-02-24,1956,"Stade Rennes","Angers SCO","4-1",4,1,"1",1,5,3,"H"
1957-02-24,1956,"FC Metz","Olympique Lyon","3-1",3,1,"1",1,4,2,"H"
1957-03-07,1956,"Angers SCO","AS Monaco","0-2",0,2,"1",1,2,-2,"D"
1957-03-10,1956,"AS Saint-Etienne","US Valenciennes-Anzin","5-4",5,4,"1",1,9,1,"H"
1957-03-10,1956,"RC Lens","FC Metz","3-1",3,1,"1",1,4,2,"H"
1957-03-10,1956,"Nimes Olympique","Stade Reims","1-2",1,2,"1",1,3,-1,"D"
1957-03-10,1956,"UA Sedan-Torcy","AS Monaco","3-3",3,3,"1",1,6,0,"D"
1957-03-10,1956,"Angers SCO","Racing Club de France","1-1",1,1,"1",1,2,0,"D"
1957-03-10,1956,"AS Nancy","Olympique Marseille","0-1",0,1,"1",1,1,-1,"D"
1957-03-10,1956,"Toulouse FC","RC Strasbourg","1-1",1,1,"1",1,2,0,"D"
1957-03-10,1956,"FC Sochaux","Olympique Lyon","3-1",3,1,"1",1,4,2,"H"
1957-03-10,1956,"OGC Nice","Stade Rennes","0-2",0,2,"1",1,2,-2,"D"
1957-03-17,1956,"Olympique Marseille","AS Saint-Etienne","4-3",4,3,"1",1,7,1,"H"
1957-03-17,1956,"Stade Reims","RC Strasbourg","3-1",3,1,"1",1,4,2,"H"
1957-03-17,1956,"Olympique Lyon","RC Lens","3-0",3,0,"1",1,3,3,"H"
1957-03-17,1956,"OGC Nice","AS Monaco","0-2",0,2,"1",1,2,-2,"D"
1957-03-17,1956,"Racing Club de France","FC Sochaux","3-1",3,1,"1",1,4,2,"H"
1957-03-17,1956,"FC Metz","Toulouse FC","4-1",4,1,"1",1,5,3,"H"
1957-03-17,1956,"AS Nancy","Angers SCO","2-2",2,2,"1",1,4,0,"D"
1957-03-17,1956,"Stade Rennes","Nimes Olympique","2-1",2,1,"1",1,3,1,"H"
1957-03-17,1956,"US Valenciennes-Anzin","UA Sedan-Torcy","0-4",0,4,"1",1,4,-4,"D"
1957-03-28,1956,"FC Sochaux","UA Sedan-Torcy","5-2",5,2,"1",1,7,3,"H"
1957-03-31,1956,"AS Saint-Etienne","OGC Nice","4-2",4,2,"1",1,6,2,"H"
1957-03-31,1956,"AS Monaco","Stade Reims","1-1",1,1,"1",1,2,0,"D"
1957-03-31,1956,"Nimes Olympique","RC Lens","2-3",2,3,"1",1,5,-1,"D"
1957-03-31,1956,"UA Sedan-Torcy","Racing Club de France","1-1",1,1,"1",1,2,0,"D"
1957-03-31,1956,"FC Metz","Olympique Marseille","1-0",1,0,"1",1,1,1,"H"
1957-03-31,1956,"Toulouse FC","AS Nancy","1-2",1,2,"1",1,3,-1,"D"
1957-03-31,1956,"Angers SCO","FC Sochaux","4-0",4,0,"1",1,4,4,"H"
1957-03-31,1956,"RC Strasbourg","Olympique Lyon","2-0",2,0,"1",1,2,2,"H"
1957-03-31,1956,"US Valenciennes-Anzin","Stade Rennes","5-2",5,2,"1",1,7,3,"H"
1957-04-14,1956,"Angers SCO","AS Saint-Etienne","0-1",0,1,"1",1,1,-1,"D"
1957-04-14,1956,"RC Lens","Stade Rennes","3-0",3,0,"1",1,3,3,"H"
1957-04-14,1956,"Stade Reims","UA Sedan-Torcy","0-1",0,1,"1",1,1,-1,"D"
1957-04-14,1956,"Olympique Marseille","Racing Club de France","0-3",0,3,"1",1,3,-3,"D"
1957-04-14,1956,"AS Monaco","RC Strasbourg","1-2",1,2,"1",1,3,-1,"D"
1957-04-14,1956,"Toulouse FC","OGC Nice","4-3",4,3,"1",1,7,1,"H"
1957-04-14,1956,"FC Sochaux","FC Metz","1-1",1,1,"1",1,2,0,"D"
1957-04-14,1956,"Nimes Olympique","US Valenciennes-Anzin","2-3",2,3,"1",1,5,-1,"D"
1957-04-14,1956,"Olympique Lyon","AS Nancy","0-1",0,1,"1",1,1,-1,"D"
1957-04-21,1956,"FC Sochaux","AS Saint-Etienne","1-1",1,1,"1",1,2,0,"D"
1957-04-21,1956,"UA Sedan-Torcy","RC Lens","4-4",4,4,"1",1,8,0,"D"
1957-04-21,1956,"AS Nancy","Stade Reims","0-0",0,0,"1",1,0,0,"D"
1957-04-21,1956,"Racing Club de France","Nimes Olympique","0-0",0,0,"1",1,0,0,"D"
1957-04-21,1956,"US Valenciennes-Anzin","AS Monaco","2-1",2,1,"1",1,3,1,"H"
1957-04-21,1956,"RC Strasbourg","Olympique Marseille","2-3",2,3,"1",1,5,-1,"D"
1957-04-21,1956,"Stade Rennes","Toulouse FC","1-0",1,0,"1",1,1,1,"H"
1957-04-21,1956,"Olympique Lyon","Angers SCO","2-1",2,1,"1",1,3,1,"H"
1957-04-21,1956,"OGC Nice","FC Metz","1-1",1,1,"1",1,2,0,"D"
1957-04-28,1956,"AS Saint-Etienne","UA Sedan-Torcy","2-2",2,2,"1",1,4,0,"D"
1957-04-28,1956,"RC Lens","Olympique Marseille","2-0",2,0,"1",1,2,2,"H"
1957-04-28,1956,"OGC Nice","Stade Reims","2-1",2,1,"1",1,3,1,"H"
1957-04-28,1956,"Racing Club de France","US Valenciennes-Anzin","3-1",3,1,"1",1,4,2,"H"
1957-04-28,1956,"AS Monaco","FC Sochaux","2-1",2,1,"1",1,3,1,"H"
1957-04-28,1956,"Toulouse FC","Olympique Lyon","2-2",2,2,"1",1,4,0,"D"
1957-04-28,1956,"Angers SCO","RC Strasbourg","4-1",4,1,"1",1,5,3,"H"
1957-04-28,1956,"Nimes Olympique","AS Nancy","4-0",4,0,"1",1,4,4,"H"
1957-04-28,1956,"FC Metz","Stade Rennes","1-1",1,1,"1",1,2,0,"D"
1957-05-01,1956,"FC Metz","AS Saint-Etienne","1-2",1,2,"1",1,3,-1,"D"
1957-05-01,1956,"US Valenciennes-Anzin","RC Lens","2-1",2,1,"1",1,3,1,"H"
1957-05-01,1956,"AS Monaco","Racing Club de France","1-1",1,1,"1",1,2,0,"D"
1957-05-01,1956,"Stade Reims","Angers SCO","1-2",1,2,"1",1,3,-1,"D"
1957-05-01,1956,"Olympique Marseille","UA Sedan-Torcy","3-0",3,0,"1",1,3,3,"H"
1957-05-01,1956,"Toulouse FC","Nimes Olympique","0-1",0,1,"1",1,1,-1,"D"
1957-05-01,1956,"Stade Rennes","FC Sochaux","2-0",2,0,"1",1,2,2,"H"
1957-05-01,1956,"Olympique Lyon","OGC Nice","1-0",1,0,"1",1,1,1,"H"
1957-05-01,1956,"RC Strasbourg","AS Nancy","0-0",0,0,"1",1,0,0,"D"
1957-05-12,1956,"RC Strasbourg","AS Saint-Etienne","1-1",1,1,"1",1,2,0,"D"
1957-05-12,1956,"OGC Nice","RC Lens","3-2",3,2,"1",1,5,1,"H"
1957-05-12,1956,"Racing Club de France","Toulouse FC","6-2",6,2,"1",1,8,4,"H"
1957-05-12,1956,"Stade Rennes","Stade Reims","1-1",1,1,"1",1,2,0,"D"
1957-05-12,1956,"Olympique Lyon","AS Monaco","1-0",1,0,"1",1,1,1,"H"
1957-05-12,1956,"FC Sochaux","Olympique Marseille","3-0",3,0,"1",1,3,3,"H"
1957-05-12,1956,"Nimes Olympique","Angers SCO","3-1",3,1,"1",1,4,2,"H"
1957-05-12,1956,"UA Sedan-Torcy","FC Metz","3-2",3,2,"1",1,5,1,"H"
1957-05-12,1956,"AS Nancy","US Valenciennes-Anzin","1-4",1,4,"1",1,5,-3,"D"
1957-05-19,1956,"AS Saint-Etienne","Stade Rennes","2-0",2,0,"1",1,2,2,"H"
1957-05-19,1956,"RC Lens","Racing Club de France","2-0",2,0,"1",1,2,2,"H"
1957-05-19,1956,"Stade Reims","Olympique Lyon","4-1",4,1,"1",1,5,3,"H"
1957-05-19,1956,"AS Nancy","AS Monaco","0-2",0,2,"1",1,2,-2,"D"
1957-05-19,1956,"Olympique Marseille","Toulouse FC","3-0",3,0,"1",1,3,3,"H"
1957-05-19,1956,"FC Sochaux","OGC Nice","4-2",4,2,"1",1,6,2,"H"
1957-05-19,1956,"UA Sedan-Torcy","Nimes Olympique","1-0",1,0,"1",1,1,1,"H"
1957-05-19,1956,"Angers SCO","FC Metz","0-3",0,3,"1",1,3,-3,"D"
1957-05-19,1956,"US Valenciennes-Anzin","RC Strasbourg","0-1",0,1,"1",1,1,-1,"D"
1957-08-18,1957,"OGC Nice","FC Metz","6-2",6,2,"1",1,8,4,"H"
1957-08-18,1957,"Racing Club de France","FC Sochaux","6-4",6,4,"1",1,10,2,"H"
1957-08-18,1957,"RC Lens","Toulouse FC","3-1",3,1,"1",1,4,2,"H"
1957-08-18,1957,"Olympique Marseille","Lille OSC","3-4",3,4,"1",1,7,-1,"D"
1957-08-18,1957,"UA Sedan-Torcy","AS Monaco","2-1",2,1,"1",1,3,1,"H"
1957-08-18,1957,"Olympique Lyon","Nimes Olympique","1-0",1,0,"1",1,1,1,"H"
1957-08-18,1957,"Olympique Ales","US Valenciennes-Anzin","0-1",0,1,"1",1,1,-1,"D"
1957-08-18,1957,"AS Beziers","AS Saint-Etienne","2-2",2,2,"1",1,4,0,"D"
1957-08-20,1957,"Angers SCO","Stade Reims","0-1",0,1,"1",1,1,-1,"D"
1957-08-25,1957,"Nimes Olympique","RC Lens","2-3",2,3,"1",1,5,-1,"D"
1957-08-25,1957,"US Valenciennes-Anzin","UA Sedan-Torcy","3-1",3,1,"1",1,4,2,"H"
1957-08-25,1957,"Olympique Lyon","FC Metz","2-0",2,0,"1",1,2,2,"H"
1957-08-25,1957,"Stade Reims","OGC Nice","3-2",3,2,"1",1,5,1,"H"
1957-08-25,1957,"Olympique Marseille","Racing Club de France","1-1",1,1,"1",1,2,0,"D"
1957-08-25,1957,"Lille OSC","AS Saint-Etienne","1-2",1,2,"1",1,3,-1,"D"
1957-08-25,1957,"AS Monaco","FC Sochaux","5-2",5,2,"1",1,7,3,"H"
1957-08-25,1957,"AS Beziers","Angers SCO","4-4",4,4,"1",1,8,0,"D"
1957-08-25,1957,"Toulouse FC","Olympique Ales","2-3",2,3,"1",1,5,-1,"D"
1957-09-08,1957,"RC Lens","Olympique Lyon","4-4",4,4,"1",1,8,0,"D"
1957-09-08,1957,"US Valenciennes-Anzin","OGC Nice","1-1",1,1,"1",1,2,0,"D"
1957-09-08,1957,"AS Monaco","Stade Reims","3-0",3,0,"1",1,3,3,"H"
1957-09-08,1957,"UA Sedan-Torcy","Nimes Olympique","3-1",3,1,"1",1,4,2,"H"
1957-09-08,1957,"Olympique Ales","Lille OSC","2-1",2,1,"1",1,3,1,"H"
1957-09-08,1957,"AS Saint-Etienne","Toulouse FC","1-1",1,1,"1",1,2,0,"D"
1957-09-08,1957,"Racing Club de France","Angers SCO","1-2",1,2,"1",1,3,-1,"D"
1957-09-08,1957,"FC Metz","Olympique Marseille","1-2",1,2,"1",1,3,-1,"D"
1957-09-08,1957,"FC Sochaux","AS Beziers","4-0",4,0,"1",1,4,4,"H"
1957-09-15,1957,"FC Metz","RC Lens","1-4",1,4,"1",1,5,-3,"D"
1957-09-15,1957,"Stade Reims","Olympique Lyon","4-0",4,0,"1",1,4,4,"H"
1957-09-15,1957,"OGC Nice","UA Sedan-Torcy","8-0",8,0,"1",1,8,8,"H"
1957-09-15,1957,"Lille OSC","Racing Club de France","1-3",1,3,"1",1,4,-2,"D"
1957-09-15,1957,"FC Sochaux","US Valenciennes-Anzin","1-0",1,0,"1",1,1,1,"H"
1957-09-15,1957,"Angers SCO","AS Monaco","3-2",3,2,"1",1,5,1,"H"
1957-09-15,1957,"AS Saint-Etienne","Olympique Ales","2-2",2,2,"1",1,4,0,"D"
1957-09-15,1957,"Toulouse FC","Olympique Marseille","1-1",1,1,"1",1,2,0,"D"
1957-09-15,1957,"Nimes Olympique","AS Beziers","2-0",2,0,"1",1,2,2,"H"
1957-09-18,1957,"RC Lens","OGC Nice","1-0",1,0,"1",1,1,1,"H"
1957-09-18,1957,"Racing Club de France","Nimes Olympique","3-1",3,1,"1",1,4,2,"H"
1957-09-18,1957,"FC Metz","AS Saint-Etienne","0-2",0,2,"1",1,2,-2,"D"
1957-09-18,1957,"AS Beziers","AS Monaco","0-3",0,3,"1",1,3,-3,"D"
1957-09-18,1957,"FC Sochaux","Toulouse FC","4-2",4,2,"1",1,6,2,"H"
1957-09-19,1957,"Angers SCO","Lille OSC","0-0",0,0,"1",1,0,0,"D"
1957-09-19,1957,"Stade Reims","US Valenciennes-Anzin","4-2",4,2,"1",1,6,2,"H"
1957-09-19,1957,"Olympique Ales","UA Sedan-Torcy","2-0",2,0,"1",1,2,2,"H"
1957-09-19,1957,"Olympique Marseille","Olympique Lyon","2-3",2,3,"1",1,5,-1,"D"
1957-09-21,1957,"AS Beziers","RC Lens","1-1",1,1,"1",1,2,0,"D"
1957-09-22,1957,"Olympique Lyon","Racing Club de France","2-0",2,0,"1",1,2,2,"H"
1957-09-22,1957,"Toulouse FC","Stade Reims","1-0",1,0,"1",1,1,1,"H"
1957-09-22,1957,"AS Saint-Etienne","FC Sochaux","2-2",2,2,"1",1,4,0,"D"
1957-09-22,1957,"OGC Nice","Olympique Ales","6-1",6,1,"1",1,7,5,"H"
1957-09-22,1957,"Lille OSC","AS Monaco","1-1",1,1,"1",1,2,0,"D"
1957-09-22,1957,"US Valenciennes-Anzin","FC Metz","2-2",2,2,"1",1,4,0,"D"
1957-09-22,1957,"Nimes Olympique","Angers SCO","5-1",5,1,"1",1,6,4,"H"
1957-09-22,1957,"UA Sedan-Torcy","Olympique Marseille","2-1",2,1,"1",1,3,1,"H"
1957-09-28,1957,"Stade Reims","AS Beziers","5-0",5,0,"1",1,5,5,"H"
1957-09-29,1957,"US Valenciennes-Anzin","RC Lens","1-1",1,1,"1",1,2,0,"D"
1957-09-29,1957,"Olympique Marseille","FC Sochaux","0-3",0,3,"1",1,3,-3,"D"
1957-09-29,1957,"Olympique Ales","Racing Club de France","1-3",1,3,"1",1,4,-2,"D"
1957-09-29,1957,"AS Saint-Etienne","OGC Nice","1-1",1,1,"1",1,2,0,"D"
1957-09-29,1957,"Toulouse FC","Olympique Lyon","3-1",3,1,"1",1,4,2,"H"
1957-09-29,1957,"AS Monaco","Nimes Olympique","1-1",1,1,"1",1,2,0,"D"
1957-09-29,1957,"FC Metz","Angers SCO","0-3",0,3,"1",1,3,-3,"D"
1957-09-29,1957,"Lille OSC","UA Sedan-Torcy","3-0",3,0,"1",1,3,3,"H"
1957-10-13,1957,"RC Lens","Stade Reims","0-1",0,1,"1",1,1,-1,"D"
1957-10-13,1957,"FC Sochaux","Olympique Ales","3-1",3,1,"1",1,4,2,"H"
1957-10-13,1957,"Olympique Lyon","Lille OSC","2-0",2,0,"1",1,2,2,"H"
1957-10-13,1957,"AS Monaco","US Valenciennes-Anzin","4-0",4,0,"1",1,4,4,"H"
1957-10-13,1957,"Racing Club de France","AS Saint-Etienne","1-1",1,1,"1",1,2,0,"D"
1957-10-13,1957,"Angers SCO","Olympique Marseille","2-2",2,2,"1",1,4,0,"D"
1957-10-13,1957,"Nimes Olympique","OGC Nice","3-2",3,2,"1",1,5,1,"H"
1957-10-13,1957,"UA Sedan-Torcy","Toulouse FC","3-0",3,0,"1",1,3,3,"H"
1957-10-13,1957,"AS Beziers","FC Metz","0-1",0,1,"1",1,1,-1,"D"
1957-10-20,1957,"Stade Reims","Lille OSC","3-1",3,1,"1",1,4,2,"H"
1957-10-20,1957,"Racing Club de France","AS Monaco","2-3",2,3,"1",1,5,-1,"D"
1957-10-20,1957,"RC Lens","FC Sochaux","1-1",1,1,"1",1,2,0,"D"
1957-10-20,1957,"AS Saint-Etienne","US Valenciennes-Anzin","5-1",5,1,"1",1,6,4,"H"
1957-10-20,1957,"Olympique Ales","Olympique Lyon","2-2",2,2,"1",1,4,0,"D"
1957-10-20,1957,"OGC Nice","AS Beziers","6-1",6,1,"1",1,7,5,"H"
1957-10-20,1957,"Olympique Marseille","Nimes Olympique","1-3",1,3,"1",1,4,-2,"D"
1957-10-20,1957,"Angers SCO","Toulouse FC","0-1",0,1,"1",1,1,-1,"D"
1957-10-20,1957,"FC Metz","UA Sedan-Torcy","3-2",3,2,"1",1,5,1,"H"
1957-11-01,1957,"FC Sochaux","Stade Reims","0-4",0,4,"1",1,4,-4,"D"
1957-11-01,1957,"AS Monaco","Olympique Marseille","3-2",3,2,"1",1,5,1,"H"
1957-11-01,1957,"UA Sedan-Torcy","RC Lens","2-3",2,3,"1",1,5,-1,"D"
1957-11-01,1957,"Nimes Olympique","AS Saint-Etienne","2-2",2,2,"1",1,4,0,"D"
1957-11-01,1957,"US Valenciennes-Anzin","Racing Club de France","0-5",0,5,"1",1,5,-5,"D"
1957-11-01,1957,"Olympique Lyon","Angers SCO","2-3",2,3,"1",1,5,-1,"D"
1957-11-01,1957,"Toulouse FC","OGC Nice","2-1",2,1,"1",1,3,1,"H"
1957-11-01,1957,"Lille OSC","FC Metz","2-1",2,1,"1",1,3,1,"H"
1957-11-01,1957,"AS Beziers","Olympique Ales","3-2",3,2,"1",1,5,1,"H"
1957-11-03,1957,"Stade Reims","UA Sedan-Torcy","3-0",3,0,"1",1,3,3,"H"
1957-11-03,1957,"OGC Nice","AS Monaco","0-1",0,1,"1",1,1,-1,"D"
1957-11-03,1957,"RC Lens","Lille OSC","1-0",1,0,"1",1,1,1,"H"
1957-11-03,1957,"AS Saint-Etienne","Olympique Lyon","1-1",1,1,"1",1,2,0,"D"
1957-11-03,1957,"Racing Club de France","Toulouse FC","1-2",1,2,"1",1,3,-1,"D"
1957-11-03,1957,"FC Metz","FC Sochaux","1-0",1,0,"1",1,1,1,"H"
1957-11-03,1957,"Olympique Ales","Nimes Olympique","1-1",1,1,"1",1,2,0,"D"
1957-11-03,1957,"Angers SCO","US Valenciennes-Anzin","3-4",3,4,"1",1,7,-1,"D"
1957-11-03,1957,"Olympique Marseille","AS Beziers","0-1",0,1,"1",1,1,-1,"D"
1957-11-10,1957,"Stade Reims","FC Metz","5-1",5,1,"1",1,6,4,"H"
1957-11-10,1957,"RC Lens","Angers SCO","2-1",2,1,"1",1,3,1,"H"
1957-11-10,1957,"Olympique Ales","AS Monaco","1-1",1,1,"1",1,2,0,"D"
1957-11-10,1957,"AS Saint-Etienne","Olympique Marseille","1-1",1,1,"1",1,2,0,"D"
1957-11-10,1957,"FC Sochaux","Olympique Lyon","1-0",1,0,"1",1,1,1,"H"
1957-11-10,1957,"US Valenciennes-Anzin","Nimes Olympique","0-3",0,3,"1",1,3,-3,"D"
1957-11-10,1957,"OGC Nice","Racing Club de France","2-0",2,0,"1",1,2,2,"H"
1957-11-10,1957,"Toulouse FC","Lille OSC","1-2",1,2,"1",1,3,-1,"D"
1957-11-10,1957,"AS Beziers","UA Sedan-Torcy","0-2",0,2,"1",1,2,-2,"D"
1957-11-17,1957,"Nimes Olympique","Stade Reims","3-0",3,0,"1",1,3,3,"H"
1957-11-17,1957,"AS Monaco","AS Saint-Etienne","0-0",0,0,"1",1,0,0,"D"
1957-11-17,1957,"Racing Club de France","RC Lens","5-0",5,0,"1",1,5,5,"H"
1957-11-17,1957,"Olympique Lyon","AS Beziers","2-1",2,1,"1",1,3,1,"H"
1957-11-17,1957,"UA Sedan-Torcy","FC Sochaux","4-1",4,1,"1",1,5,3,"H"
1957-11-17,1957,"Toulouse FC","FC Metz","4-1",4,1,"1",1,5,3,"H"
1957-11-17,1957,"Olympique Marseille","OGC Nice","2-1",2,1,"1",1,3,1,"H"
1957-11-17,1957,"Angers SCO","Olympique Ales","1-1",1,1,"1",1,2,0,"D"
1957-11-17,1957,"Lille OSC","US Valenciennes-Anzin","2-3",2,3,"1",1,5,-1,"D"
1957-11-24,1957,"Stade Reims","Olympique Ales","4-2",4,2,"1",1,6,2,"H"
1957-11-24,1957,"RC Lens","Olympique Marseille","3-1",3,1,"1",1,4,2,"H"
1957-11-24,1957,"Olympique Lyon","AS Monaco","2-0",2,0,"1",1,2,2,"H"
1957-11-24,1957,"Nimes Olympique","Toulouse FC","3-2",3,2,"1",1,5,1,"H"
1957-11-24,1957,"UA Sedan-Torcy","AS Saint-Etienne","1-1",1,1,"1",1,2,0,"D"
1957-11-24,1957,"FC Metz","Racing Club de France","1-1",1,1,"1",1,2,0,"D"
1957-11-24,1957,"FC Sochaux","Lille OSC","2-4",2,4,"1",1,6,-2,"D"
1957-11-24,1957,"OGC Nice","Angers SCO","0-0",0,0,"1",1,0,0,"D"
1957-12-01,1957,"AS Saint-Etienne","Stade Reims","0-0",0,0,"1",1,0,0,"D"
1957-12-01,1957,"AS Monaco","RC Lens","2-1",2,1,"1",1,3,1,"H"
1957-12-01,1957,"OGC Nice","Olympique Lyon","2-2",2,2,"1",1,4,0,"D"
1957-12-01,1957,"Racing Club de France","UA Sedan-Torcy","4-2",4,2,"1",1,6,2,"H"
1957-12-01,1957,"Lille OSC","Nimes Olympique","3-1",3,1,"1",1,4,2,"H"
1957-12-01,1957,"Angers SCO","FC Sochaux","5-1",5,1,"1",1,6,4,"H"
1957-12-01,1957,"AS Beziers","Toulouse FC","2-0",2,0,"1",1,2,2,"H"
1957-12-01,1957,"Olympique Ales","FC Metz","4-1",4,1,"1",1,5,3,"H"
1957-12-01,1957,"Olympique Marseille","US Valenciennes-Anzin","1-1",1,1,"1",1,2,0,"D"
1957-12-08,1957,"Stade Reims","Racing Club de France","4-1",4,1,"1",1,5,3,"H"
1957-12-08,1957,"AS Monaco","Toulouse FC","0-2",0,2,"1",1,2,-2,"D"
1957-12-08,1957,"AS Saint-Etienne","RC Lens","3-1",3,1,"1",1,4,2,"H"
1957-12-08,1957,"FC Metz","Nimes Olympique","0-1",0,1,"1",1,1,-1,"D"
1957-12-08,1957,"US Valenciennes-Anzin","Olympique Lyon","2-0",2,0,"1",1,2,2,"H"
1957-12-08,1957,"Lille OSC","AS Beziers","10-1",10,1,"1",1,11,9,"H"
1957-12-08,1957,"FC Sochaux","OGC Nice","4-0",4,0,"1",1,4,4,"H"
1957-12-08,1957,"UA Sedan-Torcy","Angers SCO","1-0",1,0,"1",1,1,1,"H"
1957-12-08,1957,"Olympique Ales","Olympique Marseille","1-0",1,0,"1",1,1,1,"H"
1957-12-11,1957,"US Valenciennes-Anzin","AS Beziers","1-1",1,1,"1",1,2,0,"D"
1957-12-15,1957,"Olympique Marseille","Stade Reims","3-3",3,3,"1",1,6,0,"D"
1957-12-15,1957,"RC Lens","Olympique Ales","5-0",5,0,"1",1,5,5,"H"
1957-12-15,1957,"Nimes Olympique","FC Sochaux","2-0",2,0,"1",1,2,2,"H"
1957-12-15,1957,"FC Metz","AS Monaco","0-0",0,0,"1",1,0,0,"D"
1957-12-15,1957,"Angers SCO","AS Saint-Etienne","2-2",2,2,"1",1,4,0,"D"
1957-12-15,1957,"Racing Club de France","AS Beziers","1-0",1,0,"1",1,1,1,"H"
1957-12-15,1957,"Toulouse FC","US Valenciennes-Anzin","3-2",3,2,"1",1,5,1,"H"
1957-12-15,1957,"Olympique Lyon","UA Sedan-Torcy","0-3",0,3,"1",1,3,-3,"D"
1957-12-15,1957,"OGC Nice","Lille OSC","5-5",5,5,"1",1,10,0,"D"
1957-12-22,1957,"Olympique Lyon","Stade Reims","1-2",1,2,"1",1,3,-1,"D"
1957-12-22,1957,"AS Monaco","AS Beziers","2-0",2,0,"1",1,2,2,"H"
1957-12-22,1957,"Toulouse FC","AS Saint-Etienne","2-3",2,3,"1",1,5,-1,"D"
1957-12-22,1957,"FC Sochaux","RC Lens","1-0",1,0,"1",1,1,1,"H"
1957-12-22,1957,"Nimes Olympique","Racing Club de France","0-1",0,1,"1",1,1,-1,"D"
1957-12-22,1957,"Lille OSC","Olympique Ales","1-0",1,0,"1",1,1,1,"H"
1957-12-22,1957,"UA Sedan-Torcy","US Valenciennes-Anzin","2-1",2,1,"1",1,3,1,"H"
1957-12-22,1957,"Angers SCO","OGC Nice","2-1",2,1,"1",1,3,1,"H"
1957-12-22,1957,"Olympique Marseille","FC Metz","2-2",2,2,"1",1,4,0,"D"
1957-12-29,1957,"Stade Reims","Angers SCO","2-3",2,3,"1",1,5,-1,"D"
1957-12-29,1957,"US Valenciennes-Anzin","AS Monaco","0-0",0,0,"1",1,0,0,"D"
1957-12-29,1957,"AS Saint-Etienne","UA Sedan-Torcy","3-3",3,3,"1",1,6,0,"D"
1957-12-29,1957,"RC Lens","Nimes Olympique","1-1",1,1,"1",1,2,0,"D"
1957-12-29,1957,"FC Metz","Lille OSC","2-3",2,3,"1",1,5,-1,"D"
1957-12-29,1957,"Racing Club de France","Olympique Lyon","2-4",2,4,"1",1,6,-2,"D"
1957-12-29,1957,"Olympique Ales","Toulouse FC","2-0",2,0,"1",1,2,2,"H"
1957-12-29,1957,"AS Beziers","FC Sochaux","2-1",2,1,"1",1,3,1,"H"
1957-12-29,1957,"OGC Nice","Olympique Marseille","3-0",3,0,"1",1,3,3,"H"
1958-01-05,1957,"Lille OSC","Stade Reims","2-1",2,1,"1",1,3,1,"H"
1958-01-05,1957,"AS Monaco","Olympique Ales","3-1",3,1,"1",1,4,2,"H"
1958-01-05,1957,"AS Saint-Etienne","FC Metz","2-2",2,2,"1",1,4,0,"D"
1958-01-05,1957,"Nimes Olympique","Olympique Marseille","5-0",5,0,"1",1,5,5,"H"
1958-01-05,1957,"Toulouse FC","RC Lens","3-2",3,2,"1",1,5,1,"H"
1958-01-05,1957,"Angers SCO","Olympique Lyon","2-1",2,1,"1",1,3,1,"H"
1958-01-05,1957,"UA Sedan-Torcy","OGC Nice","3-2",3,2,"1",1,5,1,"H"
1958-01-05,1957,"FC Sochaux","Racing Club de France","5-0",5,0,"1",1,5,5,"H"
1958-01-05,1957,"AS Beziers","US Valenciennes-Anzin","3-1",3,1,"1",1,4,2,"H"
1958-01-19,1957,"Stade Reims","AS Monaco","1-1",1,1,"1",1,2,0,"D"
1958-01-19,1957,"US Valenciennes-Anzin","AS Saint-Etienne","0-0",0,0,"1",1,0,0,"D"
1958-01-19,1957,"Racing Club de France","Lille OSC","1-3",1,3,"1",1,4,-2,"D"
1958-01-19,1957,"OGC Nice","Nimes Olympique","2-0",2,0,"1",1,2,2,"H"
1958-01-19,1957,"Olympique Marseille","Angers SCO","1-2",1,2,"1",1,3,-1,"D"
1958-01-19,1957,"RC Lens","UA Sedan-Torcy","2-3",2,3,"1",1,5,-1,"D"
1958-01-19,1957,"Olympique Lyon","FC Sochaux","1-1",1,1,"1",1,2,0,"D"
1958-01-19,1957,"FC Metz","Toulouse FC","2-1",2,1,"1",1,3,1,"H"
1958-01-19,1957,"Olympique Ales","AS Beziers","2-0",2,0,"1",1,2,2,"H"
1958-01-26,1957,"Olympique Ales","Stade Reims","2-0",2,0,"1",1,2,2,"H"
1958-01-26,1957,"FC Sochaux","AS Monaco","1-2",1,2,"1",1,3,-1,"D"
1958-01-26,1957,"Lille OSC","Olympique Lyon","3-0",3,0,"1",1,3,3,"H"
1958-01-26,1957,"AS Beziers","Nimes Olympique","0-1",0,1,"1",1,1,-1,"D"
1958-01-26,1957,"AS Saint-Etienne","Racing Club de France","0-1",0,1,"1",1,1,-1,"D"
1958-01-26,1957,"Toulouse FC","Angers SCO","1-3",1,3,"1",1,4,-2,"D"
1958-01-26,1957,"UA Sedan-Torcy","FC Metz","6-3",6,3,"1",1,9,3,"H"
1958-01-26,1957,"OGC Nice","RC Lens","0-2",0,2,"1",1,2,-2,"D"
1958-01-26,1957,"US Valenciennes-Anzin","Olympique Marseille","2-1",2,1,"1",1,3,1,"H"
1958-02-09,1957,"RC Lens","AS Saint-Etienne","1-3",1,3,"1",1,4,-2,"D"
1958-02-09,1957,"Angers SCO","AS Beziers","3-1",3,1,"1",1,4,2,"H"
1958-02-09,1957,"Nimes Olympique","UA Sedan-Torcy","2-2",2,2,"1",1,4,0,"D"
1958-02-09,1957,"Racing Club de France","US Valenciennes-Anzin","2-2",2,2,"1",1,4,0,"D"
1958-02-09,1957,"Olympique Lyon","Toulouse FC","3-1",3,1,"1",1,4,2,"H"
1958-02-09,1957,"Olympique Marseille","Olympique Ales","1-0",1,0,"1",1,1,1,"H"
1958-02-16,1957,"Racing Club de France","Stade Reims","1-5",1,5,"1",1,6,-4,"D"
1958-02-16,1957,"AS Monaco","FC Metz","2-1",2,1,"1",1,3,1,"H"
1958-02-16,1957,"Lille OSC","Angers SCO","2-3",2,3,"1",1,5,-1,"D"
1958-02-16,1957,"UA Sedan-Torcy","AS Beziers","8-4",8,4,"1",1,12,4,"H"
1958-02-16,1957,"FC Sochaux","Nimes Olympique","1-1",1,1,"1",1,2,0,"D"
1958-02-16,1957,"Olympique Marseille","AS Saint-Etienne","1-0",1,0,"1",1,1,1,"H"
1958-02-16,1957,"Olympique Ales","RC Lens","0-1",0,1,"1",1,1,-1,"D"
1958-02-16,1957,"Olympique Lyon","OGC Nice","1-1",1,1,"1",1,2,0,"D"
1958-02-16,1957,"US Valenciennes-Anzin","Toulouse FC","2-0",2,0,"1",1,2,2,"H"
1958-02-19,1957,"Stade Reims","FC Sochaux","3-1",3,1,"1",1,4,2,"H"
1958-02-20,1957,"AS Monaco","Lille OSC","1-0",1,0,"1",1,1,1,"H"
1958-02-23,1957,"Stade Reims","Olympique Marseille","4-1",4,1,"1",1,5,3,"H"
1958-02-23,1957,"AS Saint-Etienne","AS Monaco","2-1",2,1,"1",1,3,1,"H"
1958-02-23,1957,"Angers SCO","Racing Club de France","0-0",0,0,"1",1,0,0,"D"
1958-02-23,1957,"Nimes Olympique","Lille OSC","2-0",2,0,"1",1,2,2,"H"
1958-02-23,1957,"RC Lens","US Valenciennes-Anzin","2-0",2,0,"1",1,2,2,"H"
1958-02-23,1957,"Toulouse FC","UA Sedan-Torcy","2-1",2,1,"1",1,3,1,"H"
1958-02-23,1957,"AS Beziers","Olympique Lyon","1-1",1,1,"1",1,2,0,"D"
1958-02-23,1957,"FC Metz","Olympique Ales","0-1",0,1,"1",1,1,-1,"D"
1958-02-23,1957,"OGC Nice","FC Sochaux","4-3",4,3,"1",1,7,1,"H"
1958-03-09,1957,"OGC Nice","Stade Reims","1-2",1,2,"1",1,3,-1,"D"
1958-03-09,1957,"Toulouse FC","AS Monaco","0-0",0,0,"1",1,0,0,"D"
1958-03-09,1957,"Angers SCO","FC Metz","3-1",3,1,"1",1,4,2,"H"
1958-03-09,1957,"Nimes Olympique","US Valenciennes-Anzin","5-0",5,0,"1",1,5,5,"H"
1958-03-09,1957,"UA Sedan-Torcy","Olympique Ales","5-2",5,2,"1",1,7,3,"H"
1958-03-09,1957,"FC Sochaux","AS Saint-Etienne","4-1",4,1,"1",1,5,3,"H"
1958-03-09,1957,"Olympique Lyon","RC Lens","3-1",3,1,"1",1,4,2,"H"
1958-03-09,1957,"AS Beziers","Racing Club de France","1-0",1,0,"1",1,1,1,"H"
1958-03-16,1957,"Stade Reims","Nimes Olympique","2-1",2,1,"1",1,3,1,"H"
1958-03-16,1957,"AS Monaco","UA Sedan-Torcy","1-1",1,1,"1",1,2,0,"D"
1958-03-16,1957,"Olympique Ales","Angers SCO","0-0",0,0,"1",1,0,0,"D"
1958-03-16,1957,"AS Saint-Etienne","Lille OSC","6-2",6,2,"1",1,8,4,"H"
1958-03-16,1957,"RC Lens","AS Beziers","3-1",3,1,"1",1,4,2,"H"
1958-03-16,1957,"Racing Club de France","OGC Nice","3-1",3,1,"1",1,4,2,"H"
1958-03-16,1957,"FC Metz","Olympique Lyon","2-1",2,1,"1",1,3,1,"H"
1958-03-16,1957,"US Valenciennes-Anzin","FC Sochaux","1-1",1,1,"1",1,2,0,"D"
1958-03-16,1957,"Olympique Marseille","Toulouse FC","3-0",3,0,"1",1,3,3,"H"
1958-03-23,1957,"UA Sedan-Torcy","Stade Reims","2-5",2,5,"1",1,7,-3,"D"
1958-03-23,1957,"AS Monaco","OGC Nice","1-1",1,1,"1",1,2,0,"D"
1958-03-23,1957,"Nimes Olympique","Olympique Ales","3-0",3,0,"1",1,3,3,"H"
1958-03-23,1957,"Olympique Lyon","AS Saint-Etienne","0-2",0,2,"1",1,2,-2,"D"
1958-03-23,1957,"US Valenciennes-Anzin","Angers SCO","2-1",2,1,"1",1,3,1,"H"
1958-03-23,1957,"Lille OSC","RC Lens","4-1",4,1,"1",1,5,3,"H"
1958-03-23,1957,"Toulouse FC","Racing Club de France","1-1",1,1,"1",1,2,0,"D"
1958-03-23,1957,"FC Sochaux","FC Metz","1-0",1,0,"1",1,1,1,"H"
1958-03-23,1957,"AS Beziers","Olympique Marseille","0-0",0,0,"1",1,0,0,"D"
1958-03-30,1957,"FC Metz","Stade Reims","3-1",3,1,"1",1,4,2,"H"
1958-03-30,1957,"RC Lens","AS Monaco","0-1",0,1,"1",1,1,-1,"D"
1958-03-30,1957,"Angers SCO","Nimes Olympique","1-2",1,2,"1",1,3,-1,"D"
1958-03-30,1957,"Olympique Ales","AS Saint-Etienne","0-2",0,2,"1",1,2,-2,"D"
1958-03-30,1957,"UA Sedan-Torcy","Racing Club de France","2-0",2,0,"1",1,2,2,"H"
1958-03-30,1957,"AS Beziers","Lille OSC","2-0",2,0,"1",1,2,2,"H"
1958-03-30,1957,"Toulouse FC","FC Sochaux","0-0",0,0,"1",1,0,0,"D"
1958-03-30,1957,"Olympique Lyon","Olympique Marseille","1-1",1,1,"1",1,2,0,"D"
1958-03-30,1957,"OGC Nice","US Valenciennes-Anzin","1-1",1,1,"1",1,2,0,"D"
1958-04-06,1957,"Lille OSC","Olympique Marseille","3-1",3,1,"1",1,4,2,"H"
1958-04-09,1957,"FC Metz","OGC Nice","1-1",1,1,"1",1,2,0,"D"
1958-04-13,1957,"Stade Reims","Toulouse FC","2-2",2,2,"1",1,4,0,"D"
1958-04-13,1957,"Nimes Olympique","Olympique Lyon","2-0",2,0,"1",1,2,2,"H"
1958-04-13,1957,"AS Monaco","Angers SCO","0-2",0,2,"1",1,2,-2,"D"
1958-04-13,1957,"AS Saint-Etienne","AS Beziers","1-2",1,2,"1",1,3,-1,"D"
1958-04-13,1957,"FC Sochaux","UA Sedan-Torcy","2-1",2,1,"1",1,3,1,"H"
1958-04-13,1957,"Lille OSC","OGC Nice","1-0",1,0,"1",1,1,1,"H"
1958-04-13,1957,"Olympique Marseille","RC Lens","3-2",3,2,"1",1,5,1,"H"
1958-04-13,1957,"Racing Club de France","FC Metz","1-2",1,2,"1",1,3,-1,"D"
1958-04-13,1957,"US Valenciennes-Anzin","Olympique Ales","0-0",0,0,"1",1,0,0,"D"
1958-04-20,1957,"Stade Reims","RC Lens","5-0",5,0,"1",1,5,5,"H"
1958-04-20,1957,"AS Saint-Etienne","Nimes Olympique","1-1",1,1,"1",1,2,0,"D"
1958-04-20,1957,"AS Monaco","Olympique Lyon","1-2",1,2,"1",1,3,-1,"D"
1958-04-20,1957,"Angers SCO","UA Sedan-Torcy","1-1",1,1,"1",1,2,0,"D"
1958-04-20,1957,"Lille OSC","Toulouse FC","1-3",1,3,"1",1,4,-2,"D"
1958-04-20,1957,"Olympique Ales","FC Sochaux","2-1",2,1,"1",1,3,1,"H"
1958-04-20,1957,"Racing Club de France","Olympique Marseille","4-3",4,3,"1",1,7,1,"H"
1958-04-20,1957,"AS Beziers","OGC Nice","0-1",0,1,"1",1,1,-1,"D"
1958-04-20,1957,"FC Metz","US Valenciennes-Anzin","1-0",1,0,"1",1,1,1,"H"
1958-05-01,1957,"US Valenciennes-Anzin","Stade Reims","0-6",0,6,"1",1,6,-6,"D"
1958-05-01,1957,"Nimes Olympique","FC Metz","1-1",1,1,"1",1,2,0,"D"
1958-05-01,1957,"Olympique Marseille","AS Monaco","2-1",2,1,"1",1,3,1,"H"
1958-05-01,1957,"FC Sochaux","Angers SCO","2-1",2,1,"1",1,3,1,"H"
1958-05-01,1957,"OGC Nice","AS Saint-Etienne","6-1",6,1,"1",1,7,5,"H"
1958-05-01,1957,"UA Sedan-Torcy","Lille OSC","3-2",3,2,"1",1,5,1,"H"
1958-05-01,1957,"RC Lens","Racing Club de France","1-1",1,1,"1",1,2,0,"D"
1958-05-01,1957,"Olympique Lyon","Olympique Ales","2-0",2,0,"1",1,2,2,"H"
1958-05-01,1957,"Toulouse FC","AS Beziers","3-2",3,2,"1",1,5,1,"H"
1958-05-04,1957,"AS Beziers","Stade Reims","2-0",2,0,"1",1,2,2,"H"
1958-05-04,1957,"Nimes Olympique","AS Monaco","0-0",0,0,"1",1,0,0,"D"
1958-05-04,1957,"AS Saint-Etienne","Angers SCO","0-3",0,3,"1",1,3,-3,"D"
1958-05-04,1957,"UA Sedan-Torcy","Olympique Lyon","2-3",2,3,"1",1,5,-1,"D"
1958-05-04,1957,"US Valenciennes-Anzin","Lille OSC","0-1",0,1,"1",1,1,-1,"D"
1958-05-04,1957,"Racing Club de France","Olympique Ales","3-2",3,2,"1",1,5,1,"H"
1958-05-04,1957,"RC Lens","FC Metz","2-2",2,2,"1",1,4,0,"D"
1958-05-04,1957,"FC Sochaux","Olympique Marseille","1-2",1,2,"1",1,3,-1,"D"
1958-05-04,1957,"OGC Nice","Toulouse FC","2-2",2,2,"1",1,4,0,"D"
1958-05-10,1957,"Olympique Ales","OGC Nice","1-1",1,1,"1",1,2,0,"D"
1958-05-11,1957,"Stade Reims","AS Saint-Etienne","4-0",4,0,"1",1,4,4,"H"
1958-05-11,1957,"Toulouse FC","Nimes Olympique","4-0",4,0,"1",1,4,4,"H"
1958-05-11,1957,"Angers SCO","RC Lens","5-0",5,0,"1",1,5,5,"H"
1958-05-11,1957,"AS Monaco","Racing Club de France","3-2",3,2,"1",1,5,1,"H"
1958-05-11,1957,"Olympique Marseille","UA Sedan-Torcy","1-1",1,1,"1",1,2,0,"D"
1958-05-11,1957,"Lille OSC","FC Sochaux","3-2",3,2,"1",1,5,1,"H"
1958-05-11,1957,"Olympique Lyon","US Valenciennes-Anzin","1-1",1,1,"1",1,2,0,"D"
1958-05-11,1957,"FC Metz","AS Beziers","4-0",4,0,"1",1,4,4,"H"
1958-07-21,1958,"Nimes Olympique","Racing Club de France","0-0",0,0,"1",1,0,0,"D"
1958-07-21,1958,"AS Monaco","Stade Reims","0-2",0,2,"1",1,2,-2,"D"
1958-07-21,1958,"RC Strasbourg","Olympique Ales","2-0",2,0,"1",1,2,2,"H"
1958-07-21,1958,"UA Sedan-Torcy","OGC Nice","1-0",1,0,"1",1,1,1,"H"
1958-07-21,1958,"Stade Rennes","AS Saint-Etienne","0-2",0,2,"1",1,2,-2,"D"
1958-07-21,1958,"Limoges FC","RC Lens","2-1",2,1,"1",1,3,1,"H"
1958-07-21,1958,"US Valenciennes-Anzin","Olympique Marseille","5-1",5,1,"1",1,6,4,"H"
1958-07-21,1958,"Toulouse FC","Angers SCO","1-1",1,1,"1",1,2,0,"D"
1958-07-21,1958,"Olympique Lyon","AS Nancy","1-3",1,3,"1",1,4,-2,"D"
1958-07-21,1958,"Lille OSC","FC Sochaux","3-0",3,0,"1",1,3,3,"H"
1958-08-17,1958,"RC Lens","RC Strasbourg","6-0",6,0,"1",1,6,6,"H"
1958-08-17,1958,"UA Sedan-Torcy","Racing Club de France","0-3",0,3,"1",1,3,-3,"D"
1958-08-17,1958,"AS Nancy","Stade Reims","3-5",3,5,"1",1,8,-2,"D"
1958-08-17,1958,"Olympique Marseille","OGC Nice","2-0",2,0,"1",1,2,2,"H"
1958-08-17,1958,"FC Sochaux","Olympique Ales","4-5",4,5,"1",1,9,-1,"D"
1958-08-17,1958,"Limoges FC","Olympique Lyon","1-0",1,0,"1",1,1,1,"H"
1958-08-17,1958,"AS Saint-Etienne","Nimes Olympique","0-1",0,1,"1",1,1,-1,"D"
1958-08-17,1958,"Lille OSC","Stade Rennes","4-4",4,4,"1",1,8,0,"D"
1958-08-19,1958,"Angers SCO","US Valenciennes-Anzin","4-0",4,0,"1",1,4,4,"H"
1958-08-24,1958,"AS Monaco","Olympique Lyon","4-1",4,1,"1",1,5,3,"H"
1958-08-24,1958,"Limoges FC","Olympique Marseille","1-0",1,0,"1",1,1,1,"H"
1958-08-24,1958,"Stade Rennes","RC Lens","1-1",1,1,"1",1,2,0,"D"
1958-08-24,1958,"Racing Club de France","AS Nancy","4-4",4,4,"1",1,8,0,"D"
1958-08-24,1958,"Nimes Olympique","OGC Nice","1-1",1,1,"1",1,2,0,"D"
1958-08-24,1958,"RC Strasbourg","Angers SCO","4-2",4,2,"1",1,6,2,"H"
1958-08-24,1958,"US Valenciennes-Anzin","Stade Reims","3-1",3,1,"1",1,4,2,"H"
1958-08-24,1958,"AS Saint-Etienne","Olympique Ales","1-0",1,0,"1",1,1,1,"H"
1958-08-24,1958,"UA Sedan-Torcy","Lille OSC","1-1",1,1,"1",1,2,0,"D"
1958-08-24,1958,"Toulouse FC","FC Sochaux","1-1",1,1,"1",1,2,0,"D"
1958-08-27,1958,"Lille OSC","Racing Club de France","1-6",1,6,"1",1,7,-5,"D"
1958-08-27,1958,"RC Lens","US Valenciennes-Anzin","2-0",2,0,"1",1,2,2,"H"
1958-08-27,1958,"Stade Reims","Stade Rennes","4-0",4,0,"1",1,4,4,"H"
1958-08-27,1958,"Angers SCO","UA Sedan-Torcy","3-1",3,1,"1",1,4,2,"H"
1958-08-27,1958,"Olympique Ales","AS Monaco","2-1",2,1,"1",1,3,1,"H"
1958-08-27,1958,"OGC Nice","Limoges FC","3-1",3,1,"1",1,4,2,"H"
1958-08-27,1958,"AS Nancy","RC Strasbourg","0-1",0,1,"1",1,1,-1,"D"
1958-08-27,1958,"Toulouse FC","Olympique Marseille","3-0",3,0,"1",1,3,3,"H"
1958-08-27,1958,"FC Sochaux","AS Saint-Etienne","3-1",3,1,"1",1,4,2,"H"
1958-08-27,1958,"Olympique Lyon","Nimes Olympique","2-1",2,1,"1",1,3,1,"H"
1958-08-31,1958,"Racing Club de France","RC Lens","5-0",5,0,"1",1,5,5,"H"
1958-08-31,1958,"AS Saint-Etienne","AS Monaco","3-5",3,5,"1",1,8,-2,"D"
1958-08-31,1958,"Limoges FC","Nimes Olympique","3-2",3,2,"1",1,5,1,"H"
1958-08-31,1958,"OGC Nice","Toulouse FC","3-2",3,2,"1",1,5,1,"H"
1958-08-31,1958,"Stade Rennes","Angers SCO","3-2",3,2,"1",1,5,1,"H"
1958-08-31,1958,"Olympique Marseille","FC Sochaux","0-0",0,0,"1",1,0,0,"D"
1958-08-31,1958,"Olympique Ales","Olympique Lyon","1-2",1,2,"1",1,3,-1,"D"
1958-08-31,1958,"US Valenciennes-Anzin","RC Strasbourg","4-1",4,1,"1",1,5,3,"H"
1958-08-31,1958,"UA Sedan-Torcy","AS Nancy","1-2",1,2,"1",1,3,-1,"D"
1958-09-03,1958,"Stade Reims","Lille OSC","4-3",4,3,"1",1,7,1,"H"
1958-09-04,1958,"AS Monaco","Toulouse FC","1-0",1,0,"1",1,1,1,"H"
1958-09-07,1958,"Toulouse FC","Racing Club de France","1-1",1,1,"1",1,2,0,"D"
1958-09-07,1958,"Olympique Lyon","Stade Reims","1-5",1,5,"1",1,6,-4,"D"
1958-09-07,1958,"AS Monaco","US Valenciennes-Anzin","2-1",2,1,"1",1,3,1,"H"
1958-09-07,1958,"Angers SCO","OGC Nice","1-2",1,2,"1",1,3,-1,"D"
1958-09-07,1958,"Limoges FC","AS Nancy","0-0",0,0,"1",1,0,0,"D"
1958-09-07,1958,"RC Lens","Olympique Ales","2-4",2,4,"1",1,6,-2,"D"
1958-09-07,1958,"Stade Rennes","FC Sochaux","4-0",4,0,"1",1,4,4,"H"
1958-09-07,1958,"RC Strasbourg","Olympique Marseille","3-1",3,1,"1",1,4,2,"H"
1958-09-07,1958,"Nimes Olympique","Lille OSC","3-0",3,0,"1",1,3,3,"H"
1958-09-07,1958,"UA Sedan-Torcy","AS Saint-Etienne","5-0",5,0,"1",1,5,5,"H"
1958-09-10,1958,"Angers SCO","Racing Club de France","1-2",1,2,"1",1,3,-1,"D"
1958-09-10,1958,"AS Monaco","Nimes Olympique","1-1",1,1,"1",1,2,0,"D"
1958-09-10,1958,"RC Lens","Stade Reims","2-1",2,1,"1",1,3,1,"H"
1958-09-10,1958,"Olympique Ales","OGC Nice","0-0",0,0,"1",1,0,0,"D"
1958-09-10,1958,"Lille OSC","RC Strasbourg","2-3",2,3,"1",1,5,-1,"D"
1958-09-10,1958,"UA Sedan-Torcy","Stade Rennes","1-1",1,1,"1",1,2,0,"D"
1958-09-10,1958,"FC Sochaux","Limoges FC","3-1",3,1,"1",1,4,2,"H"
1958-09-10,1958,"AS Nancy","US Valenciennes-Anzin","1-1",1,1,"1",1,2,0,"D"
1958-09-10,1958,"Olympique Marseille","Olympique Lyon","1-1",1,1,"1",1,2,0,"D"
1958-09-11,1958,"AS Saint-Etienne","Toulouse FC","4-3",4,3,"1",1,7,1,"H"
1958-09-14,1958,"Racing Club de France","Olympique Lyon","2-2",2,2,"1",1,4,0,"D"
1958-09-14,1958,"Stade Reims","Nimes Olympique","3-1",3,1,"1",1,4,2,"H"
1958-09-14,1958,"Lille OSC","AS Monaco","2-2",2,2,"1",1,4,0,"D"
1958-09-14,1958,"OGC Nice","RC Lens","3-1",3,1,"1",1,4,2,"H"
1958-09-14,1958,"AS Saint-Etienne","RC Strasbourg","1-5",1,5,"1",1,6,-4,"D"
1958-09-14,1958,"Olympique Marseille","Stade Rennes","1-3",1,3,"1",1,4,-2,"D"
1958-09-14,1958,"Olympique Ales","UA Sedan-Torcy","1-1",1,1,"1",1,2,0,"D"
1958-09-14,1958,"FC Sochaux","US Valenciennes-Anzin","1-1",1,1,"1",1,2,0,"D"
1958-09-14,1958,"Angers SCO","Limoges FC","4-0",4,0,"1",1,4,4,"H"
1958-09-14,1958,"AS Nancy","Toulouse FC","0-1",0,1,"1",1,1,-1,"D"
1958-09-24,1958,"Racing Club de France","Stade Rennes","1-0",1,0,"1",1,1,1,"H"
1958-09-24,1958,"Stade Reims","RC Strasbourg","2-3",2,3,"1",1,5,-1,"D"
1958-09-24,1958,"Limoges FC","AS Saint-Etienne","4-0",4,0,"1",1,4,4,"H"
1958-09-24,1958,"US Valenciennes-Anzin","UA Sedan-Torcy","1-1",1,1,"1",1,2,0,"D"
1958-09-24,1958,"AS Nancy","Angers SCO","3-2",3,2,"1",1,5,1,"H"
1958-09-24,1958,"RC Lens","Lille OSC","2-2",2,2,"1",1,4,0,"D"
1958-09-25,1958,"Olympique Marseille","Olympique Ales","2-1",2,1,"1",1,3,1,"H"
1958-09-25,1958,"Nimes Olympique","Toulouse FC","3-1",3,1,"1",1,4,2,"H"
1958-09-25,1958,"Olympique Lyon","OGC Nice","1-0",1,0,"1",1,1,1,"H"
1958-09-25,1958,"AS Monaco","FC Sochaux","1-0",1,0,"1",1,1,1,"H"
1958-09-27,1958,"RC Strasbourg","Stade Rennes","0-1",0,1,"1",1,1,-1,"D"
1958-09-27,1958,"Angers SCO","Stade Reims","3-0",3,0,"1",1,3,3,"H"
1958-09-27,1958,"Lille OSC","AS Nancy","2-0",2,0,"1",1,2,2,"H"
1958-09-27,1958,"AS Saint-Etienne","Olympique Marseille","4-2",4,2,"1",1,6,2,"H"
1958-09-28,1958,"Racing Club de France","US Valenciennes-Anzin","3-0",3,0,"1",1,3,3,"H"
1958-09-28,1958,"OGC Nice","AS Monaco","2-0",2,0,"1",1,2,2,"H"
1958-09-28,1958,"Olympique Ales","Nimes Olympique","0-4",0,4,"1",1,4,-4,"D"
1958-09-28,1958,"Toulouse FC","Limoges FC","2-1",2,1,"1",1,3,1,"H"
1958-09-28,1958,"UA Sedan-Torcy","RC Lens","1-2",1,2,"1",1,3,-1,"D"
1958-09-28,1958,"FC Sochaux","Olympique Lyon","5-3",5,3,"1",1,8,2,"H"
1958-10-05,1958,"OGC Nice","AS Nancy","3-0",3,0,"1",1,3,3,"H"
1958-10-05,1958,"FC Sochaux","RC Strasbourg","3-0",3,0,"1",1,3,3,"H"
1958-10-05,1958,"Stade Rennes","AS Monaco","2-1",2,1,"1",1,3,1,"H"
1958-10-05,1958,"US Valenciennes-Anzin","Nimes Olympique","0-0",0,0,"1",1,0,0,"D"
1958-10-05,1958,"AS Saint-Etienne","RC Lens","3-0",3,0,"1",1,3,3,"H"
1958-10-05,1958,"Lille OSC","Olympique Lyon","2-1",2,1,"1",1,3,1,"H"
1958-10-05,1958,"Olympique Marseille","UA Sedan-Torcy","1-1",1,1,"1",1,2,0,"D"
1958-10-12,1958,"Racing Club de France","OGC Nice","1-1",1,1,"1",1,2,0,"D"
1958-10-12,1958,"Stade Reims","Limoges FC","1-0",1,0,"1",1,1,1,"H"
1958-10-12,1958,"Nimes Olympique","Stade Rennes","3-0",3,0,"1",1,3,3,"H"
1958-10-12,1958,"AS Monaco","RC Strasbourg","2-1",2,1,"1",1,3,1,"H"
1958-10-12,1958,"UA Sedan-Torcy","FC Sochaux","0-1",0,1,"1",1,1,-1,"D"
1958-10-12,1958,"RC Lens","Olympique Marseille","4-1",4,1,"1",1,5,3,"H"
1958-10-12,1958,"Angers SCO","AS Saint-Etienne","0-1",0,1,"1",1,1,-1,"D"
1958-10-12,1958,"Toulouse FC","Lille OSC","3-1",3,1,"1",1,4,2,"H"
1958-10-12,1958,"Olympique Lyon","US Valenciennes-Anzin","2-2",2,2,"1",1,4,0,"D"
1958-10-12,1958,"AS Nancy","Olympique Ales","3-0",3,0,"1",1,3,3,"H"
1958-10-19,1958,"Olympique Ales","Racing Club de France","1-1",1,1,"1",1,2,0,"D"
1958-10-19,1958,"Stade Reims","OGC Nice","1-2",1,2,"1",1,3,-1,"D"
1958-10-19,1958,"RC Strasbourg","Nimes Olympique","1-5",1,5,"1",1,6,-4,"D"
1958-10-19,1958,"FC Sochaux","RC Lens","2-1",2,1,"1",1,3,1,"H"
1958-10-19,1958,"AS Monaco","UA Sedan-Torcy","0-3",0,3,"1",1,3,-3,"D"
1958-10-19,1958,"AS Saint-Etienne","AS Nancy","4-0",4,0,"1",1,4,4,"H"
1958-10-19,1958,"US Valenciennes-Anzin","Toulouse FC","2-0",2,0,"1",1,2,2,"H"
1958-10-19,1958,"Stade Rennes","Olympique Lyon","2-4",2,4,"1",1,6,-2,"D"
1958-10-19,1958,"Lille OSC","Limoges FC","2-0",2,0,"1",1,2,2,"H"
1958-10-19,1958,"Olympique Marseille","Angers SCO","2-3",2,3,"1",1,5,-1,"D"
1958-10-26,1958,"Olympique Ales","Angers SCO","1-3",1,3,"1",1,4,-2,"D"
1958-10-29,1958,"Stade Reims","Toulouse FC","3-1",3,1,"1",1,4,2,"H"
1958-10-30,1958,"Limoges FC","Racing Club de France","1-1",1,1,"1",1,2,0,"D"
1958-11-02,1958,"Racing Club de France","RC Strasbourg","5-2",5,2,"1",1,7,3,"H"
1958-11-02,1958,"OGC Nice","AS Saint-Etienne","1-0",1,0,"1",1,1,1,"H"
1958-11-02,1958,"Nimes Olympique","FC Sochaux","2-1",2,1,"1",1,3,1,"H"
1958-11-02,1958,"UA Sedan-Torcy","Stade Reims","0-0",0,0,"1",1,0,0,"D"
1958-11-02,1958,"Olympique Marseille","AS Monaco","0-2",0,2,"1",1,2,-2,"D"
1958-11-02,1958,"Stade Rennes","AS Nancy","3-1",3,1,"1",1,4,2,"H"
1958-11-02,1958,"RC Lens","Angers SCO","1-1",1,1,"1",1,2,0,"D"
1958-11-02,1958,"Lille OSC","US Valenciennes-Anzin","6-1",6,1,"1",1,7,5,"H"
1958-11-02,1958,"Limoges FC","Olympique Ales","2-2",2,2,"1",1,4,0,"D"
1958-11-02,1958,"Toulouse FC","Olympique Lyon","0-1",0,1,"1",1,1,-1,"D"
1958-11-09,1958,"Toulouse FC","Olympique Ales","4-2",4,2,"1",1,6,2,"H"
1958-11-11,1958,"Stade Reims","Racing Club de France","0-0",0,0,"1",1,0,0,"D"
1958-11-11,1958,"Nimes Olympique","Olympique Marseille","1-1",1,1,"1",1,2,0,"D"
1958-11-11,1958,"FC Sochaux","OGC Nice","1-0",1,0,"1",1,1,1,"H"
1958-11-11,1958,"AS Monaco","Limoges FC","0-0",0,0,"1",1,0,0,"D"
1958-11-11,1958,"Angers SCO","Lille OSC","2-0",2,0,"1",1,2,2,"H"
1958-11-11,1958,"US Valenciennes-Anzin","Stade Rennes","1-1",1,1,"1",1,2,0,"D"
1958-11-11,1958,"Olympique Lyon","AS Saint-Etienne","2-0",2,0,"1",1,2,2,"H"
1958-11-11,1958,"RC Strasbourg","UA Sedan-Torcy","1-3",1,3,"1",1,4,-2,"D"
1958-11-11,1958,"AS Nancy","RC Lens","2-1",2,1,"1",1,3,1,"H"
1958-11-16,1958,"Racing Club de France","AS Saint-Etienne","2-2",2,2,"1",1,4,0,"D"
1958-11-16,1958,"UA Sedan-Torcy","Nimes Olympique","1-2",1,2,"1",1,3,-1,"D"
1958-11-16,1958,"OGC Nice","Lille OSC","2-1",2,1,"1",1,3,1,"H"
1958-11-16,1958,"Olympique Ales","Stade Reims","3-6",3,6,"1",1,9,-3,"D"
1958-11-16,1958,"Angers SCO","FC Sochaux","1-1",1,1,"1",1,2,0,"D"
1958-11-16,1958,"Toulouse FC","Stade Rennes","1-1",1,1,"1",1,2,0,"D"
1958-11-16,1958,"Limoges FC","US Valenciennes-Anzin","1-0",1,0,"1",1,1,1,"H"
1958-11-16,1958,"Olympique Lyon","RC Strasbourg","2-2",2,2,"1",1,4,0,"D"
1958-11-16,1958,"AS Nancy","Olympique Marseille","2-2",2,2,"1",1,4,0,"D"
1958-11-23,1958,"Olympique Marseille","Racing Club de France","1-2",1,2,"1",1,3,-1,"D"
1958-11-23,1958,"Nimes Olympique","RC Lens","4-2",4,2,"1",1,6,2,"H"
1958-11-23,1958,"AS Saint-Etienne","Stade Reims","4-4",4,4,"1",1,8,0,"D"
1958-11-23,1958,"US Valenciennes-Anzin","OGC Nice","2-1",2,1,"1",1,3,1,"H"
1958-11-23,1958,"FC Sochaux","AS Nancy","2-1",2,1,"1",1,3,1,"H"
1958-11-23,1958,"AS Monaco","Angers SCO","1-0",1,0,"1",1,1,1,"H"
1958-11-23,1958,"Stade Rennes","Limoges FC","0-1",0,1,"1",1,1,-1,"D"
1958-11-23,1958,"Olympique Lyon","UA Sedan-Torcy","4-3",4,3,"1",1,7,1,"H"
1958-11-23,1958,"Lille OSC","Olympique Ales","5-0",5,0,"1",1,5,5,"H"
1958-11-23,1958,"RC Strasbourg","Toulouse FC","1-2",1,2,"1",1,3,-1,"D"
1958-11-30,1958,"Racing Club de France","FC Sochaux","0-2",0,2,"1",1,2,-2,"D"
1958-11-30,1958,"Angers SCO","Nimes Olympique","1-1",1,1,"1",1,2,0,"D"
1958-11-30,1958,"Stade Reims","Olympique Marseille","2-1",2,1,"1",1,3,1,"H"
1958-11-30,1958,"OGC Nice","Stade Rennes","2-0",2,0,"1",1,2,2,"H"
1958-11-30,1958,"AS Nancy","AS Monaco","2-2",2,2,"1",1,4,0,"D"
1958-11-30,1958,"Limoges FC","RC Strasbourg","1-2",1,2,"1",1,3,-1,"D"
1958-11-30,1958,"RC Lens","Olympique Lyon","2-1",2,1,"1",1,3,1,"H"
1958-11-30,1958,"AS Saint-Etienne","Lille OSC","1-0",1,0,"1",1,1,1,"H"
1958-11-30,1958,"UA Sedan-Torcy","Toulouse FC","1-1",1,1,"1",1,2,0,"D"
1958-11-30,1958,"Olympique Ales","US Valenciennes-Anzin","3-0",3,0,"1",1,3,3,"H"
1958-12-07,1958,"Nimes Olympique","AS Nancy","1-0",1,0,"1",1,1,1,"H"
1958-12-07,1958,"AS Monaco","Racing Club de France","4-1",4,1,"1",1,5,3,"H"
1958-12-07,1958,"RC Strasbourg","OGC Nice","2-2",2,2,"1",1,4,0,"D"
1958-12-07,1958,"Stade Reims","FC Sochaux","1-3",1,3,"1",1,4,-2,"D"
1958-12-07,1958,"Olympique Lyon","Angers SCO","1-0",1,0,"1",1,1,1,"H"
1958-12-07,1958,"Toulouse FC","RC Lens","3-1",3,1,"1",1,4,2,"H"
1958-12-07,1958,"Stade Rennes","Olympique Ales","4-2",4,2,"1",1,6,2,"H"
1958-12-07,1958,"Limoges FC","UA Sedan-Torcy","1-1",1,1,"1",1,2,0,"D"
1958-12-14,1958,"RC Strasbourg","Racing Club de France","0-2",0,2,"1",1,2,-2,"D"
1958-12-14,1958,"OGC Nice","Nimes Olympique","2-0",2,0,"1",1,2,2,"H"
1958-12-14,1958,"FC Sochaux","Toulouse FC","2-2",2,2,"1",1,4,0,"D"
1958-12-14,1958,"Stade Reims","UA Sedan-Torcy","1-1",1,1,"1",1,2,0,"D"
1958-12-14,1958,"Olympique Lyon","AS Monaco","4-1",4,1,"1",1,5,3,"H"
1958-12-14,1958,"Angers SCO","RC Lens","2-2",2,2,"1",1,4,0,"D"
1958-12-14,1958,"AS Nancy","Stade Rennes","2-1",2,1,"1",1,3,1,"H"
1958-12-14,1958,"Olympique Marseille","Limoges FC","2-0",2,0,"1",1,2,2,"H"
1958-12-14,1958,"Olympique Ales","AS Saint-Etienne","1-1",1,1,"1",1,2,0,"D"
1958-12-14,1958,"US Valenciennes-Anzin","Lille OSC","3-2",3,2,"1",1,5,1,"H"
1958-12-17,1958,"RC Lens","AS Monaco","2-1",2,1,"1",1,3,1,"H"
1958-12-21,1958,"Nimes Olympique","Olympique Lyon","4-1",4,1,"1",1,5,3,"H"
1958-12-21,1958,"Limoges FC","OGC Nice","0-2",0,2,"1",1,2,-2,"D"
1958-12-21,1958,"Racing Club de France","Stade Reims","0-1",0,1,"1",1,1,-1,"D"
1958-12-21,1958,"AS Saint-Etienne","FC Sochaux","4-3",4,3,"1",1,7,1,"H"
1958-12-21,1958,"Olympique Marseille","Toulouse FC","1-1",1,1,"1",1,2,0,"D"
1958-12-21,1958,"Stade Rennes","US Valenciennes-Anzin","4-0",4,0,"1",1,4,4,"H"
1958-12-21,1958,"Lille OSC","Angers SCO","1-1",1,1,"1",1,2,0,"D"
1958-12-21,1958,"UA Sedan-Torcy","RC Strasbourg","1-3",1,3,"1",1,4,-2,"D"
1958-12-21,1958,"RC Lens","AS Nancy","2-4",2,4,"1",1,6,-2,"D"
1958-12-28,1958,"Nimes Olympique","AS Saint-Etienne","2-1",2,1,"1",1,3,1,"H"
1958-12-28,1958,"OGC Nice","Olympique Marseille","6-1",6,1,"1",1,7,5,"H"
1958-12-28,1958,"Stade Reims","AS Nancy","7-1",7,1,"1",1,8,6,"H"
1958-12-28,1958,"Racing Club de France","UA Sedan-Torcy","1-1",1,1,"1",1,2,0,"D"
1958-12-28,1958,"Olympique Ales","FC Sochaux","2-1",2,1,"1",1,3,1,"H"
1958-12-28,1958,"Toulouse FC","AS Monaco","1-2",1,2,"1",1,3,-1,"D"
1958-12-28,1958,"Olympique Lyon","Limoges FC","2-1",2,1,"1",1,3,1,"H"
1958-12-28,1958,"Stade Rennes","Lille OSC","3-0",3,0,"1",1,3,3,"H"
1958-12-28,1958,"RC Strasbourg","RC Lens","1-0",1,0,"1",1,1,1,"H"
1958-12-28,1958,"US Valenciennes-Anzin","Angers SCO","4-0",4,0,"1",1,4,4,"H"
1959-01-01,1958,"AS Monaco","Olympique Ales","1-1",1,1,"1",1,2,0,"D"
1959-01-04,1958,"OGC Nice","UA Sedan-Torcy","3-1",3,1,"1",1,4,2,"H"
1959-01-04,1958,"Racing Club de France","Nimes Olympique","2-2",2,2,"1",1,4,0,"D"
1959-01-04,1958,"Stade Reims","AS Monaco","3-2",3,2,"1",1,5,1,"H"
1959-01-04,1958,"FC Sochaux","Lille OSC","2-3",2,3,"1",1,5,-1,"D"
1959-01-04,1958,"AS Saint-Etienne","Stade Rennes","2-2",2,2,"1",1,4,0,"D"
1959-01-04,1958,"AS Nancy","Olympique Lyon","4-3",4,3,"1",1,7,1,"H"
1959-01-04,1958,"Angers SCO","Toulouse FC","3-1",3,1,"1",1,4,2,"H"
1959-01-04,1958,"Olympique Ales","RC Strasbourg","1-0",1,0,"1",1,1,1,"H"
1959-01-04,1958,"Olympique Marseille","US Valenciennes-Anzin","3-1",3,1,"1",1,4,2,"H"
1959-01-04,1958,"RC Lens","Limoges FC","1-1",1,1,"1",1,2,0,"D"
1959-01-18,1958,"OGC Nice","Racing Club de France","3-2",3,2,"1",1,5,1,"H"
1959-01-18,1958,"Stade Rennes","Nimes Olympique","1-2",1,2,"1",1,3,-1,"D"
1959-01-18,1958,"FC Sochaux","UA Sedan-Torcy","2-2",2,2,"1",1,4,0,"D"
1959-01-18,1958,"AS Saint-Etienne","Angers SCO","1-1",1,1,"1",1,2,0,"D"
1959-01-18,1958,"Olympique Ales","AS Nancy","0-3",0,3,"1",1,3,-3,"D"
1959-01-18,1958,"Olympique Marseille","RC Lens","0-2",0,2,"1",1,2,-2,"D"
1959-01-22,1958,"US Valenciennes-Anzin","AS Saint-Etienne","3-1",3,1,"1",1,4,2,"H"
1959-01-22,1958,"Lille OSC","Olympique Marseille","2-2",2,2,"1",1,4,0,"D"
1959-01-25,1958,"AS Nancy","OGC Nice","3-6",3,6,"1",1,9,-3,"D"
1959-01-25,1958,"Nimes Olympique","US Valenciennes-Anzin","2-0",2,0,"1",1,2,2,"H"
1959-01-25,1958,"Toulouse FC","Stade Reims","1-1",1,1,"1",1,2,0,"D"
1959-01-25,1958,"Racing Club de France","Limoges FC","4-1",4,1,"1",1,5,3,"H"
1959-01-25,1958,"AS Monaco","Stade Rennes","1-0",1,0,"1",1,1,1,"H"
1959-01-25,1958,"RC Strasbourg","FC Sochaux","2-1",2,1,"1",1,3,1,"H"
1959-01-25,1958,"Olympique Lyon","Lille OSC","1-0",1,0,"1",1,1,1,"H"
1959-01-25,1958,"Angers SCO","Olympique Ales","1-0",1,0,"1",1,1,1,"H"
1959-01-25,1958,"RC Lens","AS Saint-Etienne","0-2",0,2,"1",1,2,-2,"D"
1959-01-25,1958,"UA Sedan-Torcy","Olympique Marseille","6-1",6,1,"1",1,7,5,"H"
1959-02-08,1958,"Nimes Olympique","Olympique Ales","3-0",3,0,"1",1,3,3,"H"
1959-02-08,1958,"AS Monaco","OGC Nice","1-1",1,1,"1",1,2,0,"D"
1959-02-08,1958,"Stade Reims","Angers SCO","1-1",1,1,"1",1,2,0,"D"
1959-02-08,1958,"US Valenciennes-Anzin","Racing Club de France","1-0",1,0,"1",1,1,1,"H"
1959-02-08,1958,"Olympique Lyon","FC Sochaux","2-0",2,0,"1",1,2,2,"H"
1959-02-08,1958,"Stade Rennes","RC Strasbourg","2-2",2,2,"1",1,4,0,"D"
1959-02-08,1958,"Olympique Marseille","AS Saint-Etienne","4-1",4,1,"1",1,5,3,"H"
1959-02-08,1958,"AS Nancy","Lille OSC","1-1",1,1,"1",1,2,0,"D"
1959-02-08,1958,"RC Lens","UA Sedan-Torcy","0-2",0,2,"1",1,2,-2,"D"
1959-02-08,1958,"Limoges FC","Toulouse FC","0-0",0,0,"1",1,0,0,"D"
1959-02-15,1958,"Toulouse FC","Nimes Olympique","2-4",2,4,"1",1,6,-2,"D"
1959-02-15,1958,"OGC Nice","Olympique Lyon","2-0",2,0,"1",1,2,2,"H"
1959-02-15,1958,"RC Strasbourg","Stade Reims","0-2",0,2,"1",1,2,-2,"D"
1959-02-15,1958,"Stade Rennes","Racing Club de France","0-1",0,1,"1",1,1,-1,"D"
1959-02-15,1958,"Angers SCO","AS Nancy","4-2",4,2,"1",1,6,2,"H"
1959-02-15,1958,"FC Sochaux","AS Monaco","3-2",3,2,"1",1,5,1,"H"
1959-02-15,1958,"AS Saint-Etienne","Limoges FC","2-1",2,1,"1",1,3,1,"H"
1959-02-15,1958,"UA Sedan-Torcy","US Valenciennes-Anzin","4-0",4,0,"1",1,4,4,"H"
1959-02-15,1958,"Lille OSC","RC Lens","1-1",1,1,"1",1,2,0,"D"
1959-02-15,1958,"Olympique Ales","Olympique Marseille","2-1",2,1,"1",1,3,1,"H"
1959-03-04,1958,"US Valenciennes-Anzin","Olympique Lyon","1-0",1,0,"1",1,1,1,"H"
1959-03-05,1958,"Limoges FC","Stade Reims","2-2",2,2,"1",1,4,0,"D"
1959-03-05,1958,"RC Strasbourg","AS Monaco","1-1",1,1,"1",1,2,0,"D"
1959-03-08,1958,"OGC Nice","Stade Reims","4-0",4,0,"1",1,4,4,"H"
1959-03-08,1958,"Nimes Olympique","RC Strasbourg","1-1",1,1,"1",1,2,0,"D"
1959-03-08,1958,"Racing Club de France","Olympique Ales","5-2",5,2,"1",1,7,3,"H"
1959-03-08,1958,"Angers SCO","Olympique Marseille","3-2",3,2,"1",1,5,1,"H"
1959-03-08,1958,"UA Sedan-Torcy","AS Monaco","2-2",2,2,"1",1,4,0,"D"
1959-03-08,1958,"Olympique Lyon","Stade Rennes","5-2",5,2,"1",1,7,3,"H"
1959-03-08,1958,"AS Nancy","AS Saint-Etienne","0-1",0,1,"1",1,1,-1,"D"
1959-03-08,1958,"RC Lens","FC Sochaux","3-2",3,2,"1",1,5,1,"H"
1959-03-08,1958,"Toulouse FC","US Valenciennes-Anzin","1-2",1,2,"1",1,3,-1,"D"
1959-03-08,1958,"Limoges FC","Lille OSC","5-0",5,0,"1",1,5,5,"H"
1959-03-12,1958,"Lille OSC","Toulouse FC","3-2",3,2,"1",1,5,1,"H"
1959-03-15,1958,"Lille OSC","OGC Nice","0-0",0,0,"1",1,0,0,"D"
1959-03-15,1958,"Nimes Olympique","UA Sedan-Torcy","2-2",2,2,"1",1,4,0,"D"
1959-03-15,1958,"AS Saint-Etienne","Racing Club de France","3-3",3,3,"1",1,6,0,"D"
1959-03-15,1958,"Stade Reims","Olympique Ales","1-1",1,1,"1",1,2,0,"D"
1959-03-15,1958,"AS Monaco","RC Lens","0-0",0,0,"1",1,0,0,"D"
1959-03-15,1958,"FC Sochaux","Angers SCO","2-1",2,1,"1",1,3,1,"H"
1959-03-15,1958,"RC Strasbourg","Olympique Lyon","3-0",3,0,"1",1,3,3,"H"
1959-03-15,1958,"US Valenciennes-Anzin","Limoges FC","2-3",2,3,"1",1,5,-1,"D"
1959-03-15,1958,"Stade Rennes","Toulouse FC","3-0",3,0,"1",1,3,3,"H"
1959-03-15,1958,"Olympique Marseille","AS Nancy","4-2",4,2,"1",1,6,2,"H"
1959-03-29,1958,"OGC Nice","US Valenciennes-Anzin","1-0",1,0,"1",1,1,1,"H"
1959-03-29,1958,"RC Lens","Nimes Olympique","0-1",0,1,"1",1,1,-1,"D"
1959-03-29,1958,"Racing Club de France","Olympique Marseille","2-1",2,1,"1",1,3,1,"H"
1959-03-29,1958,"Stade Reims","AS Saint-Etienne","3-0",3,0,"1",1,3,3,"H"
1959-03-29,1958,"Angers SCO","AS Monaco","0-0",0,0,"1",1,0,0,"D"
1959-03-29,1958,"AS Nancy","FC Sochaux","2-2",2,2,"1",1,4,0,"D"
1959-03-29,1958,"UA Sedan-Torcy","Olympique Lyon","3-1",3,1,"1",1,4,2,"H"
1959-03-29,1958,"Limoges FC","Stade Rennes","2-4",2,4,"1",1,6,-2,"D"
1959-03-29,1958,"Toulouse FC","RC Strasbourg","5-1",5,1,"1",1,6,4,"H"
1959-03-29,1958,"Olympique Ales","Lille OSC","1-2",1,2,"1",1,3,-1,"D"
1959-04-05,1958,"Stade Rennes","OGC Nice","0-3",0,3,"1",1,3,-3,"D"
1959-04-05,1958,"Nimes Olympique","Angers SCO","5-3",5,3,"1",1,8,2,"H"
1959-04-05,1958,"Olympique Marseille","Stade Reims","2-3",2,3,"1",1,5,-1,"D"
1959-04-05,1958,"FC Sochaux","Racing Club de France","1-1",1,1,"1",1,2,0,"D"
1959-04-05,1958,"AS Monaco","AS Nancy","1-0",1,0,"1",1,1,1,"H"
1959-04-05,1958,"Olympique Lyon","RC Lens","2-0",2,0,"1",1,2,2,"H"
1959-04-05,1958,"Lille OSC","AS Saint-Etienne","2-4",2,4,"1",1,6,-2,"D"
1959-04-05,1958,"US Valenciennes-Anzin","Olympique Ales","1-0",1,0,"1",1,1,1,"H"
1959-04-05,1958,"RC Strasbourg","Limoges FC","1-1",1,1,"1",1,2,0,"D"
1959-04-05,1958,"Toulouse FC","UA Sedan-Torcy","4-1",4,1,"1",1,5,3,"H"
1959-04-19,1958,"OGC Nice","RC Strasbourg","4-2",4,2,"1",1,6,2,"H"
1959-04-19,1958,"AS Nancy","Nimes Olympique","2-1",2,1,"1",1,3,1,"H"
1959-04-19,1958,"Racing Club de France","AS Monaco","2-0",2,0,"1",1,2,2,"H"
1959-04-19,1958,"FC Sochaux","Stade Reims","3-1",3,1,"1",1,4,2,"H"
1959-04-19,1958,"Angers SCO","Olympique Lyon","3-1",3,1,"1",1,4,2,"H"
1959-04-19,1958,"AS Saint-Etienne","US Valenciennes-Anzin","1-1",1,1,"1",1,2,0,"D"
1959-04-19,1958,"UA Sedan-Torcy","Limoges FC","3-1",3,1,"1",1,4,2,"H"
1959-04-19,1958,"Olympique Ales","Stade Rennes","0-1",0,1,"1",1,1,-1,"D"
1959-04-19,1958,"RC Lens","Toulouse FC","0-1",0,1,"1",1,1,-1,"D"
1959-04-19,1958,"Olympique Marseille","Lille OSC","0-0",0,0,"1",1,0,0,"D"
1959-04-26,1958,"OGC Nice","Olympique Ales","4-2",4,2,"1",1,6,2,"H"
1959-04-26,1958,"Nimes Olympique","AS Monaco","1-0",1,0,"1",1,1,1,"H"
1959-04-26,1958,"Racing Club de France","Angers SCO","5-0",5,0,"1",1,5,5,"H"
1959-04-26,1958,"Stade Reims","RC Lens","4-1",4,1,"1",1,5,3,"H"
1959-04-26,1958,"Limoges FC","FC Sochaux","1-2",1,2,"1",1,3,-1,"D"
1959-04-26,1958,"Stade Rennes","UA Sedan-Torcy","3-1",3,1,"1",1,4,2,"H"
1959-04-26,1958,"Olympique Lyon","Olympique Marseille","1-1",1,1,"1",1,2,0,"D"
1959-04-26,1958,"Toulouse FC","AS Saint-Etienne","2-0",2,0,"1",1,2,2,"H"
1959-04-26,1958,"US Valenciennes-Anzin","AS Nancy","1-1",1,1,"1",1,2,0,"D"
1959-04-26,1958,"RC Strasbourg","Lille OSC","2-0",2,0,"1",1,2,2,"H"
1959-05-07,1958,"AS Saint-Etienne","OGC Nice","3-4",3,4,"1",1,7,-1,"D"
1959-05-07,1958,"FC Sochaux","Nimes Olympique","3-2",3,2,"1",1,5,1,"H"
1959-05-07,1958,"AS Nancy","Racing Club de France","1-2",1,2,"1",1,3,-1,"D"
1959-05-07,1958,"Stade Reims","US Valenciennes-Anzin","2-1",2,1,"1",1,3,1,"H"
1959-05-07,1958,"AS Monaco","Olympique Marseille","2-0",2,0,"1",1,2,2,"H"
1959-05-07,1958,"Angers SCO","RC Strasbourg","2-2",2,2,"1",1,4,0,"D"
1959-05-07,1958,"Olympique Lyon","Toulouse FC","1-1",1,1,"1",1,2,0,"D"
1959-05-07,1958,"Lille OSC","UA Sedan-Torcy","0-3",0,3,"1",1,3,-3,"D"
1959-05-07,1958,"RC Lens","Stade Rennes","2-0",2,0,"1",1,2,2,"H"
1959-05-07,1958,"Olympique Ales","Limoges FC","0-2",0,2,"1",1,2,-2,"D"
1959-05-10,1958,"OGC Nice","FC Sochaux","5-0",5,0,"1",1,5,5,"H"
1959-05-10,1958,"Olympique Marseille","Nimes Olympique","0-2",0,2,"1",1,2,-2,"D"
1959-05-10,1958,"Racing Club de France","Lille OSC","7-2",7,2,"1",1,9,5,"H"
1959-05-10,1958,"Stade Rennes","Stade Reims","2-2",2,2,"1",1,4,0,"D"
1959-05-10,1958,"Limoges FC","AS Monaco","2-1",2,1,"1",1,3,1,"H"
1959-05-10,1958,"UA Sedan-Torcy","Angers SCO","2-2",2,2,"1",1,4,0,"D"
1959-05-10,1958,"AS Saint-Etienne","Olympique Lyon","2-0",2,0,"1",1,2,2,"H"
1959-05-10,1958,"US Valenciennes-Anzin","RC Lens","3-1",3,1,"1",1,4,2,"H"
1959-05-10,1958,"RC Strasbourg","AS Nancy","1-1",1,1,"1",1,2,0,"D"
1959-05-10,1958,"Olympique Ales","Toulouse FC","1-0",1,0,"1",1,1,1,"H"
1959-05-16,1958,"RC Strasbourg","US Valenciennes-Anzin","3-2",3,2,"1",1,5,1,"H"
1959-05-16,1958,"Olympique Lyon","Olympique Ales","1-1",1,1,"1",1,2,0,"D"
1959-05-17,1958,"Toulouse FC","OGC Nice","2-2",2,2,"1",1,4,0,"D"
1959-05-17,1958,"Nimes Olympique","Limoges FC","3-0",3,0,"1",1,3,3,"H"
1959-05-17,1958,"RC Lens","Racing Club de France","2-1",2,1,"1",1,3,1,"H"
1959-05-17,1958,"Lille OSC","Stade Reims","0-2",0,2,"1",1,2,-2,"D"
1959-05-17,1958,"AS Monaco","AS Saint-Etienne","0-3",0,3,"1",1,3,-3,"D"
1959-05-17,1958,"AS Nancy","UA Sedan-Torcy","0-1",0,1,"1",1,1,-1,"D"
1959-05-17,1958,"Angers SCO","Stade Rennes","0-0",0,0,"1",1,0,0,"D"
1959-05-21,1958,"FC Sochaux","Olympique Marseille","5-1",5,1,"1",1,6,4,"H"
1959-05-23,1958,"Racing Club de France","Toulouse FC","2-0",2,0,"1",1,2,2,"H"
1959-05-23,1958,"Stade Reims","Olympique Lyon","1-2",1,2,"1",1,3,-1,"D"
1959-05-23,1958,"US Valenciennes-Anzin","AS Monaco","2-2",2,2,"1",1,4,0,"D"
1959-05-24,1958,"OGC Nice","Angers SCO","0-3",0,3,"1",1,3,-3,"D"
1959-05-24,1958,"Lille OSC","Nimes Olympique","0-0",0,0,"1",1,0,0,"D"
1959-05-24,1958,"FC Sochaux","Stade Rennes","4-3",4,3,"1",1,7,1,"H"
1959-05-24,1958,"AS Saint-Etienne","UA Sedan-Torcy","2-1",2,1,"1",1,3,1,"H"
1959-05-24,1958,"Olympique Marseille","RC Strasbourg","3-3",3,3,"1",1,6,0,"D"
1959-05-24,1958,"AS Nancy","Limoges FC","0-2",0,2,"1",1,2,-2,"D"
1959-05-24,1958,"Olympique Ales","RC Lens","2-6",2,6,"1",1,8,-4,"D"
1959-05-28,1958,"Nimes Olympique","Stade Reims","2-2",2,2,"1",1,4,0,"D"
1959-05-30,1958,"US Valenciennes-Anzin","FC Sochaux","1-1",1,1,"1",1,2,0,"D"
1959-05-30,1958,"RC Strasbourg","AS Saint-Etienne","3-3",3,3,"1",1,6,0,"D"
1959-05-31,1958,"RC Lens","OGC Nice","0-0",0,0,"1",1,0,0,"D"
1959-05-31,1958,"Toulouse FC","AS Nancy","3-2",3,2,"1",1,5,1,"H"
1959-05-31,1958,"Olympique Lyon","Racing Club de France","3-2",3,2,"1",1,5,1,"H"
1959-05-31,1958,"Limoges FC","Angers SCO","2-2",2,2,"1",1,4,0,"D"
1959-05-31,1958,"AS Monaco","Lille OSC","3-0",3,0,"1",1,3,3,"H"
1959-05-31,1958,"UA Sedan-Torcy","Olympique Ales","2-0",2,0,"1",1,2,2,"H"
1959-05-31,1958,"Stade Rennes","Olympique Marseille","2-2",2,2,"1",1,4,0,"D"
1959-08-15,1959,"Stade Reims","FC Sochaux","4-1",4,1,"1",1,5,3,"H"
1959-08-15,1959,"AS Monaco","Racing Club de France","3-3",3,3,"1",1,6,0,"D"
1959-08-16,1959,"OGC Nice","RC Lens","3-0",3,0,"1",1,3,3,"H"
1959-08-16,1959,"RC Strasbourg","Nimes Olympique","1-3",1,3,"1",1,4,-2,"D"
1959-08-16,1959,"Stade Francais FC","Stade Rennes","1-2",1,2,"1",1,3,-1,"D"
1959-08-16,1959,"Sporting Toulon Var","UA Sedan-Torcy","2-1",2,1,"1",1,3,1,"H"
1959-08-16,1959,"Limoges FC","Toulouse FC","2-1",2,1,"1",1,3,1,"H"
1959-08-16,1959,"Olympique Lyon","Girondins Bordeaux","2-2",2,2,"1",1,4,0,"D"
1959-08-16,1959,"Le Havre AC","AS Saint-Etienne","0-0",0,0,"1",1,0,0,"D"
1959-08-18,1959,"Angers SCO","US Valenciennes-Anzin","1-2",1,2,"1",1,3,-1,"D"
1959-08-22,1959,"Stade Reims","US Valenciennes-Anzin","2-1",2,1,"1",1,3,1,"H"
1959-08-22,1959,"RC Lens","Limoges FC","0-0",0,0,"1",1,0,0,"D"
1959-08-22,1959,"RC Strasbourg","Stade Francais FC","2-5",2,5,"1",1,7,-3,"D"
1959-08-23,1959,"OGC Nice","FC Sochaux","3-0",3,0,"1",1,3,3,"H"
1959-08-23,1959,"Nimes Olympique","Sporting Toulon Var","4-1",4,1,"1",1,5,3,"H"
1959-08-23,1959,"Racing Club de France","Le Havre AC","9-0",9,0,"1",1,9,9,"H"
1959-08-23,1959,"Stade Rennes","Olympique Lyon","1-2",1,2,"1",1,3,-1,"D"
1959-08-23,1959,"Toulouse FC","AS Monaco","1-1",1,1,"1",1,2,0,"D"
1959-08-23,1959,"Girondins Bordeaux","Angers SCO","1-1",1,1,"1",1,2,0,"D"
1959-08-23,1959,"AS Saint-Etienne","UA Sedan-Torcy","3-3",3,3,"1",1,6,0,"D"
1959-08-29,1959,"FC Sochaux","AS Saint-Etienne","2-0",2,0,"1",1,2,2,"H"
1959-08-29,1959,"Stade Francais FC","Toulouse FC","3-1",3,1,"1",1,4,2,"H"
1959-08-30,1959,"Olympique Lyon","OGC Nice","0-2",0,2,"1",1,2,-2,"D"
1959-08-30,1959,"Limoges FC","Stade Reims","2-2",2,2,"1",1,4,0,"D"
1959-08-30,1959,"Angers SCO","Racing Club de France","0-0",0,0,"1",1,0,0,"D"
1959-08-30,1959,"RC Lens","Nimes Olympique","3-1",3,1,"1",1,4,2,"H"
1959-08-30,1959,"AS Monaco","RC Strasbourg","4-2",4,2,"1",1,6,2,"H"
1959-08-30,1959,"UA Sedan-Torcy","Girondins Bordeaux","2-3",2,3,"1",1,5,-1,"D"
1959-08-30,1959,"Sporting Toulon Var","Stade Rennes","0-1",0,1,"1",1,1,-1,"D"
1959-08-30,1959,"Le Havre AC","US Valenciennes-Anzin","3-2",3,2,"1",1,5,1,"H"
1959-09-05,1959,"FC Sochaux","Limoges FC","0-0",0,0,"1",1,0,0,"D"
1959-09-05,1959,"US Valenciennes-Anzin","Stade Francais FC","1-0",1,0,"1",1,1,1,"H"
1959-09-06,1959,"OGC Nice","UA Sedan-Torcy","3-0",3,0,"1",1,3,3,"H"
1959-09-06,1959,"Stade Reims","Toulouse FC","5-2",5,2,"1",1,7,3,"H"
1959-09-06,1959,"Racing Club de France","Sporting Toulon Var","7-1",7,1,"1",1,8,6,"H"
1959-09-06,1959,"Nimes Olympique","AS Saint-Etienne","2-0",2,0,"1",1,2,2,"H"
1959-09-06,1959,"Stade Rennes","AS Monaco","1-2",1,2,"1",1,3,-1,"D"
1959-09-06,1959,"Girondins Bordeaux","RC Lens","2-3",2,3,"1",1,5,-1,"D"
1959-09-06,1959,"Olympique Lyon","Le Havre AC","1-1",1,1,"1",1,2,0,"D"
1959-09-06,1959,"RC Strasbourg","Angers SCO","4-2",4,2,"1",1,6,2,"H"
1959-09-12,1959,"Limoges FC","US Valenciennes-Anzin","1-1",1,1,"1",1,2,0,"D"
1959-09-13,1959,"Angers SCO","OGC Nice","2-2",2,2,"1",1,4,0,"D"
1959-09-13,1959,"AS Monaco","Stade Reims","2-2",2,2,"1",1,4,0,"D"
1959-09-13,1959,"UA Sedan-Torcy","Nimes Olympique","2-3",2,3,"1",1,5,-1,"D"
1959-09-13,1959,"RC Lens","Racing Club de France","3-2",3,2,"1",1,5,1,"H"
1959-09-13,1959,"Stade Francais FC","FC Sochaux","2-1",2,1,"1",1,3,1,"H"
1959-09-13,1959,"Le Havre AC","Stade Rennes","4-2",4,2,"1",1,6,2,"H"
1959-09-13,1959,"Sporting Toulon Var","RC Strasbourg","1-4",1,4,"1",1,5,-3,"D"
1959-09-13,1959,"AS Saint-Etienne","Girondins Bordeaux","4-2",4,2,"1",1,6,2,"H"
1959-09-13,1959,"Toulouse FC","Olympique Lyon","1-0",1,0,"1",1,1,1,"H"
1959-09-16,1959,"RC Strasbourg","RC Lens","0-0",0,0,"1",1,0,0,"D"
1959-09-16,1959,"FC Sochaux","Le Havre AC","0-0",0,0,"1",1,0,0,"D"
1959-09-16,1959,"US Valenciennes-Anzin","Olympique Lyon","1-4",1,4,"1",1,5,-3,"D"
1959-09-16,1959,"Stade Reims","Stade Rennes","2-1",2,1,"1",1,3,1,"H"
1959-09-17,1959,"Nimes Olympique","AS Monaco","5-1",5,1,"1",1,6,4,"H"
1959-09-17,1959,"OGC Nice","Racing Club de France","2-5",2,5,"1",1,7,-3,"D"
1959-09-17,1959,"Stade Francais FC","Limoges FC","2-3",2,3,"1",1,5,-1,"D"
1959-09-17,1959,"Girondins Bordeaux","Sporting Toulon Var","2-1",2,1,"1",1,3,1,"H"
1959-09-17,1959,"AS Saint-Etienne","Toulouse FC","3-3",3,3,"1",1,6,0,"D"
1959-09-17,1959,"Angers SCO","UA Sedan-Torcy","0-0",0,0,"1",1,0,0,"D"
1959-09-20,1959,"RC Lens","Stade Reims","2-5",2,5,"1",1,7,-3,"D"
1959-09-20,1959,"Racing Club de France","Nimes Olympique","1-2",1,2,"1",1,3,-1,"D"
1959-09-20,1959,"Limoges FC","Girondins Bordeaux","3-0",3,0,"1",1,3,3,"H"
1959-09-20,1959,"Toulouse FC","OGC Nice","4-1",4,1,"1",1,5,3,"H"
1959-09-20,1959,"Le Havre AC","Stade Francais FC","1-2",1,2,"1",1,3,-1,"D"
1959-09-20,1959,"Olympique Lyon","Angers SCO","2-0",2,0,"1",1,2,2,"H"
1959-09-20,1959,"AS Monaco","AS Saint-Etienne","1-1",1,1,"1",1,2,0,"D"
1959-09-20,1959,"UA Sedan-Torcy","RC Strasbourg","2-2",2,2,"1",1,4,0,"D"
1959-09-20,1959,"Stade Rennes","US Valenciennes-Anzin","2-1",2,1,"1",1,3,1,"H"
1959-09-20,1959,"Sporting Toulon Var","FC Sochaux","2-2",2,2,"1",1,4,0,"D"
1959-09-26,1959,"FC Sochaux","RC Lens","1-0",1,0,"1",1,1,1,"H"
1959-09-27,1959,"Le Havre AC","Nimes Olympique","0-3",0,3,"1",1,3,-3,"D"
1959-09-27,1959,"Stade Reims","OGC Nice","2-2",2,2,"1",1,4,0,"D"
1959-09-27,1959,"Limoges FC","UA Sedan-Torcy","2-2",2,2,"1",1,4,0,"D"
1959-09-27,1959,"US Valenciennes-Anzin","Racing Club de France","1-4",1,4,"1",1,5,-3,"D"
1959-09-27,1959,"Girondins Bordeaux","RC Strasbourg","0-1",0,1,"1",1,1,-1,"D"
1959-09-27,1959,"Toulouse FC","Stade Rennes","1-2",1,2,"1",1,3,-1,"D"
1959-09-27,1959,"AS Monaco","Sporting Toulon Var","1-3",1,3,"1",1,4,-2,"D"
1959-09-27,1959,"AS Saint-Etienne","Angers SCO","1-1",1,1,"1",1,2,0,"D"
1959-09-27,1959,"Stade Francais FC","Olympique Lyon","2-1",2,1,"1",1,3,1,"H"
1959-09-30,1959,"RC Strasbourg","Stade Reims","1-3",1,3,"1",1,4,-2,"D"
1959-09-30,1959,"Racing Club de France","Girondins Bordeaux","6-1",6,1,"1",1,7,5,"H"
1959-09-30,1959,"RC Lens","Stade Francais FC","3-2",3,2,"1",1,5,1,"H"
1959-10-01,1959,"Nimes Olympique","US Valenciennes-Anzin","3-0",3,0,"1",1,3,3,"H"
1959-10-01,1959,"Stade Rennes","Limoges FC","0-2",0,2,"1",1,2,-2,"D"
1959-10-01,1959,"OGC Nice","AS Saint-Etienne","2-0",2,0,"1",1,2,2,"H"
1959-10-01,1959,"Olympique Lyon","AS Monaco","0-4",0,4,"1",1,4,-4,"D"
1959-10-01,1959,"Sporting Toulon Var","Toulouse FC","0-1",0,1,"1",1,1,-1,"D"
1959-10-01,1959,"Angers SCO","Le Havre AC","4-2",4,2,"1",1,6,2,"H"
1959-10-01,1959,"UA Sedan-Torcy","FC Sochaux","2-1",2,1,"1",1,3,1,"H"
1959-10-03,1959,"Stade Reims","Girondins Bordeaux","8-2",8,2,"1",1,10,6,"H"
1959-10-04,1959,"Nimes Olympique","OGC Nice","5-1",5,1,"1",1,6,4,"H"
1959-10-04,1959,"Limoges FC","Racing Club de France","1-0",1,0,"1",1,1,1,"H"
1959-10-04,1959,"Stade Francais FC","Sporting Toulon Var","3-1",3,1,"1",1,4,2,"H"
1959-10-04,1959,"AS Monaco","US Valenciennes-Anzin","1-0",1,0,"1",1,1,1,"H"
1959-10-04,1959,"RC Lens","Angers SCO","4-2",4,2,"1",1,6,2,"H"
1959-10-04,1959,"FC Sochaux","Olympique Lyon","1-3",1,3,"1",1,4,-2,"D"
1959-10-04,1959,"Toulouse FC","Le Havre AC","2-1",2,1,"1",1,3,1,"H"
1959-10-04,1959,"AS Saint-Etienne","RC Strasbourg","7-3",7,3,"1",1,10,4,"H"
1959-10-04,1959,"Stade Rennes","UA Sedan-Torcy","1-2",1,2,"1",1,3,-1,"D"
1959-10-11,1959,"Angers SCO","Nimes Olympique","0-0",0,0,"1",1,0,0,"D"
1959-10-11,1959,"Olympique Lyon","Limoges FC","1-0",1,0,"1",1,1,1,"H"
1959-10-11,1959,"OGC Nice","Stade Francais FC","1-3",1,3,"1",1,4,-2,"D"
1959-10-11,1959,"UA Sedan-Torcy","RC Lens","2-2",2,2,"1",1,4,0,"D"
1959-10-11,1959,"Le Havre AC","AS Monaco","2-0",2,0,"1",1,2,2,"H"
1959-10-11,1959,"US Valenciennes-Anzin","Toulouse FC","5-3",5,3,"1",1,8,2,"H"
1959-10-11,1959,"RC Strasbourg","Stade Rennes","1-1",1,1,"1",1,2,0,"D"
1959-10-11,1959,"Girondins Bordeaux","FC Sochaux","6-4",6,4,"1",1,10,2,"H"
1959-10-18,1959,"Stade Reims","UA Sedan-Torcy","1-0",1,0,"1",1,1,1,"H"
1959-10-18,1959,"Limoges FC","Nimes Olympique","2-1",2,1,"1",1,3,1,"H"
1959-10-18,1959,"Stade Francais FC","Racing Club de France","3-3",3,3,"1",1,6,0,"D"
1959-10-18,1959,"US Valenciennes-Anzin","RC Lens","0-1",0,1,"1",1,1,-1,"D"
1959-10-18,1959,"OGC Nice","AS Monaco","3-2",3,2,"1",1,5,1,"H"
1959-10-18,1959,"AS Saint-Etienne","Olympique Lyon","2-1",2,1,"1",1,3,1,"H"
1959-10-18,1959,"Toulouse FC","Girondins Bordeaux","2-1",2,1,"1",1,3,1,"H"
1959-10-18,1959,"Le Havre AC","Sporting Toulon Var","2-0",2,0,"1",1,2,2,"H"
1959-10-18,1959,"Stade Rennes","Angers SCO","2-3",2,3,"1",1,5,-1,"D"
1959-10-18,1959,"FC Sochaux","RC Strasbourg","1-1",1,1,"1",1,2,0,"D"
1959-10-21,1959,"Racing Club de France","AS Saint-Etienne","4-0",4,0,"1",1,4,4,"H"
1959-10-25,1959,"Nimes Olympique","Stade Francais FC","3-1",3,1,"1",1,4,2,"H"
1959-10-25,1959,"Olympique Lyon","Stade Reims","0-1",0,1,"1",1,1,-1,"D"
1959-10-25,1959,"AS Monaco","Limoges FC","0-0",0,0,"1",1,0,0,"D"
1959-10-25,1959,"RC Strasbourg","OGC Nice","1-4",1,4,"1",1,5,-3,"D"
1959-10-25,1959,"RC Lens","AS Saint-Etienne","0-0",0,0,"1",1,0,0,"D"
1959-10-25,1959,"Racing Club de France","Stade Rennes","0-2",0,2,"1",1,2,-2,"D"
1959-10-25,1959,"FC Sochaux","Toulouse FC","0-2",0,2,"1",1,2,-2,"D"
1959-10-25,1959,"UA Sedan-Torcy","Le Havre AC","0-3",0,3,"1",1,3,-3,"D"
1959-10-25,1959,"Angers SCO","Sporting Toulon Var","3-2",3,2,"1",1,5,1,"H"
1959-10-25,1959,"Girondins Bordeaux","US Valenciennes-Anzin","3-7",3,7,"1",1,10,-4,"D"
1959-10-28,1959,"Stade Reims","Angers SCO","6-0",6,0,"1",1,6,6,"H"
1959-10-28,1959,"Toulouse FC","Racing Club de France","1-1",1,1,"1",1,2,0,"D"
1959-10-28,1959,"US Valenciennes-Anzin","RC Strasbourg","2-0",2,0,"1",1,2,2,"H"
1959-10-29,1959,"Olympique Lyon","Nimes Olympique","1-2",1,2,"1",1,3,-1,"D"
1959-10-29,1959,"Limoges FC","OGC Nice","2-1",2,1,"1",1,3,1,"H"
1959-10-29,1959,"Le Havre AC","RC Lens","3-1",3,1,"1",1,4,2,"H"
1959-10-29,1959,"AS Monaco","Girondins Bordeaux","5-0",5,0,"1",1,5,5,"H"
1959-10-29,1959,"Stade Francais FC","UA Sedan-Torcy","1-5",1,5,"1",1,6,-4,"D"
1959-10-29,1959,"Sporting Toulon Var","AS Saint-Etienne","0-1",0,1,"1",1,1,-1,"D"
1959-10-29,1959,"Stade Rennes","FC Sochaux","0-1",0,1,"1",1,1,-1,"D"
1959-11-01,1959,"AS Saint-Etienne","Stade Reims","2-5",2,5,"1",1,7,-3,"D"
1959-11-01,1959,"Nimes Olympique","Toulouse FC","2-2",2,2,"1",1,4,0,"D"
1959-11-01,1959,"Angers SCO","Limoges FC","1-0",1,0,"1",1,1,1,"H"
1959-11-01,1959,"Racing Club de France","Olympique Lyon","4-0",4,0,"1",1,4,4,"H"
1959-11-01,1959,"OGC Nice","Sporting Toulon Var","4-2",4,2,"1",1,6,2,"H"
1959-11-01,1959,"RC Lens","Stade Rennes","1-0",1,0,"1",1,1,1,"H"
1959-11-01,1959,"RC Strasbourg","Le Havre AC","1-2",1,2,"1",1,3,-1,"D"
1959-11-01,1959,"Girondins Bordeaux","Stade Francais FC","3-3",3,3,"1",1,6,0,"D"
1959-11-01,1959,"FC Sochaux","AS Monaco","1-0",1,0,"1",1,1,1,"H"
1959-11-01,1959,"UA Sedan-Torcy","US Valenciennes-Anzin","2-2",2,2,"1",1,4,0,"D"
1959-11-08,1959,"Stade Reims","Nimes Olympique","1-2",1,2,"1",1,3,-1,"D"
1959-11-08,1959,"Limoges FC","AS Saint-Etienne","2-1",2,1,"1",1,3,1,"H"
1959-11-08,1959,"Racing Club de France","RC Strasbourg","2-2",2,2,"1",1,4,0,"D"
1959-11-08,1959,"Sporting Toulon Var","RC Lens","1-1",1,1,"1",1,2,0,"D"
1959-11-08,1959,"Le Havre AC","OGC Nice","3-1",3,1,"1",1,4,2,"H"
1959-11-08,1959,"Toulouse FC","Angers SCO","5-1",5,1,"1",1,6,4,"H"
1959-11-08,1959,"AS Monaco","Stade Francais FC","3-0",3,0,"1",1,3,3,"H"
1959-11-08,1959,"Olympique Lyon","UA Sedan-Torcy","0-1",0,1,"1",1,1,-1,"D"
1959-11-08,1959,"US Valenciennes-Anzin","FC Sochaux","1-1",1,1,"1",1,2,0,"D"
1959-11-08,1959,"Stade Rennes","Girondins Bordeaux","1-0",1,0,"1",1,1,1,"H"
1959-11-15,1959,"Nimes Olympique","FC Sochaux","2-1",2,1,"1",1,3,1,"H"
1959-11-15,1959,"Stade Francais FC","Stade Reims","0-3",0,3,"1",1,3,-3,"D"
1959-11-15,1959,"Sporting Toulon Var","Limoges FC","3-1",3,1,"1",1,4,2,"H"
1959-11-15,1959,"UA Sedan-Torcy","Racing Club de France","1-4",1,4,"1",1,5,-3,"D"
1959-11-15,1959,"RC Lens","Toulouse FC","4-0",4,0,"1",1,4,4,"H"
1959-11-15,1959,"Girondins Bordeaux","Le Havre AC","0-1",0,1,"1",1,1,-1,"D"
1959-11-15,1959,"OGC Nice","US Valenciennes-Anzin","1-1",1,1,"1",1,2,0,"D"
1959-11-15,1959,"Angers SCO","AS Monaco","1-1",1,1,"1",1,2,0,"D"
1959-11-15,1959,"AS Saint-Etienne","Stade Rennes","2-1",2,1,"1",1,3,1,"H"
1959-11-15,1959,"RC Strasbourg","Olympique Lyon","2-1",2,1,"1",1,3,1,"H"
1959-11-22,1959,"Stade Rennes","Nimes Olympique","1-1",1,1,"1",1,2,0,"D"
1959-11-22,1959,"Stade Reims","Racing Club de France","0-0",0,0,"1",1,0,0,"D"
1959-11-22,1959,"Limoges FC","Le Havre AC","0-0",0,0,"1",1,0,0,"D"
1959-11-22,1959,"Olympique Lyon","RC Lens","0-1",0,1,"1",1,1,-1,"D"
1959-11-22,1959,"Girondins Bordeaux","OGC Nice","0-3",0,3,"1",1,3,-3,"D"
1959-11-22,1959,"AS Monaco","UA Sedan-Torcy","2-1",2,1,"1",1,3,1,"H"
1959-11-22,1959,"Toulouse FC","RC Strasbourg","2-1",2,1,"1",1,3,1,"H"
1959-11-22,1959,"Stade Francais FC","AS Saint-Etienne","3-2",3,2,"1",1,5,1,"H"
1959-11-22,1959,"US Valenciennes-Anzin","Sporting Toulon Var","3-1",3,1,"1",1,4,2,"H"
1959-11-22,1959,"FC Sochaux","Angers SCO","2-0",2,0,"1",1,2,2,"H"
1959-11-26,1959,"Sporting Toulon Var","Stade Reims","1-1",1,1,"1",1,2,0,"D"
1959-11-29,1959,"Nimes Olympique","Girondins Bordeaux","4-0",4,0,"1",1,4,4,"H"
1959-11-29,1959,"Le Havre AC","Stade Reims","2-2",2,2,"1",1,4,0,"D"
1959-11-29,1959,"RC Strasbourg","Limoges FC","1-3",1,3,"1",1,4,-2,"D"
1959-11-29,1959,"Racing Club de France","FC Sochaux","8-0",8,0,"1",1,8,8,"H"
1959-11-29,1959,"OGC Nice","Stade Rennes","3-1",3,1,"1",1,4,2,"H"
1959-11-29,1959,"RC Lens","AS Monaco","1-2",1,2,"1",1,3,-1,"D"
1959-11-29,1959,"UA Sedan-Torcy","Toulouse FC","3-4",3,4,"1",1,7,-1,"D"
1959-11-29,1959,"AS Saint-Etienne","US Valenciennes-Anzin","3-1",3,1,"1",1,4,2,"H"
1959-11-29,1959,"Angers SCO","Stade Francais FC","3-0",3,0,"1",1,3,3,"H"
1959-11-29,1959,"Sporting Toulon Var","Olympique Lyon","1-1",1,1,"1",1,2,0,"D"
1959-12-06,1959,"Nimes Olympique","RC Strasbourg","2-1",2,1,"1",1,3,1,"H"
1959-12-06,1959,"Stade Rennes","Stade Reims","0-1",0,1,"1",1,1,-1,"D"
1959-12-06,1959,"Racing Club de France","RC Lens","3-0",3,0,"1",1,3,3,"H"
1959-12-06,1959,"US Valenciennes-Anzin","Limoges FC","0-0",0,0,"1",1,0,0,"D"
1959-12-06,1959,"OGC Nice","Olympique Lyon","2-1",2,1,"1",1,3,1,"H"
1959-12-06,1959,"Toulouse FC","Sporting Toulon Var","3-0",3,0,"1",1,3,3,"H"
1959-12-06,1959,"AS Saint-Etienne","Le Havre AC","3-1",3,1,"1",1,4,2,"H"
1959-12-06,1959,"Girondins Bordeaux","AS Monaco","4-2",4,2,"1",1,6,2,"H"
1959-12-06,1959,"FC Sochaux","Stade Francais FC","3-2",3,2,"1",1,5,1,"H"
1959-12-06,1959,"UA Sedan-Torcy","Angers SCO","2-0",2,0,"1",1,2,2,"H"
1959-12-19,1959,"Limoges FC","Sporting Toulon Var","2-0",2,0,"1",1,2,2,"H"
1959-12-20,1959,"AS Monaco","Nimes Olympique","0-1",0,1,"1",1,1,-1,"D"
1959-12-20,1959,"US Valenciennes-Anzin","Stade Reims","3-0",3,0,"1",1,3,3,"H"
1959-12-20,1959,"Le Havre AC","Racing Club de France","2-2",2,2,"1",1,4,0,"D"
1959-12-20,1959,"Stade Francais FC","OGC Nice","2-3",2,3,"1",1,5,-1,"D"
1959-12-20,1959,"Olympique Lyon","Toulouse FC","1-2",1,2,"1",1,3,-1,"D"
1959-12-20,1959,"RC Lens","UA Sedan-Torcy","1-1",1,1,"1",1,2,0,"D"
1959-12-20,1959,"RC Strasbourg","AS Saint-Etienne","3-0",3,0,"1",1,3,3,"H"
1959-12-20,1959,"Angers SCO","Girondins Bordeaux","4-1",4,1,"1",1,5,3,"H"
1959-12-20,1959,"FC Sochaux","Stade Rennes","2-2",2,2,"1",1,4,0,"D"
1959-12-27,1959,"Nimes Olympique","Le Havre AC","4-1",4,1,"1",1,5,3,"H"
1959-12-27,1959,"Stade Reims","Stade Francais FC","4-0",4,0,"1",1,4,4,"H"
1959-12-27,1959,"Racing Club de France","Angers SCO","4-1",4,1,"1",1,5,3,"H"
1959-12-27,1959,"UA Sedan-Torcy","Limoges FC","0-0",0,0,"1",1,0,0,"D"
1959-12-27,1959,"Toulouse FC","FC Sochaux","3-0",3,0,"1",1,3,3,"H"
1959-12-27,1959,"US Valenciennes-Anzin","OGC Nice","4-3",4,3,"1",1,7,1,"H"
1959-12-27,1959,"Sporting Toulon Var","AS Monaco","0-3",0,3,"1",1,3,-3,"D"
1959-12-27,1959,"AS Saint-Etienne","RC Lens","6-0",6,0,"1",1,6,6,"H"
1959-12-27,1959,"Stade Rennes","RC Strasbourg","4-0",4,0,"1",1,4,4,"H"
1959-12-27,1959,"Girondins Bordeaux","Olympique Lyon","2-2",2,2,"1",1,4,0,"D"
1960-01-03,1959,"Girondins Bordeaux","Nimes Olympique","1-3",1,3,"1",1,4,-2,"D"
1960-01-03,1959,"Angers SCO","Stade Reims","6-1",6,1,"1",1,7,5,"H"
1960-01-03,1959,"RC Strasbourg","Racing Club de France","2-5",2,5,"1",1,7,-3,"D"
1960-01-03,1959,"Toulouse FC","AS Saint-Etienne","2-1",2,1,"1",1,3,1,"H"
1960-01-03,1959,"Limoges FC","Stade Rennes","1-2",1,2,"1",1,3,-1,"D"
1960-01-03,1959,"RC Lens","OGC Nice","1-0",1,0,"1",1,1,1,"H"
1960-01-03,1959,"AS Monaco","Le Havre AC","0-1",0,1,"1",1,1,-1,"D"
1960-01-03,1959,"Stade Francais FC","US Valenciennes-Anzin","1-2",1,2,"1",1,3,-1,"D"
1960-01-03,1959,"UA Sedan-Torcy","Sporting Toulon Var","1-2",1,2,"1",1,3,-1,"D"
1960-01-03,1959,"Olympique Lyon","FC Sochaux","3-1",3,1,"1",1,4,2,"H"
1960-01-10,1959,"Nimes Olympique","RC Lens","0-0",0,0,"1",1,0,0,"D"
1960-01-10,1959,"Stade Reims","Limoges FC","1-0",1,0,"1",1,1,1,"H"
1960-01-10,1959,"Racing Club de France","UA Sedan-Torcy","2-3",2,3,"1",1,5,-1,"D"
1960-01-10,1959,"OGC Nice","Toulouse FC","1-0",1,0,"1",1,1,1,"H"
1960-01-10,1959,"Le Havre AC","Angers SCO","5-0",5,0,"1",1,5,5,"H"
1960-01-10,1959,"US Valenciennes-Anzin","AS Monaco","0-2",0,2,"1",1,2,-2,"D"
1960-01-10,1959,"Stade Rennes","AS Saint-Etienne","0-0",0,0,"1",1,0,0,"D"
1960-01-10,1959,"Sporting Toulon Var","Stade Francais FC","1-2",1,2,"1",1,3,-1,"D"
1960-01-10,1959,"FC Sochaux","Girondins Bordeaux","0-0",0,0,"1",1,0,0,"D"
1960-01-10,1959,"Olympique Lyon","RC Strasbourg","3-2",3,2,"1",1,5,1,"H"
1960-01-17,1959,"OGC Nice","Nimes Olympique","2-1",2,1,"1",1,3,1,"H"
1960-01-17,1959,"Toulouse FC","Stade Reims","2-2",2,2,"1",1,4,0,"D"
1960-01-17,1959,"Racing Club de France","AS Monaco","1-1",1,1,"1",1,2,0,"D"
1960-01-17,1959,"RC Lens","FC Sochaux","3-1",3,1,"1",1,4,2,"H"
1960-01-17,1959,"Sporting Toulon Var","US Valenciennes-Anzin","1-2",1,2,"1",1,3,-1,"D"
1960-01-17,1959,"AS Saint-Etienne","Stade Francais FC","1-1",1,1,"1",1,2,0,"D"
1960-01-17,1959,"UA Sedan-Torcy","Stade Rennes","2-0",2,0,"1",1,2,2,"H"
1960-01-27,1959,"Limoges FC","RC Strasbourg","8-0",8,0,"1",1,8,8,"H"
1960-01-27,1959,"Angers SCO","Olympique Lyon","1-1",1,1,"1",1,2,0,"D"
1960-01-31,1959,"Nimes Olympique","Olympique Lyon","2-2",2,2,"1",1,4,0,"D"
1960-01-31,1959,"Stade Reims","RC Lens","5-1",5,1,"1",1,6,4,"H"
1960-01-31,1959,"Girondins Bordeaux","Racing Club de France","1-5",1,5,"1",1,6,-4,"D"
1960-01-31,1959,"FC Sochaux","OGC Nice","1-2",1,2,"1",1,3,-1,"D"
1960-01-31,1959,"AS Saint-Etienne","Limoges FC","2-0",2,0,"1",1,2,2,"H"
1960-01-31,1959,"Angers SCO","Toulouse FC","2-0",2,0,"1",1,2,2,"H"
1960-01-31,1959,"US Valenciennes-Anzin","Le Havre AC","2-0",2,0,"1",1,2,2,"H"
1960-01-31,1959,"Stade Francais FC","AS Monaco","3-2",3,2,"1",1,5,1,"H"
1960-01-31,1959,"RC Strasbourg","UA Sedan-Torcy","3-3",3,3,"1",1,6,0,"D"
1960-01-31,1959,"Stade Rennes","Sporting Toulon Var","3-3",3,3,"1",1,6,0,"D"
1960-02-04,1959,"Le Havre AC","Girondins Bordeaux","2-0",2,0,"1",1,2,2,"H"
1960-02-06,1959,"AS Monaco","Angers SCO","2-1",2,1,"1",1,3,1,"H"
1960-02-07,1959,"Nimes Olympique","Stade Rennes","3-0",3,0,"1",1,3,3,"H"
1960-02-07,1959,"OGC Nice","Stade Reims","1-4",1,4,"1",1,5,-3,"D"
1960-02-07,1959,"Racing Club de France","Limoges FC","4-0",4,0,"1",1,4,4,"H"
1960-02-07,1959,"Le Havre AC","Toulouse FC","0-3",0,3,"1",1,3,-3,"D"
1960-02-07,1959,"RC Lens","Girondins Bordeaux","3-1",3,1,"1",1,4,2,"H"
1960-02-07,1959,"FC Sochaux","US Valenciennes-Anzin","0-0",0,0,"1",1,0,0,"D"
1960-02-07,1959,"UA Sedan-Torcy","AS Saint-Etienne","3-1",3,1,"1",1,4,2,"H"
1960-02-07,1959,"Olympique Lyon","Stade Francais FC","0-0",0,0,"1",1,0,0,"D"
1960-02-07,1959,"RC Strasbourg","Sporting Toulon Var","3-2",3,2,"1",1,5,1,"H"
1960-02-21,1959,"AS Saint-Etienne","Nimes Olympique","2-2",2,2,"1",1,4,0,"D"
1960-02-21,1959,"Stade Reims","RC Strasbourg","5-0",5,0,"1",1,5,5,"H"
1960-02-21,1959,"Sporting Toulon Var","Racing Club de France","1-3",1,3,"1",1,4,-2,"D"
1960-02-21,1959,"Toulouse FC","RC Lens","1-0",1,0,"1",1,1,1,"H"
1960-02-21,1959,"Limoges FC","FC Sochaux","1-0",1,0,"1",1,1,1,"H"
1960-02-21,1959,"Stade Rennes","OGC Nice","3-1",3,1,"1",1,4,2,"H"
1960-02-21,1959,"AS Monaco","Olympique Lyon","4-1",4,1,"1",1,5,3,"H"
1960-02-21,1959,"Le Havre AC","UA Sedan-Torcy","3-3",3,3,"1",1,6,0,"D"
1960-02-21,1959,"US Valenciennes-Anzin","Angers SCO","3-1",3,1,"1",1,4,2,"H"
1960-02-21,1959,"Stade Francais FC","Girondins Bordeaux","0-2",0,2,"1",1,2,-2,"D"
1960-02-27,1959,"RC Strasbourg","Toulouse FC","2-0",2,0,"1",1,2,2,"H"
1960-02-28,1959,"Sporting Toulon Var","Nimes Olympique","3-2",3,2,"1",1,5,1,"H"
1960-02-28,1959,"Limoges FC","Stade Francais FC","1-0",1,0,"1",1,1,1,"H"
1960-02-28,1959,"AS Monaco","Stade Rennes","5-0",5,0,"1",1,5,5,"H"
1960-02-28,1959,"RC Lens","Le Havre AC","1-1",1,1,"1",1,2,0,"D"
1960-02-28,1959,"Olympique Lyon","US Valenciennes-Anzin","3-0",3,0,"1",1,3,3,"H"
1960-02-28,1959,"Girondins Bordeaux","AS Saint-Etienne","0-0",0,0,"1",1,0,0,"D"
1960-02-28,1959,"Angers SCO","FC Sochaux","1-0",1,0,"1",1,1,1,"H"
1960-03-13,1959,"Nimes Olympique","UA Sedan-Torcy","2-0",2,0,"1",1,2,2,"H"
1960-03-13,1959,"Stade Reims","Olympique Lyon","3-0",3,0,"1",1,3,3,"H"
1960-03-13,1959,"AS Saint-Etienne","Racing Club de France","3-4",3,4,"1",1,7,-1,"D"
1960-03-13,1959,"Toulouse FC","US Valenciennes-Anzin","2-1",2,1,"1",1,3,1,"H"
1960-03-13,1959,"RC Strasbourg","AS Monaco","0-2",0,2,"1",1,2,-2,"D"
1960-03-13,1959,"Le Havre AC","Limoges FC","2-0",2,0,"1",1,2,2,"H"
1960-03-13,1959,"OGC Nice","Girondins Bordeaux","2-1",2,1,"1",1,3,1,"H"
1960-03-13,1959,"Stade Rennes","RC Lens","2-0",2,0,"1",1,2,2,"H"
1960-03-13,1959,"Stade Francais FC","Angers SCO","2-0",2,0,"1",1,2,2,"H"
1960-03-13,1959,"FC Sochaux","Sporting Toulon Var","1-2",1,2,"1",1,3,-1,"D"
1960-03-20,1959,"FC Sochaux","Stade Reims","1-2",1,2,"1",1,3,-1,"D"
1960-03-20,1959,"US Valenciennes-Anzin","Nimes Olympique","3-1",3,1,"1",1,4,2,"H"
1960-03-20,1959,"Racing Club de France","OGC Nice","1-2",1,2,"1",1,3,-1,"D"
1960-03-20,1959,"Toulouse FC","Limoges FC","6-0",6,0,"1",1,6,6,"H"
1960-03-20,1959,"AS Monaco","RC Lens","2-1",2,1,"1",1,3,1,"H"
1960-03-20,1959,"Le Havre AC","RC Strasbourg","2-1",2,1,"1",1,3,1,"H"
1960-03-20,1959,"Angers SCO","AS Saint-Etienne","3-3",3,3,"1",1,6,0,"D"
1960-03-20,1959,"UA Sedan-Torcy","Stade Francais FC","2-1",2,1,"1",1,3,1,"H"
1960-03-20,1959,"Girondins Bordeaux","Stade Rennes","0-1",0,1,"1",1,1,-1,"D"
1960-03-20,1959,"Olympique Lyon","Sporting Toulon Var","1-2",1,2,"1",1,3,-1,"D"
1960-03-26,1959,"RC Lens","RC Strasbourg","2-1",2,1,"1",1,3,1,"H"
1960-03-27,1959,"Stade Rennes","Toulouse FC","1-0",1,0,"1",1,1,1,"H"
1960-03-27,1959,"Stade Francais FC","Le Havre AC","0-1",0,1,"1",1,1,-1,"D"
1960-03-27,1959,"OGC Nice","Angers SCO","1-5",1,5,"1",1,6,-4,"D"
1960-03-27,1959,"Limoges FC","Olympique Lyon","0-1",0,1,"1",1,1,-1,"D"
1960-03-27,1959,"US Valenciennes-Anzin","UA Sedan-Torcy","2-1",2,1,"1",1,3,1,"H"
1960-03-27,1959,"Sporting Toulon Var","Girondins Bordeaux","2-0",2,0,"1",1,2,2,"H"
1960-04-10,1959,"UA Sedan-Torcy","Stade Reims","1-3",1,3,"1",1,4,-2,"D"
1960-04-10,1959,"Nimes Olympique","Limoges FC","2-0",2,0,"1",1,2,2,"H"
1960-04-10,1959,"Racing Club de France","Stade Francais FC","1-1",1,1,"1",1,2,0,"D"
1960-04-10,1959,"Girondins Bordeaux","Toulouse FC","3-5",3,5,"1",1,8,-2,"D"
1960-04-10,1959,"AS Monaco","OGC Nice","2-0",2,0,"1",1,2,2,"H"
1960-04-10,1959,"Sporting Toulon Var","Le Havre AC","3-3",3,3,"1",1,6,0,"D"
1960-04-10,1959,"RC Lens","US Valenciennes-Anzin","1-0",1,0,"1",1,1,1,"H"
1960-04-10,1959,"Angers SCO","Stade Rennes","2-0",2,0,"1",1,2,2,"H"
1960-04-10,1959,"Olympique Lyon","AS Saint-Etienne","0-0",0,0,"1",1,0,0,"D"
1960-04-10,1959,"RC Strasbourg","FC Sochaux","0-1",0,1,"1",1,1,-1,"D"
1960-04-13,1959,"Racing Club de France","Stade Reims","3-3",3,3,"1",1,6,0,"D"
1960-04-13,1959,"AS Saint-Etienne","FC Sochaux","0-3",0,3,"1",1,3,-3,"D"
1960-04-16,1959,"FC Sochaux","Nimes Olympique","1-1",1,1,"1",1,2,0,"D"
1960-04-16,1959,"US Valenciennes-Anzin","Girondins Bordeaux","2-2",2,2,"1",1,4,0,"D"
1960-04-17,1959,"Stade Reims","Sporting Toulon Var","3-0",3,0,"1",1,3,3,"H"
1960-04-17,1959,"Stade Rennes","Racing Club de France","3-2",3,2,"1",1,5,1,"H"
1960-04-17,1959,"Toulouse FC","UA Sedan-Torcy","1-1",1,1,"1",1,2,0,"D"
1960-04-17,1959,"AS Saint-Etienne","AS Monaco","1-0",1,0,"1",1,1,1,"H"
1960-04-17,1959,"Le Havre AC","Olympique Lyon","1-2",1,2,"1",1,3,-1,"D"
1960-04-17,1959,"Stade Francais FC","RC Lens","0-1",0,1,"1",1,1,-1,"D"
1960-04-17,1959,"Limoges FC","Angers SCO","2-0",2,0,"1",1,2,2,"H"
1960-04-17,1959,"OGC Nice","RC Strasbourg","2-3",2,3,"1",1,5,-1,"D"
1960-04-24,1959,"Nimes Olympique","Racing Club de France","0-2",0,2,"1",1,2,-2,"D"
1960-05-01,1959,"Nimes Olympique","Stade Reims","0-3",0,3,"1",1,3,-3,"D"
1960-05-01,1959,"Racing Club de France","US Valenciennes-Anzin","6-4",6,4,"1",1,10,2,"H"
1960-05-01,1959,"Toulouse FC","Stade Francais FC","1-3",1,3,"1",1,4,-2,"D"
1960-05-01,1959,"AS Monaco","FC Sochaux","1-0",1,0,"1",1,1,1,"H"
1960-05-01,1959,"Stade Rennes","Le Havre AC","2-2",2,2,"1",1,4,0,"D"
1960-05-01,1959,"RC Lens","Sporting Toulon Var","6-2",6,2,"1",1,8,4,"H"
1960-05-01,1959,"Girondins Bordeaux","Limoges FC","2-1",2,1,"1",1,3,1,"H"
1960-05-01,1959,"AS Saint-Etienne","OGC Nice","4-1",4,1,"1",1,5,3,"H"
1960-05-01,1959,"Angers SCO","RC Strasbourg","3-1",3,1,"1",1,4,2,"H"
1960-05-01,1959,"UA Sedan-Torcy","Olympique Lyon","0-0",0,0,"1",1,0,0,"D"
1960-05-04,1959,"UA Sedan-Torcy","OGC Nice","2-0",2,0,"1",1,2,2,"H"
1960-05-04,1959,"Stade Reims","AS Monaco","2-1",2,1,"1",1,3,1,"H"
1960-05-07,1959,"Stade Reims","AS Saint-Etienne","3-0",3,0,"1",1,3,3,"H"
1960-05-08,1959,"Stade Francais FC","Nimes Olympique","0-0",0,0,"1",1,0,0,"D"
1960-05-08,1959,"Olympique Lyon","Racing Club de France","0-0",0,0,"1",1,0,0,"D"
1960-05-08,1959,"AS Monaco","Toulouse FC","3-0",3,0,"1",1,3,3,"H"
1960-05-08,1959,"Limoges FC","RC Lens","1-2",1,2,"1",1,3,-1,"D"
1960-05-08,1959,"OGC Nice","Le Havre AC","2-2",2,2,"1",1,4,0,"D"
1960-05-08,1959,"US Valenciennes-Anzin","Stade Rennes","3-0",3,0,"1",1,3,3,"H"
1960-05-08,1959,"FC Sochaux","UA Sedan-Torcy","0-0",0,0,"1",1,0,0,"D"
1960-05-08,1959,"Sporting Toulon Var","Angers SCO","1-0",1,0,"1",1,1,1,"H"
1960-05-08,1959,"RC Strasbourg","Girondins Bordeaux","2-1",2,1,"1",1,3,1,"H"
1960-05-21,1959,"RC Strasbourg","US Valenciennes-Anzin","0-0",0,0,"1",1,0,0,"D"
1960-05-22,1959,"Girondins Bordeaux","Stade Reims","2-1",2,1,"1",1,3,1,"H"
1960-05-22,1959,"Nimes Olympique","Angers SCO","1-1",1,1,"1",1,2,0,"D"
1960-05-22,1959,"Racing Club de France","Toulouse FC","1-3",1,3,"1",1,4,-2,"D"
1960-05-22,1959,"RC Lens","Olympique Lyon","1-0",1,0,"1",1,1,1,"H"
1960-05-22,1959,"UA Sedan-Torcy","AS Monaco","2-1",2,1,"1",1,3,1,"H"
1960-05-22,1959,"Le Havre AC","FC Sochaux","2-2",2,2,"1",1,4,0,"D"
1960-05-22,1959,"OGC Nice","Limoges FC","3-3",3,3,"1",1,6,0,"D"
1960-05-22,1959,"AS Saint-Etienne","Sporting Toulon Var","3-1",3,1,"1",1,4,2,"H"
1960-05-22,1959,"Stade Rennes","Stade Francais FC","2-3",2,3,"1",1,5,-1,"D"
1960-05-28,1959,"Stade Reims","Le Havre AC","8-2",8,2,"1",1,10,6,"H"
1960-05-28,1959,"FC Sochaux","Racing Club de France","3-6",3,6,"1",1,9,-3,"D"
1960-05-28,1959,"Limoges FC","AS Monaco","0-2",0,2,"1",1,2,-2,"D"
1960-05-28,1959,"Angers SCO","RC Lens","4-1",4,1,"1",1,5,3,"H"
1960-05-28,1959,"US Valenciennes-Anzin","AS Saint-Etienne","2-0",2,0,"1",1,2,2,"H"
1960-05-29,1959,"Toulouse FC","Nimes Olympique","2-3",2,3,"1",1,5,-1,"D"
1960-05-29,1959,"Sporting Toulon Var","OGC Nice","1-1",1,1,"1",1,2,0,"D"
1960-05-29,1959,"Girondins Bordeaux","UA Sedan-Torcy","1-4",1,4,"1",1,5,-3,"D"
1960-05-29,1959,"Stade Francais FC","RC Strasbourg","2-1",2,1,"1",1,3,1,"H"
1960-05-29,1959,"Olympique Lyon","Stade Rennes","0-0",0,0,"1",1,0,0,"D"
1960-08-20,1960,"OGC Nice","Grenoble Foot 38","4-2",4,2,"1",1,6,2,"H"
1960-08-20,1960,"Stade Reims","Olympique Lyon","2-0",2,0,"1",1,2,2,"H"
1960-08-20,1960,"FC Rouen","Angers SCO","1-0",1,0,"1",1,1,1,"H"
1960-08-21,1960,"UA Sedan-Torcy","Stade Francais FC","4-0",4,0,"1",1,4,4,"H"
1960-08-21,1960,"AS Troyes-Savinienne","US Valenciennes-Anzin","0-2",0,2,"1",1,2,-2,"D"
1960-08-21,1960,"Stade Rennes","Toulouse FC","3-2",3,2,"1",1,5,1,"H"
1960-08-21,1960,"AS Saint-Etienne","Nimes Olympique","2-1",2,1,"1",1,3,1,"H"
1960-08-21,1960,"RC Lens","AS Monaco","0-1",0,1,"1",1,1,-1,"D"
1960-08-21,1960,"Racing Club de France","Le Havre AC","4-4",4,4,"1",1,8,0,"D"
1960-08-21,1960,"Limoges FC","AS Nancy","0-0",0,0,"1",1,0,0,"D"
1960-08-24,1960,"Stade Reims","US Valenciennes-Anzin","4-0",4,0,"1",1,4,4,"H"
1960-08-27,1960,"UA Sedan-Torcy","FC Rouen","4-0",4,0,"1",1,4,4,"H"
1960-08-27,1960,"AS Monaco","Nimes Olympique","3-0",3,0,"1",1,3,3,"H"
1960-08-27,1960,"Grenoble Foot 38","Le Havre AC","0-1",0,1,"1",1,1,-1,"D"
1960-08-27,1960,"Olympique Lyon","Stade Rennes","4-0",4,0,"1",1,4,4,"H"
1960-08-27,1960,"Stade Francais FC","AS Saint-Etienne","5-0",5,0,"1",1,5,5,"H"
1960-08-28,1960,"Toulouse FC","Limoges FC","2-1",2,1,"1",1,3,1,"H"
1960-08-28,1960,"RC Lens","AS Troyes-Savinienne","1-0",1,0,"1",1,1,1,"H"
1960-08-28,1960,"AS Nancy","OGC Nice","3-3",3,3,"1",1,6,0,"D"
1960-08-31,1960,"Angers SCO","Racing Club de France","0-3",0,3,"1",1,3,-3,"D"
1960-09-03,1960,"OGC Nice","RC Lens","1-0",1,0,"1",1,1,1,"H"
1960-09-03,1960,"FC Rouen","Olympique Lyon","0-1",0,1,"1",1,1,-1,"D"
1960-09-04,1960,"Limoges FC","AS Monaco","1-5",1,5,"1",1,6,-4,"D"
1960-09-04,1960,"Racing Club de France","Grenoble Foot 38","6-3",6,3,"1",1,9,3,"H"
1960-09-04,1960,"Stade Rennes","Stade Reims","2-2",2,2,"1",1,4,0,"D"
1960-09-04,1960,"Le Havre AC","UA Sedan-Torcy","1-0",1,0,"1",1,1,1,"H"
1960-09-04,1960,"US Valenciennes-Anzin","Toulouse FC","1-2",1,2,"1",1,3,-1,"D"
1960-09-04,1960,"AS Saint-Etienne","AS Nancy","1-1",1,1,"1",1,2,0,"D"
1960-09-04,1960,"Nimes Olympique","Stade Francais FC","4-3",4,3,"1",1,7,1,"H"
1960-09-04,1960,"AS Troyes-Savinienne","Angers SCO","1-2",1,2,"1",1,3,-1,"D"
1960-09-10,1960,"AS Monaco","FC Rouen","1-0",1,0,"1",1,1,1,"H"
1960-09-10,1960,"Olympique Lyon","OGC Nice","4-3",4,3,"1",1,7,1,"H"
1960-09-10,1960,"UA Sedan-Torcy","AS Saint-Etienne","2-2",2,2,"1",1,4,0,"D"
1960-09-10,1960,"Angers SCO","Nimes Olympique","4-2",4,2,"1",1,6,2,"H"
1960-09-11,1960,"Limoges FC","Racing Club de France","0-1",0,1,"1",1,1,-1,"D"
1960-09-11,1960,"RC Lens","Stade Reims","2-0",2,0,"1",1,2,2,"H"
1960-09-11,1960,"Toulouse FC","AS Troyes-Savinienne","3-3",3,3,"1",1,6,0,"D"
1960-09-11,1960,"Le Havre AC","US Valenciennes-Anzin","0-1",0,1,"1",1,1,-1,"D"
1960-09-11,1960,"Stade Francais FC","Stade Rennes","3-1",3,1,"1",1,4,2,"H"
1960-09-11,1960,"AS Nancy","Grenoble Foot 38","1-1",1,1,"1",1,2,0,"D"
1960-09-14,1960,"Stade Reims","Toulouse FC","4-2",4,2,"1",1,6,2,"H"
1960-09-14,1960,"Angers SCO","UA Sedan-Torcy","0-0",0,0,"1",1,0,0,"D"
1960-09-14,1960,"OGC Nice","Le Havre AC","3-3",3,3,"1",1,6,0,"D"
1960-09-14,1960,"Grenoble Foot 38","Stade Francais FC","1-0",1,0,"1",1,1,1,"H"
1960-09-14,1960,"FC Rouen","AS Nancy","3-1",3,1,"1",1,4,2,"H"
1960-09-14,1960,"Limoges FC","US Valenciennes-Anzin","2-1",2,1,"1",1,3,1,"H"
1960-09-15,1960,"AS Saint-Etienne","AS Monaco","0-1",0,1,"1",1,1,-1,"D"
1960-09-15,1960,"Racing Club de France","Olympique Lyon","3-2",3,2,"1",1,5,1,"H"
1960-09-15,1960,"Nimes Olympique","RC Lens","1-2",1,2,"1",1,3,-1,"D"
1960-09-15,1960,"AS Troyes-Savinienne","Stade Rennes","2-3",2,3,"1",1,5,-1,"D"
1960-09-17,1960,"Stade Francais FC","OGC Nice","1-3",1,3,"1",1,4,-2,"D"
1960-09-18,1960,"AS Nancy","Racing Club de France","1-1",1,1,"1",1,2,0,"D"
1960-09-18,1960,"US Valenciennes-Anzin","Olympique Lyon","1-2",1,2,"1",1,3,-1,"D"
1960-09-18,1960,"Le Havre AC","Stade Reims","2-1",2,1,"1",1,3,1,"H"
1960-09-18,1960,"Toulouse FC","FC Rouen","2-0",2,0,"1",1,2,2,"H"
1960-09-18,1960,"Stade Rennes","Limoges FC","3-2",3,2,"1",1,5,1,"H"
1960-09-18,1960,"UA Sedan-Torcy","Nimes Olympique","1-3",1,3,"1",1,4,-2,"D"
1960-09-18,1960,"RC Lens","AS Saint-Etienne","1-3",1,3,"1",1,4,-2,"D"
1960-09-18,1960,"Grenoble Foot 38","AS Troyes-Savinienne","1-0",1,0,"1",1,1,1,"H"
1960-09-24,1960,"FC Rouen","Nimes Olympique","2-1",2,1,"1",1,3,1,"H"
1960-09-25,1960,"Stade Rennes","Grenoble Foot 38","1-0",1,0,"1",1,1,1,"H"
1960-09-25,1960,"US Valenciennes-Anzin","UA Sedan-Torcy","1-3",1,3,"1",1,4,-2,"D"
1960-09-25,1960,"Limoges FC","Olympique Lyon","3-1",3,1,"1",1,4,2,"H"
1960-09-25,1960,"Toulouse FC","AS Nancy","2-2",2,2,"1",1,4,0,"D"
1960-09-25,1960,"AS Troyes-Savinienne","Le Havre AC","4-3",4,3,"1",1,7,1,"H"
1960-09-25,1960,"Stade Francais FC","RC Lens","0-0",0,0,"1",1,0,0,"D"
1960-10-02,1960,"AS Monaco","OGC Nice","5-1",5,1,"1",1,6,4,"H"
1960-10-02,1960,"Racing Club de France","Stade Francais FC","3-1",3,1,"1",1,4,2,"H"
1960-10-02,1960,"Angers SCO","Stade Rennes","1-1",1,1,"1",1,2,0,"D"
1960-10-02,1960,"Stade Reims","UA Sedan-Torcy","4-3",4,3,"1",1,7,1,"H"
1960-10-02,1960,"Olympique Lyon","AS Saint-Etienne","2-2",2,2,"1",1,4,0,"D"
1960-10-02,1960,"RC Lens","US Valenciennes-Anzin","2-0",2,0,"1",1,2,2,"H"
1960-10-02,1960,"Le Havre AC","FC Rouen","0-2",0,2,"1",1,2,-2,"D"
1960-10-02,1960,"Nimes Olympique","Toulouse FC","3-0",3,0,"1",1,3,3,"H"
1960-10-02,1960,"Grenoble Foot 38","Limoges FC","2-0",2,0,"1",1,2,2,"H"
1960-10-02,1960,"AS Troyes-Savinienne","AS Nancy","2-1",2,1,"1",1,3,1,"H"
1960-10-05,1960,"AS Monaco","Angers SCO","2-0",2,0,"1",1,2,2,"H"
1960-10-09,1960,"Toulouse FC","AS Monaco","3-0",3,0,"1",1,3,3,"H"
1960-10-09,1960,"US Valenciennes-Anzin","Racing Club de France","1-3",1,3,"1",1,4,-2,"D"
1960-10-09,1960,"OGC Nice","Stade Reims","1-4",1,4,"1",1,5,-3,"D"
1960-10-09,1960,"UA Sedan-Torcy","RC Lens","0-0",0,0,"1",1,0,0,"D"
1960-10-09,1960,"FC Rouen","AS Troyes-Savinienne","1-0",1,0,"1",1,1,1,"H"
1960-10-09,1960,"Nimes Olympique","Stade Rennes","1-0",1,0,"1",1,1,1,"H"
1960-10-09,1960,"Angers SCO","Olympique Lyon","3-0",3,0,"1",1,3,3,"H"
1960-10-09,1960,"AS Nancy","Le Havre AC","0-0",0,0,"1",1,0,0,"D"
1960-10-09,1960,"AS Saint-Etienne","Grenoble Foot 38","3-1",3,1,"1",1,4,2,"H"
1960-10-09,1960,"Stade Francais FC","Limoges FC","0-1",0,1,"1",1,1,-1,"D"
1960-10-15,1960,"AS Monaco","Stade Francais FC","2-4",2,4,"1",1,6,-2,"D"
1960-10-16,1960,"Racing Club de France","UA Sedan-Torcy","2-0",2,0,"1",1,2,2,"H"
1960-10-16,1960,"Stade Reims","FC Rouen","3-1",3,1,"1",1,4,2,"H"
1960-10-16,1960,"Olympique Lyon","RC Lens","1-2",1,2,"1",1,3,-1,"D"
1960-10-16,1960,"Stade Rennes","AS Nancy","1-0",1,0,"1",1,1,1,"H"
1960-10-16,1960,"Le Havre AC","AS Saint-Etienne","2-1",2,1,"1",1,3,1,"H"
1960-10-16,1960,"Limoges FC","Angers SCO","1-3",1,3,"1",1,4,-2,"D"
1960-10-16,1960,"AS Troyes-Savinienne","Nimes Olympique","0-2",0,2,"1",1,2,-2,"D"
1960-10-16,1960,"Grenoble Foot 38","Toulouse FC","4-0",4,0,"1",1,4,4,"H"
1960-10-16,1960,"US Valenciennes-Anzin","OGC Nice","3-1",3,1,"1",1,4,2,"H"
1960-10-19,1960,"OGC Nice","Racing Club de France","0-1",0,1,"1",1,1,-1,"D"
1960-10-19,1960,"Stade Reims","AS Monaco","3-0",3,0,"1",1,3,3,"H"
1960-10-19,1960,"AS Saint-Etienne","Angers SCO","2-2",2,2,"1",1,4,0,"D"
1960-10-23,1960,"FC Rouen","Racing Club de France","0-3",0,3,"1",1,3,-3,"D"
1960-10-23,1960,"Stade Francais FC","Stade Reims","0-1",0,1,"1",1,1,-1,"D"
1960-10-23,1960,"AS Troyes-Savinienne","AS Monaco","0-1",0,1,"1",1,1,-1,"D"
1960-10-23,1960,"AS Saint-Etienne","Stade Rennes","1-3",1,3,"1",1,4,-2,"D"
1960-10-23,1960,"Angers SCO","US Valenciennes-Anzin","3-1",3,1,"1",1,4,2,"H"
1960-10-23,1960,"RC Lens","Grenoble Foot 38","1-1",1,1,"1",1,2,0,"D"
1960-10-23,1960,"Nimes Olympique","Limoges FC","3-2",3,2,"1",1,5,1,"H"
1960-10-23,1960,"Toulouse FC","Le Havre AC","4-1",4,1,"1",1,5,3,"H"
1960-10-23,1960,"UA Sedan-Torcy","OGC Nice","4-3",4,3,"1",1,7,1,"H"
1960-10-23,1960,"AS Nancy","Olympique Lyon","2-1",2,1,"1",1,3,1,"H"
1960-10-30,1960,"Grenoble Foot 38","AS Monaco","0-0",0,0,"1",1,0,0,"D"
1960-10-30,1960,"Stade Rennes","FC Rouen","0-0",0,0,"1",1,0,0,"D"
1960-10-30,1960,"OGC Nice","Nimes Olympique","0-1",0,1,"1",1,1,-1,"D"
1960-10-30,1960,"Le Havre AC","Stade Francais FC","0-0",0,0,"1",1,0,0,"D"
1960-10-30,1960,"AS Troyes-Savinienne","AS Saint-Etienne","4-0",4,0,"1",1,4,4,"H"
1960-10-30,1960,"US Valenciennes-Anzin","AS Nancy","2-1",2,1,"1",1,3,1,"H"
1960-11-01,1960,"AS Saint-Etienne","Racing Club de France","1-2",1,2,"1",1,3,-1,"D"
1960-11-01,1960,"AS Monaco","Le Havre AC","2-2",2,2,"1",1,4,0,"D"
1960-11-01,1960,"AS Nancy","Stade Reims","2-0",2,0,"1",1,2,2,"H"
1960-11-01,1960,"Nimes Olympique","Olympique Lyon","3-0",3,0,"1",1,3,3,"H"
1960-11-01,1960,"Angers SCO","OGC Nice","5-0",5,0,"1",1,5,5,"H"
1960-11-01,1960,"RC Lens","Stade Rennes","3-1",3,1,"1",1,4,2,"H"
1960-11-01,1960,"UA Sedan-Torcy","Toulouse FC","1-1",1,1,"1",1,2,0,"D"
1960-11-01,1960,"FC Rouen","Grenoble Foot 38","2-0",2,0,"1",1,2,2,"H"
1960-11-01,1960,"Stade Francais FC","US Valenciennes-Anzin","3-0",3,0,"1",1,3,3,"H"
1960-11-01,1960,"Limoges FC","AS Troyes-Savinienne","1-0",1,0,"1",1,1,1,"H"
1960-11-06,1960,"Racing Club de France","RC Lens","3-2",3,2,"1",1,5,1,"H"
1960-11-06,1960,"US Valenciennes-Anzin","AS Monaco","1-3",1,3,"1",1,4,-2,"D"
1960-11-06,1960,"Stade Reims","Nimes Olympique","5-1",5,1,"1",1,6,4,"H"
1960-11-06,1960,"AS Nancy","Angers SCO","0-2",0,2,"1",1,2,-2,"D"
1960-11-06,1960,"Stade Rennes","UA Sedan-Torcy","2-0",2,0,"1",1,2,2,"H"
1960-11-06,1960,"Le Havre AC","Limoges FC","2-1",2,1,"1",1,3,1,"H"
1960-11-06,1960,"Toulouse FC","AS Saint-Etienne","0-1",0,1,"1",1,1,-1,"D"
1960-11-06,1960,"OGC Nice","FC Rouen","3-0",3,0,"1",1,3,3,"H"
1960-11-06,1960,"Olympique Lyon","Grenoble Foot 38","1-1",1,1,"1",1,2,0,"D"
1960-11-06,1960,"AS Troyes-Savinienne","Stade Francais FC","5-3",5,3,"1",1,8,2,"H"
1960-11-11,1960,"AS Troyes-Savinienne","Racing Club de France","1-4",1,4,"1",1,5,-3,"D"
1960-11-11,1960,"AS Monaco","Stade Rennes","3-0",3,0,"1",1,3,3,"H"
1960-11-11,1960,"Grenoble Foot 38","Stade Reims","3-2",3,2,"1",1,5,1,"H"
1960-11-11,1960,"Angers SCO","Le Havre AC","1-0",1,0,"1",1,1,1,"H"
1960-11-11,1960,"Nimes Olympique","US Valenciennes-Anzin","2-0",2,0,"1",1,2,2,"H"
1960-11-11,1960,"RC Lens","Toulouse FC","3-1",3,1,"1",1,4,2,"H"
1960-11-11,1960,"FC Rouen","Limoges FC","3-1",3,1,"1",1,4,2,"H"
1960-11-11,1960,"UA Sedan-Torcy","AS Nancy","2-1",2,1,"1",1,3,1,"H"
1960-11-11,1960,"AS Saint-Etienne","OGC Nice","0-0",0,0,"1",1,0,0,"D"
1960-11-11,1960,"Stade Francais FC","Olympique Lyon","3-1",3,1,"1",1,4,2,"H"
1960-11-13,1960,"Racing Club de France","Stade Rennes","0-2",0,2,"1",1,2,-2,"D"
1960-11-13,1960,"Olympique Lyon","AS Monaco","2-0",2,0,"1",1,2,2,"H"
1960-11-13,1960,"Grenoble Foot 38","Angers SCO","0-0",0,0,"1",1,0,0,"D"
1960-11-13,1960,"Stade Reims","AS Saint-Etienne","0-1",0,1,"1",1,1,-1,"D"
1960-11-13,1960,"AS Nancy","RC Lens","2-2",2,2,"1",1,4,0,"D"
1960-11-13,1960,"Le Havre AC","Nimes Olympique","3-0",3,0,"1",1,3,3,"H"
1960-11-13,1960,"Limoges FC","UA Sedan-Torcy","1-2",1,2,"1",1,3,-1,"D"
1960-11-13,1960,"Toulouse FC","Stade Francais FC","1-0",1,0,"1",1,1,1,"H"
1960-11-13,1960,"US Valenciennes-Anzin","FC Rouen","2-1",2,1,"1",1,3,1,"H"
1960-11-13,1960,"OGC Nice","AS Troyes-Savinienne","1-1",1,1,"1",1,2,0,"D"
1960-11-19,1960,"AS Monaco","Racing Club de France","3-0",3,0,"1",1,3,3,"H"
1960-11-20,1960,"Limoges FC","Stade Reims","0-1",0,1,"1",1,1,-1,"D"
1960-11-20,1960,"Toulouse FC","Angers SCO","3-1",3,1,"1",1,4,2,"H"
1960-11-20,1960,"RC Lens","FC Rouen","1-0",1,0,"1",1,1,1,"H"
1960-11-20,1960,"Nimes Olympique","Grenoble Foot 38","2-2",2,2,"1",1,4,0,"D"
1960-11-20,1960,"Le Havre AC","Olympique Lyon","3-2",3,2,"1",1,5,1,"H"
1960-11-20,1960,"Stade Rennes","OGC Nice","1-2",1,2,"1",1,3,-1,"D"
1960-11-20,1960,"UA Sedan-Torcy","AS Troyes-Savinienne","4-1",4,1,"1",1,5,3,"H"
1960-11-20,1960,"AS Saint-Etienne","US Valenciennes-Anzin","1-0",1,0,"1",1,1,1,"H"
1960-11-20,1960,"Stade Francais FC","AS Nancy","0-2",0,2,"1",1,2,-2,"D"
1960-11-23,1960,"Racing Club de France","Toulouse FC","3-0",3,0,"1",1,3,3,"H"
1960-11-27,1960,"Racing Club de France","Nimes Olympique","3-2",3,2,"1",1,5,1,"H"
1960-11-27,1960,"AS Nancy","AS Monaco","0-4",0,4,"1",1,4,-4,"D"
1960-11-27,1960,"AS Troyes-Savinienne","Stade Reims","1-4",1,4,"1",1,5,-3,"D"
1960-11-27,1960,"Angers SCO","Stade Francais FC","1-0",1,0,"1",1,1,1,"H"
1960-11-27,1960,"RC Lens","Le Havre AC","2-1",2,1,"1",1,3,1,"H"
1960-11-27,1960,"UA Sedan-Torcy","Grenoble Foot 38","3-0",3,0,"1",1,3,3,"H"
1960-11-27,1960,"US Valenciennes-Anzin","Stade Rennes","1-0",1,0,"1",1,1,1,"H"
1960-11-27,1960,"Olympique Lyon","Toulouse FC","1-0",1,0,"1",1,1,1,"H"
1960-11-27,1960,"FC Rouen","AS Saint-Etienne","1-0",1,0,"1",1,1,1,"H"
1960-11-27,1960,"OGC Nice","Limoges FC","2-1",2,1,"1",1,3,1,"H"
1960-12-04,1960,"Stade Reims","Racing Club de France","5-3",5,3,"1",1,8,2,"H"
1960-12-04,1960,"AS Monaco","UA Sedan-Torcy","2-0",2,0,"1",1,2,2,"H"
1960-12-04,1960,"Angers SCO","RC Lens","3-2",3,2,"1",1,5,1,"H"
1960-12-04,1960,"Stade Rennes","Le Havre AC","3-2",3,2,"1",1,5,1,"H"
1960-12-04,1960,"AS Nancy","Nimes Olympique","2-2",2,2,"1",1,4,0,"D"
1960-12-04,1960,"Stade Francais FC","FC Rouen","0-1",0,1,"1",1,1,-1,"D"
1960-12-04,1960,"Toulouse FC","OGC Nice","0-0",0,0,"1",1,0,0,"D"
1960-12-04,1960,"Limoges FC","AS Saint-Etienne","1-1",1,1,"1",1,2,0,"D"
1960-12-04,1960,"Grenoble Foot 38","US Valenciennes-Anzin","0-0",0,0,"1",1,0,0,"D"
1960-12-04,1960,"Olympique Lyon","AS Troyes-Savinienne","5-2",5,2,"1",1,7,3,"H"
1960-12-14,1960,"Stade Reims","Angers SCO","1-0",1,0,"1",1,1,1,"H"
1960-12-14,1960,"Limoges FC","RC Lens","5-2",5,2,"1",1,7,3,"H"
1960-12-14,1960,"Olympique Lyon","UA Sedan-Torcy","1-1",1,1,"1",1,2,0,"D"
1960-12-18,1960,"Racing Club de France","Angers SCO","5-3",5,3,"1",1,8,2,"H"
1960-12-18,1960,"UA Sedan-Torcy","AS Monaco","4-1",4,1,"1",1,5,3,"H"
1960-12-18,1960,"RC Lens","Limoges FC","1-1",1,1,"1",1,2,0,"D"
1960-12-18,1960,"Stade Rennes","AS Troyes-Savinienne","2-2",2,2,"1",1,4,0,"D"
1960-12-18,1960,"Le Havre AC","Toulouse FC","3-0",3,0,"1",1,3,3,"H"
1960-12-18,1960,"OGC Nice","US Valenciennes-Anzin","2-0",2,0,"1",1,2,2,"H"
1960-12-18,1960,"Grenoble Foot 38","Olympique Lyon","2-2",2,2,"1",1,4,0,"D"
1960-12-18,1960,"AS Nancy","Stade Francais FC","5-1",5,1,"1",1,6,4,"H"
1960-12-24,1960,"Olympique Lyon","Racing Club de France","4-2",4,2,"1",1,6,2,"H"
1960-12-24,1960,"AS Monaco","RC Lens","2-1",2,1,"1",1,3,1,"H"
1960-12-25,1960,"Stade Reims","Grenoble Foot 38","1-0",1,0,"1",1,1,1,"H"
1960-12-25,1960,"Toulouse FC","UA Sedan-Torcy","0-2",0,2,"1",1,2,-2,"D"
1960-12-25,1960,"Angers SCO","AS Nancy","1-2",1,2,"1",1,3,-1,"D"
1960-12-25,1960,"Stade Francais FC","Nimes Olympique","2-1",2,1,"1",1,3,1,"H"
1960-12-25,1960,"FC Rouen","Stade Rennes","1-0",1,0,"1",1,1,1,"H"
1960-12-25,1960,"Limoges FC","Le Havre AC","2-1",2,1,"1",1,3,1,"H"
1960-12-25,1960,"AS Troyes-Savinienne","OGC Nice","0-5",0,5,"1",1,5,-5,"D"
1960-12-25,1960,"US Valenciennes-Anzin","AS Saint-Etienne","3-1",3,1,"1",1,4,2,"H"
1961-01-01,1960,"Racing Club de France","US Valenciennes-Anzin","1-1",1,1,"1",1,2,0,"D"
1961-01-01,1960,"Stade Rennes","AS Monaco","1-3",1,3,"1",1,4,-2,"D"
1961-01-01,1960,"Stade Reims","Limoges FC","2-2",2,2,"1",1,4,0,"D"
1961-01-01,1960,"OGC Nice","UA Sedan-Torcy","3-1",3,1,"1",1,4,2,"H"
1961-01-01,1960,"Grenoble Foot 38","Nimes Olympique","1-2",1,2,"1",1,3,-1,"D"
1961-01-01,1960,"AS Troyes-Savinienne","FC Rouen","0-2",0,2,"1",1,2,-2,"D"
1961-01-01,1960,"Le Havre AC","AS Nancy","1-1",1,1,"1",1,2,0,"D"
1961-01-01,1960,"Toulouse FC","Olympique Lyon","2-0",2,0,"1",1,2,2,"H"
1961-01-01,1960,"AS Saint-Etienne","Stade Francais FC","2-0",2,0,"1",1,2,2,"H"
1961-01-02,1960,"RC Lens","Angers SCO","2-2",2,2,"1",1,4,0,"D"
1961-01-08,1960,"AS Monaco","Grenoble Foot 38","1-0",1,0,"1",1,1,1,"H"
1961-01-08,1960,"Stade Rennes","Racing Club de France","1-1",1,1,"1",1,2,0,"D"
1961-01-08,1960,"Angers SCO","Stade Reims","3-2",3,2,"1",1,5,1,"H"
1961-01-08,1960,"UA Sedan-Torcy","Le Havre AC","2-1",2,1,"1",1,3,1,"H"
1961-01-08,1960,"Nimes Olympique","AS Troyes-Savinienne","2-0",2,0,"1",1,2,2,"H"
1961-01-08,1960,"FC Rouen","OGC Nice","1-0",1,0,"1",1,1,1,"H"
1961-01-08,1960,"AS Saint-Etienne","RC Lens","1-0",1,0,"1",1,1,1,"H"
1961-01-08,1960,"Stade Francais FC","Toulouse FC","1-3",1,3,"1",1,4,-2,"D"
1961-01-08,1960,"AS Nancy","Limoges FC","0-0",0,0,"1",1,0,0,"D"
1961-01-08,1960,"Olympique Lyon","US Valenciennes-Anzin","0-0",0,0,"1",1,0,0,"D"
1961-01-19,1960,"AS Saint-Etienne","FC Rouen","1-1",1,1,"1",1,2,0,"D"
1961-01-22,1960,"AS Monaco","AS Troyes-Savinienne","5-0",5,0,"1",1,5,5,"H"
1961-01-22,1960,"Racing Club de France","AS Nancy","2-0",2,0,"1",1,2,2,"H"
1961-01-22,1960,"Stade Reims","RC Lens","1-0",1,0,"1",1,1,1,"H"
1961-01-22,1960,"Olympique Lyon","Angers SCO","1-1",1,1,"1",1,2,0,"D"
1961-01-22,1960,"FC Rouen","UA Sedan-Torcy","1-0",1,0,"1",1,1,1,"H"
1961-01-22,1960,"US Valenciennes-Anzin","Nimes Olympique","2-2",2,2,"1",1,4,0,"D"
1961-01-22,1960,"Le Havre AC","Stade Rennes","3-2",3,2,"1",1,5,1,"H"
1961-01-22,1960,"OGC Nice","Toulouse FC","1-1",1,1,"1",1,2,0,"D"
1961-01-22,1960,"Grenoble Foot 38","AS Saint-Etienne","1-1",1,1,"1",1,2,0,"D"
1961-01-22,1960,"Limoges FC","Stade Francais FC","4-3",4,3,"1",1,7,1,"H"
1961-01-29,1960,"AS Monaco","Olympique Lyon","3-1",3,1,"1",1,4,2,"H"
1961-01-29,1960,"Racing Club de France","FC Rouen","0-1",0,1,"1",1,1,-1,"D"
1961-01-29,1960,"Toulouse FC","Stade Reims","3-1",3,1,"1",1,4,2,"H"
1961-01-29,1960,"Angers SCO","Limoges FC","4-0",4,0,"1",1,4,4,"H"
1961-01-29,1960,"UA Sedan-Torcy","Stade Rennes","2-1",2,1,"1",1,3,1,"H"
1961-01-29,1960,"Nimes Olympique","OGC Nice","4-1",4,1,"1",1,5,3,"H"
1961-01-29,1960,"AS Saint-Etienne","AS Troyes-Savinienne","7-1",7,1,"1",1,8,6,"H"
1961-01-29,1960,"Le Havre AC","Grenoble Foot 38","1-1",1,1,"1",1,2,0,"D"
1961-01-29,1960,"RC Lens","Stade Francais FC","2-2",2,2,"1",1,4,0,"D"
1961-01-29,1960,"AS Nancy","US Valenciennes-Anzin","4-0",4,0,"1",1,4,4,"H"
1961-02-05,1960,"AS Monaco","AS Nancy","2-0",2,0,"1",1,2,2,"H"
1961-02-05,1960,"Nimes Olympique","Racing Club de France","2-2",2,2,"1",1,4,0,"D"
1961-02-05,1960,"Olympique Lyon","Stade Reims","0-2",0,2,"1",1,2,-2,"D"
1961-02-05,1960,"US Valenciennes-Anzin","Angers SCO","0-1",0,1,"1",1,1,-1,"D"
1961-02-05,1960,"FC Rouen","Toulouse FC","7-0",7,0,"1",1,7,7,"H"
1961-02-05,1960,"AS Troyes-Savinienne","UA Sedan-Torcy","3-7",3,7,"1",1,10,-4,"D"
1961-02-05,1960,"Stade Rennes","AS Saint-Etienne","2-2",2,2,"1",1,4,0,"D"
1961-02-05,1960,"Stade Francais FC","Le Havre AC","3-1",3,1,"1",1,4,2,"H"
1961-02-05,1960,"Limoges FC","OGC Nice","4-2",4,2,"1",1,6,2,"H"
1961-02-15,1960,"Nimes Olympique","Stade Reims","2-0",2,0,"1",1,2,2,"H"
1961-02-19,1960,"Stade Francais FC","AS Monaco","1-1",1,1,"1",1,2,0,"D"
1961-02-19,1960,"RC Lens","Racing Club de France","1-3",1,3,"1",1,4,-2,"D"
1961-02-19,1960,"Stade Reims","AS Nancy","3-0",3,0,"1",1,3,3,"H"
1961-02-19,1960,"Le Havre AC","Angers SCO","0-0",0,0,"1",1,0,0,"D"
1961-02-19,1960,"Grenoble Foot 38","FC Rouen","0-0",0,0,"1",1,0,0,"D"
1961-02-19,1960,"UA Sedan-Torcy","Limoges FC","1-1",1,1,"1",1,2,0,"D"
1961-02-19,1960,"Olympique Lyon","Nimes Olympique","2-2",2,2,"1",1,4,0,"D"
1961-02-19,1960,"OGC Nice","AS Saint-Etienne","1-0",1,0,"1",1,1,1,"H"
1961-02-19,1960,"AS Troyes-Savinienne","Toulouse FC","0-3",0,3,"1",1,3,-3,"D"
1961-02-19,1960,"Stade Rennes","US Valenciennes-Anzin","1-2",1,2,"1",1,3,-1,"D"
1961-02-26,1960,"Nimes Olympique","AS Monaco","1-1",1,1,"1",1,2,0,"D"
1961-02-26,1960,"Racing Club de France","AS Troyes-Savinienne","3-3",3,3,"1",1,6,0,"D"
1961-02-26,1960,"AS Saint-Etienne","Stade Reims","3-1",3,1,"1",1,4,2,"H"
1961-02-26,1960,"Angers SCO","Grenoble Foot 38","2-2",2,2,"1",1,4,0,"D"
1961-02-26,1960,"FC Rouen","Stade Francais FC","0-0",0,0,"1",1,0,0,"D"
1961-02-26,1960,"AS Nancy","UA Sedan-Torcy","2-1",2,1,"1",1,3,1,"H"
1961-02-26,1960,"Toulouse FC","RC Lens","0-0",0,0,"1",1,0,0,"D"
1961-02-26,1960,"OGC Nice","Olympique Lyon","2-2",2,2,"1",1,4,0,"D"
1961-02-26,1960,"US Valenciennes-Anzin","Le Havre AC","1-0",1,0,"1",1,1,1,"H"
1961-02-26,1960,"Limoges FC","Stade Rennes","0-0",0,0,"1",1,0,0,"D"
1961-03-11,1960,"UA Sedan-Torcy","Olympique Lyon","2-1",2,1,"1",1,3,1,"H"
1961-03-11,1960,"AS Nancy","Toulouse FC","1-0",1,0,"1",1,1,1,"H"
1961-03-12,1960,"AS Monaco","Stade Reims","2-0",2,0,"1",1,2,2,"H"
1961-03-12,1960,"Grenoble Foot 38","Racing Club de France","0-2",0,2,"1",1,2,-2,"D"
1961-03-12,1960,"Stade Francais FC","Angers SCO","1-0",1,0,"1",1,1,1,"H"
1961-03-12,1960,"Nimes Olympique","FC Rouen","3-1",3,1,"1",1,4,2,"H"
1961-03-12,1960,"AS Saint-Etienne","Limoges FC","3-1",3,1,"1",1,4,2,"H"
1961-03-12,1960,"Le Havre AC","OGC Nice","3-2",3,2,"1",1,5,1,"H"
1961-03-12,1960,"Stade Rennes","RC Lens","4-2",4,2,"1",1,6,2,"H"
1961-03-12,1960,"US Valenciennes-Anzin","AS Troyes-Savinienne","1-0",1,0,"1",1,1,1,"H"
1961-03-19,1960,"AS Monaco","Toulouse FC","3-1",3,1,"1",1,4,2,"H"
1961-03-19,1960,"Racing Club de France","Limoges FC","3-1",3,1,"1",1,4,2,"H"
1961-03-19,1960,"Stade Reims","Stade Francais FC","2-0",2,0,"1",1,2,2,"H"
1961-03-19,1960,"Nimes Olympique","Le Havre AC","2-1",2,1,"1",1,3,1,"H"
1961-03-19,1960,"FC Rouen","US Valenciennes-Anzin","3-0",3,0,"1",1,3,3,"H"
1961-03-19,1960,"RC Lens","UA Sedan-Torcy","0-0",0,0,"1",1,0,0,"D"
1961-03-19,1960,"Angers SCO","AS Saint-Etienne","2-4",2,4,"1",1,6,-2,"D"
1961-03-19,1960,"Olympique Lyon","AS Nancy","0-1",0,1,"1",1,1,-1,"D"
1961-03-19,1960,"OGC Nice","Stade Rennes","3-1",3,1,"1",1,4,2,"H"
1961-03-19,1960,"AS Troyes-Savinienne","Grenoble Foot 38","3-3",3,3,"1",1,6,0,"D"
1961-03-22,1960,"Grenoble Foot 38","RC Lens","2-1",2,1,"1",1,3,1,"H"
1961-04-08,1960,"AS Nancy","AS Troyes-Savinienne","3-2",3,2,"1",1,5,1,"H"
1961-04-08,1960,"FC Rouen","Le Havre AC","3-1",3,1,"1",1,4,2,"H"
1961-04-09,1960,"OGC Nice","AS Monaco","6-0",6,0,"1",1,6,6,"H"
1961-04-09,1960,"Stade Francais FC","Racing Club de France","3-3",3,3,"1",1,6,0,"D"
1961-04-09,1960,"UA Sedan-Torcy","Stade Reims","0-4",0,4,"1",1,4,-4,"D"
1961-04-09,1960,"Toulouse FC","Nimes Olympique","0-0",0,0,"1",1,0,0,"D"
1961-04-09,1960,"AS Saint-Etienne","Olympique Lyon","4-2",4,2,"1",1,6,2,"H"
1961-04-09,1960,"Stade Rennes","Angers SCO","2-0",2,0,"1",1,2,2,"H"
1961-04-09,1960,"US Valenciennes-Anzin","RC Lens","0-1",0,1,"1",1,1,-1,"D"
1961-04-09,1960,"Limoges FC","Grenoble Foot 38","1-0",1,0,"1",1,1,1,"H"
1961-04-22,1960,"Olympique Lyon","FC Rouen","4-1",4,1,"1",1,5,3,"H"
1961-04-22,1960,"Stade Reims","AS Troyes-Savinienne","3-1",3,1,"1",1,4,2,"H"
1961-04-22,1960,"Grenoble Foot 38","Stade Rennes","1-1",1,1,"1",1,2,0,"D"
1961-04-23,1960,"Racing Club de France","OGC Nice","4-2",4,2,"1",1,6,2,"H"
1961-04-23,1960,"Angers SCO","Toulouse FC","1-0",1,0,"1",1,1,1,"H"
1961-04-23,1960,"Le Havre AC","RC Lens","3-2",3,2,"1",1,5,1,"H"
1961-04-23,1960,"US Valenciennes-Anzin","Stade Francais FC","0-0",0,0,"1",1,0,0,"D"
1961-04-23,1960,"AS Saint-Etienne","UA Sedan-Torcy","0-0",0,0,"1",1,0,0,"D"
1961-04-29,1960,"UA Sedan-Torcy","Racing Club de France","1-3",1,3,"1",1,4,-2,"D"
1961-04-29,1960,"FC Rouen","AS Monaco","2-3",2,3,"1",1,5,-1,"D"
1961-04-29,1960,"Stade Reims","Le Havre AC","2-0",2,0,"1",1,2,2,"H"
1961-04-29,1960,"OGC Nice","Angers SCO","3-2",3,2,"1",1,5,1,"H"
1961-04-30,1960,"Stade Rennes","Nimes Olympique","0-0",0,0,"1",1,0,0,"D"
1961-04-30,1960,"AS Nancy","AS Saint-Etienne","2-2",2,2,"1",1,4,0,"D"
1961-04-30,1960,"Toulouse FC","US Valenciennes-Anzin","2-2",2,2,"1",1,4,0,"D"
1961-04-30,1960,"RC Lens","Olympique Lyon","0-1",0,1,"1",1,1,-1,"D"
1961-04-30,1960,"Stade Francais FC","Grenoble Foot 38","1-0",1,0,"1",1,1,1,"H"
1961-04-30,1960,"AS Troyes-Savinienne","Limoges FC","3-2",3,2,"1",1,5,1,"H"
1961-05-03,1960,"AS Monaco","Limoges FC","3-2",3,2,"1",1,5,1,"H"
1961-05-10,1960,"Racing Club de France","AS Saint-Etienne","4-2",4,2,"1",1,6,2,"H"
1961-05-11,1960,"Angers SCO","AS Monaco","1-4",1,4,"1",1,5,-3,"D"
1961-05-11,1960,"US Valenciennes-Anzin","Stade Reims","0-2",0,2,"1",1,2,-2,"D"
1961-05-11,1960,"Nimes Olympique","UA Sedan-Torcy","5-0",5,0,"1",1,5,5,"H"
1961-05-11,1960,"Limoges FC","FC Rouen","3-2",3,2,"1",1,5,1,"H"
1961-05-11,1960,"AS Nancy","Stade Rennes","2-0",2,0,"1",1,2,2,"H"
1961-05-11,1960,"RC Lens","OGC Nice","1-0",1,0,"1",1,1,1,"H"
1961-05-11,1960,"Le Havre AC","AS Troyes-Savinienne","5-2",5,2,"1",1,7,3,"H"
1961-05-11,1960,"Toulouse FC","Grenoble Foot 38","2-1",2,1,"1",1,3,1,"H"
1961-05-13,1960,"FC Rouen","Stade Reims","2-1",2,1,"1",1,3,1,"H"
1961-05-13,1960,"UA Sedan-Torcy","US Valenciennes-Anzin","2-1",2,1,"1",1,3,1,"H"
1961-05-13,1960,"Grenoble Foot 38","AS Nancy","2-2",2,2,"1",1,4,0,"D"
1961-05-14,1960,"Racing Club de France","AS Monaco","3-0",3,0,"1",1,3,3,"H"
1961-05-14,1960,"Nimes Olympique","Angers SCO","3-2",3,2,"1",1,5,1,"H"
1961-05-14,1960,"AS Saint-Etienne","Le Havre AC","2-1",2,1,"1",1,3,1,"H"
1961-05-14,1960,"OGC Nice","Stade Francais FC","0-0",0,0,"1",1,0,0,"D"
1961-05-14,1960,"AS Troyes-Savinienne","RC Lens","1-3",1,3,"1",1,4,-2,"D"
1961-05-14,1960,"Stade Rennes","Olympique Lyon","6-1",6,1,"1",1,7,5,"H"
1961-05-14,1960,"Limoges FC","Toulouse FC","1-1",1,1,"1",1,2,0,"D"
1961-05-18,1960,"Angers SCO","AS Troyes-Savinienne","5-1",5,1,"1",1,6,4,"H"
1961-05-19,1960,"Toulouse FC","Racing Club de France","1-1",1,1,"1",1,2,0,"D"
1961-05-20,1960,"AS Monaco","AS Saint-Etienne","3-0",3,0,"1",1,3,3,"H"
1961-05-20,1960,"Stade Reims","Stade Rennes","1-1",1,1,"1",1,2,0,"D"
1961-05-20,1960,"RC Lens","Nimes Olympique","2-1",2,1,"1",1,3,1,"H"
1961-05-20,1960,"Grenoble Foot 38","OGC Nice","3-1",3,1,"1",1,4,2,"H"
1961-05-20,1960,"Olympique Lyon","Le Havre AC","1-3",1,3,"1",1,4,-2,"D"
1961-05-20,1960,"US Valenciennes-Anzin","Limoges FC","3-1",3,1,"1",1,4,2,"H"
1961-05-21,1960,"AS Nancy","FC Rouen","0-1",0,1,"1",1,1,-1,"D"
1961-05-21,1960,"Stade Francais FC","UA Sedan-Torcy","3-1",3,1,"1",1,4,2,"H"
1961-05-27,1960,"UA Sedan-Torcy","Angers SCO","1-2",1,2,"1",1,3,-1,"D"
1961-05-27,1960,"OGC Nice","AS Nancy","1-4",1,4,"1",1,5,-3,"D"
1961-05-27,1960,"US Valenciennes-Anzin","Grenoble Foot 38","1-0",1,0,"1",1,1,1,"H"
1961-05-28,1960,"Racing Club de France","Stade Reims","1-1",1,1,"1",1,2,0,"D"
1961-05-28,1960,"Le Havre AC","AS Monaco","1-1",1,1,"1",1,2,0,"D"
1961-05-28,1960,"FC Rouen","RC Lens","6-2",6,2,"1",1,8,4,"H"
1961-05-28,1960,"Limoges FC","Nimes Olympique","4-1",4,1,"1",1,5,3,"H"
1961-05-28,1960,"AS Saint-Etienne","Toulouse FC","1-0",1,0,"1",1,1,1,"H"
1961-05-28,1960,"Stade Rennes","Stade Francais FC","0-2",0,2,"1",1,2,-2,"D"
1961-05-28,1960,"AS Troyes-Savinienne","Olympique Lyon","2-3",2,3,"1",1,5,-1,"D"
1961-05-31,1960,"Olympique Lyon","Stade Francais FC","2-1",2,1,"1",1,3,1,"H"
1961-06-01,1960,"Nimes Olympique","AS Nancy","3-4",3,4,"1",1,7,-1,"D"
1961-06-03,1960,"Stade Reims","OGC Nice","3-0",3,0,"1",1,3,3,"H"
1961-06-03,1960,"Angers SCO","FC Rouen","1-3",1,3,"1",1,4,-2,"D"
1961-06-03,1960,"Nimes Olympique","AS Saint-Etienne","0-2",0,2,"1",1,2,-2,"D"
1961-06-04,1960,"AS Monaco","US Valenciennes-Anzin","1-0",1,0,"1",1,1,1,"H"
1961-06-04,1960,"Le Havre AC","Racing Club de France","2-2",2,2,"1",1,4,0,"D"
1961-06-04,1960,"RC Lens","AS Nancy","1-0",1,0,"1",1,1,1,"H"
1961-06-04,1960,"Grenoble Foot 38","UA Sedan-Torcy","6-3",6,3,"1",1,9,3,"H"
1961-06-04,1960,"Toulouse FC","Stade Rennes","2-0",2,0,"1",1,2,2,"H"
1961-06-04,1960,"Olympique Lyon","Limoges FC","2-1",2,1,"1",1,3,1,"H"
1961-06-04,1960,"Stade Francais FC","AS Troyes-Savinienne","2-1",2,1,"1",1,3,1,"H"
1961-08-19,1961,"OGC Nice","Le Havre AC","4-0",4,0,"1",1,4,4,"H"
1961-08-19,1961,"Stade Reims","FC Metz","5-3",5,3,"1",1,8,2,"H"
1961-08-19,1961,"Olympique Lyon","Toulouse FC","1-3",1,3,"1",1,4,-2,"D"
1961-08-19,1961,"RC Strasbourg","Angers SCO","2-1",2,1,"1",1,3,1,"H"
1961-08-19,1961,"FC Rouen","Nimes Olympique","1-2",1,2,"1",1,3,-1,"D"
1961-08-20,1961,"Stade Olympique Montpellierain","UA Sedan-Torcy","5-0",5,0,"1",1,5,5,"H"
1961-08-20,1961,"RC Lens","FC Sochaux","3-1",3,1,"1",1,4,2,"H"
1961-08-20,1961,"AS Monaco","AS Saint-Etienne","1-0",1,0,"1",1,1,1,"H"
1961-08-20,1961,"Stade Francais FC","Stade Rennes","2-2",2,2,"1",1,4,0,"D"
1961-08-20,1961,"AS Nancy","Racing Club de France","0-0",0,0,"1",1,0,0,"D"
1961-08-26,1961,"OGC Nice","AS Nancy","3-1",3,1,"1",1,4,2,"H"
1961-08-26,1961,"UA Sedan-Torcy","Stade Francais FC","1-1",1,1,"1",1,2,0,"D"
1961-08-26,1961,"FC Metz","FC Rouen","0-1",0,1,"1",1,1,-1,"D"
1961-08-27,1961,"Stade Olympique Montpellierain","Olympique Lyon","4-2",4,2,"1",1,6,2,"H"
1961-08-27,1961,"Stade Reims","Toulouse FC","5-1",5,1,"1",1,6,4,"H"
1961-08-27,1961,"FC Sochaux","AS Monaco","1-4",1,4,"1",1,5,-3,"D"
1961-08-27,1961,"Le Havre AC","RC Strasbourg","0-2",0,2,"1",1,2,-2,"D"
1961-08-27,1961,"Stade Rennes","RC Lens","2-1",2,1,"1",1,3,1,"H"
1961-08-27,1961,"Racing Club de France","Angers SCO","4-3",4,3,"1",1,7,1,"H"
1961-08-27,1961,"AS Saint-Etienne","Nimes Olympique","5-0",5,0,"1",1,5,5,"H"
1961-08-30,1961,"AS Monaco","Stade Rennes","4-2",4,2,"1",1,6,2,"H"
1961-09-02,1961,"AS Monaco","AS Nancy","1-1",1,1,"1",1,2,0,"D"
1961-09-02,1961,"Stade Reims","RC Lens","4-1",4,1,"1",1,5,3,"H"
1961-09-02,1961,"AS Saint-Etienne","Stade Olympique Montpellierain","1-1",1,1,"1",1,2,0,"D"
1961-09-02,1961,"FC Metz","Stade Rennes","0-1",0,1,"1",1,1,-1,"D"
1961-09-02,1961,"Stade Francais FC","FC Sochaux","1-1",1,1,"1",1,2,0,"D"
1961-09-02,1961,"FC Rouen","Olympique Lyon","3-4",3,4,"1",1,7,-1,"D"
1961-09-03,1961,"RC Strasbourg","Racing Club de France","1-3",1,3,"1",1,4,-2,"D"
1961-09-03,1961,"Toulouse FC","OGC Nice","3-1",3,1,"1",1,4,2,"H"
1961-09-03,1961,"Nimes Olympique","Le Havre AC","3-2",3,2,"1",1,5,1,"H"
1961-09-03,1961,"Angers SCO","UA Sedan-Torcy","2-2",2,2,"1",1,4,0,"D"
1961-09-06,1961,"Stade Reims","AS Saint-Etienne","1-1",1,1,"1",1,2,0,"D"
1961-09-06,1961,"Stade Olympique Montpellierain","FC Metz","2-0",2,0,"1",1,2,2,"H"
1961-09-06,1961,"Stade Francais FC","RC Strasbourg","0-1",0,1,"1",1,1,-1,"D"
1961-09-06,1961,"OGC Nice","Nimes Olympique","1-3",1,3,"1",1,4,-2,"D"
1961-09-06,1961,"FC Sochaux","Racing Club de France","4-3",4,3,"1",1,7,1,"H"
1961-09-06,1961,"Olympique Lyon","Angers SCO","2-0",2,0,"1",1,2,2,"H"
1961-09-06,1961,"AS Nancy","Toulouse FC","2-1",2,1,"1",1,3,1,"H"
1961-09-06,1961,"RC Lens","FC Rouen","1-0",1,0,"1",1,1,1,"H"
1961-09-06,1961,"Le Havre AC","UA Sedan-Torcy","1-1",1,1,"1",1,2,0,"D"
1961-09-09,1961,"AS Monaco","Stade Francais FC","2-0",2,0,"1",1,2,2,"H"
1961-09-09,1961,"FC Rouen","Stade Olympique Montpellierain","3-2",3,2,"1",1,5,1,"H"
1961-09-09,1961,"UA Sedan-Torcy","Olympique Lyon","3-1",3,1,"1",1,4,2,"H"
1961-09-09,1961,"FC Metz","OGC Nice","2-1",2,1,"1",1,3,1,"H"
1961-09-10,1961,"Nimes Olympique","Stade Reims","2-1",2,1,"1",1,3,1,"H"
1961-09-10,1961,"Racing Club de France","Le Havre AC","4-1",4,1,"1",1,5,3,"H"
1961-09-10,1961,"RC Strasbourg","AS Nancy","2-2",2,2,"1",1,4,0,"D"
1961-09-10,1961,"AS Saint-Etienne","RC Lens","3-4",3,4,"1",1,7,-1,"D"
1961-09-10,1961,"Toulouse FC","Stade Rennes","3-3",3,3,"1",1,6,0,"D"
1961-09-10,1961,"Angers SCO","FC Sochaux","3-1",3,1,"1",1,4,2,"H"
1961-09-16,1961,"Stade Francais FC","Stade Reims","2-4",2,4,"1",1,6,-2,"D"
1961-09-16,1961,"Olympique Lyon","Racing Club de France","2-0",2,0,"1",1,2,2,"H"
1961-09-16,1961,"OGC Nice","AS Saint-Etienne","3-1",3,1,"1",1,4,2,"H"
1961-09-16,1961,"FC Sochaux","FC Rouen","1-1",1,1,"1",1,2,0,"D"
1961-09-17,1961,"UA Sedan-Torcy","AS Monaco","2-0",2,0,"1",1,2,2,"H"
1961-09-17,1961,"Stade Olympique Montpellierain","Toulouse FC","3-3",3,3,"1",1,6,0,"D"
1961-09-17,1961,"Stade Rennes","Nimes Olympique","4-2",4,2,"1",1,6,2,"H"
1961-09-17,1961,"RC Lens","RC Strasbourg","0-0",0,0,"1",1,0,0,"D"
1961-09-17,1961,"AS Nancy","Angers SCO","3-2",3,2,"1",1,5,1,"H"
1961-09-17,1961,"Le Havre AC","FC Metz","2-1",2,1,"1",1,3,1,"H"
1961-09-20,1961,"Stade Reims","OGC Nice","5-0",5,0,"1",1,5,5,"H"
1961-09-20,1961,"AS Monaco","Le Havre AC","2-2",2,2,"1",1,4,0,"D"
1961-09-20,1961,"Racing Club de France","Stade Olympique Montpellierain","2-1",2,1,"1",1,3,1,"H"
1961-09-20,1961,"RC Strasbourg","Stade Rennes","1-1",1,1,"1",1,2,0,"D"
1961-09-20,1961,"Toulouse FC","UA Sedan-Torcy","1-4",1,4,"1",1,5,-3,"D"
1961-09-20,1961,"Angers SCO","RC Lens","0-2",0,2,"1",1,2,-2,"D"
1961-09-20,1961,"Nimes Olympique","AS Nancy","1-1",1,1,"1",1,2,0,"D"
1961-09-20,1961,"FC Rouen","Stade Francais FC","2-1",2,1,"1",1,3,1,"H"
1961-09-20,1961,"FC Metz","Olympique Lyon","2-1",2,1,"1",1,3,1,"H"
1961-09-20,1961,"AS Saint-Etienne","FC Sochaux","2-2",2,2,"1",1,4,0,"D"
1961-09-24,1961,"FC Sochaux","Toulouse FC","2-0",2,0,"1",1,2,2,"H"
1961-09-24,1961,"Olympique Lyon","RC Strasbourg","2-1",2,1,"1",1,3,1,"H"
1961-09-25,1961,"Stade Olympique Montpellierain","Stade Reims","1-3",1,3,"1",1,4,-2,"D"
1961-09-25,1961,"RC Lens","AS Monaco","5-0",5,0,"1",1,5,5,"H"
1961-09-25,1961,"Stade Rennes","FC Rouen","3-2",3,2,"1",1,5,1,"H"
1961-09-25,1961,"OGC Nice","Racing Club de France","1-0",1,0,"1",1,1,1,"H"
1961-09-25,1961,"Stade Francais FC","AS Nancy","1-0",1,0,"1",1,1,1,"H"
1961-09-25,1961,"Le Havre AC","AS Saint-Etienne","1-0",1,0,"1",1,1,1,"H"
1961-09-25,1961,"FC Metz","Angers SCO","1-2",1,2,"1",1,3,-1,"D"
1961-09-30,1961,"Stade Reims","FC Sochaux","2-1",2,1,"1",1,3,1,"H"
1961-09-30,1961,"Angers SCO","Toulouse FC","1-2",1,2,"1",1,3,-1,"D"
1961-10-01,1961,"RC Lens","OGC Nice","4-2",4,2,"1",1,6,2,"H"
1961-10-01,1961,"AS Nancy","Stade Rennes","2-2",2,2,"1",1,4,0,"D"
1961-10-01,1961,"AS Monaco","Stade Olympique Montpellierain","5-3",5,3,"1",1,8,2,"H"
1961-10-01,1961,"Nimes Olympique","Stade Francais FC","4-0",4,0,"1",1,4,4,"H"
1961-10-01,1961,"Racing Club de France","UA Sedan-Torcy","2-2",2,2,"1",1,4,0,"D"
1961-10-01,1961,"Le Havre AC","Olympique Lyon","1-2",1,2,"1",1,3,-1,"D"
1961-10-01,1961,"RC Strasbourg","FC Metz","0-1",0,1,"1",1,1,-1,"D"
1961-10-01,1961,"AS Saint-Etienne","FC Rouen","2-0",2,0,"1",1,2,2,"H"
1961-10-04,1961,"FC Rouen","Stade Reims","2-2",2,2,"1",1,4,0,"D"
1961-10-04,1961,"UA Sedan-Torcy","RC Lens","1-1",1,1,"1",1,2,0,"D"
1961-10-04,1961,"Stade Rennes","Le Havre AC","1-0",1,0,"1",1,1,1,"H"
1961-10-04,1961,"FC Metz","AS Monaco","1-1",1,1,"1",1,2,0,"D"
1961-10-04,1961,"Toulouse FC","Racing Club de France","1-1",1,1,"1",1,2,0,"D"
1961-10-04,1961,"FC Sochaux","AS Nancy","0-1",0,1,"1",1,1,-1,"D"
1961-10-04,1961,"OGC Nice","RC Strasbourg","3-2",3,2,"1",1,5,1,"H"
1961-10-04,1961,"Stade Olympique Montpellierain","Angers SCO","0-0",0,0,"1",1,0,0,"D"
1961-10-04,1961,"Stade Francais FC","AS Saint-Etienne","1-1",1,1,"1",1,2,0,"D"
1961-10-08,1961,"Angers SCO","Stade Reims","2-0",2,0,"1",1,2,2,"H"
1961-10-08,1961,"RC Lens","Stade Francais FC","2-1",2,1,"1",1,3,1,"H"
1961-10-08,1961,"AS Monaco","FC Rouen","0-0",0,0,"1",1,0,0,"D"
1961-10-08,1961,"Racing Club de France","Stade Rennes","3-1",3,1,"1",1,4,2,"H"
1961-10-08,1961,"AS Nancy","Olympique Lyon","5-1",5,1,"1",1,6,4,"H"
1961-10-08,1961,"Nimes Olympique","FC Sochaux","2-1",2,1,"1",1,3,1,"H"
1961-10-08,1961,"UA Sedan-Torcy","OGC Nice","2-2",2,2,"1",1,4,0,"D"
1961-10-08,1961,"RC Strasbourg","Toulouse FC","0-1",0,1,"1",1,1,-1,"D"
1961-10-08,1961,"Le Havre AC","Stade Olympique Montpellierain","2-2",2,2,"1",1,4,0,"D"
1961-10-08,1961,"AS Saint-Etienne","FC Metz","2-2",2,2,"1",1,4,0,"D"
1961-10-11,1961,"Olympique Lyon","Nimes Olympique","0-0",0,0,"1",1,0,0,"D"
1961-10-14,1961,"FC Sochaux","RC Strasbourg","0-0",0,0,"1",1,0,0,"D"
1961-10-14,1961,"FC Rouen","Le Havre AC","0-0",0,0,"1",1,0,0,"D"
1961-10-15,1961,"Stade Reims","UA Sedan-Torcy","1-3",1,3,"1",1,4,-2,"D"
1961-10-15,1961,"Toulouse FC","RC Lens","2-0",2,0,"1",1,2,2,"H"
1961-10-15,1961,"Nimes Olympique","Stade Olympique Montpellierain","3-1",3,1,"1",1,4,2,"H"
1961-10-15,1961,"Stade Rennes","Angers SCO","2-1",2,1,"1",1,3,1,"H"
1961-10-15,1961,"AS Nancy","FC Metz","3-0",3,0,"1",1,3,3,"H"
1961-10-15,1961,"AS Monaco","OGC Nice","1-2",1,2,"1",1,3,-1,"D"
1961-10-15,1961,"Stade Francais FC","Racing Club de France","2-0",2,0,"1",1,2,2,"H"
1961-10-15,1961,"AS Saint-Etienne","Olympique Lyon","2-0",2,0,"1",1,2,2,"H"
1961-10-21,1961,"FC Metz","RC Lens","1-0",1,0,"1",1,1,1,"H"
1961-10-22,1961,"Olympique Lyon","Stade Reims","1-3",1,3,"1",1,4,-2,"D"
1961-10-22,1961,"Racing Club de France","Nimes Olympique","0-4",0,4,"1",1,4,-4,"D"
1961-10-22,1961,"Stade Rennes","AS Saint-Etienne","1-1",1,1,"1",1,2,0,"D"
1961-10-22,1961,"UA Sedan-Torcy","FC Sochaux","4-1",4,1,"1",1,5,3,"H"
1961-10-22,1961,"RC Strasbourg","AS Monaco","0-1",0,1,"1",1,1,-1,"D"
1961-10-22,1961,"Stade Olympique Montpellierain","AS Nancy","1-0",1,0,"1",1,1,1,"H"
1961-10-22,1961,"Toulouse FC","FC Rouen","1-0",1,0,"1",1,1,1,"H"
1961-10-22,1961,"OGC Nice","Angers SCO","0-2",0,2,"1",1,2,-2,"D"
1961-10-22,1961,"Le Havre AC","Stade Francais FC","1-0",1,0,"1",1,1,1,"H"
1961-10-25,1961,"Nimes Olympique","FC Metz","3-1",3,1,"1",1,4,2,"H"
1961-10-25,1961,"Stade Reims","Stade Rennes","2-3",2,3,"1",1,5,-1,"D"
1961-10-25,1961,"AS Nancy","UA Sedan-Torcy","0-3",0,3,"1",1,3,-3,"D"
1961-10-25,1961,"AS Monaco","Olympique Lyon","3-1",3,1,"1",1,4,2,"H"
1961-10-25,1961,"RC Lens","Racing Club de France","2-3",2,3,"1",1,5,-1,"D"
1961-10-25,1961,"AS Saint-Etienne","Toulouse FC","4-1",4,1,"1",1,5,3,"H"
1961-10-25,1961,"FC Sochaux","Stade Olympique Montpellierain","1-1",1,1,"1",1,2,0,"D"
1961-10-25,1961,"Stade Francais FC","OGC Nice","4-0",4,0,"1",1,4,4,"H"
1961-10-25,1961,"FC Rouen","RC Strasbourg","1-0",1,0,"1",1,1,1,"H"
1961-10-25,1961,"Angers SCO","Le Havre AC","0-0",0,0,"1",1,0,0,"D"
1961-10-28,1961,"FC Metz","Stade Francais FC","0-2",0,2,"1",1,2,-2,"D"
1961-10-29,1961,"Toulouse FC","Nimes Olympique","0-1",0,1,"1",1,1,-1,"D"
1961-10-29,1961,"UA Sedan-Torcy","AS Saint-Etienne","1-0",1,0,"1",1,1,1,"H"
1961-10-29,1961,"RC Strasbourg","Stade Reims","1-1",1,1,"1",1,2,0,"D"
1961-10-29,1961,"Stade Olympique Montpellierain","Stade Rennes","3-1",3,1,"1",1,4,2,"H"
1961-10-29,1961,"Angers SCO","AS Monaco","2-0",2,0,"1",1,2,2,"H"
1961-10-29,1961,"Olympique Lyon","RC Lens","3-0",3,0,"1",1,3,3,"H"
1961-10-29,1961,"Le Havre AC","AS Nancy","1-1",1,1,"1",1,2,0,"D"
1961-10-29,1961,"Racing Club de France","FC Rouen","0-2",0,2,"1",1,2,-2,"D"
1961-10-29,1961,"OGC Nice","FC Sochaux","1-1",1,1,"1",1,2,0,"D"
1961-10-31,1961,"FC Metz","UA Sedan-Torcy","2-2",2,2,"1",1,4,0,"D"
1961-11-01,1961,"Nimes Olympique","RC Strasbourg","1-0",1,0,"1",1,1,1,"H"
1961-11-01,1961,"Stade Reims","AS Nancy","2-0",2,0,"1",1,2,2,"H"
1961-11-01,1961,"Stade Rennes","Olympique Lyon","2-0",2,0,"1",1,2,2,"H"
1961-11-01,1961,"AS Monaco","Toulouse FC","4-3",4,3,"1",1,7,1,"H"
1961-11-01,1961,"RC Lens","Stade Olympique Montpellierain","5-1",5,1,"1",1,6,4,"H"
1961-11-01,1961,"FC Rouen","OGC Nice","2-1",2,1,"1",1,3,1,"H"
1961-11-01,1961,"AS Saint-Etienne","Racing Club de France","1-1",1,1,"1",1,2,0,"D"
1961-11-01,1961,"Stade Francais FC","Angers SCO","1-1",1,1,"1",1,2,0,"D"
1961-11-01,1961,"FC Sochaux","Le Havre AC","6-1",6,1,"1",1,7,5,"H"
1961-11-10,1961,"FC Metz","FC Sochaux","1-1",1,1,"1",1,2,0,"D"
1961-11-11,1961,"RC Lens","Le Havre AC","2-0",2,0,"1",1,2,2,"H"
1961-11-11,1961,"FC Rouen","Angers SCO","2-1",2,1,"1",1,3,1,"H"
1961-11-11,1961,"RC Strasbourg","Stade Olympique Montpellierain","1-2",1,2,"1",1,3,-1,"D"
1961-11-11,1961,"Stade Francais FC","Toulouse FC","3-4",3,4,"1",1,7,-1,"D"
1961-11-11,1961,"OGC Nice","Olympique Lyon","0-2",0,2,"1",1,2,-2,"D"
1961-11-15,1961,"UA Sedan-Torcy","Nimes Olympique","5-1",5,1,"1",1,6,4,"H"
1961-11-19,1961,"UA Sedan-Torcy","RC Strasbourg","5-0",5,0,"1",1,5,5,"H"
1961-11-19,1961,"RC Lens","Nimes Olympique","3-1",3,1,"1",1,4,2,"H"
1961-11-19,1961,"AS Monaco","Stade Reims","0-1",0,1,"1",1,1,-1,"D"
1961-11-19,1961,"FC Sochaux","Stade Rennes","1-2",1,2,"1",1,3,-1,"D"
1961-11-19,1961,"Stade Olympique Montpellierain","OGC Nice","3-2",3,2,"1",1,5,1,"H"
1961-11-19,1961,"Racing Club de France","FC Metz","11-2",11,2,"1",1,13,9,"H"
1961-11-19,1961,"AS Nancy","FC Rouen","2-1",2,1,"1",1,3,1,"H"
1961-11-19,1961,"Le Havre AC","Toulouse FC","2-0",2,0,"1",1,2,2,"H"
1961-11-19,1961,"Angers SCO","AS Saint-Etienne","2-1",2,1,"1",1,3,1,"H"
1961-11-19,1961,"Olympique Lyon","Stade Francais FC","1-2",1,2,"1",1,3,-1,"D"
1961-11-22,1961,"AS Saint-Etienne","AS Nancy","1-1",1,1,"1",1,2,0,"D"
1961-11-22,1961,"Stade Reims","Racing Club de France","1-4",1,4,"1",1,5,-3,"D"
1961-11-23,1961,"Stade Rennes","UA Sedan-Torcy","1-0",1,0,"1",1,1,1,"H"
1961-11-26,1961,"Stade Reims","Le Havre AC","3-0",3,0,"1",1,3,3,"H"
1961-11-26,1961,"Stade Francais FC","UA Sedan-Torcy","4-2",4,2,"1",1,6,2,"H"
1961-11-26,1961,"Stade Rennes","FC Metz","1-2",1,2,"1",1,3,-1,"D"
1961-11-26,1961,"FC Sochaux","Nimes Olympique","3-1",3,1,"1",1,4,2,"H"
1961-11-26,1961,"OGC Nice","RC Lens","2-0",2,0,"1",1,2,2,"H"
1961-11-26,1961,"Olympique Lyon","AS Monaco","2-4",2,4,"1",1,6,-2,"D"
1961-11-26,1961,"AS Nancy","RC Strasbourg","3-1",3,1,"1",1,4,2,"H"
1961-11-26,1961,"Stade Olympique Montpellierain","Racing Club de France","2-1",2,1,"1",1,3,1,"H"
1961-11-26,1961,"FC Rouen","AS Saint-Etienne","3-1",3,1,"1",1,4,2,"H"
1961-11-26,1961,"Toulouse FC","Angers SCO","2-0",2,0,"1",1,2,2,"H"
1961-11-30,1961,"Nimes Olympique","AS Monaco","1-1",1,1,"1",1,2,0,"D"
1961-12-03,1961,"Nimes Olympique","FC Rouen","3-2",3,2,"1",1,5,1,"H"
1961-12-03,1961,"UA Sedan-Torcy","Stade Rennes","0-0",0,0,"1",1,0,0,"D"
1961-12-03,1961,"AS Saint-Etienne","Stade Reims","2-0",2,0,"1",1,2,2,"H"
1961-12-03,1961,"RC Lens","Olympique Lyon","1-0",1,0,"1",1,1,1,"H"
1961-12-03,1961,"Toulouse FC","AS Monaco","2-0",2,0,"1",1,2,2,"H"
1961-12-03,1961,"Racing Club de France","AS Nancy","2-0",2,0,"1",1,2,2,"H"
1961-12-03,1961,"FC Metz","Stade Olympique Montpellierain","1-1",1,1,"1",1,2,0,"D"
1961-12-03,1961,"Angers SCO","Stade Francais FC","2-2",2,2,"1",1,4,0,"D"
1961-12-03,1961,"RC Strasbourg","OGC Nice","2-0",2,0,"1",1,2,2,"H"
1961-12-03,1961,"Le Havre AC","FC Sochaux","3-1",3,1,"1",1,4,2,"H"
1961-12-24,1961,"Nimes Olympique","Stade Rennes","3-0",3,0,"1",1,3,3,"H"
1961-12-24,1961,"UA Sedan-Torcy","Stade Olympique Montpellierain","1-0",1,0,"1",1,1,1,"H"
1961-12-24,1961,"OGC Nice","Stade Reims","4-1",4,1,"1",1,5,3,"H"
1961-12-24,1961,"Le Havre AC","RC Lens","0-0",0,0,"1",1,0,0,"D"
1961-12-24,1961,"Racing Club de France","FC Sochaux","2-2",2,2,"1",1,4,0,"D"
1961-12-24,1961,"AS Nancy","Stade Francais FC","2-1",2,1,"1",1,3,1,"H"
1961-12-24,1961,"AS Saint-Etienne","AS Monaco","5-1",5,1,"1",1,6,4,"H"
1961-12-24,1961,"Toulouse FC","Olympique Lyon","1-1",1,1,"1",1,2,0,"D"
1961-12-24,1961,"RC Strasbourg","FC Rouen","1-0",1,0,"1",1,1,1,"H"
1961-12-24,1961,"Angers SCO","FC Metz","3-1",3,1,"1",1,4,2,"H"
1961-12-31,1961,"Olympique Lyon","UA Sedan-Torcy","2-2",2,2,"1",1,4,0,"D"
1961-12-31,1961,"Stade Reims","Nimes Olympique","2-0",2,0,"1",1,2,2,"H"
1961-12-31,1961,"RC Lens","Angers SCO","2-1",2,1,"1",1,3,1,"H"
1961-12-31,1961,"Stade Rennes","Toulouse FC","1-1",1,1,"1",1,2,0,"D"
1961-12-31,1961,"Racing Club de France","OGC Nice","3-1",3,1,"1",1,4,2,"H"
1961-12-31,1961,"FC Rouen","AS Nancy","0-2",0,2,"1",1,2,-2,"D"
1961-12-31,1961,"Stade Olympique Montpellierain","Le Havre AC","1-1",1,1,"1",1,2,0,"D"
1961-12-31,1961,"AS Monaco","RC Strasbourg","0-2",0,2,"1",1,2,-2,"D"
1961-12-31,1961,"FC Metz","AS Saint-Etienne","6-0",6,0,"1",1,6,6,"H"
1962-01-14,1961,"Nimes Olympique","OGC Nice","3-0",3,0,"1",1,3,3,"H"
1962-01-14,1961,"UA Sedan-Torcy","Racing Club de France","0-1",0,1,"1",1,1,-1,"D"
1962-01-14,1961,"AS Nancy","Stade Reims","1-1",1,1,"1",1,2,0,"D"
1962-01-14,1961,"Stade Francais FC","RC Lens","2-2",2,2,"1",1,4,0,"D"
1962-01-14,1961,"Stade Rennes","AS Monaco","4-6",4,6,"1",1,10,-2,"D"
1962-01-14,1961,"Toulouse FC","AS Saint-Etienne","2-1",2,1,"1",1,3,1,"H"
1962-01-14,1961,"Angers SCO","Stade Olympique Montpellierain","1-0",1,0,"1",1,1,1,"H"
1962-01-14,1961,"FC Rouen","FC Sochaux","2-2",2,2,"1",1,4,0,"D"
1962-01-14,1961,"RC Strasbourg","Le Havre AC","3-1",3,1,"1",1,4,2,"H"
1962-01-14,1961,"Olympique Lyon","FC Metz","1-0",1,0,"1",1,1,1,"H"
1962-01-21,1961,"Le Havre AC","Nimes Olympique","1-2",1,2,"1",1,3,-1,"D"
1962-01-21,1961,"RC Lens","AS Nancy","4-1",4,1,"1",1,5,3,"H"
1962-01-21,1961,"FC Sochaux","UA Sedan-Torcy","2-0",2,0,"1",1,2,2,"H"
1962-01-21,1961,"Stade Rennes","RC Strasbourg","1-0",1,0,"1",1,1,1,"H"
1962-01-21,1961,"Stade Reims","Stade Francais FC","0-4",0,4,"1",1,4,-4,"D"
1962-01-21,1961,"Racing Club de France","Olympique Lyon","0-4",0,4,"1",1,4,-4,"D"
1962-01-21,1961,"Stade Olympique Montpellierain","AS Monaco","0-2",0,2,"1",1,2,-2,"D"
1962-01-21,1961,"FC Metz","Toulouse FC","1-1",1,1,"1",1,2,0,"D"
1962-01-21,1961,"AS Saint-Etienne","Angers SCO","2-3",2,3,"1",1,5,-1,"D"
1962-01-21,1961,"OGC Nice","FC Rouen","1-1",1,1,"1",1,2,0,"D"
1962-02-04,1961,"Nimes Olympique","Angers SCO","2-0",2,0,"1",1,2,2,"H"
1962-02-04,1961,"RC Strasbourg","RC Lens","3-1",3,1,"1",1,4,2,"H"
1962-02-04,1961,"Stade Rennes","Stade Reims","2-2",2,2,"1",1,4,0,"D"
1962-02-04,1961,"AS Nancy","AS Saint-Etienne","2-1",2,1,"1",1,3,1,"H"
1962-02-04,1961,"AS Monaco","FC Sochaux","1-1",1,1,"1",1,2,0,"D"
1962-02-04,1961,"Toulouse FC","Le Havre AC","1-0",1,0,"1",1,1,1,"H"
1962-02-04,1961,"FC Rouen","Racing Club de France","2-1",2,1,"1",1,3,1,"H"
1962-02-04,1961,"Stade Francais FC","Stade Olympique Montpellierain","3-0",3,0,"1",1,3,3,"H"
1962-02-04,1961,"Olympique Lyon","OGC Nice","1-2",1,2,"1",1,3,-1,"D"
1962-02-11,1961,"FC Metz","Nimes Olympique","3-1",3,1,"1",1,4,2,"H"
1962-02-11,1961,"Stade Reims","AS Monaco","1-0",1,0,"1",1,1,1,"H"
1962-02-11,1961,"Stade Olympique Montpellierain","RC Lens","2-0",2,0,"1",1,2,2,"H"
1962-02-11,1961,"Toulouse FC","AS Nancy","2-0",2,0,"1",1,2,2,"H"
1962-02-11,1961,"Le Havre AC","Stade Rennes","2-0",2,0,"1",1,2,2,"H"
1962-02-11,1961,"AS Saint-Etienne","UA Sedan-Torcy","1-0",1,0,"1",1,1,1,"H"
1962-02-11,1961,"Racing Club de France","RC Strasbourg","3-3",3,3,"1",1,6,0,"D"
1962-02-11,1961,"Angers SCO","FC Rouen","1-0",1,0,"1",1,1,1,"H"
1962-02-11,1961,"OGC Nice","Stade Francais FC","1-0",1,0,"1",1,1,1,"H"
1962-02-11,1961,"FC Sochaux","Olympique Lyon","1-2",1,2,"1",1,3,-1,"D"
1962-02-25,1961,"Nimes Olympique","Racing Club de France","2-4",2,4,"1",1,6,-2,"D"
1962-02-25,1961,"Toulouse FC","Stade Reims","1-2",1,2,"1",1,3,-1,"D"
1962-02-25,1961,"RC Lens","FC Metz","5-2",5,2,"1",1,7,3,"H"
1962-02-25,1961,"FC Rouen","UA Sedan-Torcy","2-3",2,3,"1",1,5,-1,"D"
1962-02-25,1961,"Stade Rennes","Stade Olympique Montpellierain","1-1",1,1,"1",1,2,0,"D"
1962-02-25,1961,"AS Monaco","Angers SCO","5-0",5,0,"1",1,5,5,"H"
1962-02-25,1961,"AS Nancy","FC Sochaux","1-0",1,0,"1",1,1,1,"H"
1962-02-25,1961,"AS Saint-Etienne","OGC Nice","1-2",1,2,"1",1,3,-1,"D"
1962-02-25,1961,"Stade Francais FC","Le Havre AC","1-1",1,1,"1",1,2,0,"D"
1962-02-25,1961,"RC Strasbourg","Olympique Lyon","5-2",5,2,"1",1,7,3,"H"
1962-03-01,1961,"FC Sochaux","Stade Francais FC","2-3",2,3,"1",1,5,-1,"D"
1962-03-04,1961,"Nimes Olympique","Toulouse FC","2-0",2,0,"1",1,2,2,"H"
1962-03-04,1961,"FC Metz","Stade Reims","2-1",2,1,"1",1,3,1,"H"
1962-03-04,1961,"UA Sedan-Torcy","AS Nancy","1-1",1,1,"1",1,2,0,"D"
1962-03-04,1961,"Racing Club de France","RC Lens","1-0",1,0,"1",1,1,1,"H"
1962-03-04,1961,"Le Havre AC","AS Monaco","0-1",0,1,"1",1,1,-1,"D"
1962-03-04,1961,"Olympique Lyon","Stade Rennes","0-0",0,0,"1",1,0,0,"D"
1962-03-04,1961,"Stade Olympique Montpellierain","FC Rouen","4-1",4,1,"1",1,5,3,"H"
1962-03-04,1961,"Angers SCO","OGC Nice","0-0",0,0,"1",1,0,0,"D"
1962-03-14,1961,"UA Sedan-Torcy","FC Metz","2-0",2,0,"1",1,2,2,"H"
1962-03-17,1961,"FC Rouen","RC Lens","2-1",2,1,"1",1,3,1,"H"
1962-03-17,1961,"AS Nancy","Le Havre AC","1-1",1,1,"1",1,2,0,"D"
1962-03-17,1961,"FC Sochaux","FC Metz","1-1",1,1,"1",1,2,0,"D"
1962-03-18,1961,"AS Monaco","Nimes Olympique","1-1",1,1,"1",1,2,0,"D"
1962-03-18,1961,"Stade Reims","Angers SCO","2-0",2,0,"1",1,2,2,"H"
1962-03-18,1961,"OGC Nice","UA Sedan-Torcy","3-2",3,2,"1",1,5,1,"H"
1962-03-18,1961,"Stade Rennes","Racing Club de France","2-3",2,3,"1",1,5,-1,"D"
1962-03-18,1961,"Toulouse FC","Stade Olympique Montpellierain","1-2",1,2,"1",1,3,-1,"D"
1962-03-18,1961,"Stade Francais FC","Olympique Lyon","2-1",2,1,"1",1,3,1,"H"
1962-03-18,1961,"AS Saint-Etienne","RC Strasbourg","0-1",0,1,"1",1,1,-1,"D"
1962-03-21,1961,"FC Sochaux","AS Saint-Etienne","0-2",0,2,"1",1,2,-2,"D"
1962-03-21,1961,"RC Strasbourg","Stade Francais FC","0-0",0,0,"1",1,0,0,"D"
1962-03-25,1961,"Stade Olympique Montpellierain","Nimes Olympique","3-5",3,5,"1",1,8,-2,"D"
1962-03-25,1961,"UA Sedan-Torcy","Stade Reims","0-3",0,3,"1",1,3,-3,"D"
1962-03-25,1961,"Racing Club de France","Stade Francais FC","3-1",3,1,"1",1,4,2,"H"
1962-03-25,1961,"RC Lens","Toulouse FC","4-0",4,0,"1",1,4,4,"H"
1962-03-25,1961,"OGC Nice","AS Monaco","1-1",1,1,"1",1,2,0,"D"
1962-03-25,1961,"FC Metz","AS Nancy","0-1",0,1,"1",1,1,-1,"D"
1962-03-25,1961,"Angers SCO","Stade Rennes","1-1",1,1,"1",1,2,0,"D"
1962-03-25,1961,"RC Strasbourg","FC Sochaux","1-1",1,1,"1",1,2,0,"D"
1962-03-25,1961,"Le Havre AC","FC Rouen","1-1",1,1,"1",1,2,0,"D"
1962-03-25,1961,"Olympique Lyon","AS Saint-Etienne","4-0",4,0,"1",1,4,4,"H"
1962-03-28,1961,"Angers SCO","Racing Club de France","2-3",2,3,"1",1,5,-1,"D"
1962-03-28,1961,"Stade Reims","Olympique Lyon","0-4",0,4,"1",1,4,-4,"D"
1962-03-28,1961,"AS Monaco","UA Sedan-Torcy","2-1",2,1,"1",1,3,1,"H"
1962-03-28,1961,"FC Rouen","Stade Rennes","4-1",4,1,"1",1,5,3,"H"
1962-03-28,1961,"FC Sochaux","OGC Nice","2-0",2,0,"1",1,2,2,"H"
1962-03-29,1961,"AS Nancy","Stade Olympique Montpellierain","3-1",3,1,"1",1,4,2,"H"
1962-03-29,1961,"Stade Francais FC","FC Metz","2-2",2,2,"1",1,4,0,"D"
1962-03-29,1961,"AS Saint-Etienne","Le Havre AC","1-1",1,1,"1",1,2,0,"D"
1962-03-31,1961,"Olympique Lyon","FC Sochaux","1-0",1,0,"1",1,1,1,"H"
1962-04-01,1961,"Nimes Olympique","RC Lens","2-1",2,1,"1",1,3,1,"H"
1962-04-01,1961,"Toulouse FC","RC Strasbourg","4-1",4,1,"1",1,5,3,"H"
1962-04-01,1961,"Le Havre AC","Stade Reims","1-2",1,2,"1",1,3,-1,"D"
1962-04-01,1961,"UA Sedan-Torcy","FC Rouen","2-2",2,2,"1",1,4,0,"D"
1962-04-01,1961,"OGC Nice","Stade Rennes","1-0",1,0,"1",1,1,1,"H"
1962-04-01,1961,"Stade Olympique Montpellierain","Stade Francais FC","4-0",4,0,"1",1,4,4,"H"
1962-04-07,1961,"UA Sedan-Torcy","Toulouse FC","1-0",1,0,"1",1,1,1,"H"
1962-04-07,1961,"Olympique Lyon","FC Rouen","1-1",1,1,"1",1,2,0,"D"
1962-04-08,1961,"RC Strasbourg","Nimes Olympique","2-1",2,1,"1",1,3,1,"H"
1962-04-08,1961,"RC Lens","Stade Reims","3-4",3,4,"1",1,7,-1,"D"
1962-04-08,1961,"Racing Club de France","AS Saint-Etienne","1-2",1,2,"1",1,3,-1,"D"
1962-04-08,1961,"AS Monaco","FC Metz","4-0",4,0,"1",1,4,4,"H"
1962-04-08,1961,"AS Nancy","OGC Nice","2-0",2,0,"1",1,2,2,"H"
1962-04-08,1961,"Stade Olympique Montpellierain","FC Sochaux","4-1",4,1,"1",1,5,3,"H"
1962-04-08,1961,"Stade Rennes","Stade Francais FC","2-3",2,3,"1",1,5,-1,"D"
1962-04-08,1961,"Le Havre AC","Angers SCO","0-1",0,1,"1",1,1,-1,"D"
1962-04-14,1961,"Stade Francais FC","AS Monaco","1-1",1,1,"1",1,2,0,"D"
1962-04-14,1961,"FC Sochaux","RC Lens","1-2",1,2,"1",1,3,-1,"D"
1962-04-14,1961,"Olympique Lyon","Stade Olympique Montpellierain","1-2",1,2,"1",1,3,-1,"D"
1962-04-14,1961,"FC Metz","RC Strasbourg","2-0",2,0,"1",1,2,2,"H"
1962-04-15,1961,"Stade Reims","FC Rouen","2-2",2,2,"1",1,4,0,"D"
1962-04-15,1961,"Nimes Olympique","UA Sedan-Torcy","0-1",0,1,"1",1,1,-1,"D"
1962-04-15,1961,"Le Havre AC","Racing Club de France","0-4",0,4,"1",1,4,-4,"D"
1962-04-15,1961,"Angers SCO","AS Nancy","2-2",2,2,"1",1,4,0,"D"
1962-04-15,1961,"AS Saint-Etienne","Stade Rennes","2-1",2,1,"1",1,3,1,"H"
1962-04-15,1961,"OGC Nice","Toulouse FC","3-1",3,1,"1",1,4,2,"H"
1962-04-18,1961,"Racing Club de France","Stade Reims","2-6",2,6,"1",1,8,-4,"D"
1962-04-18,1961,"AS Nancy","Nimes Olympique","0-0",0,0,"1",1,0,0,"D"
1962-04-18,1961,"UA Sedan-Torcy","Angers SCO","0-2",0,2,"1",1,2,-2,"D"
1962-04-18,1961,"FC Rouen","AS Monaco","2-1",2,1,"1",1,3,1,"H"
1962-04-18,1961,"RC Lens","AS Saint-Etienne","2-1",2,1,"1",1,3,1,"H"
1962-04-18,1961,"Stade Olympique Montpellierain","RC Strasbourg","1-1",1,1,"1",1,2,0,"D"
1962-04-18,1961,"Toulouse FC","Stade Francais FC","0-1",0,1,"1",1,1,-1,"D"
1962-04-18,1961,"OGC Nice","FC Metz","2-1",2,1,"1",1,3,1,"H"
1962-04-18,1961,"Olympique Lyon","Le Havre AC","1-1",1,1,"1",1,2,0,"D"
1962-04-19,1961,"Stade Rennes","FC Sochaux","2-1",2,1,"1",1,3,1,"H"
1962-04-21,1961,"Stade Reims","Stade Olympique Montpellierain","2-1",2,1,"1",1,3,1,"H"
1962-04-21,1961,"FC Metz","Racing Club de France","2-4",2,4,"1",1,6,-2,"D"
1962-04-21,1961,"AS Monaco","RC Lens","2-1",2,1,"1",1,3,1,"H"
1962-04-21,1961,"Angers SCO","Olympique Lyon","1-1",1,1,"1",1,2,0,"D"
1962-04-22,1961,"Nimes Olympique","AS Saint-Etienne","1-0",1,0,"1",1,1,1,"H"
1962-04-22,1961,"RC Strasbourg","UA Sedan-Torcy","1-2",1,2,"1",1,3,-1,"D"
1962-04-22,1961,"Stade Rennes","AS Nancy","3-0",3,0,"1",1,3,3,"H"
1962-04-22,1961,"Stade Francais FC","FC Rouen","2-4",2,4,"1",1,6,-2,"D"
1962-04-22,1961,"Le Havre AC","OGC Nice","3-0",3,0,"1",1,3,3,"H"
1962-04-22,1961,"Toulouse FC","FC Sochaux","6-1",6,1,"1",1,7,5,"H"
1962-04-24,1961,"Angers SCO","Nimes Olympique","8-3",8,3,"1",1,11,5,"H"
1962-04-24,1961,"Racing Club de France","AS Monaco","3-0",3,0,"1",1,3,3,"H"
1962-04-24,1961,"AS Nancy","RC Lens","1-0",1,0,"1",1,1,1,"H"
1962-04-24,1961,"Toulouse FC","FC Metz","6-1",6,1,"1",1,7,5,"H"
1962-04-24,1961,"RC Strasbourg","AS Saint-Etienne","2-1",2,1,"1",1,3,1,"H"
1962-04-28,1961,"UA Sedan-Torcy","Le Havre AC","2-0",2,0,"1",1,2,2,"H"
1962-04-28,1961,"RC Lens","Stade Rennes","1-0",1,0,"1",1,1,1,"H"
1962-04-28,1961,"FC Rouen","FC Metz","3-2",3,2,"1",1,5,1,"H"
1962-04-28,1961,"OGC Nice","Stade Olympique Montpellierain","1-0",1,0,"1",1,1,1,"H"
1962-04-29,1961,"Nimes Olympique","Olympique Lyon","2-1",2,1,"1",1,3,1,"H"
1962-04-29,1961,"Racing Club de France","Toulouse FC","2-0",2,0,"1",1,2,2,"H"
1962-04-29,1961,"FC Sochaux","Stade Reims","2-1",2,1,"1",1,3,1,"H"
1962-04-29,1961,"AS Nancy","AS Monaco","1-2",1,2,"1",1,3,-1,"D"
1962-04-29,1961,"AS Saint-Etienne","Stade Francais FC","1-1",1,1,"1",1,2,0,"D"
1962-04-29,1961,"Angers SCO","RC Strasbourg","1-1",1,1,"1",1,2,0,"D"
1962-05-19,1961,"Olympique Lyon","AS Nancy","1-3",1,3,"1",1,4,-2,"D"
1962-05-19,1961,"RC Lens","UA Sedan-Torcy","1-0",1,0,"1",1,1,1,"H"
1962-05-19,1961,"FC Rouen","Toulouse FC","0-1",0,1,"1",1,1,-1,"D"
1962-05-19,1961,"FC Sochaux","Angers SCO","5-2",5,2,"1",1,7,3,"H"
1962-05-19,1961,"FC Metz","Le Havre AC","0-0",0,0,"1",1,0,0,"D"
1962-05-20,1961,"AS Monaco","Racing Club de France","1-2",1,2,"1",1,3,-1,"D"
1962-05-20,1961,"Stade Reims","RC Strasbourg","5-1",5,1,"1",1,6,4,"H"
1962-05-20,1961,"Stade Francais FC","Nimes Olympique","1-0",1,0,"1",1,1,1,"H"
1962-05-20,1961,"Stade Olympique Montpellierain","AS Saint-Etienne","4-3",4,3,"1",1,7,1,"H"
1962-05-20,1961,"Stade Rennes","OGC Nice","2-2",2,2,"1",1,4,0,"D"
1962-08-18,1962,"OGC Nice","RC Strasbourg","3-1",3,1,"1",1,4,2,"H"
1962-08-18,1962,"Nimes Olympique","Girondins Bordeaux","1-2",1,2,"1",1,3,-1,"D"
1962-08-18,1962,"Olympique Lyon","Olympique Marseille","1-1",1,1,"1",1,2,0,"D"
1962-08-18,1962,"Grenoble Foot 38","US Valenciennes-Anzin","1-1",1,1,"1",1,2,0,"D"
1962-08-18,1962,"UA Sedan-Torcy","Racing Club de France","0-0",0,0,"1",1,0,0,"D"
1962-08-18,1962,"AS Nancy","Stade Rennes","2-2",2,2,"1",1,4,0,"D"
1962-08-19,1962,"Stade Reims","Angers SCO","4-0",4,0,"1",1,4,4,"H"
1962-08-19,1962,"FC Rouen","AS Monaco","3-3",3,3,"1",1,6,0,"D"
1962-08-19,1962,"Stade Francais FC","Stade Olympique Montpellierain","5-2",5,2,"1",1,7,3,"H"
1962-08-22,1962,"RC Lens","Toulouse FC","1-1",1,1,"1",1,2,0,"D"
1962-08-25,1962,"AS Monaco","Stade Francais FC","1-1",1,1,"1",1,2,0,"D"
1962-08-25,1962,"US Valenciennes-Anzin","OGC Nice","2-2",2,2,"1",1,4,0,"D"
1962-08-25,1962,"Nimes Olympique","Angers SCO","5-0",5,0,"1",1,5,5,"H"
1962-08-25,1962,"RC Strasbourg","Toulouse FC","3-1",3,1,"1",1,4,2,"H"
1962-08-25,1962,"Grenoble Foot 38","FC Rouen","1-1",1,1,"1",1,2,0,"D"
1962-08-26,1962,"Stade Rennes","Stade Olympique Montpellierain","3-1",3,1,"1",1,4,2,"H"
1962-08-26,1962,"Girondins Bordeaux","UA Sedan-Torcy","4-4",4,4,"1",1,8,0,"D"
1962-08-26,1962,"Olympique Marseille","AS Nancy","2-1",2,1,"1",1,3,1,"H"
1962-08-26,1962,"Racing Club de France","RC Lens","2-1",2,1,"1",1,3,1,"H"
1962-08-29,1962,"Stade Reims","Olympique Lyon","5-1",5,1,"1",1,6,4,"H"
1962-09-01,1962,"UA Sedan-Torcy","OGC Nice","0-0",0,0,"1",1,0,0,"D"
1962-09-01,1962,"US Valenciennes-Anzin","Stade Rennes","0-0",0,0,"1",1,0,0,"D"
1962-09-01,1962,"AS Nancy","Girondins Bordeaux","2-2",2,2,"1",1,4,0,"D"
1962-09-01,1962,"Olympique Lyon","Nimes Olympique","0-0",0,0,"1",1,0,0,"D"
1962-09-01,1962,"FC Rouen","RC Strasbourg","0-0",0,0,"1",1,0,0,"D"
1962-09-02,1962,"Stade Olympique Montpellierain","Stade Reims","3-0",3,0,"1",1,3,3,"H"
1962-09-02,1962,"Stade Francais FC","Olympique Marseille","2-2",2,2,"1",1,4,0,"D"
1962-09-02,1962,"AS Monaco","RC Lens","2-0",2,0,"1",1,2,2,"H"
1962-09-02,1962,"Toulouse FC","Grenoble Foot 38","4-2",4,2,"1",1,6,2,"H"
1962-09-02,1962,"Angers SCO","Racing Club de France","2-1",2,1,"1",1,3,1,"H"
1962-09-05,1962,"Stade Rennes","Toulouse FC","3-1",3,1,"1",1,4,2,"H"
1962-09-05,1962,"OGC Nice","FC Rouen","1-0",1,0,"1",1,1,1,"H"
1962-09-05,1962,"Girondins Bordeaux","Stade Francais FC","1-0",1,0,"1",1,1,1,"H"
1962-09-05,1962,"Olympique Marseille","Stade Olympique Montpellierain","3-2",3,2,"1",1,5,1,"H"
1962-09-05,1962,"Stade Reims","US Valenciennes-Anzin","2-2",2,2,"1",1,4,0,"D"
1962-09-05,1962,"RC Strasbourg","AS Monaco","2-2",2,2,"1",1,4,0,"D"
1962-09-05,1962,"Racing Club de France","Grenoble Foot 38","2-0",2,0,"1",1,2,2,"H"
1962-09-05,1962,"Nimes Olympique","UA Sedan-Torcy","1-2",1,2,"1",1,3,-1,"D"
1962-09-05,1962,"RC Lens","AS Nancy","0-1",0,1,"1",1,1,-1,"D"
1962-09-05,1962,"Olympique Lyon","Angers SCO","3-0",3,0,"1",1,3,3,"H"
1962-09-08,1962,"Stade Reims","Olympique Marseille","1-0",1,0,"1",1,1,1,"H"
1962-09-08,1962,"Grenoble Foot 38","Stade Rennes","1-1",1,1,"1",1,2,0,"D"
1962-09-09,1962,"AS Monaco","Girondins Bordeaux","0-2",0,2,"1",1,2,-2,"D"
1962-09-09,1962,"Stade Francais FC","Nimes Olympique","4-2",4,2,"1",1,6,2,"H"
1962-09-09,1962,"US Valenciennes-Anzin","RC Strasbourg","4-0",4,0,"1",1,4,4,"H"
1962-09-09,1962,"AS Nancy","UA Sedan-Torcy","2-0",2,0,"1",1,2,2,"H"
1962-09-09,1962,"FC Rouen","Olympique Lyon","0-1",0,1,"1",1,1,-1,"D"
1962-09-09,1962,"Toulouse FC","OGC Nice","4-0",4,0,"1",1,4,4,"H"
1962-09-09,1962,"Stade Olympique Montpellierain","Racing Club de France","4-1",4,1,"1",1,5,3,"H"
1962-09-09,1962,"Angers SCO","RC Lens","2-2",2,2,"1",1,4,0,"D"
1962-09-15,1962,"OGC Nice","Grenoble Foot 38","3-2",3,2,"1",1,5,1,"H"
1962-09-15,1962,"AS Nancy","Angers SCO","0-0",0,0,"1",1,0,0,"D"
1962-09-15,1962,"Olympique Lyon","Stade Olympique Montpellierain","1-1",1,1,"1",1,2,0,"D"
1962-09-15,1962,"RC Lens","Stade Francais FC","2-1",2,1,"1",1,3,1,"H"
1962-09-15,1962,"Nimes Olympique","Toulouse FC","3-1",3,1,"1",1,4,2,"H"
1962-09-16,1962,"Girondins Bordeaux","FC Rouen","4-1",4,1,"1",1,5,3,"H"
1962-09-16,1962,"Stade Rennes","Stade Reims","2-0",2,0,"1",1,2,2,"H"
1962-09-16,1962,"Olympique Marseille","US Valenciennes-Anzin","1-3",1,3,"1",1,4,-2,"D"
1962-09-16,1962,"UA Sedan-Torcy","AS Monaco","3-0",3,0,"1",1,3,3,"H"
1962-09-16,1962,"Racing Club de France","RC Strasbourg","1-1",1,1,"1",1,2,0,"D"
1962-09-19,1962,"Stade Rennes","Olympique Lyon","2-1",2,1,"1",1,3,1,"H"
1962-09-19,1962,"Girondins Bordeaux","OGC Nice","0-2",0,2,"1",1,2,-2,"D"
1962-09-19,1962,"Stade Reims","AS Nancy","5-1",5,1,"1",1,6,4,"H"
1962-09-19,1962,"FC Rouen","US Valenciennes-Anzin","3-2",3,2,"1",1,5,1,"H"
1962-09-19,1962,"Grenoble Foot 38","Olympique Marseille","0-3",0,3,"1",1,3,-3,"D"
1962-09-19,1962,"Stade Olympique Montpellierain","UA Sedan-Torcy","1-0",1,0,"1",1,1,1,"H"
1962-09-19,1962,"Stade Francais FC","Toulouse FC","1-2",1,2,"1",1,3,-1,"D"
1962-09-19,1962,"AS Monaco","Racing Club de France","1-1",1,1,"1",1,2,0,"D"
1962-09-19,1962,"RC Strasbourg","Angers SCO","3-1",3,1,"1",1,4,2,"H"
1962-09-19,1962,"RC Lens","Nimes Olympique","2-1",2,1,"1",1,3,1,"H"
1962-09-22,1962,"OGC Nice","Stade Olympique Montpellierain","3-1",3,1,"1",1,4,2,"H"
1962-09-22,1962,"Nimes Olympique","Stade Reims","0-0",0,0,"1",1,0,0,"D"
1962-09-22,1962,"RC Strasbourg","Grenoble Foot 38","4-0",4,0,"1",1,4,4,"H"
1962-09-22,1962,"Olympique Lyon","AS Monaco","1-1",1,1,"1",1,2,0,"D"
1962-09-23,1962,"Angers SCO","Girondins Bordeaux","0-3",0,3,"1",1,3,-3,"D"
1962-09-23,1962,"Racing Club de France","Stade Rennes","2-1",2,1,"1",1,3,1,"H"
1962-09-23,1962,"US Valenciennes-Anzin","Stade Francais FC","0-0",0,0,"1",1,0,0,"D"
1962-09-23,1962,"Toulouse FC","Olympique Marseille","3-1",3,1,"1",1,4,2,"H"
1962-09-23,1962,"UA Sedan-Torcy","RC Lens","2-1",2,1,"1",1,3,1,"H"
1962-09-23,1962,"AS Nancy","FC Rouen","1-3",1,3,"1",1,4,-2,"D"
1962-10-06,1962,"AS Monaco","US Valenciennes-Anzin","3-1",3,1,"1",1,4,2,"H"
1962-10-06,1962,"Nimes Olympique","AS Nancy","3-0",3,0,"1",1,3,3,"H"
1962-10-07,1962,"Stade Rennes","RC Strasbourg","4-1",4,1,"1",1,5,3,"H"
1962-10-07,1962,"RC Lens","OGC Nice","2-2",2,2,"1",1,4,0,"D"
1962-10-07,1962,"Grenoble Foot 38","Stade Reims","0-3",0,3,"1",1,3,-3,"D"
1962-10-07,1962,"Girondins Bordeaux","Olympique Lyon","1-2",1,2,"1",1,3,-1,"D"
1962-10-07,1962,"Toulouse FC","Stade Olympique Montpellierain","2-1",2,1,"1",1,3,1,"H"
1962-10-07,1962,"Angers SCO","UA Sedan-Torcy","0-1",0,1,"1",1,1,-1,"D"
1962-10-07,1962,"Olympique Marseille","Racing Club de France","1-3",1,3,"1",1,4,-2,"D"
1962-10-07,1962,"Stade Francais FC","FC Rouen","1-2",1,2,"1",1,3,-1,"D"
1962-10-10,1962,"OGC Nice","Nimes Olympique","1-0",1,0,"1",1,1,1,"H"
1962-10-10,1962,"Stade Reims","RC Strasbourg","1-1",1,1,"1",1,2,0,"D"
1962-10-10,1962,"US Valenciennes-Anzin","Toulouse FC","1-2",1,2,"1",1,3,-1,"D"
1962-10-10,1962,"Olympique Lyon","AS Nancy","3-0",3,0,"1",1,3,3,"H"
1962-10-10,1962,"FC Rouen","Angers SCO","3-1",3,1,"1",1,4,2,"H"
1962-10-10,1962,"Olympique Marseille","RC Lens","3-3",3,3,"1",1,6,0,"D"
1962-10-10,1962,"Grenoble Foot 38","Stade Francais FC","1-1",1,1,"1",1,2,0,"D"
1962-10-11,1962,"Stade Rennes","UA Sedan-Torcy","3-1",3,1,"1",1,4,2,"H"
1962-10-11,1962,"Racing Club de France","Girondins Bordeaux","1-3",1,3,"1",1,4,-2,"D"
1962-10-11,1962,"Stade Olympique Montpellierain","AS Monaco","0-1",0,1,"1",1,1,-1,"D"
1962-10-13,1962,"FC Rouen","Stade Reims","1-2",1,2,"1",1,3,-1,"D"
1962-10-13,1962,"Nimes Olympique","Stade Rennes","2-1",2,1,"1",1,3,1,"H"
1962-10-14,1962,"RC Lens","Girondins Bordeaux","3-3",3,3,"1",1,6,0,"D"
1962-10-14,1962,"Stade Francais FC","OGC Nice","2-0",2,0,"1",1,2,2,"H"
1962-10-14,1962,"Toulouse FC","Racing Club de France","1-1",1,1,"1",1,2,0,"D"
1962-10-14,1962,"UA Sedan-Torcy","Olympique Lyon","1-3",1,3,"1",1,4,-2,"D"
1962-10-14,1962,"AS Monaco","Grenoble Foot 38","4-0",4,0,"1",1,4,4,"H"
1962-10-14,1962,"RC Strasbourg","Stade Olympique Montpellierain","1-1",1,1,"1",1,2,0,"D"
1962-10-14,1962,"AS Nancy","US Valenciennes-Anzin","2-0",2,0,"1",1,2,2,"H"
1962-10-14,1962,"Angers SCO","Olympique Marseille","3-0",3,0,"1",1,3,3,"H"
1962-10-21,1962,"Stade Rennes","Angers SCO","1-1",1,1,"1",1,2,0,"D"
1962-10-21,1962,"Girondins Bordeaux","Toulouse FC","0-0",0,0,"1",1,0,0,"D"
1962-10-21,1962,"Grenoble Foot 38","Olympique Lyon","1-2",1,2,"1",1,3,-1,"D"
1962-10-21,1962,"OGC Nice","AS Monaco","2-2",2,2,"1",1,4,0,"D"
1962-10-21,1962,"Stade Reims","UA Sedan-Torcy","2-3",2,3,"1",1,5,-1,"D"
1962-10-21,1962,"Olympique Marseille","FC Rouen","0-1",0,1,"1",1,1,-1,"D"
1962-10-21,1962,"RC Strasbourg","AS Nancy","1-0",1,0,"1",1,1,1,"H"
1962-10-21,1962,"Racing Club de France","Stade Francais FC","0-2",0,2,"1",1,2,-2,"D"
1962-10-21,1962,"Stade Olympique Montpellierain","Nimes Olympique","1-1",1,1,"1",1,2,0,"D"
1962-10-21,1962,"US Valenciennes-Anzin","RC Lens","1-1",1,1,"1",1,2,0,"D"
1962-10-28,1962,"Girondins Bordeaux","Stade Reims","2-3",2,3,"1",1,5,-1,"D"
1962-10-28,1962,"OGC Nice","Racing Club de France","3-3",3,3,"1",1,6,0,"D"
1962-10-28,1962,"FC Rouen","Stade Rennes","2-0",2,0,"1",1,2,2,"H"
1962-10-28,1962,"RC Lens","Olympique Lyon","2-1",2,1,"1",1,3,1,"H"
1962-10-28,1962,"UA Sedan-Torcy","Toulouse FC","2-1",2,1,"1",1,3,1,"H"
1962-10-28,1962,"Stade Francais FC","RC Strasbourg","2-1",2,1,"1",1,3,1,"H"
1962-10-28,1962,"AS Nancy","AS Monaco","2-1",2,1,"1",1,3,1,"H"
1962-10-28,1962,"Nimes Olympique","Olympique Marseille","3-0",3,0,"1",1,3,3,"H"
1962-10-28,1962,"Angers SCO","US Valenciennes-Anzin","0-0",0,0,"1",1,0,0,"D"
1962-10-28,1962,"Grenoble Foot 38","Stade Olympique Montpellierain","3-1",3,1,"1",1,4,2,"H"
1962-10-31,1962,"Stade Reims","Stade Francais FC","6-2",6,2,"1",1,8,4,"H"
1962-10-31,1962,"Toulouse FC","Angers SCO","4-0",4,0,"1",1,4,4,"H"
1962-10-31,1962,"AS Monaco","Nimes Olympique","4-1",4,1,"1",1,5,3,"H"
1962-11-01,1962,"Stade Rennes","Girondins Bordeaux","1-3",1,3,"1",1,4,-2,"D"
1962-11-01,1962,"Olympique Marseille","OGC Nice","1-1",1,1,"1",1,2,0,"D"
1962-11-01,1962,"US Valenciennes-Anzin","Olympique Lyon","0-0",0,0,"1",1,0,0,"D"
1962-11-01,1962,"Grenoble Foot 38","UA Sedan-Torcy","1-1",1,1,"1",1,2,0,"D"
1962-11-01,1962,"Stade Olympique Montpellierain","FC Rouen","3-1",3,1,"1",1,4,2,"H"
1962-11-01,1962,"Racing Club de France","AS Nancy","4-2",4,2,"1",1,6,2,"H"
1962-11-01,1962,"RC Strasbourg","RC Lens","1-3",1,3,"1",1,4,-2,"D"
1962-11-04,1962,"OGC Nice","Stade Reims","4-0",4,0,"1",1,4,4,"H"
1962-11-04,1962,"Girondins Bordeaux","US Valenciennes-Anzin","2-2",2,2,"1",1,4,0,"D"
1962-11-04,1962,"FC Rouen","Toulouse FC","2-2",2,2,"1",1,4,0,"D"
1962-11-04,1962,"UA Sedan-Torcy","Olympique Marseille","4-0",4,0,"1",1,4,4,"H"
1962-11-04,1962,"Olympique Lyon","Racing Club de France","1-1",1,1,"1",1,2,0,"D"
1962-11-04,1962,"Stade Francais FC","Stade Rennes","3-3",3,3,"1",1,6,0,"D"
1962-11-04,1962,"Angers SCO","AS Monaco","4-2",4,2,"1",1,6,2,"H"
1962-11-04,1962,"RC Lens","Grenoble Foot 38","2-0",2,0,"1",1,2,2,"H"
1962-11-04,1962,"Nimes Olympique","RC Strasbourg","5-1",5,1,"1",1,6,4,"H"
1962-11-04,1962,"AS Nancy","Stade Olympique Montpellierain","2-1",2,1,"1",1,3,1,"H"
1962-11-18,1962,"Stade Reims","RC Lens","3-1",3,1,"1",1,4,2,"H"
1962-11-18,1962,"Stade Olympique Montpellierain","Girondins Bordeaux","0-3",0,3,"1",1,3,-3,"D"
1962-11-18,1962,"Toulouse FC","AS Nancy","2-0",2,0,"1",1,2,2,"H"
1962-11-18,1962,"RC Strasbourg","Olympique Lyon","0-3",0,3,"1",1,3,-3,"D"
1962-11-18,1962,"Stade Rennes","OGC Nice","3-1",3,1,"1",1,4,2,"H"
1962-11-18,1962,"FC Rouen","UA Sedan-Torcy","2-1",2,1,"1",1,3,1,"H"
1962-11-18,1962,"Grenoble Foot 38","Nimes Olympique","0-0",0,0,"1",1,0,0,"D"
1962-11-18,1962,"US Valenciennes-Anzin","Racing Club de France","4-0",4,0,"1",1,4,4,"H"
1962-11-18,1962,"Stade Francais FC","Angers SCO","0-3",0,3,"1",1,3,-3,"D"
1962-11-19,1962,"AS Monaco","Olympique Marseille","2-1",2,1,"1",1,3,1,"H"
1962-11-21,1962,"Racing Club de France","Stade Reims","3-3",3,3,"1",1,6,0,"D"
1962-11-21,1962,"Girondins Bordeaux","Grenoble Foot 38","1-1",1,1,"1",1,2,0,"D"
1962-11-21,1962,"AS Monaco","Toulouse FC","0-0",0,0,"1",1,0,0,"D"
1962-11-21,1962,"Nimes Olympique","FC Rouen","2-1",2,1,"1",1,3,1,"H"
1962-11-21,1962,"AS Nancy","Stade Francais FC","0-0",0,0,"1",1,0,0,"D"
1962-11-22,1962,"Olympique Lyon","OGC Nice","3-1",3,1,"1",1,4,2,"H"
1962-11-22,1962,"Olympique Marseille","RC Strasbourg","1-3",1,3,"1",1,4,-2,"D"
1962-11-22,1962,"Angers SCO","Stade Olympique Montpellierain","2-1",2,1,"1",1,3,1,"H"
1962-11-25,1962,"Toulouse FC","Olympique Lyon","0-1",0,1,"1",1,1,-1,"D"
1962-11-25,1962,"Stade Reims","AS Monaco","1-1",1,1,"1",1,2,0,"D"
1962-11-25,1962,"RC Strasbourg","Girondins Bordeaux","0-0",0,0,"1",1,0,0,"D"
1962-11-25,1962,"Stade Rennes","Olympique Marseille","3-2",3,2,"1",1,5,1,"H"
1962-11-25,1962,"OGC Nice","Angers SCO","1-1",1,1,"1",1,2,0,"D"
1962-11-25,1962,"US Valenciennes-Anzin","Nimes Olympique","1-1",1,1,"1",1,2,0,"D"
1962-11-25,1962,"FC Rouen","Racing Club de France","0-2",0,2,"1",1,2,-2,"D"
1962-11-25,1962,"Stade Francais FC","UA Sedan-Torcy","4-2",4,2,"1",1,6,2,"H"
1962-11-25,1962,"Stade Olympique Montpellierain","RC Lens","2-1",2,1,"1",1,3,1,"H"
1962-11-25,1962,"Grenoble Foot 38","AS Nancy","1-1",1,1,"1",1,2,0,"D"
1962-11-28,1962,"RC Lens","Stade Rennes","2-2",2,2,"1",1,4,0,"D"
1962-11-28,1962,"UA Sedan-Torcy","US Valenciennes-Anzin","4-2",4,2,"1",1,6,2,"H"
1962-12-02,1962,"Olympique Lyon","Stade Francais FC","1-0",1,0,"1",1,1,1,"H"
1962-12-02,1962,"Olympique Marseille","Girondins Bordeaux","1-1",1,1,"1",1,2,0,"D"
1962-12-02,1962,"Toulouse FC","Stade Reims","3-2",3,2,"1",1,5,1,"H"
1962-12-02,1962,"AS Monaco","Stade Rennes","5-0",5,0,"1",1,5,5,"H"
1962-12-02,1962,"UA Sedan-Torcy","RC Strasbourg","2-1",2,1,"1",1,3,1,"H"
1962-12-02,1962,"AS Nancy","OGC Nice","1-1",1,1,"1",1,2,0,"D"
1962-12-02,1962,"Racing Club de France","Nimes Olympique","2-2",2,2,"1",1,4,0,"D"
1962-12-02,1962,"RC Lens","FC Rouen","1-4",1,4,"1",1,5,-3,"D"
1962-12-02,1962,"Stade Olympique Montpellierain","US Valenciennes-Anzin","0-4",0,4,"1",1,4,-4,"D"
1962-12-02,1962,"Angers SCO","Grenoble Foot 38","2-1",2,1,"1",1,3,1,"H"
1962-12-09,1962,"Nimes Olympique","Olympique Lyon","1-0",1,0,"1",1,1,1,"H"
1962-12-09,1962,"Girondins Bordeaux","Angers SCO","0-0",0,0,"1",1,0,0,"D"
1962-12-09,1962,"UA Sedan-Torcy","AS Nancy","2-0",2,0,"1",1,2,2,"H"
1962-12-09,1962,"OGC Nice","Olympique Marseille","1-0",1,0,"1",1,1,1,"H"
1962-12-09,1962,"RC Strasbourg","Stade Reims","3-2",3,2,"1",1,5,1,"H"
1962-12-09,1962,"US Valenciennes-Anzin","AS Monaco","0-0",0,0,"1",1,0,0,"D"
1962-12-09,1962,"Grenoble Foot 38","Toulouse FC","1-0",1,0,"1",1,1,1,"H"
1962-12-09,1962,"FC Rouen","Stade Olympique Montpellierain","3-1",3,1,"1",1,4,2,"H"
1962-12-09,1962,"Stade Rennes","Racing Club de France","3-5",3,5,"1",1,8,-2,"D"
1962-12-09,1962,"Stade Francais FC","RC Lens","2-0",2,0,"1",1,2,2,"H"
1962-12-16,1962,"Stade Reims","Girondins Bordeaux","1-3",1,3,"1",1,4,-2,"D"
1962-12-16,1962,"Olympique Lyon","UA Sedan-Torcy","0-2",0,2,"1",1,2,-2,"D"
1962-12-16,1962,"AS Monaco","FC Rouen","3-1",3,1,"1",1,4,2,"H"
1962-12-16,1962,"Toulouse FC","Stade Rennes","2-1",2,1,"1",1,3,1,"H"
1962-12-16,1962,"Olympique Marseille","Nimes Olympique","0-3",0,3,"1",1,3,-3,"D"
1962-12-16,1962,"Stade Olympique Montpellierain","OGC Nice","1-0",1,0,"1",1,1,1,"H"
1962-12-16,1962,"Racing Club de France","US Valenciennes-Anzin","3-2",3,2,"1",1,5,1,"H"
1962-12-16,1962,"Angers SCO","Stade Francais FC","2-0",2,0,"1",1,2,2,"H"
1962-12-16,1962,"RC Lens","RC Strasbourg","0-0",0,0,"1",1,0,0,"D"
1962-12-16,1962,"AS Nancy","Grenoble Foot 38","1-0",1,0,"1",1,1,1,"H"
1962-12-23,1962,"FC Rouen","Girondins Bordeaux","1-1",1,1,"1",1,2,0,"D"
1962-12-23,1962,"UA Sedan-Torcy","Stade Olympique Montpellierain","2-0",2,0,"1",1,2,2,"H"
1962-12-23,1962,"Olympique Lyon","RC Lens","1-0",1,0,"1",1,1,1,"H"
1962-12-23,1962,"Nimes Olympique","AS Monaco","1-2",1,2,"1",1,3,-1,"D"
1962-12-23,1962,"OGC Nice","Toulouse FC","2-1",2,1,"1",1,3,1,"H"
1962-12-23,1962,"Stade Francais FC","Stade Reims","0-4",0,4,"1",1,4,-4,"D"
1962-12-23,1962,"Grenoble Foot 38","Racing Club de France","1-1",1,1,"1",1,2,0,"D"
1962-12-23,1962,"Stade Rennes","AS Nancy","1-1",1,1,"1",1,2,0,"D"
1962-12-23,1962,"US Valenciennes-Anzin","Angers SCO","4-0",4,0,"1",1,4,4,"H"
1962-12-23,1962,"RC Strasbourg","Olympique Marseille","0-0",0,0,"1",1,0,0,"D"
1962-12-30,1962,"Girondins Bordeaux","Stade Rennes","6-0",6,0,"1",1,6,6,"H"
1962-12-30,1962,"AS Monaco","UA Sedan-Torcy","0-1",0,1,"1",1,1,-1,"D"
1962-12-30,1962,"Racing Club de France","Olympique Lyon","1-1",1,1,"1",1,2,0,"D"
1962-12-30,1962,"Toulouse FC","RC Strasbourg","1-1",1,1,"1",1,2,0,"D"
1962-12-30,1962,"Angers SCO","Nimes Olympique","0-0",0,0,"1",1,0,0,"D"
1962-12-30,1962,"Olympique Marseille","Stade Francais FC","3-2",3,2,"1",1,5,1,"H"
1962-12-30,1962,"Stade Olympique Montpellierain","Grenoble Foot 38","2-0",2,0,"1",1,2,2,"H"
1963-01-05,1962,"Girondins Bordeaux","Olympique Marseille","1-3",1,3,"1",1,4,-2,"D"
1963-01-06,1962,"UA Sedan-Torcy","Nimes Olympique","3-0",3,0,"1",1,3,3,"H"
1963-01-06,1962,"Stade Olympique Montpellierain","Olympique Lyon","1-1",1,1,"1",1,2,0,"D"
1963-01-06,1962,"AS Monaco","Stade Reims","5-2",5,2,"1",1,7,3,"H"
1963-01-06,1962,"Racing Club de France","Toulouse FC","2-2",2,2,"1",1,4,0,"D"
1963-01-06,1962,"Grenoble Foot 38","OGC Nice","3-1",3,1,"1",1,4,2,"H"
1963-01-06,1962,"FC Rouen","AS Nancy","2-1",2,1,"1",1,3,1,"H"
1963-01-06,1962,"Stade Rennes","Stade Francais FC","2-0",2,0,"1",1,2,2,"H"
1963-01-13,1962,"Toulouse FC","UA Sedan-Torcy","0-2",0,2,"1",1,2,-2,"D"
1963-01-13,1962,"Stade Rennes","AS Monaco","2-0",2,0,"1",1,2,2,"H"
1963-01-13,1962,"Stade Reims","FC Rouen","4-0",4,0,"1",1,4,4,"H"
1963-01-13,1962,"Nimes Olympique","RC Lens","4-2",4,2,"1",1,6,2,"H"
1963-01-13,1962,"Stade Francais FC","Grenoble Foot 38","1-1",1,1,"1",1,2,0,"D"
1963-01-27,1962,"UA Sedan-Torcy","Grenoble Foot 38","3-1",3,1,"1",1,4,2,"H"
1963-01-27,1962,"Girondins Bordeaux","Nimes Olympique","0-0",0,0,"1",1,0,0,"D"
1963-01-27,1962,"AS Monaco","Olympique Lyon","1-0",1,0,"1",1,1,1,"H"
1963-01-27,1962,"Angers SCO","Stade Reims","0-1",0,1,"1",1,1,-1,"D"
1963-01-27,1962,"Racing Club de France","Olympique Marseille","3-0",3,0,"1",1,3,3,"H"
1963-01-27,1962,"Stade Olympique Montpellierain","Stade Rennes","1-1",1,1,"1",1,2,0,"D"
1963-01-27,1962,"Toulouse FC","RC Lens","1-2",1,2,"1",1,3,-1,"D"
1963-01-27,1962,"FC Rouen","Stade Francais FC","3-1",3,1,"1",1,4,2,"H"
1963-01-27,1962,"RC Strasbourg","OGC Nice","7-0",7,0,"1",1,7,7,"H"
1963-01-27,1962,"US Valenciennes-Anzin","AS Nancy","2-0",2,0,"1",1,2,2,"H"
1963-02-03,1962,"OGC Nice","UA Sedan-Torcy","2-1",2,1,"1",1,3,1,"H"
1963-02-03,1962,"Olympique Marseille","AS Monaco","2-4",2,4,"1",1,6,-2,"D"
1963-02-03,1962,"Olympique Lyon","Girondins Bordeaux","1-0",1,0,"1",1,1,1,"H"
1963-02-03,1962,"Stade Reims","Toulouse FC","1-0",1,0,"1",1,1,1,"H"
1963-02-03,1962,"RC Strasbourg","FC Rouen","3-0",3,0,"1",1,3,3,"H"
1963-02-03,1962,"Stade Francais FC","AS Nancy","2-0",2,0,"1",1,2,2,"H"
1963-02-10,1962,"AS Monaco","RC Strasbourg","1-0",1,0,"1",1,1,1,"H"
1963-02-10,1962,"Girondins Bordeaux","RC Lens","3-0",3,0,"1",1,3,3,"H"
1963-02-10,1962,"Angers SCO","Olympique Lyon","2-2",2,2,"1",1,4,0,"D"
1963-02-10,1962,"US Valenciennes-Anzin","Stade Reims","2-0",2,0,"1",1,2,2,"H"
1963-02-10,1962,"Racing Club de France","OGC Nice","3-4",3,4,"1",1,7,-1,"D"
1963-02-10,1962,"Toulouse FC","Nimes Olympique","2-0",2,0,"1",1,2,2,"H"
1963-02-10,1962,"Stade Olympique Montpellierain","Stade Francais FC","4-5",4,5,"1",1,9,-1,"D"
1963-02-10,1962,"AS Nancy","Olympique Marseille","1-0",1,0,"1",1,1,1,"H"
1963-03-03,1962,"Racing Club de France","AS Monaco","2-3",2,3,"1",1,5,-1,"D"
1963-03-03,1962,"Girondins Bordeaux","RC Strasbourg","3-0",3,0,"1",1,3,3,"H"
1963-03-03,1962,"OGC Nice","RC Lens","3-1",3,1,"1",1,4,2,"H"
1963-03-03,1962,"Olympique Marseille","Stade Reims","1-0",1,0,"1",1,1,1,"H"
1963-03-03,1962,"Stade Rennes","Nimes Olympique","1-1",1,1,"1",1,2,0,"D"
1963-03-03,1962,"Toulouse FC","FC Rouen","1-2",1,2,"1",1,3,-1,"D"
1963-03-03,1962,"US Valenciennes-Anzin","Grenoble Foot 38","1-1",1,1,"1",1,2,0,"D"
1963-03-03,1962,"Stade Olympique Montpellierain","Angers SCO","1-2",1,2,"1",1,3,-1,"D"
1963-03-10,1962,"US Valenciennes-Anzin","Stade Olympique Montpellierain","2-0",2,0,"1",1,2,2,"H"
1963-03-17,1962,"Grenoble Foot 38","AS Monaco","0-1",0,1,"1",1,1,-1,"D"
1963-03-17,1962,"RC Strasbourg","UA Sedan-Torcy","1-5",1,5,"1",1,6,-4,"D"
1963-03-17,1962,"Stade Francais FC","Girondins Bordeaux","0-0",0,0,"1",1,0,0,"D"
1963-03-17,1962,"Olympique Lyon","Stade Rennes","1-1",1,1,"1",1,2,0,"D"
1963-03-17,1962,"OGC Nice","AS Nancy","2-0",2,0,"1",1,2,2,"H"
1963-03-17,1962,"Stade Reims","Stade Olympique Montpellierain","1-1",1,1,"1",1,2,0,"D"
1963-03-17,1962,"Olympique Marseille","Toulouse FC","0-1",0,1,"1",1,1,-1,"D"
1963-03-17,1962,"RC Lens","Racing Club de France","1-2",1,2,"1",1,3,-1,"D"
1963-03-17,1962,"Nimes Olympique","US Valenciennes-Anzin","1-3",1,3,"1",1,4,-2,"D"
1963-03-17,1962,"Angers SCO","FC Rouen","3-1",3,1,"1",1,4,2,"H"
1963-03-23,1962,"AS Nancy","RC Strasbourg","1-1",1,1,"1",1,2,0,"D"
1963-03-23,1962,"FC Rouen","Olympique Marseille","3-0",3,0,"1",1,3,3,"H"
1963-03-24,1962,"AS Monaco","OGC Nice","6-2",6,2,"1",1,8,4,"H"
1963-03-24,1962,"UA Sedan-Torcy","Stade Reims","1-2",1,2,"1",1,3,-1,"D"
1963-03-24,1962,"Toulouse FC","Girondins Bordeaux","0-0",0,0,"1",1,0,0,"D"
1963-03-24,1962,"Olympique Lyon","Grenoble Foot 38","0-1",0,1,"1",1,1,-1,"D"
1963-03-24,1962,"Stade Francais FC","Racing Club de France","1-2",1,2,"1",1,3,-1,"D"
1963-03-24,1962,"RC Lens","US Valenciennes-Anzin","1-2",1,2,"1",1,3,-1,"D"
1963-03-24,1962,"Angers SCO","Stade Rennes","2-3",2,3,"1",1,5,-1,"D"
1963-03-24,1962,"Nimes Olympique","Stade Olympique Montpellierain","1-1",1,1,"1",1,2,0,"D"
1963-03-30,1962,"AS Nancy","RC Lens","1-3",1,3,"1",1,4,-2,"D"
1963-03-30,1962,"AS Nancy","Racing Club de France","2-2",2,2,"1",1,4,0,"D"
1963-03-31,1962,"US Valenciennes-Anzin","FC Rouen","1-1",1,1,"1",1,2,0,"D"
1963-03-31,1962,"Grenoble Foot 38","Angers SCO","0-2",0,2,"1",1,2,-2,"D"
1963-03-31,1962,"RC Lens","Stade Olympique Montpellierain","3-0",3,0,"1",1,3,3,"H"
1963-04-03,1962,"RC Lens","AS Monaco","1-0",1,0,"1",1,1,1,"H"
1963-04-03,1962,"Girondins Bordeaux","AS Nancy","2-0",2,0,"1",1,2,2,"H"
1963-04-03,1962,"Racing Club de France","UA Sedan-Torcy","4-3",4,3,"1",1,7,1,"H"
1963-04-03,1962,"Stade Reims","Grenoble Foot 38","1-1",1,1,"1",1,2,0,"D"
1963-04-03,1962,"Olympique Lyon","US Valenciennes-Anzin","1-1",1,1,"1",1,2,0,"D"
1963-04-03,1962,"Angers SCO","Toulouse FC","1-3",1,3,"1",1,4,-2,"D"
1963-04-03,1962,"OGC Nice","Stade Francais FC","0-2",0,2,"1",1,2,-2,"D"
1963-04-03,1962,"RC Strasbourg","Stade Rennes","1-1",1,1,"1",1,2,0,"D"
1963-04-03,1962,"FC Rouen","Nimes Olympique","0-1",0,1,"1",1,1,-1,"D"
1963-04-03,1962,"Stade Olympique Montpellierain","Olympique Marseille","2-0",2,0,"1",1,2,2,"H"
1963-04-06,1962,"UA Sedan-Torcy","FC Rouen","0-1",0,1,"1",1,1,-1,"D"
1963-04-06,1962,"Grenoble Foot 38","RC Strasbourg","3-3",3,3,"1",1,6,0,"D"
1963-04-06,1962,"AS Monaco","Stade Olympique Montpellierain","3-1",3,1,"1",1,4,2,"H"
1963-04-06,1962,"US Valenciennes-Anzin","Girondins Bordeaux","2-0",2,0,"1",1,2,2,"H"
1963-04-06,1962,"AS Nancy","Stade Reims","0-2",0,2,"1",1,2,-2,"D"
1963-04-06,1962,"Olympique Marseille","Olympique Lyon","1-2",1,2,"1",1,3,-1,"D"
1963-04-06,1962,"Toulouse FC","Stade Francais FC","5-2",5,2,"1",1,7,3,"H"
1963-04-06,1962,"Racing Club de France","Angers SCO","2-4",2,4,"1",1,6,-2,"D"
1963-04-06,1962,"Stade Rennes","RC Lens","4-2",4,2,"1",1,6,2,"H"
1963-04-06,1962,"Nimes Olympique","OGC Nice","6-3",6,3,"1",1,9,3,"H"
1963-04-12,1962,"Olympique Lyon","Stade Reims","0-0",0,0,"1",1,0,0,"D"
1963-04-12,1962,"RC Strasbourg","Racing Club de France","2-2",2,2,"1",1,4,0,"D"
1963-04-12,1962,"AS Nancy","Nimes Olympique","0-4",0,4,"1",1,4,-4,"D"
1963-04-12,1962,"FC Rouen","OGC Nice","4-2",4,2,"1",1,6,2,"H"
1963-04-13,1962,"Girondins Bordeaux","Stade Olympique Montpellierain","2-0",2,0,"1",1,2,2,"H"
1963-04-13,1962,"UA Sedan-Torcy","Angers SCO","0-1",0,1,"1",1,1,-1,"D"
1963-04-13,1962,"Stade Rennes","Grenoble Foot 38","3-0",3,0,"1",1,3,3,"H"
1963-04-13,1962,"RC Lens","Olympique Marseille","8-1",8,1,"1",1,9,7,"H"
1963-04-14,1962,"Toulouse FC","AS Monaco","0-5",0,5,"1",1,5,-5,"D"
1963-04-14,1962,"Stade Francais FC","US Valenciennes-Anzin","1-3",1,3,"1",1,4,-2,"D"
1963-04-20,1962,"RC Lens","Angers SCO","3-3",3,3,"1",1,6,0,"D"
1963-04-20,1962,"Stade Rennes","US Valenciennes-Anzin","3-1",3,1,"1",1,4,2,"H"
1963-04-20,1962,"Nimes Olympique","Racing Club de France","4-1",4,1,"1",1,5,3,"H"
1963-04-20,1962,"FC Rouen","Grenoble Foot 38","0-2",0,2,"1",1,2,-2,"D"
1963-04-20,1962,"UA Sedan-Torcy","Stade Francais FC","3-0",3,0,"1",1,3,3,"H"
1963-04-21,1962,"OGC Nice","Girondins Bordeaux","1-1",1,1,"1",1,2,0,"D"
1963-04-30,1962,"Nimes Olympique","Stade Francais FC","4-0",4,0,"1",1,4,4,"H"
1963-04-30,1962,"Olympique Lyon","Toulouse FC","3-3",3,3,"1",1,6,0,"D"
1963-04-30,1962,"OGC Nice","US Valenciennes-Anzin","2-0",2,0,"1",1,2,2,"H"
1963-05-01,1962,"Girondins Bordeaux","AS Monaco","0-1",0,1,"1",1,1,-1,"D"
1963-05-01,1962,"RC Lens","UA Sedan-Torcy","1-2",1,2,"1",1,3,-1,"D"
1963-05-01,1962,"Stade Reims","Stade Rennes","4-0",4,0,"1",1,4,4,"H"
1963-05-01,1962,"Racing Club de France","FC Rouen","3-0",3,0,"1",1,3,3,"H"
1963-05-01,1962,"Angers SCO","AS Nancy","1-1",1,1,"1",1,2,0,"D"
1963-05-01,1962,"Stade Olympique Montpellierain","RC Strasbourg","1-1",1,1,"1",1,2,0,"D"
1963-05-01,1962,"Olympique Marseille","Grenoble Foot 38","2-2",2,2,"1",1,4,0,"D"
1963-05-04,1962,"FC Rouen","RC Lens","3-2",3,2,"1",1,5,1,"H"
1963-05-05,1962,"AS Monaco","AS Nancy","0-1",0,1,"1",1,1,-1,"D"
1963-05-05,1962,"US Valenciennes-Anzin","UA Sedan-Torcy","1-1",1,1,"1",1,2,0,"D"
1963-05-05,1962,"Grenoble Foot 38","Girondins Bordeaux","2-1",2,1,"1",1,3,1,"H"
1963-05-05,1962,"Stade Reims","Racing Club de France","3-2",3,2,"1",1,5,1,"H"
1963-05-05,1962,"RC Strasbourg","Nimes Olympique","2-1",2,1,"1",1,3,1,"H"
1963-05-05,1962,"Stade Francais FC","Olympique Lyon","1-0",1,0,"1",1,1,1,"H"
1963-05-05,1962,"Olympique Marseille","Stade Rennes","4-2",4,2,"1",1,6,2,"H"
1963-05-05,1962,"Stade Olympique Montpellierain","Toulouse FC","1-1",1,1,"1",1,2,0,"D"
1963-05-05,1962,"Angers SCO","OGC Nice","3-0",3,0,"1",1,3,3,"H"
1963-05-11,1962,"RC Strasbourg","US Valenciennes-Anzin","0-2",0,2,"1",1,2,-2,"D"
1963-05-11,1962,"Olympique Marseille","Angers SCO","1-0",1,0,"1",1,1,1,"H"
1963-05-11,1962,"UA Sedan-Torcy","Stade Rennes","3-3",3,3,"1",1,6,0,"D"
1963-05-15,1962,"Stade Reims","OGC Nice","4-2",4,2,"1",1,6,2,"H"
1963-05-15,1962,"AS Nancy","Olympique Lyon","3-2",3,2,"1",1,5,1,"H"
1963-05-18,1962,"OGC Nice","Olympique Lyon","3-5",3,5,"1",1,8,-2,"D"
1963-05-18,1962,"US Valenciennes-Anzin","Olympique Marseille","0-1",0,1,"1",1,1,-1,"D"
1963-05-19,1962,"AS Monaco","Angers SCO","5-1",5,1,"1",1,6,4,"H"
1963-05-19,1962,"RC Lens","Stade Reims","0-0",0,0,"1",1,0,0,"D"
1963-05-19,1962,"UA Sedan-Torcy","Girondins Bordeaux","1-1",1,1,"1",1,2,0,"D"
1963-05-19,1962,"Nimes Olympique","Grenoble Foot 38","1-0",1,0,"1",1,1,1,"H"
1963-05-19,1962,"Racing Club de France","Stade Olympique Montpellierain","9-1",9,1,"1",1,10,8,"H"
1963-05-19,1962,"AS Nancy","Toulouse FC","1-2",1,2,"1",1,3,-1,"D"
1963-05-19,1962,"Stade Rennes","FC Rouen","0-3",0,3,"1",1,3,-3,"D"
1963-05-19,1962,"RC Strasbourg","Stade Francais FC","1-1",1,1,"1",1,2,0,"D"
1963-05-25,1962,"Stade Reims","Nimes Olympique","4-1",4,1,"1",1,5,3,"H"
1963-05-25,1962,"Girondins Bordeaux","Racing Club de France","2-1",2,1,"1",1,3,1,"H"
1963-05-25,1962,"Toulouse FC","US Valenciennes-Anzin","5-1",5,1,"1",1,6,4,"H"
1963-05-25,1962,"Angers SCO","RC Strasbourg","2-2",2,2,"1",1,4,0,"D"
1963-05-26,1962,"Stade Francais FC","AS Monaco","2-2",2,2,"1",1,4,0,"D"
1963-05-26,1962,"Olympique Marseille","UA Sedan-Torcy","0-0",0,0,"1",1,0,0,"D"
1963-05-26,1962,"Olympique Lyon","FC Rouen","0-1",0,1,"1",1,1,-1,"D"
1963-05-26,1962,"OGC Nice","Stade Rennes","3-3",3,3,"1",1,6,0,"D"
1963-05-26,1962,"Grenoble Foot 38","RC Lens","1-0",1,0,"1",1,1,1,"H"
1963-05-26,1962,"Stade Olympique Montpellierain","AS Nancy","5-3",5,3,"1",1,8,2,"H"
1963-05-30,1962,"Olympique Lyon","RC Strasbourg","3-1",3,1,"1",1,4,2,"H"
1963-09-01,1963,"OGC Nice","Toulouse FC","2-4",2,4,"1",1,6,-2,"D"
1963-09-01,1963,"RC Strasbourg","Girondins Bordeaux","3-1",3,1,"1",1,4,2,"H"
1963-09-01,1963,"RC Lens","Olympique Lyon","1-2",1,2,"1",1,3,-1,"D"
1963-09-01,1963,"AS Monaco","FC Rouen","2-1",2,1,"1",1,3,1,"H"
1963-09-01,1963,"FC Nantes","UA Sedan-Torcy","2-2",2,2,"1",1,4,0,"D"
1963-09-01,1963,"Stade Francais FC","Angers SCO","2-2",2,2,"1",1,4,0,"D"
1963-09-01,1963,"Stade Rennes","Racing Club de France","2-2",2,2,"1",1,4,0,"D"
1963-09-01,1963,"AS Saint-Etienne","US Valenciennes-Anzin","1-1",1,1,"1",1,2,0,"D"
1963-09-01,1963,"Stade Reims","Nimes Olympique","0-0",0,0,"1",1,0,0,"D"
1963-09-07,1963,"Toulouse FC","AS Saint-Etienne","4-0",4,0,"1",1,4,4,"H"
1963-09-07,1963,"Nimes Olympique","Stade Francais FC","3-0",3,0,"1",1,3,3,"H"
1963-09-07,1963,"UA Sedan-Torcy","RC Strasbourg","2-1",2,1,"1",1,3,1,"H"
1963-09-07,1963,"AS Monaco","OGC Nice","0-0",0,0,"1",1,0,0,"D"
1963-09-07,1963,"Girondins Bordeaux","Stade Reims","4-2",4,2,"1",1,6,2,"H"
1963-09-07,1963,"Olympique Lyon","FC Rouen","0-1",0,1,"1",1,1,-1,"D"
1963-09-07,1963,"US Valenciennes-Anzin","Stade Rennes","0-0",0,0,"1",1,0,0,"D"
1963-09-08,1963,"Racing Club de France","FC Nantes","3-0",3,0,"1",1,3,3,"H"
1963-09-08,1963,"Angers SCO","RC Lens","1-2",1,2,"1",1,3,-1,"D"
1963-09-13,1963,"RC Strasbourg","Racing Club de France","2-1",2,1,"1",1,3,1,"H"
1963-09-13,1963,"OGC Nice","Olympique Lyon","1-2",1,2,"1",1,3,-1,"D"
1963-09-13,1963,"FC Rouen","Angers SCO","0-0",0,0,"1",1,0,0,"D"
1963-09-13,1963,"FC Nantes","US Valenciennes-Anzin","3-1",3,1,"1",1,4,2,"H"
1963-09-13,1963,"AS Saint-Etienne","AS Monaco","4-1",4,1,"1",1,5,3,"H"
1963-09-14,1963,"Stade Rennes","Toulouse FC","4-2",4,2,"1",1,6,2,"H"
1963-09-14,1963,"UA Sedan-Torcy","Girondins Bordeaux","2-4",2,4,"1",1,6,-2,"D"
1963-09-14,1963,"RC Lens","Nimes Olympique","4-2",4,2,"1",1,6,2,"H"
1963-09-14,1963,"Stade Francais FC","Stade Reims","0-2",0,2,"1",1,2,-2,"D"
1963-09-21,1963,"Toulouse FC","FC Nantes","1-0",1,0,"1",1,1,1,"H"
1963-09-21,1963,"Nimes Olympique","FC Rouen","0-2",0,2,"1",1,2,-2,"D"
1963-09-21,1963,"Stade Reims","RC Lens","1-0",1,0,"1",1,1,1,"H"
1963-09-21,1963,"Racing Club de France","UA Sedan-Torcy","2-2",2,2,"1",1,4,0,"D"
1963-09-21,1963,"US Valenciennes-Anzin","RC Strasbourg","1-0",1,0,"1",1,1,1,"H"
1963-09-22,1963,"Angers SCO","OGC Nice","0-3",0,3,"1",1,3,-3,"D"
1963-09-22,1963,"Girondins Bordeaux","Stade Francais FC","4-1",4,1,"1",1,5,3,"H"
1963-09-22,1963,"Olympique Lyon","AS Saint-Etienne","4-5",4,5,"1",1,9,-1,"D"
1963-09-22,1963,"AS Monaco","Stade Rennes","3-2",3,2,"1",1,5,1,"H"
1963-10-05,1963,"RC Strasbourg","Toulouse FC","1-1",1,1,"1",1,2,0,"D"
1963-10-06,1963,"FC Rouen","Stade Reims","3-4",3,4,"1",1,7,-1,"D"
1963-10-06,1963,"FC Nantes","AS Monaco","1-3",1,3,"1",1,4,-2,"D"
1963-10-06,1963,"Racing Club de France","Girondins Bordeaux","3-1",3,1,"1",1,4,2,"H"
1963-10-06,1963,"RC Lens","Stade Francais FC","3-0",3,0,"1",1,3,3,"H"
1963-10-06,1963,"Stade Rennes","Olympique Lyon","2-3",2,3,"1",1,5,-1,"D"
1963-10-06,1963,"UA Sedan-Torcy","US Valenciennes-Anzin","0-2",0,2,"1",1,2,-2,"D"
1963-10-06,1963,"AS Saint-Etienne","Angers SCO","2-2",2,2,"1",1,4,0,"D"
1963-10-06,1963,"OGC Nice","Nimes Olympique","3-2",3,2,"1",1,5,1,"H"
1963-10-12,1963,"Toulouse FC","UA Sedan-Torcy","2-0",2,0,"1",1,2,2,"H"
1963-10-12,1963,"FC Nantes","Olympique Lyon","3-1",3,1,"1",1,4,2,"H"
1963-10-13,1963,"AS Monaco","RC Strasbourg","4-2",4,2,"1",1,6,2,"H"
1963-10-13,1963,"US Valenciennes-Anzin","Racing Club de France","1-3",1,3,"1",1,4,-2,"D"
1963-10-13,1963,"Nimes Olympique","AS Saint-Etienne","0-2",0,2,"1",1,2,-2,"D"
1963-10-13,1963,"Girondins Bordeaux","RC Lens","1-1",1,1,"1",1,2,0,"D"
1963-10-13,1963,"Angers SCO","Stade Rennes","1-1",1,1,"1",1,2,0,"D"
1963-10-13,1963,"Stade Francais FC","FC Rouen","5-2",5,2,"1",1,7,3,"H"
1963-10-19,1963,"FC Rouen","RC Lens","3-0",3,0,"1",1,3,3,"H"
1963-10-19,1963,"FC Nantes","Angers SCO","1-0",1,0,"1",1,1,1,"H"
1963-10-20,1963,"Racing Club de France","Toulouse FC","1-1",1,1,"1",1,2,0,"D"
1963-10-20,1963,"AS Saint-Etienne","Stade Reims","1-1",1,1,"1",1,2,0,"D"
1963-10-20,1963,"UA Sedan-Torcy","AS Monaco","4-0",4,0,"1",1,4,4,"H"
1963-10-20,1963,"US Valenciennes-Anzin","Girondins Bordeaux","1-0",1,0,"1",1,1,1,"H"
1963-10-20,1963,"RC Strasbourg","Olympique Lyon","5-0",5,0,"1",1,5,5,"H"
1963-10-20,1963,"OGC Nice","Stade Francais FC","3-1",3,1,"1",1,4,2,"H"
1963-10-20,1963,"Stade Rennes","Nimes Olympique","3-1",3,1,"1",1,4,2,"H"
1963-10-31,1963,"Toulouse FC","US Valenciennes-Anzin","2-1",2,1,"1",1,3,1,"H"
1963-10-31,1963,"AS Monaco","Racing Club de France","5-3",5,3,"1",1,8,2,"H"
1963-10-31,1963,"RC Lens","OGC Nice","2-1",2,1,"1",1,3,1,"H"
1963-10-31,1963,"Stade Reims","Stade Rennes","3-3",3,3,"1",1,6,0,"D"
1963-10-31,1963,"Olympique Lyon","UA Sedan-Torcy","2-0",2,0,"1",1,2,2,"H"
1963-11-01,1963,"Stade Francais FC","AS Saint-Etienne","1-3",1,3,"1",1,4,-2,"D"
1963-11-01,1963,"Girondins Bordeaux","FC Rouen","2-0",2,0,"1",1,2,2,"H"
1963-11-01,1963,"Angers SCO","RC Strasbourg","1-1",1,1,"1",1,2,0,"D"
1963-11-01,1963,"Nimes Olympique","FC Nantes","3-0",3,0,"1",1,3,3,"H"
1963-11-03,1963,"AS Saint-Etienne","RC Lens","1-0",1,0,"1",1,1,1,"H"
1963-11-03,1963,"Toulouse FC","Girondins Bordeaux","0-1",0,1,"1",1,1,-1,"D"
1963-11-03,1963,"US Valenciennes-Anzin","AS Monaco","0-0",0,0,"1",1,0,0,"D"
1963-11-03,1963,"RC Strasbourg","Nimes Olympique","3-0",3,0,"1",1,3,3,"H"
1963-11-03,1963,"Stade Rennes","Stade Francais FC","4-3",4,3,"1",1,7,1,"H"
1963-11-03,1963,"FC Nantes","Stade Reims","0-0",0,0,"1",1,0,0,"D"
1963-11-03,1963,"Racing Club de France","Olympique Lyon","1-3",1,3,"1",1,4,-2,"D"
1963-11-03,1963,"OGC Nice","FC Rouen","2-0",2,0,"1",1,2,2,"H"
1963-11-03,1963,"UA Sedan-Torcy","Angers SCO","2-1",2,1,"1",1,3,1,"H"
1963-11-10,1963,"Girondins Bordeaux","OGC Nice","6-2",6,2,"1",1,8,4,"H"
1963-11-10,1963,"Stade Reims","RC Strasbourg","0-0",0,0,"1",1,0,0,"D"
1963-11-10,1963,"Angers SCO","Racing Club de France","2-1",2,1,"1",1,3,1,"H"
1963-11-13,1963,"RC Lens","Stade Rennes","5-0",5,0,"1",1,5,5,"H"
1963-11-13,1963,"Olympique Lyon","US Valenciennes-Anzin","1-1",1,1,"1",1,2,0,"D"
1963-11-13,1963,"Nimes Olympique","UA Sedan-Torcy","4-2",4,2,"1",1,6,2,"H"
1963-11-13,1963,"Stade Francais FC","FC Nantes","4-0",4,0,"1",1,4,4,"H"
1963-11-14,1963,"AS Monaco","Toulouse FC","5-0",5,0,"1",1,5,5,"H"
1963-11-17,1963,"AS Saint-Etienne","OGC Nice","2-2",2,2,"1",1,4,0,"D"
1963-11-17,1963,"Toulouse FC","Olympique Lyon","1-0",1,0,"1",1,1,1,"H"
1963-11-17,1963,"RC Strasbourg","Stade Francais FC","1-1",1,1,"1",1,2,0,"D"
1963-11-17,1963,"Stade Rennes","FC Rouen","2-1",2,1,"1",1,3,1,"H"
1963-11-17,1963,"Racing Club de France","Nimes Olympique","5-0",5,0,"1",1,5,5,"H"
1963-11-17,1963,"FC Nantes","RC Lens","2-1",2,1,"1",1,3,1,"H"
1963-11-17,1963,"UA Sedan-Torcy","Stade Reims","2-0",2,0,"1",1,2,2,"H"
1963-11-17,1963,"US Valenciennes-Anzin","Angers SCO","1-3",1,3,"1",1,4,-2,"D"
1963-11-19,1963,"AS Monaco","Girondins Bordeaux","2-0",2,0,"1",1,2,2,"H"
1963-11-24,1963,"Girondins Bordeaux","AS Saint-Etienne","2-3",2,3,"1",1,5,-1,"D"
1963-11-24,1963,"Olympique Lyon","AS Monaco","5-1",5,1,"1",1,6,4,"H"
1963-11-24,1963,"Angers SCO","Toulouse FC","4-3",4,3,"1",1,7,1,"H"
1963-11-24,1963,"OGC Nice","Stade Rennes","0-2",0,2,"1",1,2,-2,"D"
1963-11-24,1963,"Stade Reims","Racing Club de France","1-4",1,4,"1",1,5,-3,"D"
1963-11-24,1963,"RC Lens","RC Strasbourg","2-1",2,1,"1",1,3,1,"H"
1963-11-24,1963,"Stade Francais FC","UA Sedan-Torcy","3-2",3,2,"1",1,5,1,"H"
1963-11-24,1963,"Nimes Olympique","US Valenciennes-Anzin","2-0",2,0,"1",1,2,2,"H"
1963-11-24,1963,"FC Rouen","FC Nantes","5-2",5,2,"1",1,7,3,"H"
1963-11-27,1963,"Stade Reims","OGC Nice","2-0",2,0,"1",1,2,2,"H"
1963-12-01,1963,"Stade Rennes","AS Saint-Etienne","1-1",1,1,"1",1,2,0,"D"
1963-12-01,1963,"AS Monaco","Angers SCO","0-1",0,1,"1",1,1,-1,"D"
1963-12-01,1963,"Racing Club de France","Stade Francais FC","3-2",3,2,"1",1,5,1,"H"
1963-12-01,1963,"UA Sedan-Torcy","RC Lens","2-3",2,3,"1",1,5,-1,"D"
1963-12-01,1963,"Olympique Lyon","Girondins Bordeaux","3-1",3,1,"1",1,4,2,"H"
1963-12-01,1963,"Toulouse FC","Nimes Olympique","1-1",1,1,"1",1,2,0,"D"
1963-12-01,1963,"RC Strasbourg","FC Rouen","1-0",1,0,"1",1,1,1,"H"
1963-12-01,1963,"US Valenciennes-Anzin","Stade Reims","2-1",2,1,"1",1,3,1,"H"
1963-12-01,1963,"FC Nantes","OGC Nice","3-0",3,0,"1",1,3,3,"H"
1963-12-07,1963,"Girondins Bordeaux","Stade Rennes","3-1",3,1,"1",1,4,2,"H"
1963-12-08,1963,"AS Saint-Etienne","FC Nantes","6-1",6,1,"1",1,7,5,"H"
1963-12-08,1963,"RC Lens","Racing Club de France","10-2",10,2,"1",1,12,8,"H"
1963-12-08,1963,"Stade Reims","Toulouse FC","1-3",1,3,"1",1,4,-2,"D"
1963-12-08,1963,"Angers SCO","Olympique Lyon","1-1",1,1,"1",1,2,0,"D"
1963-12-08,1963,"Nimes Olympique","AS Monaco","1-0",1,0,"1",1,1,1,"H"
1963-12-08,1963,"OGC Nice","RC Strasbourg","1-1",1,1,"1",1,2,0,"D"
1963-12-08,1963,"Stade Francais FC","US Valenciennes-Anzin","0-2",0,2,"1",1,2,-2,"D"
1963-12-08,1963,"FC Rouen","UA Sedan-Torcy","2-2",2,2,"1",1,4,0,"D"
1963-12-14,1963,"Toulouse FC","Stade Francais FC","0-2",0,2,"1",1,2,-2,"D"
1963-12-15,1963,"RC Strasbourg","AS Saint-Etienne","2-0",2,0,"1",1,2,2,"H"
1963-12-15,1963,"US Valenciennes-Anzin","RC Lens","0-0",0,0,"1",1,0,0,"D"
1963-12-15,1963,"Olympique Lyon","Nimes Olympique","2-1",2,1,"1",1,3,1,"H"
1963-12-15,1963,"AS Monaco","Stade Reims","1-0",1,0,"1",1,1,1,"H"
1963-12-15,1963,"Angers SCO","Girondins Bordeaux","1-1",1,1,"1",1,2,0,"D"
1963-12-15,1963,"Racing Club de France","FC Rouen","2-2",2,2,"1",1,4,0,"D"
1963-12-15,1963,"FC Nantes","Stade Rennes","2-1",2,1,"1",1,3,1,"H"
1963-12-15,1963,"UA Sedan-Torcy","OGC Nice","8-1",8,1,"1",1,9,7,"H"
1963-12-22,1963,"RC Lens","Toulouse FC","2-1",2,1,"1",1,3,1,"H"
1963-12-22,1963,"Stade Rennes","RC Strasbourg","0-0",0,0,"1",1,0,0,"D"
1963-12-22,1963,"Girondins Bordeaux","FC Nantes","2-0",2,0,"1",1,2,2,"H"
1963-12-22,1963,"Stade Francais FC","AS Monaco","1-0",1,0,"1",1,1,1,"H"
1963-12-22,1963,"OGC Nice","Racing Club de France","1-1",1,1,"1",1,2,0,"D"
1963-12-22,1963,"FC Rouen","US Valenciennes-Anzin","0-4",0,4,"1",1,4,-4,"D"
1963-12-22,1963,"Nimes Olympique","Angers SCO","2-0",2,0,"1",1,2,2,"H"
1963-12-29,1963,"Racing Club de France","AS Saint-Etienne","1-3",1,3,"1",1,4,-2,"D"
1963-12-29,1963,"AS Monaco","RC Lens","5-0",5,0,"1",1,5,5,"H"
1963-12-29,1963,"Olympique Lyon","Stade Francais FC","2-0",2,0,"1",1,2,2,"H"
1963-12-29,1963,"RC Strasbourg","FC Nantes","0-0",0,0,"1",1,0,0,"D"
1963-12-29,1963,"Nimes Olympique","Girondins Bordeaux","0-0",0,0,"1",1,0,0,"D"
1963-12-29,1963,"US Valenciennes-Anzin","OGC Nice","7-2",7,2,"1",1,9,5,"H"
1963-12-29,1963,"Toulouse FC","FC Rouen","2-2",2,2,"1",1,4,0,"D"
1963-12-29,1963,"Angers SCO","Stade Reims","3-1",3,1,"1",1,4,2,"H"
1963-12-29,1963,"UA Sedan-Torcy","Stade Rennes","5-0",5,0,"1",1,5,5,"H"
1964-01-05,1963,"AS Saint-Etienne","Racing Club de France","2-1",2,1,"1",1,3,1,"H"
1964-01-05,1963,"Stade Francais FC","Olympique Lyon","1-2",1,2,"1",1,3,-1,"D"
1964-01-05,1963,"RC Lens","AS Monaco","0-0",0,0,"1",1,0,0,"D"
1964-01-05,1963,"OGC Nice","US Valenciennes-Anzin","1-3",1,3,"1",1,4,-2,"D"
1964-01-05,1963,"Girondins Bordeaux","Nimes Olympique","2-2",2,2,"1",1,4,0,"D"
1964-01-05,1963,"FC Nantes","RC Strasbourg","2-1",2,1,"1",1,3,1,"H"
1964-01-05,1963,"FC Rouen","Toulouse FC","2-1",2,1,"1",1,3,1,"H"
1964-01-05,1963,"Stade Reims","Angers SCO","1-1",1,1,"1",1,2,0,"D"
1964-01-05,1963,"Stade Rennes","UA Sedan-Torcy","1-0",1,0,"1",1,1,1,"H"
1964-01-19,1963,"US Valenciennes-Anzin","AS Saint-Etienne","1-2",1,2,"1",1,3,-1,"D"
1964-01-19,1963,"Girondins Bordeaux","RC Strasbourg","2-0",2,0,"1",1,2,2,"H"
1964-01-19,1963,"Olympique Lyon","RC Lens","1-1",1,1,"1",1,2,0,"D"
1964-01-19,1963,"FC Rouen","AS Monaco","4-0",4,0,"1",1,4,4,"H"
1964-01-19,1963,"Toulouse FC","OGC Nice","2-1",2,1,"1",1,3,1,"H"
1964-01-19,1963,"Racing Club de France","Stade Rennes","0-2",0,2,"1",1,2,-2,"D"
1964-01-19,1963,"Nimes Olympique","Stade Reims","4-0",4,0,"1",1,4,4,"H"
1964-01-19,1963,"Angers SCO","Stade Francais FC","1-3",1,3,"1",1,4,-2,"D"
1964-01-19,1963,"UA Sedan-Torcy","FC Nantes","2-0",2,0,"1",1,2,2,"H"
1964-01-26,1963,"AS Saint-Etienne","Toulouse FC","7-1",7,1,"1",1,8,6,"H"
1964-01-26,1963,"RC Lens","Angers SCO","4-0",4,0,"1",1,4,4,"H"
1964-01-26,1963,"FC Rouen","Olympique Lyon","2-2",2,2,"1",1,4,0,"D"
1964-01-26,1963,"OGC Nice","AS Monaco","0-2",0,2,"1",1,2,-2,"D"
1964-01-26,1963,"Stade Reims","Girondins Bordeaux","1-0",1,0,"1",1,1,1,"H"
1964-01-26,1963,"Stade Rennes","US Valenciennes-Anzin","2-1",2,1,"1",1,3,1,"H"
1964-01-26,1963,"Stade Francais FC","Nimes Olympique","0-0",0,0,"1",1,0,0,"D"
1964-01-26,1963,"FC Nantes","Racing Club de France","1-0",1,0,"1",1,1,1,"H"
1964-02-02,1963,"AS Monaco","AS Saint-Etienne","2-1",2,1,"1",1,3,1,"H"
1964-02-02,1963,"Nimes Olympique","RC Lens","1-1",1,1,"1",1,2,0,"D"
1964-02-02,1963,"Olympique Lyon","OGC Nice","0-0",0,0,"1",1,0,0,"D"
1964-02-02,1963,"Girondins Bordeaux","UA Sedan-Torcy","3-2",3,2,"1",1,5,1,"H"
1964-02-02,1963,"Toulouse FC","Stade Rennes","1-1",1,1,"1",1,2,0,"D"
1964-02-02,1963,"US Valenciennes-Anzin","FC Nantes","0-0",0,0,"1",1,0,0,"D"
1964-02-02,1963,"Angers SCO","FC Rouen","3-0",3,0,"1",1,3,3,"H"
1964-02-02,1963,"Racing Club de France","RC Strasbourg","3-0",3,0,"1",1,3,3,"H"
1964-02-02,1963,"Stade Reims","Stade Francais FC","0-3",0,3,"1",1,3,-3,"D"
1964-02-16,1963,"AS Saint-Etienne","Olympique Lyon","2-1",2,1,"1",1,3,1,"H"
1964-02-16,1963,"RC Lens","Stade Reims","2-1",2,1,"1",1,3,1,"H"
1964-02-16,1963,"Stade Rennes","AS Monaco","2-1",2,1,"1",1,3,1,"H"
1964-02-16,1963,"Stade Francais FC","Girondins Bordeaux","2-0",2,0,"1",1,2,2,"H"
1964-02-16,1963,"RC Strasbourg","US Valenciennes-Anzin","1-0",1,0,"1",1,1,1,"H"
1964-02-16,1963,"FC Nantes","Toulouse FC","2-2",2,2,"1",1,4,0,"D"
1964-02-16,1963,"FC Rouen","Nimes Olympique","1-0",1,0,"1",1,1,1,"H"
1964-02-16,1963,"OGC Nice","Angers SCO","3-1",3,1,"1",1,4,2,"H"
1964-02-16,1963,"UA Sedan-Torcy","Racing Club de France","1-0",1,0,"1",1,1,1,"H"
1964-02-23,1963,"Angers SCO","AS Saint-Etienne","3-1",3,1,"1",1,4,2,"H"
1964-02-23,1963,"Stade Francais FC","RC Lens","1-0",1,0,"1",1,1,1,"H"
1964-02-23,1963,"Olympique Lyon","Stade Rennes","4-1",4,1,"1",1,5,3,"H"
1964-02-23,1963,"AS Monaco","FC Nantes","3-1",3,1,"1",1,4,2,"H"
1964-02-23,1963,"Girondins Bordeaux","Racing Club de France","2-2",2,2,"1",1,4,0,"D"
1964-02-23,1963,"US Valenciennes-Anzin","UA Sedan-Torcy","2-0",2,0,"1",1,2,2,"H"
1964-02-23,1963,"Toulouse FC","RC Strasbourg","3-2",3,2,"1",1,5,1,"H"
1964-02-23,1963,"Nimes Olympique","OGC Nice","0-0",0,0,"1",1,0,0,"D"
1964-02-23,1963,"Stade Reims","FC Rouen","0-0",0,0,"1",1,0,0,"D"
1964-02-26,1963,"FC Rouen","AS Saint-Etienne","0-0",0,0,"1",1,0,0,"D"
1964-03-08,1963,"AS Saint-Etienne","Nimes Olympique","3-0",3,0,"1",1,3,3,"H"
1964-03-08,1963,"RC Lens","Girondins Bordeaux","8-1",8,1,"1",1,9,7,"H"
1964-03-08,1963,"Olympique Lyon","FC Nantes","1-1",1,1,"1",1,2,0,"D"
1964-03-08,1963,"RC Strasbourg","AS Monaco","1-1",1,1,"1",1,2,0,"D"
1964-03-08,1963,"Racing Club de France","US Valenciennes-Anzin","1-3",1,3,"1",1,4,-2,"D"
1964-03-08,1963,"UA Sedan-Torcy","Toulouse FC","1-1",1,1,"1",1,2,0,"D"
1964-03-08,1963,"Stade Rennes","Angers SCO","2-4",2,4,"1",1,6,-2,"D"
1964-03-08,1963,"FC Rouen","Stade Francais FC","2-0",2,0,"1",1,2,2,"H"
1964-03-13,1963,"Olympique Lyon","RC Strasbourg","1-1",1,1,"1",1,2,0,"D"
1964-03-14,1963,"Girondins Bordeaux","US Valenciennes-Anzin","0-3",0,3,"1",1,3,-3,"D"
1964-03-14,1963,"Stade Reims","AS Saint-Etienne","3-1",3,1,"1",1,4,2,"H"
1964-03-15,1963,"AS Monaco","UA Sedan-Torcy","3-1",3,1,"1",1,4,2,"H"
1964-03-15,1963,"RC Lens","FC Rouen","0-2",0,2,"1",1,2,-2,"D"
1964-03-15,1963,"Toulouse FC","Racing Club de France","2-2",2,2,"1",1,4,0,"D"
1964-03-15,1963,"Angers SCO","FC Nantes","3-3",3,3,"1",1,6,0,"D"
1964-03-15,1963,"Nimes Olympique","Stade Rennes","3-1",3,1,"1",1,4,2,"H"
1964-03-15,1963,"Stade Francais FC","OGC Nice","2-2",2,2,"1",1,4,0,"D"
1964-03-18,1963,"AS Saint-Etienne","UA Sedan-Torcy","2-1",2,1,"1",1,3,1,"H"
1964-03-25,1963,"Stade Reims","Olympique Lyon","2-2",2,2,"1",1,4,0,"D"
1964-03-26,1963,"Racing Club de France","AS Monaco","1-5",1,5,"1",1,6,-4,"D"
1964-03-27,1963,"US Valenciennes-Anzin","Toulouse FC","2-3",2,3,"1",1,5,-1,"D"
1964-03-27,1963,"RC Strasbourg","Angers SCO","2-1",2,1,"1",1,3,1,"H"
1964-03-28,1963,"AS Saint-Etienne","Stade Francais FC","0-1",0,1,"1",1,1,-1,"D"
1964-03-28,1963,"Stade Rennes","Stade Reims","2-0",2,0,"1",1,2,2,"H"
1964-03-28,1963,"FC Nantes","Nimes Olympique","2-1",2,1,"1",1,3,1,"H"
1964-03-29,1963,"UA Sedan-Torcy","Olympique Lyon","2-0",2,0,"1",1,2,2,"H"
1964-03-29,1963,"OGC Nice","RC Lens","3-2",3,2,"1",1,5,1,"H"
1964-03-29,1963,"FC Rouen","Girondins Bordeaux","0-0",0,0,"1",1,0,0,"D"
1964-04-01,1963,"OGC Nice","AS Saint-Etienne","1-1",1,1,"1",1,2,0,"D"
1964-04-01,1963,"Girondins Bordeaux","AS Monaco","0-0",0,0,"1",1,0,0,"D"
1964-04-01,1963,"RC Lens","FC Nantes","2-0",2,0,"1",1,2,2,"H"
1964-04-01,1963,"Olympique Lyon","Toulouse FC","1-2",1,2,"1",1,3,-1,"D"
1964-04-01,1963,"Angers SCO","US Valenciennes-Anzin","3-2",3,2,"1",1,5,1,"H"
1964-04-01,1963,"FC Rouen","Stade Rennes","3-1",3,1,"1",1,4,2,"H"
1964-04-01,1963,"Stade Francais FC","RC Strasbourg","1-0",1,0,"1",1,1,1,"H"
1964-04-01,1963,"Stade Reims","UA Sedan-Torcy","1-0",1,0,"1",1,1,1,"H"
1964-04-04,1963,"Girondins Bordeaux","Toulouse FC","2-1",2,1,"1",1,3,1,"H"
1964-04-04,1963,"Stade Reims","FC Nantes","1-1",1,1,"1",1,2,0,"D"
1964-04-05,1963,"RC Lens","AS Saint-Etienne","4-2",4,2,"1",1,6,2,"H"
1964-04-05,1963,"AS Monaco","US Valenciennes-Anzin","3-0",3,0,"1",1,3,3,"H"
1964-04-05,1963,"FC Rouen","OGC Nice","3-0",3,0,"1",1,3,3,"H"
1964-04-05,1963,"Angers SCO","UA Sedan-Torcy","1-0",1,0,"1",1,1,1,"H"
1964-04-05,1963,"Stade Francais FC","Stade Rennes","4-2",4,2,"1",1,6,2,"H"
1964-04-05,1963,"Nimes Olympique","RC Strasbourg","1-1",1,1,"1",1,2,0,"D"
1964-04-11,1963,"UA Sedan-Torcy","Nimes Olympique","3-1",3,1,"1",1,4,2,"H"
1964-04-11,1963,"FC Nantes","Stade Francais FC","3-1",3,1,"1",1,4,2,"H"
1964-04-12,1963,"AS Saint-Etienne","FC Rouen","1-0",1,0,"1",1,1,1,"H"
1964-04-12,1963,"Toulouse FC","AS Monaco","1-1",1,1,"1",1,2,0,"D"
1964-04-12,1963,"Stade Rennes","RC Lens","0-0",0,0,"1",1,0,0,"D"
1964-04-12,1963,"US Valenciennes-Anzin","Olympique Lyon","0-1",0,1,"1",1,1,-1,"D"
1964-04-12,1963,"Racing Club de France","Angers SCO","3-4",3,4,"1",1,7,-1,"D"
1964-04-12,1963,"OGC Nice","Girondins Bordeaux","2-0",2,0,"1",1,2,2,"H"
1964-04-12,1963,"RC Strasbourg","Stade Reims","1-2",1,2,"1",1,3,-1,"D"
1964-04-15,1963,"RC Strasbourg","UA Sedan-Torcy","2-0",2,0,"1",1,2,2,"H"
1964-04-18,1963,"Nimes Olympique","Racing Club de France","3-1",3,1,"1",1,4,2,"H"
1964-04-19,1963,"OGC Nice","Stade Reims","1-1",1,1,"1",1,2,0,"D"
1964-04-29,1963,"AS Saint-Etienne","Girondins Bordeaux","4-0",4,0,"1",1,4,4,"H"
1964-04-29,1963,"AS Monaco","Olympique Lyon","0-1",0,1,"1",1,1,-1,"D"
1964-04-29,1963,"FC Nantes","FC Rouen","7-1",7,1,"1",1,8,6,"H"
1964-04-29,1963,"Racing Club de France","Stade Reims","2-1",2,1,"1",1,3,1,"H"
1964-04-30,1963,"RC Strasbourg","RC Lens","1-2",1,2,"1",1,3,-1,"D"
1964-04-30,1963,"Toulouse FC","Angers SCO","4-0",4,0,"1",1,4,4,"H"
1964-04-30,1963,"US Valenciennes-Anzin","Nimes Olympique","1-0",1,0,"1",1,1,1,"H"
1964-04-30,1963,"UA Sedan-Torcy","Stade Francais FC","2-0",2,0,"1",1,2,2,"H"
1964-05-01,1963,"Stade Rennes","OGC Nice","3-1",3,1,"1",1,4,2,"H"
1964-05-03,1963,"AS Saint-Etienne","Stade Rennes","3-0",3,0,"1",1,3,3,"H"
1964-05-03,1963,"RC Lens","UA Sedan-Torcy","3-1",3,1,"1",1,4,2,"H"
1964-05-03,1963,"Angers SCO","AS Monaco","4-4",4,4,"1",1,8,0,"D"
1964-05-03,1963,"Nimes Olympique","Toulouse FC","1-0",1,0,"1",1,1,1,"H"
1964-05-03,1963,"Stade Reims","US Valenciennes-Anzin","1-4",1,4,"1",1,5,-3,"D"
1964-05-03,1963,"FC Rouen","RC Strasbourg","3-0",3,0,"1",1,3,3,"H"
1964-05-03,1963,"OGC Nice","FC Nantes","1-2",1,2,"1",1,3,-1,"D"
1964-05-03,1963,"Stade Francais FC","Racing Club de France","2-3",2,3,"1",1,5,-1,"D"
1964-05-13,1963,"Olympique Lyon","Racing Club de France","5-1",5,1,"1",1,6,4,"H"
1964-05-17,1963,"FC Nantes","AS Saint-Etienne","1-3",1,3,"1",1,4,-2,"D"
1964-05-17,1963,"AS Monaco","Nimes Olympique","2-0",2,0,"1",1,2,2,"H"
1964-05-17,1963,"Racing Club de France","RC Lens","3-2",3,2,"1",1,5,1,"H"
1964-05-17,1963,"Olympique Lyon","Angers SCO","2-2",2,2,"1",1,4,0,"D"
1964-05-17,1963,"Toulouse FC","Stade Reims","0-0",0,0,"1",1,0,0,"D"
1964-05-17,1963,"US Valenciennes-Anzin","Stade Francais FC","0-0",0,0,"1",1,0,0,"D"
1964-05-17,1963,"UA Sedan-Torcy","FC Rouen","2-1",2,1,"1",1,3,1,"H"
1964-05-17,1963,"Stade Rennes","Girondins Bordeaux","2-2",2,2,"1",1,4,0,"D"
1964-05-17,1963,"RC Strasbourg","OGC Nice","2-1",2,1,"1",1,3,1,"H"
1964-05-26,1963,"Girondins Bordeaux","Olympique Lyon","4-0",4,0,"1",1,4,4,"H"
1964-05-30,1963,"US Valenciennes-Anzin","FC Rouen","2-1",2,1,"1",1,3,1,"H"
1964-05-31,1963,"UA Sedan-Torcy","AS Saint-Etienne","3-0",3,0,"1",1,3,3,"H"
1964-05-31,1963,"AS Monaco","Stade Francais FC","0-1",0,1,"1",1,1,-1,"D"
1964-05-31,1963,"Olympique Lyon","Stade Reims","3-1",3,1,"1",1,4,2,"H"
1964-05-31,1963,"Toulouse FC","RC Lens","4-2",4,2,"1",1,6,2,"H"
1964-05-31,1963,"FC Nantes","Girondins Bordeaux","4-1",4,1,"1",1,5,3,"H"
1964-05-31,1963,"Angers SCO","Nimes Olympique","0-1",0,1,"1",1,1,-1,"D"
1964-05-31,1963,"RC Strasbourg","Stade Rennes","2-1",2,1,"1",1,3,1,"H"
1964-05-31,1963,"Racing Club de France","OGC Nice","3-2",3,2,"1",1,5,1,"H"
1964-06-06,1963,"Stade Reims","AS Monaco","2-3",2,3,"1",1,5,-1,"D"
1964-06-07,1963,"AS Saint-Etienne","RC Strasbourg","2-2",2,2,"1",1,4,0,"D"
1964-06-07,1963,"RC Lens","US Valenciennes-Anzin","2-0",2,0,"1",1,2,2,"H"
1964-06-07,1963,"Nimes Olympique","Olympique Lyon","5-0",5,0,"1",1,5,5,"H"
1964-06-07,1963,"Stade Francais FC","Toulouse FC","0-0",0,0,"1",1,0,0,"D"
1964-06-07,1963,"Girondins Bordeaux","Angers SCO","3-0",3,0,"1",1,3,3,"H"
1964-06-07,1963,"Stade Rennes","FC Nantes","3-1",3,1,"1",1,4,2,"H"
1964-06-07,1963,"OGC Nice","UA Sedan-Torcy","2-4",2,4,"1",1,6,-2,"D"
1964-06-07,1963,"FC Rouen","Racing Club de France","1-2",1,2,"1",1,3,-1,"D"
1964-08-29,1964,"AS Monaco","FC Nantes","4-1",4,1,"1",1,5,3,"H"
1964-08-29,1964,"FC Sochaux","Stade Francais FC","4-1",4,1,"1",1,5,3,"H"
1964-08-29,1964,"UA Sedan-Torcy","Nimes Olympique","4-2",4,2,"1",1,6,2,"H"
1964-08-29,1964,"RC Lens","Olympique Lyon","1-2",1,2,"1",1,3,-1,"D"
1964-08-29,1964,"AS Saint-Etienne","Girondins Bordeaux","0-1",0,1,"1",1,1,-1,"D"
1964-08-30,1964,"US Valenciennes-Anzin","FC Rouen","3-0",3,0,"1",1,3,3,"H"
1964-08-30,1964,"Angers SCO","Toulouse FC","2-4",2,4,"1",1,6,-2,"D"
1964-08-30,1964,"Sporting Toulon Var","Lille OSC","3-1",3,1,"1",1,4,2,"H"
1964-08-30,1964,"Stade Rennes","RC Strasbourg","1-2",1,2,"1",1,3,-1,"D"
1964-09-04,1964,"Olympique Lyon","Angers SCO","5-2",5,2,"1",1,7,3,"H"
1964-09-05,1964,"FC Rouen","FC Sochaux","0-4",0,4,"1",1,4,-4,"D"
1964-09-05,1964,"Girondins Bordeaux","UA Sedan-Torcy","5-1",5,1,"1",1,6,4,"H"
1964-09-05,1964,"RC Strasbourg","US Valenciennes-Anzin","3-3",3,3,"1",1,6,0,"D"
1964-09-05,1964,"Toulouse FC","RC Lens","2-2",2,2,"1",1,4,0,"D"
1964-09-05,1964,"FC Nantes","AS Saint-Etienne","4-1",4,1,"1",1,5,3,"H"
1964-09-05,1964,"Nimes Olympique","Stade Rennes","2-3",2,3,"1",1,5,-1,"D"
1964-09-06,1964,"Stade Francais FC","Sporting Toulon Var","3-2",3,2,"1",1,5,1,"H"
1964-09-06,1964,"Lille OSC","AS Monaco","3-0",3,0,"1",1,3,3,"H"
1964-09-12,1964,"FC Sochaux","Girondins Bordeaux","4-1",4,1,"1",1,5,3,"H"
1964-09-12,1964,"FC Nantes","FC Rouen","3-0",3,0,"1",1,3,3,"H"
1964-09-12,1964,"UA Sedan-Torcy","RC Strasbourg","5-2",5,2,"1",1,7,3,"H"
1964-09-12,1964,"AS Monaco","Stade Francais FC","1-0",1,0,"1",1,1,1,"H"
1964-09-12,1964,"AS Saint-Etienne","Lille OSC","3-3",3,3,"1",1,6,0,"D"
1964-09-12,1964,"RC Lens","Angers SCO","1-0",1,0,"1",1,1,1,"H"
1964-09-13,1964,"Sporting Toulon Var","Olympique Lyon","1-1",1,1,"1",1,2,0,"D"
1964-09-13,1964,"US Valenciennes-Anzin","Nimes Olympique","1-0",1,0,"1",1,1,1,"H"
1964-09-13,1964,"Stade Rennes","Toulouse FC","1-1",1,1,"1",1,2,0,"D"
1964-09-19,1964,"RC Strasbourg","FC Sochaux","0-0",0,0,"1",1,0,0,"D"
1964-09-19,1964,"Girondins Bordeaux","AS Monaco","2-0",2,0,"1",1,2,2,"H"
1964-09-19,1964,"Toulouse FC","US Valenciennes-Anzin","1-0",1,0,"1",1,1,1,"H"
1964-09-19,1964,"Nimes Olympique","RC Lens","2-2",2,2,"1",1,4,0,"D"
1964-09-19,1964,"FC Rouen","Sporting Toulon Var","1-0",1,0,"1",1,1,1,"H"
1964-09-20,1964,"Olympique Lyon","UA Sedan-Torcy","2-0",2,0,"1",1,2,2,"H"
1964-09-20,1964,"Lille OSC","FC Nantes","2-2",2,2,"1",1,4,0,"D"
1964-09-20,1964,"Angers SCO","Stade Rennes","1-2",1,2,"1",1,3,-1,"D"
1964-09-20,1964,"Stade Francais FC","AS Saint-Etienne","2-3",2,3,"1",1,5,-1,"D"
1964-09-26,1964,"FC Sochaux","Olympique Lyon","2-1",2,1,"1",1,3,1,"H"
1964-09-26,1964,"FC Nantes","Stade Francais FC","4-2",4,2,"1",1,6,2,"H"
1964-09-26,1964,"UA Sedan-Torcy","Toulouse FC","6-0",6,0,"1",1,6,6,"H"
1964-09-26,1964,"FC Rouen","AS Monaco","1-1",1,1,"1",1,2,0,"D"
1964-09-26,1964,"AS Saint-Etienne","Nimes Olympique","1-2",1,2,"1",1,3,-1,"D"
1964-09-27,1964,"US Valenciennes-Anzin","Angers SCO","0-0",0,0,"1",1,0,0,"D"
1964-09-27,1964,"Sporting Toulon Var","Girondins Bordeaux","2-0",2,0,"1",1,2,2,"H"
1964-09-27,1964,"Stade Rennes","RC Lens","3-3",3,3,"1",1,6,0,"D"
1964-09-27,1964,"Lille OSC","RC Strasbourg","1-1",1,1,"1",1,2,0,"D"
1964-10-07,1964,"Nimes Olympique","FC Sochaux","3-0",3,0,"1",1,3,3,"H"
1964-10-07,1964,"Olympique Lyon","Stade Rennes","1-0",1,0,"1",1,1,1,"H"
1964-10-07,1964,"Girondins Bordeaux","FC Nantes","2-2",2,2,"1",1,4,0,"D"
1964-10-07,1964,"Toulouse FC","Sporting Toulon Var","0-1",0,1,"1",1,1,-1,"D"
1964-10-07,1964,"RC Lens","US Valenciennes-Anzin","3-2",3,2,"1",1,5,1,"H"
1964-10-07,1964,"Angers SCO","UA Sedan-Torcy","3-0",3,0,"1",1,3,3,"H"
1964-10-07,1964,"Stade Francais FC","Lille OSC","0-0",0,0,"1",1,0,0,"D"
1964-10-07,1964,"RC Strasbourg","AS Monaco","3-3",3,3,"1",1,6,0,"D"
1964-10-07,1964,"FC Rouen","AS Saint-Etienne","0-1",0,1,"1",1,1,-1,"D"
1964-10-10,1964,"FC Sochaux","Toulouse FC","0-2",0,2,"1",1,2,-2,"D"
1964-10-10,1964,"FC Nantes","Nimes Olympique","0-2",0,2,"1",1,2,-2,"D"
1964-10-11,1964,"Sporting Toulon Var","Angers SCO","4-0",4,0,"1",1,4,4,"H"
1964-10-11,1964,"AS Monaco","Olympique Lyon","3-2",3,2,"1",1,5,1,"H"
1964-10-11,1964,"UA Sedan-Torcy","RC Lens","3-1",3,1,"1",1,4,2,"H"
1964-10-11,1964,"Lille OSC","Girondins Bordeaux","3-1",3,1,"1",1,4,2,"H"
1964-10-11,1964,"US Valenciennes-Anzin","Stade Rennes","0-0",0,0,"1",1,0,0,"D"
1964-10-11,1964,"AS Saint-Etienne","RC Strasbourg","1-1",1,1,"1",1,2,0,"D"
1964-10-11,1964,"Stade Francais FC","FC Rouen","2-0",2,0,"1",1,2,2,"H"
1964-10-17,1964,"Olympique Lyon","US Valenciennes-Anzin","1-0",1,0,"1",1,1,1,"H"
1964-10-17,1964,"Nimes Olympique","AS Monaco","1-0",1,0,"1",1,1,1,"H"
1964-10-17,1964,"Toulouse FC","AS Saint-Etienne","2-2",2,2,"1",1,4,0,"D"
1964-10-18,1964,"RC Strasbourg","Sporting Toulon Var","0-0",0,0,"1",1,0,0,"D"
1964-10-18,1964,"RC Lens","FC Nantes","0-3",0,3,"1",1,3,-3,"D"
1964-10-18,1964,"Angers SCO","FC Sochaux","1-0",1,0,"1",1,1,1,"H"
1964-10-18,1964,"Girondins Bordeaux","Stade Francais FC","2-1",2,1,"1",1,3,1,"H"
1964-10-18,1964,"Stade Rennes","UA Sedan-Torcy","3-2",3,2,"1",1,5,1,"H"
1964-10-18,1964,"FC Rouen","Lille OSC","2-1",2,1,"1",1,3,1,"H"
1964-10-24,1964,"FC Nantes","Angers SCO","2-1",2,1,"1",1,3,1,"H"
1964-10-24,1964,"FC Sochaux","Stade Rennes","3-0",3,0,"1",1,3,3,"H"
1964-10-24,1964,"Girondins Bordeaux","FC Rouen","1-2",1,2,"1",1,3,-1,"D"
1964-10-25,1964,"Sporting Toulon Var","Nimes Olympique","1-2",1,2,"1",1,3,-1,"D"
1964-10-25,1964,"AS Saint-Etienne","Olympique Lyon","6-0",6,0,"1",1,6,6,"H"
1964-10-25,1964,"Lille OSC","RC Lens","4-0",4,0,"1",1,4,4,"H"
1964-10-25,1964,"AS Monaco","Toulouse FC","2-1",2,1,"1",1,3,1,"H"
1964-10-25,1964,"UA Sedan-Torcy","US Valenciennes-Anzin","1-3",1,3,"1",1,4,-2,"D"
1964-10-25,1964,"Stade Francais FC","RC Strasbourg","2-2",2,2,"1",1,4,0,"D"
1964-10-30,1964,"Toulouse FC","FC Nantes","3-0",3,0,"1",1,3,3,"H"
1964-10-31,1964,"US Valenciennes-Anzin","FC Sochaux","1-0",1,0,"1",1,1,1,"H"
1964-10-31,1964,"RC Strasbourg","Girondins Bordeaux","0-0",0,0,"1",1,0,0,"D"
1964-11-01,1964,"Nimes Olympique","Stade Francais FC","3-0",3,0,"1",1,3,3,"H"
1964-11-01,1964,"Olympique Lyon","Lille OSC","1-0",1,0,"1",1,1,1,"H"
1964-11-01,1964,"Angers SCO","AS Saint-Etienne","0-1",0,1,"1",1,1,-1,"D"
1964-11-01,1964,"Stade Rennes","Sporting Toulon Var","4-1",4,1,"1",1,5,3,"H"
1964-11-01,1964,"FC Rouen","UA Sedan-Torcy","2-0",2,0,"1",1,2,2,"H"
1964-11-02,1964,"RC Lens","AS Monaco","2-0",2,0,"1",1,2,2,"H"
1964-11-08,1964,"FC Nantes","RC Strasbourg","3-2",3,2,"1",1,5,1,"H"
1964-11-08,1964,"FC Rouen","Olympique Lyon","1-1",1,1,"1",1,2,0,"D"
1964-11-08,1964,"Girondins Bordeaux","Nimes Olympique","2-1",2,1,"1",1,3,1,"H"
1964-11-08,1964,"Sporting Toulon Var","US Valenciennes-Anzin","1-3",1,3,"1",1,4,-2,"D"
1964-11-08,1964,"Lille OSC","Toulouse FC","0-2",0,2,"1",1,2,-2,"D"
1964-11-08,1964,"FC Sochaux","UA Sedan-Torcy","2-2",2,2,"1",1,4,0,"D"
1964-11-08,1964,"AS Saint-Etienne","RC Lens","2-2",2,2,"1",1,4,0,"D"
1964-11-08,1964,"AS Monaco","Stade Rennes","2-1",2,1,"1",1,3,1,"H"
1964-11-08,1964,"Stade Francais FC","Angers SCO","2-0",2,0,"1",1,2,2,"H"
1964-11-15,1964,"Nimes Olympique","Lille OSC","2-1",2,1,"1",1,3,1,"H"
1964-11-15,1964,"US Valenciennes-Anzin","FC Nantes","2-1",2,1,"1",1,3,1,"H"
1964-11-15,1964,"Olympique Lyon","Girondins Bordeaux","0-0",0,0,"1",1,0,0,"D"
1964-11-15,1964,"RC Lens","FC Sochaux","2-3",2,3,"1",1,5,-1,"D"
1964-11-15,1964,"Toulouse FC","Stade Francais FC","1-1",1,1,"1",1,2,0,"D"
1964-11-15,1964,"Stade Rennes","AS Saint-Etienne","2-1",2,1,"1",1,3,1,"H"
1964-11-15,1964,"Angers SCO","AS Monaco","0-0",0,0,"1",1,0,0,"D"
1964-11-15,1964,"RC Strasbourg","FC Rouen","3-0",3,0,"1",1,3,3,"H"
1964-11-15,1964,"UA Sedan-Torcy","Sporting Toulon Var","3-2",3,2,"1",1,5,1,"H"
1964-11-22,1964,"AS Saint-Etienne","US Valenciennes-Anzin","0-1",0,1,"1",1,1,-1,"D"
1964-11-22,1964,"Sporting Toulon Var","FC Sochaux","0-1",0,1,"1",1,1,-1,"D"
1964-11-22,1964,"RC Strasbourg","Olympique Lyon","3-3",3,3,"1",1,6,0,"D"
1964-11-22,1964,"FC Rouen","Nimes Olympique","1-0",1,0,"1",1,1,1,"H"
1964-11-22,1964,"Girondins Bordeaux","Toulouse FC","4-2",4,2,"1",1,6,2,"H"
1964-11-22,1964,"FC Nantes","Stade Rennes","2-3",2,3,"1",1,5,-1,"D"
1964-11-22,1964,"AS Monaco","UA Sedan-Torcy","0-4",0,4,"1",1,4,-4,"D"
1964-11-22,1964,"Stade Francais FC","RC Lens","0-0",0,0,"1",1,0,0,"D"
1964-11-22,1964,"Lille OSC","Angers SCO","3-4",3,4,"1",1,7,-1,"D"
1964-11-29,1964,"US Valenciennes-Anzin","AS Monaco","3-0",3,0,"1",1,3,3,"H"
1964-11-29,1964,"Olympique Lyon","Stade Francais FC","4-0",4,0,"1",1,4,4,"H"
1964-11-29,1964,"FC Sochaux","FC Nantes","1-1",1,1,"1",1,2,0,"D"
1964-11-29,1964,"Nimes Olympique","RC Strasbourg","2-1",2,1,"1",1,3,1,"H"
1964-11-29,1964,"Stade Rennes","Lille OSC","3-3",3,3,"1",1,6,0,"D"
1964-11-29,1964,"UA Sedan-Torcy","AS Saint-Etienne","1-0",1,0,"1",1,1,1,"H"
1964-11-29,1964,"Angers SCO","Girondins Bordeaux","2-1",2,1,"1",1,3,1,"H"
1964-11-29,1964,"Toulouse FC","FC Rouen","0-1",0,1,"1",1,1,-1,"D"
1964-11-29,1964,"RC Lens","Sporting Toulon Var","2-1",2,1,"1",1,3,1,"H"
1964-12-06,1964,"Lille OSC","US Valenciennes-Anzin","1-1",1,1,"1",1,2,0,"D"
1964-12-06,1964,"Nimes Olympique","Olympique Lyon","1-2",1,2,"1",1,3,-1,"D"
1964-12-06,1964,"FC Nantes","UA Sedan-Torcy","2-2",2,2,"1",1,4,0,"D"
1964-12-06,1964,"Girondins Bordeaux","RC Lens","0-0",0,0,"1",1,0,0,"D"
1964-12-06,1964,"Stade Francais FC","Stade Rennes","2-1",2,1,"1",1,3,1,"H"
1964-12-06,1964,"RC Strasbourg","Toulouse FC","5-3",5,3,"1",1,8,2,"H"
1964-12-06,1964,"AS Monaco","Sporting Toulon Var","1-0",1,0,"1",1,1,1,"H"
1964-12-06,1964,"FC Rouen","Angers SCO","0-1",0,1,"1",1,1,-1,"D"
1964-12-12,1964,"FC Sochaux","AS Monaco","3-0",3,0,"1",1,3,3,"H"
1964-12-13,1964,"US Valenciennes-Anzin","Stade Francais FC","0-0",0,0,"1",1,0,0,"D"
1964-12-13,1964,"Olympique Lyon","FC Nantes","1-1",1,1,"1",1,2,0,"D"
1964-12-13,1964,"Stade Rennes","Girondins Bordeaux","1-2",1,2,"1",1,3,-1,"D"
1964-12-13,1964,"UA Sedan-Torcy","Lille OSC","0-0",0,0,"1",1,0,0,"D"
1964-12-13,1964,"Toulouse FC","Nimes Olympique","1-0",1,0,"1",1,1,1,"H"
1964-12-13,1964,"Angers SCO","RC Strasbourg","0-0",0,0,"1",1,0,0,"D"
1964-12-13,1964,"RC Lens","FC Rouen","2-2",2,2,"1",1,4,0,"D"
1964-12-13,1964,"Sporting Toulon Var","AS Saint-Etienne","1-3",1,3,"1",1,4,-2,"D"
1964-12-16,1964,"AS Saint-Etienne","FC Sochaux","0-0",0,0,"1",1,0,0,"D"
1964-12-20,1964,"Girondins Bordeaux","US Valenciennes-Anzin","1-0",1,0,"1",1,1,1,"H"
1964-12-20,1964,"Toulouse FC","Olympique Lyon","3-2",3,2,"1",1,5,1,"H"
1964-12-20,1964,"Lille OSC","FC Sochaux","3-0",3,0,"1",1,3,3,"H"
1964-12-20,1964,"FC Nantes","Sporting Toulon Var","5-1",5,1,"1",1,6,4,"H"
1964-12-20,1964,"Nimes Olympique","Angers SCO","2-1",2,1,"1",1,3,1,"H"
1964-12-20,1964,"RC Strasbourg","RC Lens","3-0",3,0,"1",1,3,3,"H"
1964-12-20,1964,"AS Saint-Etienne","AS Monaco","2-0",2,0,"1",1,2,2,"H"
1964-12-20,1964,"Stade Francais FC","UA Sedan-Torcy","1-0",1,0,"1",1,1,1,"H"
1964-12-20,1964,"FC Rouen","Stade Rennes","1-0",1,0,"1",1,1,1,"H"
1965-01-03,1964,"US Valenciennes-Anzin","RC Strasbourg","3-0",3,0,"1",1,3,3,"H"
1965-01-03,1964,"UA Sedan-Torcy","Girondins Bordeaux","0-1",0,1,"1",1,1,-1,"D"
1965-01-03,1964,"Angers SCO","Olympique Lyon","2-1",2,1,"1",1,3,1,"H"
1965-01-03,1964,"FC Sochaux","FC Rouen","2-3",2,3,"1",1,5,-1,"D"
1965-01-03,1964,"AS Saint-Etienne","FC Nantes","2-0",2,0,"1",1,2,2,"H"
1965-01-03,1964,"Stade Rennes","Nimes Olympique","4-0",4,0,"1",1,4,4,"H"
1965-01-03,1964,"RC Lens","Toulouse FC","1-1",1,1,"1",1,2,0,"D"
1965-01-03,1964,"AS Monaco","Lille OSC","1-1",1,1,"1",1,2,0,"D"
1965-01-03,1964,"Sporting Toulon Var","Stade Francais FC","2-1",2,1,"1",1,3,1,"H"
1965-01-10,1964,"Girondins Bordeaux","FC Sochaux","1-0",1,0,"1",1,1,1,"H"
1965-01-10,1964,"Nimes Olympique","US Valenciennes-Anzin","2-1",2,1,"1",1,3,1,"H"
1965-01-10,1964,"Olympique Lyon","Sporting Toulon Var","1-0",1,0,"1",1,1,1,"H"
1965-01-10,1964,"FC Rouen","FC Nantes","1-3",1,3,"1",1,4,-2,"D"
1965-01-10,1964,"Lille OSC","AS Saint-Etienne","3-3",3,3,"1",1,6,0,"D"
1965-01-10,1964,"RC Strasbourg","UA Sedan-Torcy","2-0",2,0,"1",1,2,2,"H"
1965-01-10,1964,"Toulouse FC","Stade Rennes","1-1",1,1,"1",1,2,0,"D"
1965-01-10,1964,"Angers SCO","RC Lens","3-1",3,1,"1",1,4,2,"H"
1965-01-10,1964,"Stade Francais FC","AS Monaco","3-2",3,2,"1",1,5,1,"H"
1965-01-24,1964,"AS Monaco","Girondins Bordeaux","0-0",0,0,"1",1,0,0,"D"
1965-01-24,1964,"US Valenciennes-Anzin","Toulouse FC","1-1",1,1,"1",1,2,0,"D"
1965-01-24,1964,"FC Nantes","Lille OSC","1-1",1,1,"1",1,2,0,"D"
1965-01-24,1964,"Stade Rennes","Angers SCO","6-0",6,0,"1",1,6,6,"H"
1965-01-24,1964,"AS Saint-Etienne","Stade Francais FC","0-0",0,0,"1",1,0,0,"D"
1965-01-24,1964,"RC Lens","Nimes Olympique","3-1",3,1,"1",1,4,2,"H"
1965-01-24,1964,"Sporting Toulon Var","FC Rouen","1-0",1,0,"1",1,1,1,"H"
1965-01-30,1964,"Girondins Bordeaux","Sporting Toulon Var","3-0",3,0,"1",1,3,3,"H"
1965-01-31,1964,"Angers SCO","US Valenciennes-Anzin","2-2",2,2,"1",1,4,0,"D"
1965-01-31,1964,"Olympique Lyon","FC Sochaux","2-1",2,1,"1",1,3,1,"H"
1965-01-31,1964,"Toulouse FC","UA Sedan-Torcy","5-0",5,0,"1",1,5,5,"H"
1965-01-31,1964,"Nimes Olympique","AS Saint-Etienne","1-0",1,0,"1",1,1,1,"H"
1965-01-31,1964,"RC Lens","Stade Rennes","1-1",1,1,"1",1,2,0,"D"
1965-01-31,1964,"RC Strasbourg","Lille OSC","3-2",3,2,"1",1,5,1,"H"
1965-01-31,1964,"AS Monaco","FC Rouen","1-0",1,0,"1",1,1,1,"H"
1965-02-03,1964,"Stade Francais FC","FC Nantes","1-1",1,1,"1",1,2,0,"D"
1965-02-06,1964,"Sporting Toulon Var","Toulouse FC","0-2",0,2,"1",1,2,-2,"D"
1965-02-07,1964,"US Valenciennes-Anzin","RC Lens","6-1",6,1,"1",1,7,5,"H"
1965-02-07,1964,"FC Nantes","Girondins Bordeaux","2-0",2,0,"1",1,2,2,"H"
1965-02-07,1964,"Stade Rennes","Olympique Lyon","3-0",3,0,"1",1,3,3,"H"
1965-02-07,1964,"AS Monaco","RC Strasbourg","0-1",0,1,"1",1,1,-1,"D"
1965-02-07,1964,"FC Sochaux","Nimes Olympique","1-1",1,1,"1",1,2,0,"D"
1965-02-07,1964,"AS Saint-Etienne","FC Rouen","1-3",1,3,"1",1,4,-2,"D"
1965-02-07,1964,"Lille OSC","Stade Francais FC","1-1",1,1,"1",1,2,0,"D"
1965-02-07,1964,"UA Sedan-Torcy","Angers SCO","1-0",1,0,"1",1,1,1,"H"
1965-02-20,1964,"Nimes Olympique","FC Nantes","0-3",0,3,"1",1,3,-3,"D"
1965-02-21,1964,"Girondins Bordeaux","Lille OSC","2-0",2,0,"1",1,2,2,"H"
1965-02-21,1964,"Stade Rennes","US Valenciennes-Anzin","3-1",3,1,"1",1,4,2,"H"
1965-02-21,1964,"Toulouse FC","FC Sochaux","1-0",1,0,"1",1,1,1,"H"
1965-02-21,1964,"RC Strasbourg","AS Saint-Etienne","1-0",1,0,"1",1,1,1,"H"
1965-02-21,1964,"Olympique Lyon","AS Monaco","0-1",0,1,"1",1,1,-1,"D"
1965-02-21,1964,"FC Rouen","Stade Francais FC","1-1",1,1,"1",1,2,0,"D"
1965-02-21,1964,"RC Lens","UA Sedan-Torcy","3-1",3,1,"1",1,4,2,"H"
1965-02-21,1964,"Angers SCO","Sporting Toulon Var","0-0",0,0,"1",1,0,0,"D"
1965-02-27,1964,"FC Sochaux","Angers SCO","2-0",2,0,"1",1,2,2,"H"
1965-02-28,1964,"Stade Francais FC","Girondins Bordeaux","0-0",0,0,"1",1,0,0,"D"
1965-02-28,1964,"US Valenciennes-Anzin","Olympique Lyon","1-1",1,1,"1",1,2,0,"D"
1965-02-28,1964,"FC Nantes","RC Lens","1-1",1,1,"1",1,2,0,"D"
1965-02-28,1964,"UA Sedan-Torcy","Stade Rennes","2-2",2,2,"1",1,4,0,"D"
1965-02-28,1964,"AS Saint-Etienne","Toulouse FC","1-0",1,0,"1",1,1,1,"H"
1965-02-28,1964,"Sporting Toulon Var","RC Strasbourg","0-0",0,0,"1",1,0,0,"D"
1965-02-28,1964,"AS Monaco","Nimes Olympique","1-1",1,1,"1",1,2,0,"D"
1965-02-28,1964,"Lille OSC","FC Rouen","1-0",1,0,"1",1,1,1,"H"
1965-03-14,1964,"FC Rouen","Girondins Bordeaux","1-0",1,0,"1",1,1,1,"H"
1965-03-14,1964,"US Valenciennes-Anzin","UA Sedan-Torcy","1-1",1,1,"1",1,2,0,"D"
1965-03-14,1964,"Angers SCO","FC Nantes","2-2",2,2,"1",1,4,0,"D"
1965-03-14,1964,"RC Strasbourg","Stade Francais FC","2-0",2,0,"1",1,2,2,"H"
1965-03-14,1964,"Stade Rennes","FC Sochaux","1-1",1,1,"1",1,2,0,"D"
1965-03-14,1964,"Toulouse FC","AS Monaco","0-2",0,2,"1",1,2,-2,"D"
1965-03-14,1964,"Olympique Lyon","AS Saint-Etienne","0-1",0,1,"1",1,1,-1,"D"
1965-03-14,1964,"Nimes Olympique","Sporting Toulon Var","0-1",0,1,"1",1,1,-1,"D"
1965-03-14,1964,"RC Lens","Lille OSC","0-1",0,1,"1",1,1,-1,"D"
1965-03-18,1964,"UA Sedan-Torcy","Olympique Lyon","4-1",4,1,"1",1,5,3,"H"
1965-03-20,1964,"Girondins Bordeaux","RC Strasbourg","1-0",1,0,"1",1,1,1,"H"
1965-03-21,1964,"FC Nantes","Toulouse FC","4-0",4,0,"1",1,4,4,"H"
1965-03-21,1964,"FC Sochaux","US Valenciennes-Anzin","3-2",3,2,"1",1,5,1,"H"
1965-03-21,1964,"Sporting Toulon Var","Stade Rennes","4-1",4,1,"1",1,5,3,"H"
1965-03-21,1964,"AS Saint-Etienne","Angers SCO","2-1",2,1,"1",1,3,1,"H"
1965-03-21,1964,"Lille OSC","Olympique Lyon","2-2",2,2,"1",1,4,0,"D"
1965-03-21,1964,"UA Sedan-Torcy","FC Rouen","0-2",0,2,"1",1,2,-2,"D"
1965-03-21,1964,"AS Monaco","RC Lens","2-1",2,1,"1",1,3,1,"H"
1965-03-21,1964,"Stade Francais FC","Nimes Olympique","3-1",3,1,"1",1,4,2,"H"
1965-03-27,1964,"FC Nantes","US Valenciennes-Anzin","1-0",1,0,"1",1,1,1,"H"
1965-03-27,1964,"Girondins Bordeaux","Olympique Lyon","0-2",0,2,"1",1,2,-2,"D"
1965-03-27,1964,"FC Sochaux","RC Lens","2-3",2,3,"1",1,5,-1,"D"
1965-03-28,1964,"FC Rouen","RC Strasbourg","1-3",1,3,"1",1,4,-2,"D"
1965-03-28,1964,"AS Saint-Etienne","Stade Rennes","3-1",3,1,"1",1,4,2,"H"
1965-03-28,1964,"AS Monaco","Angers SCO","3-1",3,1,"1",1,4,2,"H"
1965-03-28,1964,"Stade Francais FC","Toulouse FC","2-0",2,0,"1",1,2,2,"H"
1965-03-28,1964,"Lille OSC","Nimes Olympique","2-1",2,1,"1",1,3,1,"H"
1965-03-28,1964,"Sporting Toulon Var","UA Sedan-Torcy","1-0",1,0,"1",1,1,1,"H"
1965-03-31,1964,"FC Sochaux","RC Strasbourg","0-2",0,2,"1",1,2,-2,"D"
1965-04-09,1964,"Olympique Lyon","RC Strasbourg","2-1",2,1,"1",1,3,1,"H"
1965-04-10,1964,"Stade Rennes","FC Nantes","4-0",4,0,"1",1,4,4,"H"
1965-04-10,1964,"US Valenciennes-Anzin","AS Saint-Etienne","2-0",2,0,"1",1,2,2,"H"
1965-04-10,1964,"FC Sochaux","Sporting Toulon Var","2-0",2,0,"1",1,2,2,"H"
1965-04-10,1964,"UA Sedan-Torcy","AS Monaco","2-1",2,1,"1",1,3,1,"H"
1965-04-10,1964,"Nimes Olympique","FC Rouen","2-0",2,0,"1",1,2,2,"H"
1965-04-10,1964,"RC Lens","Stade Francais FC","5-2",5,2,"1",1,7,3,"H"
1965-04-11,1964,"Toulouse FC","Girondins Bordeaux","1-1",1,1,"1",1,2,0,"D"
1965-04-11,1964,"Angers SCO","Lille OSC","1-1",1,1,"1",1,2,0,"D"
1965-04-21,1964,"FC Nantes","FC Sochaux","3-0",3,0,"1",1,3,3,"H"
1965-04-21,1964,"RC Strasbourg","Nimes Olympique","3-2",3,2,"1",1,5,1,"H"
1965-04-21,1964,"Girondins Bordeaux","Angers SCO","2-1",2,1,"1",1,3,1,"H"
1965-04-21,1964,"AS Monaco","US Valenciennes-Anzin","1-1",1,1,"1",1,2,0,"D"
1965-04-21,1964,"Stade Francais FC","Olympique Lyon","1-1",1,1,"1",1,2,0,"D"
1965-04-21,1964,"Lille OSC","Stade Rennes","3-2",3,2,"1",1,5,1,"H"
1965-04-21,1964,"AS Saint-Etienne","UA Sedan-Torcy","1-1",1,1,"1",1,2,0,"D"
1965-04-21,1964,"FC Rouen","Toulouse FC","3-0",3,0,"1",1,3,3,"H"
1965-04-21,1964,"Sporting Toulon Var","RC Lens","1-3",1,3,"1",1,4,-2,"D"
1965-04-24,1964,"UA Sedan-Torcy","FC Nantes","2-2",2,2,"1",1,4,0,"D"
1965-04-24,1964,"RC Lens","Girondins Bordeaux","3-2",3,2,"1",1,5,1,"H"
1965-04-24,1964,"Olympique Lyon","Nimes Olympique","0-3",0,3,"1",1,3,-3,"D"
1965-04-24,1964,"FC Sochaux","AS Saint-Etienne","3-2",3,2,"1",1,5,1,"H"
1965-04-24,1964,"Angers SCO","FC Rouen","3-0",3,0,"1",1,3,3,"H"
1965-04-25,1964,"Toulouse FC","RC Strasbourg","3-1",3,1,"1",1,4,2,"H"
1965-04-25,1964,"US Valenciennes-Anzin","Lille OSC","3-0",3,0,"1",1,3,3,"H"
1965-04-25,1964,"Stade Rennes","Stade Francais FC","2-0",2,0,"1",1,2,2,"H"
1965-04-25,1964,"Sporting Toulon Var","AS Monaco","0-6",0,6,"1",1,6,-6,"D"
1965-05-05,1964,"RC Strasbourg","FC Nantes","1-1",1,1,"1",1,2,0,"D"
1965-05-05,1964,"Nimes Olympique","Girondins Bordeaux","0-3",0,3,"1",1,3,-3,"D"
1965-05-05,1964,"US Valenciennes-Anzin","Sporting Toulon Var","1-0",1,0,"1",1,1,1,"H"
1965-05-05,1964,"Stade Rennes","AS Monaco","1-0",1,0,"1",1,1,1,"H"
1965-05-05,1964,"Olympique Lyon","FC Rouen","1-1",1,1,"1",1,2,0,"D"
1965-05-05,1964,"RC Lens","AS Saint-Etienne","4-1",4,1,"1",1,5,3,"H"
1965-05-05,1964,"UA Sedan-Torcy","FC Sochaux","0-0",0,0,"1",1,0,0,"D"
1965-05-05,1964,"Toulouse FC","Lille OSC","1-1",1,1,"1",1,2,0,"D"
1965-05-05,1964,"Angers SCO","Stade Francais FC","1-0",1,0,"1",1,1,1,"H"
1965-05-08,1964,"FC Nantes","Olympique Lyon","3-0",3,0,"1",1,3,3,"H"
1965-05-08,1964,"Girondins Bordeaux","Stade Rennes","1-0",1,0,"1",1,1,1,"H"
1965-05-08,1964,"RC Strasbourg","Angers SCO","0-1",0,1,"1",1,1,-1,"D"
1965-05-08,1964,"FC Rouen","RC Lens","0-1",0,1,"1",1,1,-1,"D"
1965-05-08,1964,"Nimes Olympique","Toulouse FC","0-4",0,4,"1",1,4,-4,"D"
1965-05-08,1964,"Lille OSC","UA Sedan-Torcy","3-0",3,0,"1",1,3,3,"H"
1965-05-09,1964,"AS Saint-Etienne","Sporting Toulon Var","1-0",1,0,"1",1,1,1,"H"
1965-05-09,1964,"Stade Francais FC","US Valenciennes-Anzin","0-3",0,3,"1",1,3,-3,"D"
1965-05-09,1964,"AS Monaco","FC Sochaux","2-0",2,0,"1",1,2,2,"H"
1965-05-14,1964,"Olympique Lyon","Toulouse FC","2-1",2,1,"1",1,3,1,"H"
1965-05-15,1964,"RC Lens","RC Strasbourg","0-3",0,3,"1",1,3,-3,"D"
1965-05-15,1964,"AS Monaco","AS Saint-Etienne","0-2",0,2,"1",1,2,-2,"D"
1965-05-15,1964,"FC Sochaux","Lille OSC","2-1",2,1,"1",1,3,1,"H"
1965-05-16,1964,"Sporting Toulon Var","FC Nantes","0-1",0,1,"1",1,1,-1,"D"
1965-05-16,1964,"US Valenciennes-Anzin","Girondins Bordeaux","0-0",0,0,"1",1,0,0,"D"
1965-05-16,1964,"Stade Rennes","FC Rouen","4-0",4,0,"1",1,4,4,"H"
1965-05-16,1964,"Angers SCO","Nimes Olympique","5-0",5,0,"1",1,5,5,"H"
1965-05-16,1964,"UA Sedan-Torcy","Stade Francais FC","0-3",0,3,"1",1,3,-3,"D"
1965-05-29,1964,"RC Strasbourg","Stade Rennes","2-3",2,3,"1",1,5,-1,"D"
1965-05-29,1964,"Olympique Lyon","RC Lens","1-1",1,1,"1",1,2,0,"D"
1965-05-29,1964,"Lille OSC","Sporting Toulon Var","5-0",5,0,"1",1,5,5,"H"
1965-05-30,1964,"FC Nantes","AS Monaco","2-1",2,1,"1",1,3,1,"H"
1965-05-30,1964,"Girondins Bordeaux","AS Saint-Etienne","1-1",1,1,"1",1,2,0,"D"
1965-05-30,1964,"FC Rouen","US Valenciennes-Anzin","1-1",1,1,"1",1,2,0,"D"
1965-05-30,1964,"Stade Francais FC","FC Sochaux","3-3",3,3,"1",1,6,0,"D"
1965-05-30,1964,"Toulouse FC","Angers SCO","1-3",1,3,"1",1,4,-2,"D"
1965-05-30,1964,"Nimes Olympique","UA Sedan-Torcy","0-3",0,3,"1",1,3,-3,"D"
1965-08-21,1965,"Toulouse FC","Angers SCO","1-0",1,0,"1",1,1,1,"H"
1965-08-22,1965,"UA Sedan-Torcy","Stade Rennes","3-1",3,1,"1",1,4,2,"H"
1965-08-22,1965,"FC Nantes","Olympique Lyon","2-0",2,0,"1",1,2,2,"H"
1965-08-22,1965,"Red Star FC","US Valenciennes-Anzin","2-0",2,0,"1",1,2,2,"H"
1965-08-22,1965,"AS Monaco","Lille OSC","2-0",2,0,"1",1,2,2,"H"
1965-08-22,1965,"AS Saint-Etienne","Nimes Olympique","2-1",2,1,"1",1,3,1,"H"
1965-08-22,1965,"AS Cannes","Girondins Bordeaux","2-1",2,1,"1",1,3,1,"H"
1965-08-22,1965,"RC Lens","Stade Francais FC","1-0",1,0,"1",1,1,1,"H"
1965-08-22,1965,"FC Sochaux","OGC Nice","1-0",1,0,"1",1,1,1,"H"
1965-08-22,1965,"RC Strasbourg","FC Rouen","0-0",0,0,"1",1,0,0,"D"
1965-08-28,1965,"UA Sedan-Torcy","FC Sochaux","3-0",3,0,"1",1,3,3,"H"
1965-08-28,1965,"FC Nantes","RC Lens","4-2",4,2,"1",1,6,2,"H"
1965-08-28,1965,"AS Saint-Etienne","AS Monaco","1-3",1,3,"1",1,4,-2,"D"
1965-08-28,1965,"OGC Nice","RC Strasbourg","0-2",0,2,"1",1,2,-2,"D"
1965-08-28,1965,"FC Rouen","AS Cannes","1-0",1,0,"1",1,1,1,"H"
1965-08-28,1965,"Nimes Olympique","Red Star FC","3-1",3,1,"1",1,4,2,"H"
1965-08-28,1965,"Lille OSC","Toulouse FC","1-0",1,0,"1",1,1,1,"H"
1965-08-28,1965,"US Valenciennes-Anzin","Stade Rennes","2-1",2,1,"1",1,3,1,"H"
1965-08-28,1965,"Girondins Bordeaux","Olympique Lyon","2-2",2,2,"1",1,4,0,"D"
1965-08-29,1965,"Angers SCO","Stade Francais FC","0-0",0,0,"1",1,0,0,"D"
1965-09-01,1965,"AS Monaco","FC Rouen","3-0",3,0,"1",1,3,3,"H"
1965-09-01,1965,"Stade Francais FC","FC Nantes","0-1",0,1,"1",1,1,-1,"D"
1965-09-01,1965,"RC Strasbourg","UA Sedan-Torcy","3-3",3,3,"1",1,6,0,"D"
1965-09-01,1965,"AS Cannes","Lille OSC","2-0",2,0,"1",1,2,2,"H"
1965-09-01,1965,"FC Sochaux","AS Saint-Etienne","2-3",2,3,"1",1,5,-1,"D"
1965-09-01,1965,"Nimes Olympique","US Valenciennes-Anzin","2-2",2,2,"1",1,4,0,"D"
1965-09-01,1965,"Olympique Lyon","OGC Nice","2-0",2,0,"1",1,2,2,"H"
1965-09-01,1965,"Toulouse FC","Girondins Bordeaux","0-0",0,0,"1",1,0,0,"D"
1965-09-01,1965,"RC Lens","Angers SCO","2-2",2,2,"1",1,4,0,"D"
1965-09-01,1965,"Stade Rennes","Red Star FC","2-1",2,1,"1",1,3,1,"H"
1965-09-04,1965,"FC Nantes","Angers SCO","5-3",5,3,"1",1,8,2,"H"
1965-09-04,1965,"UA Sedan-Torcy","Nimes Olympique","2-0",2,0,"1",1,2,2,"H"
1965-09-04,1965,"AS Saint-Etienne","Toulouse FC","3-0",3,0,"1",1,3,3,"H"
1965-09-04,1965,"US Valenciennes-Anzin","RC Strasbourg","3-2",3,2,"1",1,5,1,"H"
1965-09-04,1965,"Girondins Bordeaux","Stade Francais FC","10-0",10,0,"1",1,10,10,"H"
1965-09-04,1965,"FC Rouen","Olympique Lyon","0-0",0,0,"1",1,0,0,"D"
1965-09-05,1965,"OGC Nice","AS Monaco","1-2",1,2,"1",1,3,-1,"D"
1965-09-05,1965,"Stade Rennes","AS Cannes","2-2",2,2,"1",1,4,0,"D"
1965-09-05,1965,"Lille OSC","RC Lens","1-1",1,1,"1",1,2,0,"D"
1965-09-05,1965,"Red Star FC","FC Sochaux","1-1",1,1,"1",1,2,0,"D"
1965-09-09,1965,"AS Monaco","UA Sedan-Torcy","3-3",3,3,"1",1,6,0,"D"
1965-09-09,1965,"RC Lens","FC Rouen","0-0",0,0,"1",1,0,0,"D"
1965-09-10,1965,"Toulouse FC","FC Nantes","0-0",0,0,"1",1,0,0,"D"
1965-09-10,1965,"AS Cannes","AS Saint-Etienne","2-8",2,8,"1",1,10,-6,"D"
1965-09-10,1965,"RC Strasbourg","Red Star FC","7-1",7,1,"1",1,8,6,"H"
1965-09-10,1965,"Olympique Lyon","Lille OSC","6-3",6,3,"1",1,9,3,"H"
1965-09-10,1965,"FC Sochaux","US Valenciennes-Anzin","1-1",1,1,"1",1,2,0,"D"
1965-09-10,1965,"Angers SCO","Girondins Bordeaux","0-0",0,0,"1",1,0,0,"D"
1965-09-10,1965,"Nimes Olympique","Stade Rennes","2-2",2,2,"1",1,4,0,"D"
1965-09-10,1965,"Stade Francais FC","OGC Nice","2-1",2,1,"1",1,3,1,"H"
1965-09-17,1965,"OGC Nice","Toulouse FC","2-1",2,1,"1",1,3,1,"H"
1965-09-18,1965,"Girondins Bordeaux","FC Nantes","1-2",1,2,"1",1,3,-1,"D"
1965-09-18,1965,"AS Saint-Etienne","RC Strasbourg","5-1",5,1,"1",1,6,4,"H"
1965-09-18,1965,"UA Sedan-Torcy","AS Cannes","3-1",3,1,"1",1,4,2,"H"
1965-09-18,1965,"FC Rouen","Stade Francais FC","2-1",2,1,"1",1,3,1,"H"
1965-09-18,1965,"Stade Rennes","FC Sochaux","4-3",4,3,"1",1,7,1,"H"
1965-09-19,1965,"US Valenciennes-Anzin","AS Monaco","1-0",1,0,"1",1,1,1,"H"
1965-09-19,1965,"Red Star FC","Olympique Lyon","2-2",2,2,"1",1,4,0,"D"
1965-09-19,1965,"Lille OSC","Angers SCO","1-0",1,0,"1",1,1,1,"H"
1965-09-24,1965,"Olympique Lyon","UA Sedan-Torcy","2-1",2,1,"1",1,3,1,"H"
1965-09-24,1965,"AS Cannes","US Valenciennes-Anzin","0-1",0,1,"1",1,1,-1,"D"
1965-09-25,1965,"FC Nantes","OGC Nice","2-1",2,1,"1",1,3,1,"H"
1965-09-25,1965,"Angers SCO","AS Saint-Etienne","1-1",1,1,"1",1,2,0,"D"
1965-09-25,1965,"AS Monaco","Red Star FC","2-1",2,1,"1",1,3,1,"H"
1965-09-25,1965,"RC Strasbourg","Stade Rennes","3-1",3,1,"1",1,4,2,"H"
1965-09-25,1965,"RC Lens","Girondins Bordeaux","0-1",0,1,"1",1,1,-1,"D"
1965-09-25,1965,"Toulouse FC","FC Rouen","6-5",6,5,"1",1,11,1,"H"
1965-09-25,1965,"FC Sochaux","Nimes Olympique","3-1",3,1,"1",1,4,2,"H"
1965-09-26,1965,"Stade Francais FC","Lille OSC","1-1",1,1,"1",1,2,0,"D"
1965-09-28,1965,"US Valenciennes-Anzin","Olympique Lyon","1-0",1,0,"1",1,1,1,"H"
1965-09-29,1965,"FC Rouen","FC Nantes","0-0",0,0,"1",1,0,0,"D"
1965-09-29,1965,"AS Saint-Etienne","Stade Francais FC","0-0",0,0,"1",1,0,0,"D"
1965-09-29,1965,"UA Sedan-Torcy","Angers SCO","3-1",3,1,"1",1,4,2,"H"
1965-09-29,1965,"Lille OSC","Girondins Bordeaux","0-0",0,0,"1",1,0,0,"D"
1965-09-29,1965,"Nimes Olympique","RC Strasbourg","4-1",4,1,"1",1,5,3,"H"
1965-09-29,1965,"FC Sochaux","Toulouse FC","0-1",0,1,"1",1,1,-1,"D"
1965-09-29,1965,"OGC Nice","RC Lens","0-3",0,3,"1",1,3,-3,"D"
1965-09-29,1965,"Red Star FC","AS Cannes","3-2",3,2,"1",1,5,1,"H"
1965-10-02,1965,"FC Nantes","Lille OSC","3-1",3,1,"1",1,4,2,"H"
1965-10-02,1965,"AS Monaco","Nimes Olympique","4-0",4,0,"1",1,4,4,"H"
1965-10-02,1965,"RC Strasbourg","FC Sochaux","5-1",5,1,"1",1,6,4,"H"
1965-10-03,1965,"Olympique Lyon","AS Saint-Etienne","1-1",1,1,"1",1,2,0,"D"
1965-10-03,1965,"Toulouse FC","UA Sedan-Torcy","2-2",2,2,"1",1,4,0,"D"
1965-10-03,1965,"RC Lens","US Valenciennes-Anzin","1-1",1,1,"1",1,2,0,"D"
1965-10-03,1965,"Girondins Bordeaux","FC Rouen","4-1",4,1,"1",1,5,3,"H"
1965-10-03,1965,"Stade Francais FC","Red Star FC","1-1",1,1,"1",1,2,0,"D"
1965-10-03,1965,"Angers SCO","Stade Rennes","5-3",5,3,"1",1,8,2,"H"
1965-10-03,1965,"AS Cannes","OGC Nice","1-3",1,3,"1",1,4,-2,"D"
1965-10-06,1965,"Nimes Olympique","RC Lens","4-5",4,5,"1",1,9,-1,"D"
1965-10-12,1965,"Stade Rennes","AS Monaco","0-1",0,1,"1",1,1,-1,"D"
1965-10-13,1965,"Stade Francais FC","UA Sedan-Torcy","1-1",1,1,"1",1,2,0,"D"
1965-10-13,1965,"RC Lens","AS Saint-Etienne","2-1",2,1,"1",1,3,1,"H"
1965-10-16,1965,"FC Rouen","Lille OSC","1-1",1,1,"1",1,2,0,"D"
1965-10-17,1965,"AS Saint-Etienne","FC Nantes","0-3",0,3,"1",1,3,-3,"D"
1965-10-17,1965,"FC Sochaux","AS Monaco","2-1",2,1,"1",1,3,1,"H"
1965-10-17,1965,"US Valenciennes-Anzin","Stade Francais FC","1-0",1,0,"1",1,1,1,"H"
1965-10-17,1965,"UA Sedan-Torcy","RC Lens","1-3",1,3,"1",1,4,-2,"D"
1965-10-17,1965,"OGC Nice","Girondins Bordeaux","1-2",1,2,"1",1,3,-1,"D"
1965-10-17,1965,"RC Strasbourg","Angers SCO","1-1",1,1,"1",1,2,0,"D"
1965-10-17,1965,"Stade Rennes","Olympique Lyon","5-2",5,2,"1",1,7,3,"H"
1965-10-17,1965,"Red Star FC","Toulouse FC","1-1",1,1,"1",1,2,0,"D"
1965-10-17,1965,"Nimes Olympique","AS Cannes","1-1",1,1,"1",1,2,0,"D"
1965-10-20,1965,"FC Nantes","Red Star FC","7-2",7,2,"1",1,9,5,"H"
1965-10-20,1965,"Toulouse FC","US Valenciennes-Anzin","1-2",1,2,"1",1,3,-1,"D"
1965-10-20,1965,"AS Monaco","RC Strasbourg","0-0",0,0,"1",1,0,0,"D"
1965-10-20,1965,"Girondins Bordeaux","Stade Rennes","2-1",2,1,"1",1,3,1,"H"
1965-10-20,1965,"Olympique Lyon","Nimes Olympique","3-1",3,1,"1",1,4,2,"H"
1965-10-20,1965,"Lille OSC","OGC Nice","2-1",2,1,"1",1,3,1,"H"
1965-10-20,1965,"Angers SCO","FC Rouen","6-0",6,0,"1",1,6,6,"H"
1965-10-20,1965,"AS Cannes","FC Sochaux","1-1",1,1,"1",1,2,0,"D"
1965-10-24,1965,"US Valenciennes-Anzin","FC Nantes","2-2",2,2,"1",1,4,0,"D"
1965-10-24,1965,"AS Monaco","AS Cannes","0-0",0,0,"1",1,0,0,"D"
1965-10-24,1965,"UA Sedan-Torcy","Girondins Bordeaux","1-1",1,1,"1",1,2,0,"D"
1965-10-24,1965,"AS Saint-Etienne","Lille OSC","7-4",7,4,"1",1,11,3,"H"
1965-10-24,1965,"RC Strasbourg","RC Lens","1-0",1,0,"1",1,1,1,"H"
1965-10-24,1965,"FC Sochaux","Olympique Lyon","7-2",7,2,"1",1,9,5,"H"
1965-10-24,1965,"Red Star FC","Angers SCO","0-2",0,2,"1",1,2,-2,"D"
1965-10-24,1965,"Stade Rennes","Stade Francais FC","4-3",4,3,"1",1,7,1,"H"
1965-10-24,1965,"Nimes Olympique","Toulouse FC","2-0",2,0,"1",1,2,2,"H"
1965-10-24,1965,"OGC Nice","FC Rouen","6-0",6,0,"1",1,6,6,"H"
1965-10-29,1965,"Toulouse FC","Stade Rennes","4-1",4,1,"1",1,5,3,"H"
1965-10-29,1965,"Olympique Lyon","AS Monaco","1-0",1,0,"1",1,1,1,"H"
1965-10-30,1965,"Lille OSC","Red Star FC","3-0",3,0,"1",1,3,3,"H"
1965-10-30,1965,"FC Nantes","UA Sedan-Torcy","4-2",4,2,"1",1,6,2,"H"
1965-10-30,1965,"FC Rouen","AS Saint-Etienne","2-0",2,0,"1",1,2,2,"H"
1965-10-31,1965,"Girondins Bordeaux","US Valenciennes-Anzin","2-0",2,0,"1",1,2,2,"H"
1965-10-31,1965,"AS Cannes","RC Strasbourg","2-1",2,1,"1",1,3,1,"H"
1965-10-31,1965,"RC Lens","FC Sochaux","0-1",0,1,"1",1,1,-1,"D"
1965-10-31,1965,"Angers SCO","OGC Nice","1-0",1,0,"1",1,1,1,"H"
1965-10-31,1965,"Stade Francais FC","Nimes Olympique","2-1",2,1,"1",1,3,1,"H"
1965-11-10,1965,"UA Sedan-Torcy","FC Rouen","4-4",4,4,"1",1,8,0,"D"
1965-11-10,1965,"AS Monaco","RC Lens","3-0",3,0,"1",1,3,3,"H"
1965-11-11,1965,"Stade Rennes","FC Nantes","2-0",2,0,"1",1,2,2,"H"
1965-11-11,1965,"US Valenciennes-Anzin","Lille OSC","2-0",2,0,"1",1,2,2,"H"
1965-11-11,1965,"AS Saint-Etienne","OGC Nice","5-1",5,1,"1",1,6,4,"H"
1965-11-11,1965,"Red Star FC","Girondins Bordeaux","2-0",2,0,"1",1,2,2,"H"
1965-11-11,1965,"RC Strasbourg","Olympique Lyon","0-0",0,0,"1",1,0,0,"D"
1965-11-11,1965,"FC Sochaux","Stade Francais FC","1-0",1,0,"1",1,1,1,"H"
1965-11-11,1965,"Nimes Olympique","Angers SCO","1-0",1,0,"1",1,1,1,"H"
1965-11-11,1965,"AS Cannes","Toulouse FC","5-3",5,3,"1",1,8,2,"H"
1965-11-13,1965,"FC Nantes","Nimes Olympique","4-1",4,1,"1",1,5,3,"H"
1965-11-14,1965,"FC Rouen","US Valenciennes-Anzin","1-3",1,3,"1",1,4,-2,"D"
1965-11-14,1965,"Girondins Bordeaux","AS Saint-Etienne","4-0",4,0,"1",1,4,4,"H"
1965-11-14,1965,"Toulouse FC","AS Monaco","5-1",5,1,"1",1,6,4,"H"
1965-11-14,1965,"Stade Francais FC","RC Strasbourg","0-2",0,2,"1",1,2,-2,"D"
1965-11-14,1965,"Lille OSC","UA Sedan-Torcy","1-1",1,1,"1",1,2,0,"D"
1965-11-14,1965,"Olympique Lyon","AS Cannes","2-0",2,0,"1",1,2,2,"H"
1965-11-14,1965,"RC Lens","Stade Rennes","4-1",4,1,"1",1,5,3,"H"
1965-11-14,1965,"Angers SCO","FC Sochaux","2-2",2,2,"1",1,4,0,"D"
1965-11-14,1965,"OGC Nice","Red Star FC","4-0",4,0,"1",1,4,4,"H"
1965-11-19,1965,"AS Monaco","Stade Francais FC","3-1",3,1,"1",1,4,2,"H"
1965-11-20,1965,"FC Sochaux","FC Nantes","3-1",3,1,"1",1,4,2,"H"
1965-11-21,1965,"US Valenciennes-Anzin","OGC Nice","4-2",4,2,"1",1,6,2,"H"
1965-11-21,1965,"Nimes Olympique","Girondins Bordeaux","1-1",1,1,"1",1,2,0,"D"
1965-11-21,1965,"UA Sedan-Torcy","AS Saint-Etienne","4-1",4,1,"1",1,5,3,"H"
1965-11-21,1965,"Olympique Lyon","Angers SCO","2-1",2,1,"1",1,3,1,"H"
1965-11-21,1965,"RC Strasbourg","Toulouse FC","2-2",2,2,"1",1,4,0,"D"
1965-11-21,1965,"AS Cannes","RC Lens","1-1",1,1,"1",1,2,0,"D"
1965-11-21,1965,"Stade Rennes","Lille OSC","4-0",4,0,"1",1,4,4,"H"
1965-11-21,1965,"Red Star FC","FC Rouen","0-1",0,1,"1",1,1,-1,"D"
1965-11-28,1965,"FC Nantes","RC Strasbourg","2-0",2,0,"1",1,2,2,"H"
1965-11-28,1965,"AS Saint-Etienne","US Valenciennes-Anzin","5-1",5,1,"1",1,6,4,"H"
1965-11-28,1965,"Girondins Bordeaux","FC Sochaux","4-2",4,2,"1",1,6,2,"H"
1965-11-28,1965,"Angers SCO","AS Monaco","1-1",1,1,"1",1,2,0,"D"
1965-11-28,1965,"OGC Nice","UA Sedan-Torcy","1-0",1,0,"1",1,1,1,"H"
1965-11-28,1965,"RC Lens","Red Star FC","3-0",3,0,"1",1,3,3,"H"
1965-11-28,1965,"Toulouse FC","Olympique Lyon","1-0",1,0,"1",1,1,1,"H"
1965-11-28,1965,"FC Rouen","Stade Rennes","2-2",2,2,"1",1,4,0,"D"
1965-11-28,1965,"Lille OSC","Nimes Olympique","1-2",1,2,"1",1,3,-1,"D"
1965-11-28,1965,"Stade Francais FC","AS Cannes","3-1",3,1,"1",1,4,2,"H"
1965-12-05,1965,"AS Monaco","FC Nantes","1-3",1,3,"1",1,4,-2,"D"
1965-12-05,1965,"US Valenciennes-Anzin","UA Sedan-Torcy","0-4",0,4,"1",1,4,-4,"D"
1965-12-05,1965,"RC Strasbourg","Girondins Bordeaux","3-0",3,0,"1",1,3,3,"H"
1965-12-05,1965,"Red Star FC","AS Saint-Etienne","1-5",1,5,"1",1,6,-4,"D"
1965-12-05,1965,"Olympique Lyon","Stade Francais FC","2-0",2,0,"1",1,2,2,"H"
1965-12-05,1965,"FC Sochaux","Lille OSC","1-0",1,0,"1",1,1,1,"H"
1965-12-05,1965,"Toulouse FC","RC Lens","4-1",4,1,"1",1,5,3,"H"
1965-12-05,1965,"AS Cannes","Angers SCO","2-5",2,5,"1",1,7,-3,"D"
1965-12-05,1965,"Stade Rennes","OGC Nice","3-0",3,0,"1",1,3,3,"H"
1965-12-05,1965,"Nimes Olympique","FC Rouen","2-1",2,1,"1",1,3,1,"H"
1965-12-12,1965,"FC Nantes","AS Cannes","1-0",1,0,"1",1,1,1,"H"
1965-12-12,1965,"Angers SCO","US Valenciennes-Anzin","0-1",0,1,"1",1,1,-1,"D"
1965-12-12,1965,"Girondins Bordeaux","AS Monaco","5-0",5,0,"1",1,5,5,"H"
1965-12-12,1965,"AS Saint-Etienne","Stade Rennes","4-0",4,0,"1",1,4,4,"H"
1965-12-12,1965,"UA Sedan-Torcy","Red Star FC","5-2",5,2,"1",1,7,3,"H"
1965-12-12,1965,"RC Lens","Olympique Lyon","2-1",2,1,"1",1,3,1,"H"
1965-12-12,1965,"FC Rouen","FC Sochaux","1-1",1,1,"1",1,2,0,"D"
1965-12-12,1965,"Lille OSC","RC Strasbourg","2-1",2,1,"1",1,3,1,"H"
1965-12-12,1965,"Stade Francais FC","Toulouse FC","2-0",2,0,"1",1,2,2,"H"
1965-12-12,1965,"OGC Nice","Nimes Olympique","4-1",4,1,"1",1,5,3,"H"
1965-12-19,1965,"Olympique Lyon","FC Nantes","0-2",0,2,"1",1,2,-2,"D"
1965-12-19,1965,"US Valenciennes-Anzin","Red Star FC","1-0",1,0,"1",1,1,1,"H"
1965-12-19,1965,"Girondins Bordeaux","AS Cannes","1-0",1,0,"1",1,1,1,"H"
1965-12-19,1965,"Nimes Olympique","AS Saint-Etienne","1-1",1,1,"1",1,2,0,"D"
1965-12-19,1965,"Stade Rennes","UA Sedan-Torcy","4-2",4,2,"1",1,6,2,"H"
1965-12-19,1965,"Lille OSC","AS Monaco","2-1",2,1,"1",1,3,1,"H"
1965-12-19,1965,"FC Rouen","RC Strasbourg","0-0",0,0,"1",1,0,0,"D"
1965-12-19,1965,"Stade Francais FC","RC Lens","3-1",3,1,"1",1,4,2,"H"
1965-12-19,1965,"OGC Nice","FC Sochaux","3-1",3,1,"1",1,4,2,"H"
1965-12-19,1965,"Angers SCO","Toulouse FC","2-0",2,0,"1",1,2,2,"H"
1966-01-08,1965,"Toulouse FC","Lille OSC","2-0",2,0,"1",1,2,2,"H"
1966-01-09,1965,"RC Lens","FC Nantes","1-1",1,1,"1",1,2,0,"D"
1966-01-09,1965,"Stade Rennes","US Valenciennes-Anzin","1-1",1,1,"1",1,2,0,"D"
1966-01-09,1965,"Olympique Lyon","Girondins Bordeaux","1-4",1,4,"1",1,5,-3,"D"
1966-01-09,1965,"AS Monaco","AS Saint-Etienne","1-1",1,1,"1",1,2,0,"D"
1966-01-09,1965,"FC Sochaux","UA Sedan-Torcy","0-1",0,1,"1",1,1,-1,"D"
1966-01-09,1965,"RC Strasbourg","OGC Nice","1-3",1,3,"1",1,4,-2,"D"
1966-01-09,1965,"Stade Francais FC","Angers SCO","2-1",2,1,"1",1,3,1,"H"
1966-01-09,1965,"AS Cannes","FC Rouen","1-2",1,2,"1",1,3,-1,"D"
1966-01-09,1965,"Red Star FC","Nimes Olympique","3-3",3,3,"1",1,6,0,"D"
1966-01-23,1965,"FC Nantes","Stade Francais FC","2-1",2,1,"1",1,3,1,"H"
1966-01-23,1965,"US Valenciennes-Anzin","Nimes Olympique","3-0",3,0,"1",1,3,3,"H"
1966-01-23,1965,"Girondins Bordeaux","Toulouse FC","3-0",3,0,"1",1,3,3,"H"
1966-01-23,1965,"AS Saint-Etienne","FC Sochaux","3-1",3,1,"1",1,4,2,"H"
1966-01-23,1965,"OGC Nice","Olympique Lyon","4-2",4,2,"1",1,6,2,"H"
1966-01-23,1965,"Lille OSC","AS Cannes","2-0",2,0,"1",1,2,2,"H"
1966-01-30,1965,"Angers SCO","FC Nantes","1-1",1,1,"1",1,2,0,"D"
1966-01-30,1965,"Stade Francais FC","Girondins Bordeaux","2-4",2,4,"1",1,6,-2,"D"
1966-01-30,1965,"RC Strasbourg","US Valenciennes-Anzin","0-0",0,0,"1",1,0,0,"D"
1966-01-30,1965,"Toulouse FC","AS Saint-Etienne","2-0",2,0,"1",1,2,2,"H"
1966-01-30,1965,"Nimes Olympique","UA Sedan-Torcy","1-0",1,0,"1",1,1,1,"H"
1966-01-30,1965,"RC Lens","Lille OSC","2-0",2,0,"1",1,2,2,"H"
1966-01-30,1965,"AS Monaco","OGC Nice","0-3",0,3,"1",1,3,-3,"D"
1966-01-30,1965,"FC Sochaux","Red Star FC","3-0",3,0,"1",1,3,3,"H"
1966-01-30,1965,"Olympique Lyon","FC Rouen","0-0",0,0,"1",1,0,0,"D"
1966-01-30,1965,"AS Cannes","Stade Rennes","1-0",1,0,"1",1,1,1,"H"
1966-02-06,1965,"FC Nantes","Toulouse FC","2-0",2,0,"1",1,2,2,"H"
1966-02-06,1965,"Girondins Bordeaux","Angers SCO","2-0",2,0,"1",1,2,2,"H"
1966-02-06,1965,"US Valenciennes-Anzin","FC Sochaux","0-0",0,0,"1",1,0,0,"D"
1966-02-06,1965,"AS Saint-Etienne","AS Cannes","1-1",1,1,"1",1,2,0,"D"
1966-02-06,1965,"FC Rouen","RC Lens","1-3",1,3,"1",1,4,-2,"D"
1966-02-06,1965,"UA Sedan-Torcy","AS Monaco","0-2",0,2,"1",1,2,-2,"D"
1966-02-06,1965,"Red Star FC","RC Strasbourg","2-2",2,2,"1",1,4,0,"D"
1966-02-06,1965,"Stade Rennes","Nimes Olympique","3-1",3,1,"1",1,4,2,"H"
1966-02-06,1965,"Lille OSC","Olympique Lyon","1-0",1,0,"1",1,1,1,"H"
1966-02-06,1965,"OGC Nice","Stade Francais FC","1-1",1,1,"1",1,2,0,"D"
1966-02-13,1965,"FC Rouen","AS Monaco","1-2",1,2,"1",1,3,-1,"D"
1966-02-16,1965,"UA Sedan-Torcy","RC Strasbourg","0-0",0,0,"1",1,0,0,"D"
1966-02-20,1965,"FC Nantes","Girondins Bordeaux","2-2",2,2,"1",1,4,0,"D"
1966-02-20,1965,"AS Monaco","US Valenciennes-Anzin","0-2",0,2,"1",1,2,-2,"D"
1966-02-20,1965,"RC Strasbourg","AS Saint-Etienne","0-1",0,1,"1",1,1,-1,"D"
1966-02-20,1965,"RC Lens","Nimes Olympique","1-1",1,1,"1",1,2,0,"D"
1966-02-20,1965,"FC Sochaux","Stade Rennes","3-2",3,2,"1",1,5,1,"H"
1966-02-20,1965,"Toulouse FC","OGC Nice","2-1",2,1,"1",1,3,1,"H"
1966-02-20,1965,"Olympique Lyon","Red Star FC","0-0",0,0,"1",1,0,0,"D"
1966-02-20,1965,"Angers SCO","Lille OSC","3-1",3,1,"1",1,4,2,"H"
1966-02-20,1965,"Stade Francais FC","FC Rouen","0-0",0,0,"1",1,0,0,"D"
1966-02-27,1965,"OGC Nice","FC Nantes","0-0",0,0,"1",1,0,0,"D"
1966-02-27,1965,"Girondins Bordeaux","RC Lens","2-1",2,1,"1",1,3,1,"H"
1966-02-27,1965,"US Valenciennes-Anzin","AS Cannes","3-0",3,0,"1",1,3,3,"H"
1966-02-27,1965,"AS Saint-Etienne","Angers SCO","4-0",4,0,"1",1,4,4,"H"
1966-02-27,1965,"UA Sedan-Torcy","Olympique Lyon","2-0",2,0,"1",1,2,2,"H"
1966-02-27,1965,"FC Rouen","Toulouse FC","0-1",0,1,"1",1,1,-1,"D"
1966-02-27,1965,"Red Star FC","AS Monaco","2-0",2,0,"1",1,2,2,"H"
1966-02-27,1965,"Nimes Olympique","FC Sochaux","1-0",1,0,"1",1,1,1,"H"
1966-02-27,1965,"Stade Rennes","RC Strasbourg","2-1",2,1,"1",1,3,1,"H"
1966-02-27,1965,"Lille OSC","Stade Francais FC","3-3",3,3,"1",1,6,0,"D"
1966-03-02,1965,"FC Nantes","FC Rouen","2-1",2,1,"1",1,3,1,"H"
1966-03-02,1965,"Girondins Bordeaux","Lille OSC","1-0",1,0,"1",1,1,1,"H"
1966-03-02,1965,"Stade Francais FC","AS Saint-Etienne","1-2",1,2,"1",1,3,-1,"D"
1966-03-02,1965,"RC Lens","OGC Nice","4-2",4,2,"1",1,6,2,"H"
1966-03-02,1965,"Angers SCO","UA Sedan-Torcy","2-0",2,0,"1",1,2,2,"H"
1966-03-02,1965,"Toulouse FC","FC Sochaux","1-1",1,1,"1",1,2,0,"D"
1966-03-02,1965,"AS Monaco","Stade Rennes","1-1",1,1,"1",1,2,0,"D"
1966-03-02,1965,"RC Strasbourg","Nimes Olympique","1-0",1,0,"1",1,1,1,"H"
1966-03-02,1965,"AS Cannes","Red Star FC","1-1",1,1,"1",1,2,0,"D"
1966-03-06,1965,"Lille OSC","FC Nantes","0-1",0,1,"1",1,1,-1,"D"
1966-03-06,1965,"FC Rouen","Girondins Bordeaux","0-0",0,0,"1",1,0,0,"D"
1966-03-06,1965,"US Valenciennes-Anzin","RC Lens","2-0",2,0,"1",1,2,2,"H"
1966-03-06,1965,"AS Saint-Etienne","Olympique Lyon","2-1",2,1,"1",1,3,1,"H"
1966-03-06,1965,"UA Sedan-Torcy","Toulouse FC","0-1",0,1,"1",1,1,-1,"D"
1966-03-06,1965,"FC Sochaux","RC Strasbourg","2-1",2,1,"1",1,3,1,"H"
1966-03-06,1965,"Nimes Olympique","AS Monaco","4-0",4,0,"1",1,4,4,"H"
1966-03-06,1965,"Stade Rennes","Angers SCO","4-4",4,4,"1",1,8,0,"D"
1966-03-06,1965,"OGC Nice","AS Cannes","1-1",1,1,"1",1,2,0,"D"
1966-03-06,1965,"Red Star FC","Stade Francais FC","1-5",1,5,"1",1,6,-4,"D"
1966-03-23,1965,"Angers SCO","RC Lens","3-2",3,2,"1",1,5,1,"H"
1966-03-26,1965,"FC Nantes","AS Saint-Etienne","5-0",5,0,"1",1,5,5,"H"
1966-03-26,1965,"Girondins Bordeaux","OGC Nice","0-2",0,2,"1",1,2,-2,"D"
1966-03-26,1965,"AS Monaco","FC Sochaux","1-1",1,1,"1",1,2,0,"D"
1966-03-26,1965,"Olympique Lyon","Stade Rennes","1-2",1,2,"1",1,3,-1,"D"
1966-03-26,1965,"Lille OSC","FC Rouen","2-1",2,1,"1",1,3,1,"H"
1966-03-27,1965,"Stade Francais FC","US Valenciennes-Anzin","1-1",1,1,"1",1,2,0,"D"
1966-03-27,1965,"Toulouse FC","Red Star FC","1-0",1,0,"1",1,1,1,"H"
1966-03-27,1965,"RC Lens","UA Sedan-Torcy","1-1",1,1,"1",1,2,0,"D"
1966-03-27,1965,"Angers SCO","RC Strasbourg","0-3",0,3,"1",1,3,-3,"D"
1966-03-27,1965,"AS Cannes","Nimes Olympique","1-2",1,2,"1",1,3,-1,"D"
1966-04-03,1965,"AS Cannes","UA Sedan-Torcy","2-1",2,1,"1",1,3,1,"H"
1966-04-08,1965,"Red Star FC","FC Nantes","0-3",0,3,"1",1,3,-3,"D"
1966-04-08,1965,"US Valenciennes-Anzin","Toulouse FC","1-1",1,1,"1",1,2,0,"D"
1966-04-08,1965,"AS Saint-Etienne","RC Lens","2-0",2,0,"1",1,2,2,"H"
1966-04-08,1965,"FC Sochaux","AS Cannes","3-1",3,1,"1",1,4,2,"H"
1966-04-08,1965,"RC Strasbourg","AS Monaco","1-1",1,1,"1",1,2,0,"D"
1966-04-08,1965,"Nimes Olympique","Olympique Lyon","0-0",0,0,"1",1,0,0,"D"
1966-04-08,1965,"FC Rouen","Angers SCO","4-0",4,0,"1",1,4,4,"H"
1966-04-09,1965,"Stade Rennes","Girondins Bordeaux","2-0",2,0,"1",1,2,2,"H"
1966-04-09,1965,"UA Sedan-Torcy","Stade Francais FC","0-0",0,0,"1",1,0,0,"D"
1966-04-10,1965,"OGC Nice","Lille OSC","2-0",2,0,"1",1,2,2,"H"
1966-04-13,1965,"FC Nantes","US Valenciennes-Anzin","1-1",1,1,"1",1,2,0,"D"
1966-04-13,1965,"Girondins Bordeaux","UA Sedan-Torcy","4-2",4,2,"1",1,6,2,"H"
1966-04-13,1965,"Lille OSC","AS Saint-Etienne","3-0",3,0,"1",1,3,3,"H"
1966-04-13,1965,"Toulouse FC","Nimes Olympique","3-0",3,0,"1",1,3,3,"H"
1966-04-13,1965,"Olympique Lyon","FC Sochaux","1-0",1,0,"1",1,1,1,"H"
1966-04-13,1965,"AS Cannes","AS Monaco","0-3",0,3,"1",1,3,-3,"D"
1966-04-13,1965,"RC Lens","RC Strasbourg","0-0",0,0,"1",1,0,0,"D"
1966-04-13,1965,"Stade Francais FC","Stade Rennes","2-1",2,1,"1",1,3,1,"H"
1966-04-13,1965,"Angers SCO","Red Star FC","2-2",2,2,"1",1,4,0,"D"
1966-04-13,1965,"FC Rouen","OGC Nice","1-0",1,0,"1",1,1,1,"H"
1966-04-17,1965,"UA Sedan-Torcy","FC Nantes","3-0",3,0,"1",1,3,3,"H"
1966-04-17,1965,"US Valenciennes-Anzin","Girondins Bordeaux","2-2",2,2,"1",1,4,0,"D"
1966-04-17,1965,"AS Saint-Etienne","FC Rouen","2-2",2,2,"1",1,4,0,"D"
1966-04-17,1965,"Stade Rennes","Toulouse FC","2-1",2,1,"1",1,3,1,"H"
1966-04-17,1965,"FC Sochaux","RC Lens","3-2",3,2,"1",1,5,1,"H"
1966-04-17,1965,"AS Monaco","Olympique Lyon","2-0",2,0,"1",1,2,2,"H"
1966-04-17,1965,"RC Strasbourg","AS Cannes","5-0",5,0,"1",1,5,5,"H"
1966-04-17,1965,"OGC Nice","Angers SCO","5-2",5,2,"1",1,7,3,"H"
1966-04-17,1965,"Nimes Olympique","Stade Francais FC","0-0",0,0,"1",1,0,0,"D"
1966-04-17,1965,"Red Star FC","Lille OSC","6-4",6,4,"1",1,10,2,"H"
1966-04-22,1965,"Toulouse FC","AS Cannes","6-1",6,1,"1",1,7,5,"H"
1966-04-23,1965,"FC Nantes","Stade Rennes","4-0",4,0,"1",1,4,4,"H"
1966-04-23,1965,"Girondins Bordeaux","Red Star FC","6-0",6,0,"1",1,6,6,"H"
1966-04-23,1965,"Lille OSC","US Valenciennes-Anzin","6-1",6,1,"1",1,7,5,"H"
1966-04-23,1965,"Stade Francais FC","FC Sochaux","1-1",1,1,"1",1,2,0,"D"
1966-04-23,1965,"RC Lens","AS Monaco","0-0",0,0,"1",1,0,0,"D"
1966-04-23,1965,"Olympique Lyon","RC Strasbourg","2-0",2,0,"1",1,2,2,"H"
1966-04-23,1965,"FC Rouen","UA Sedan-Torcy","3-1",3,1,"1",1,4,2,"H"
1966-04-23,1965,"Angers SCO","Nimes Olympique","3-0",3,0,"1",1,3,3,"H"
1966-04-24,1965,"OGC Nice","AS Saint-Etienne","4-2",4,2,"1",1,6,2,"H"
1966-04-28,1965,"Olympique Lyon","US Valenciennes-Anzin","0-1",0,1,"1",1,1,-1,"D"
1966-04-29,1965,"Red Star FC","Stade Rennes","0-2",0,2,"1",1,2,-2,"D"
1966-05-07,1965,"Nimes Olympique","FC Nantes","1-2",1,2,"1",1,3,-1,"D"
1966-05-07,1965,"US Valenciennes-Anzin","FC Rouen","1-1",1,1,"1",1,2,0,"D"
1966-05-07,1965,"AS Saint-Etienne","Girondins Bordeaux","2-1",2,1,"1",1,3,1,"H"
1966-05-07,1965,"FC Sochaux","Angers SCO","3-2",3,2,"1",1,5,1,"H"
1966-05-07,1965,"Stade Rennes","RC Lens","4-1",4,1,"1",1,5,3,"H"
1966-05-07,1965,"RC Strasbourg","Stade Francais FC","4-0",4,0,"1",1,4,4,"H"
1966-05-07,1965,"UA Sedan-Torcy","Lille OSC","1-0",1,0,"1",1,1,1,"H"
1966-05-07,1965,"AS Cannes","Olympique Lyon","0-0",0,0,"1",1,0,0,"D"
1966-05-08,1965,"Red Star FC","OGC Nice","2-3",2,3,"1",1,5,-1,"D"
1966-05-10,1965,"AS Monaco","Toulouse FC","2-3",2,3,"1",1,5,-1,"D"
1966-05-14,1965,"FC Nantes","FC Sochaux","2-1",2,1,"1",1,3,1,"H"
1966-05-14,1965,"Girondins Bordeaux","Nimes Olympique","5-2",5,2,"1",1,7,3,"H"
1966-05-14,1965,"AS Saint-Etienne","UA Sedan-Torcy","2-1",2,1,"1",1,3,1,"H"
1966-05-14,1965,"Lille OSC","Stade Rennes","1-3",1,3,"1",1,4,-2,"D"
1966-05-14,1965,"RC Lens","AS Cannes","1-0",1,0,"1",1,1,1,"H"
1966-05-14,1965,"Angers SCO","Olympique Lyon","4-1",4,1,"1",1,5,3,"H"
1966-05-14,1965,"FC Rouen","Red Star FC","1-0",1,0,"1",1,1,1,"H"
1966-05-15,1965,"OGC Nice","US Valenciennes-Anzin","1-1",1,1,"1",1,2,0,"D"
1966-05-15,1965,"Toulouse FC","RC Strasbourg","2-0",2,0,"1",1,2,2,"H"
1966-05-15,1965,"Stade Francais FC","AS Monaco","1-0",1,0,"1",1,1,1,"H"
1966-05-18,1965,"FC Sochaux","Girondins Bordeaux","0-1",0,1,"1",1,1,-1,"D"
1966-05-18,1965,"US Valenciennes-Anzin","AS Saint-Etienne","3-1",3,1,"1",1,4,2,"H"
1966-05-18,1965,"Olympique Lyon","Toulouse FC","0-1",0,1,"1",1,1,-1,"D"
1966-05-18,1965,"UA Sedan-Torcy","OGC Nice","2-0",2,0,"1",1,2,2,"H"
1966-05-18,1965,"AS Monaco","Angers SCO","1-3",1,3,"1",1,4,-2,"D"
1966-05-18,1965,"Nimes Olympique","Lille OSC","4-1",4,1,"1",1,5,3,"H"
1966-05-19,1965,"Red Star FC","RC Lens","1-2",1,2,"1",1,3,-1,"D"
1966-05-19,1965,"AS Cannes","Stade Francais FC","0-4",0,4,"1",1,4,-4,"D"
1966-05-21,1965,"Stade Rennes","FC Rouen","4-0",4,0,"1",1,4,4,"H"
1966-05-25,1965,"RC Strasbourg","FC Nantes","1-0",1,0,"1",1,1,1,"H"
1966-05-27,1965,"AS Saint-Etienne","Red Star FC","7-0",7,0,"1",1,7,7,"H"
1966-05-27,1965,"Lille OSC","FC Sochaux","2-1",2,1,"1",1,3,1,"H"
1966-05-27,1965,"Angers SCO","AS Cannes","4-1",4,1,"1",1,5,3,"H"
1966-05-27,1965,"FC Rouen","Nimes Olympique","1-0",1,0,"1",1,1,1,"H"
1966-05-27,1965,"Stade Francais FC","Olympique Lyon","0-1",0,1,"1",1,1,-1,"D"
1966-05-28,1965,"FC Nantes","AS Monaco","2-1",2,1,"1",1,3,1,"H"
1966-05-28,1965,"Girondins Bordeaux","RC Strasbourg","4-0",4,0,"1",1,4,4,"H"
1966-05-28,1965,"UA Sedan-Torcy","US Valenciennes-Anzin","2-2",2,2,"1",1,4,0,"D"
1966-05-28,1965,"RC Lens","Toulouse FC","0-1",0,1,"1",1,1,-1,"D"
1966-06-10,1965,"US Valenciennes-Anzin","Angers SCO","4-1",4,1,"1",1,5,3,"H"
1966-06-10,1965,"FC Sochaux","FC Rouen","4-0",4,0,"1",1,4,4,"H"
1966-06-10,1965,"Red Star FC","UA Sedan-Torcy","3-3",3,3,"1",1,6,0,"D"
1966-06-11,1965,"AS Cannes","FC Nantes","1-6",1,6,"1",1,7,-5,"D"
1966-06-11,1965,"Toulouse FC","Stade Francais FC","1-1",1,1,"1",1,2,0,"D"
1966-06-11,1965,"Stade Rennes","AS Saint-Etienne","2-0",2,0,"1",1,2,2,"H"
1966-06-11,1965,"RC Strasbourg","Lille OSC","4-1",4,1,"1",1,5,3,"H"
1966-06-11,1965,"Olympique Lyon","RC Lens","3-2",3,2,"1",1,5,1,"H"
1966-06-11,1965,"Nimes Olympique","OGC Nice","1-0",1,0,"1",1,1,1,"H"
1966-06-12,1965,"AS Monaco","Girondins Bordeaux","0-2",0,2,"1",1,2,-2,"D"
1966-06-15,1965,"OGC Nice","Stade Rennes","3-2",3,2,"1",1,5,1,"H"
1966-08-18,1966,"Girondins Bordeaux","Stade Rennes","2-0",2,0,"1",1,2,2,"H"
1966-08-19,1966,"Toulouse FC","AS Saint-Etienne","0-2",0,2,"1",1,2,-2,"D"
1966-08-19,1966,"Olympique Marseille","US Valenciennes-Anzin","2-1",2,1,"1",1,3,1,"H"
1966-08-20,1966,"FC Nantes","Olympique Lyon","5-2",5,2,"1",1,7,3,"H"
1966-08-20,1966,"RC Strasbourg","AS Monaco","4-2",4,2,"1",1,6,2,"H"
1966-08-20,1966,"Stade Reims","Lille OSC","0-1",0,1,"1",1,1,-1,"D"
1966-08-20,1966,"FC Rouen","Stade de Paris FC","0-1",0,1,"1",1,1,-1,"D"
1966-08-20,1966,"RC Lens","CS Sedan","2-2",2,2,"1",1,4,0,"D"
1966-08-21,1966,"OGC Nice","FC Sochaux","1-4",1,4,"1",1,5,-3,"D"
1966-08-21,1966,"Angers SCO","Nimes Olympique","1-2",1,2,"1",1,3,-1,"D"
1966-08-24,1966,"CS Sedan","FC Nantes","3-3",3,3,"1",1,6,0,"D"
1966-08-26,1966,"US Valenciennes-Anzin","Girondins Bordeaux","0-1",0,1,"1",1,1,-1,"D"
1966-08-26,1966,"Nimes Olympique","OGC Nice","1-1",1,1,"1",1,2,0,"D"
1966-08-27,1966,"FC Nantes","RC Lens","3-1",3,1,"1",1,4,2,"H"
1966-08-27,1966,"FC Sochaux","FC Rouen","3-0",3,0,"1",1,3,3,"H"
1966-08-27,1966,"AS Saint-Etienne","Olympique Marseille","2-0",2,0,"1",1,2,2,"H"
1966-08-27,1966,"Stade de Paris FC","RC Strasbourg","0-0",0,0,"1",1,0,0,"D"
1966-08-27,1966,"Lille OSC","Angers SCO","0-0",0,0,"1",1,0,0,"D"
1966-08-27,1966,"Stade Rennes","CS Sedan","5-0",5,0,"1",1,5,5,"H"
1966-08-27,1966,"AS Monaco","Olympique Lyon","4-0",4,0,"1",1,4,4,"H"
1966-08-27,1966,"Stade Reims","Toulouse FC","1-3",1,3,"1",1,4,-2,"D"
1966-08-31,1966,"OGC Nice","AS Saint-Etienne","1-2",1,2,"1",1,3,-1,"D"
1966-08-31,1966,"Olympique Lyon","FC Sochaux","0-0",0,0,"1",1,0,0,"D"
1966-08-31,1966,"RC Strasbourg","US Valenciennes-Anzin","4-1",4,1,"1",1,5,3,"H"
1966-08-31,1966,"Girondins Bordeaux","AS Monaco","1-1",1,1,"1",1,2,0,"D"
1966-08-31,1966,"Olympique Marseille","Stade de Paris FC","1-2",1,2,"1",1,3,-1,"D"
1966-08-31,1966,"Toulouse FC","Lille OSC","2-1",2,1,"1",1,3,1,"H"
1966-08-31,1966,"RC Lens","Stade Rennes","2-1",2,1,"1",1,3,1,"H"
1966-08-31,1966,"FC Rouen","Nimes Olympique","2-0",2,0,"1",1,2,2,"H"
1966-08-31,1966,"Angers SCO","Stade Reims","2-2",2,2,"1",1,4,0,"D"
1966-09-03,1966,"FC Nantes","Stade Rennes","1-0",1,0,"1",1,1,1,"H"
1966-09-03,1966,"AS Saint-Etienne","Girondins Bordeaux","1-1",1,1,"1",1,2,0,"D"
1966-09-03,1966,"FC Sochaux","Olympique Marseille","0-1",0,1,"1",1,1,-1,"D"
1966-09-03,1966,"Angers SCO","RC Strasbourg","3-1",3,1,"1",1,4,2,"H"
1966-09-03,1966,"Nimes Olympique","Toulouse FC","2-0",2,0,"1",1,2,2,"H"
1966-09-03,1966,"Stade de Paris FC","Olympique Lyon","0-1",0,1,"1",1,1,-1,"D"
1966-09-03,1966,"Stade Reims","OGC Nice","2-0",2,0,"1",1,2,2,"H"
1966-09-04,1966,"AS Monaco","CS Sedan","4-2",4,2,"1",1,6,2,"H"
1966-09-04,1966,"US Valenciennes-Anzin","RC Lens","1-3",1,3,"1",1,4,-2,"D"
1966-09-04,1966,"Lille OSC","FC Rouen","1-0",1,0,"1",1,1,1,"H"
1966-09-09,1966,"OGC Nice","Lille OSC","1-2",1,2,"1",1,3,-1,"D"
1966-09-09,1966,"Toulouse FC","Angers SCO","1-1",1,1,"1",1,2,0,"D"
1966-09-09,1966,"Olympique Lyon","US Valenciennes-Anzin","0-0",0,0,"1",1,0,0,"D"
1966-09-10,1966,"Girondins Bordeaux","FC Nantes","0-1",0,1,"1",1,1,-1,"D"
1966-09-10,1966,"RC Lens","Stade de Paris FC","4-1",4,1,"1",1,5,3,"H"
1966-09-10,1966,"RC Strasbourg","AS Saint-Etienne","2-1",2,1,"1",1,3,1,"H"
1966-09-10,1966,"CS Sedan","FC Sochaux","1-1",1,1,"1",1,2,0,"D"
1966-09-10,1966,"Olympique Marseille","Nimes Olympique","4-0",4,0,"1",1,4,4,"H"
1966-09-10,1966,"FC Rouen","Stade Reims","2-0",2,0,"1",1,2,2,"H"
1966-09-11,1966,"Stade Rennes","AS Monaco","3-1",3,1,"1",1,4,2,"H"
1966-09-14,1966,"AS Monaco","FC Nantes","0-0",0,0,"1",1,0,0,"D"
1966-09-14,1966,"AS Saint-Etienne","FC Rouen","3-0",3,0,"1",1,3,3,"H"
1966-09-14,1966,"Lille OSC","Olympique Marseille","0-0",0,0,"1",1,0,0,"D"
1966-09-14,1966,"FC Sochaux","Girondins Bordeaux","1-1",1,1,"1",1,2,0,"D"
1966-09-14,1966,"Toulouse FC","RC Lens","3-2",3,2,"1",1,5,1,"H"
1966-09-14,1966,"Nimes Olympique","RC Strasbourg","1-0",1,0,"1",1,1,1,"H"
1966-09-14,1966,"Angers SCO","OGC Nice","1-0",1,0,"1",1,1,1,"H"
1966-09-14,1966,"Stade de Paris FC","CS Sedan","1-1",1,1,"1",1,2,0,"D"
1966-09-14,1966,"Stade Reims","Olympique Lyon","2-0",2,0,"1",1,2,2,"H"
1966-09-14,1966,"US Valenciennes-Anzin","Stade Rennes","3-1",3,1,"1",1,4,2,"H"
1966-09-17,1966,"FC Nantes","FC Sochaux","1-1",1,1,"1",1,2,0,"D"
1966-09-17,1966,"Olympique Marseille","Stade Reims","0-0",0,0,"1",1,0,0,"D"
1966-09-17,1966,"Girondins Bordeaux","Stade de Paris FC","0-0",0,0,"1",1,0,0,"D"
1966-09-17,1966,"FC Rouen","Angers SCO","1-0",1,0,"1",1,1,1,"H"
1966-09-17,1966,"Olympique Lyon","Nimes Olympique","3-1",3,1,"1",1,4,2,"H"
1966-09-17,1966,"CS Sedan","US Valenciennes-Anzin","0-0",0,0,"1",1,0,0,"D"
1966-09-18,1966,"Stade Rennes","AS Saint-Etienne","1-1",1,1,"1",1,2,0,"D"
1966-09-18,1966,"RC Strasbourg","Lille OSC","3-1",3,1,"1",1,4,2,"H"
1966-09-18,1966,"RC Lens","AS Monaco","2-1",2,1,"1",1,3,1,"H"
1966-09-18,1966,"OGC Nice","Toulouse FC","3-1",3,1,"1",1,4,2,"H"
1966-09-23,1966,"AS Saint-Etienne","CS Sedan","1-0",1,0,"1",1,1,1,"H"
1966-09-23,1966,"FC Sochaux","RC Lens","2-5",2,5,"1",1,7,-3,"D"
1966-09-23,1966,"Stade de Paris FC","FC Nantes","1-0",1,0,"1",1,1,1,"H"
1966-09-23,1966,"Angers SCO","Olympique Marseille","5-0",5,0,"1",1,5,5,"H"
1966-09-23,1966,"Stade Reims","RC Strasbourg","2-1",2,1,"1",1,3,1,"H"
1966-09-23,1966,"Toulouse FC","FC Rouen","1-1",1,1,"1",1,2,0,"D"
1966-09-23,1966,"Nimes Olympique","Stade Rennes","1-2",1,2,"1",1,3,-1,"D"
1966-09-23,1966,"US Valenciennes-Anzin","AS Monaco","2-0",2,0,"1",1,2,2,"H"
1966-09-24,1966,"OGC Nice","Girondins Bordeaux","2-1",2,1,"1",1,3,1,"H"
1966-09-24,1966,"Lille OSC","Olympique Lyon","0-1",0,1,"1",1,1,-1,"D"
1966-10-01,1966,"FC Nantes","US Valenciennes-Anzin","3-1",3,1,"1",1,4,2,"H"
1966-10-01,1966,"Girondins Bordeaux","Nimes Olympique","2-0",2,0,"1",1,2,2,"H"
1966-10-01,1966,"Olympique Marseille","Toulouse FC","2-0",2,0,"1",1,2,2,"H"
1966-10-01,1966,"FC Rouen","OGC Nice","1-0",1,0,"1",1,1,1,"H"
1966-10-02,1966,"RC Lens","Lille OSC","1-1",1,1,"1",1,2,0,"D"
1966-10-02,1966,"Olympique Lyon","AS Saint-Etienne","3-0",3,0,"1",1,3,3,"H"
1966-10-02,1966,"Stade Rennes","Angers SCO","2-3",2,3,"1",1,5,-1,"D"
1966-10-02,1966,"RC Strasbourg","FC Sochaux","3-1",3,1,"1",1,4,2,"H"
1966-10-02,1966,"AS Monaco","Stade de Paris FC","0-1",0,1,"1",1,1,-1,"D"
1966-10-02,1966,"CS Sedan","Stade Reims","1-0",1,0,"1",1,1,1,"H"
1966-10-08,1966,"Nimes Olympique","RC Lens","1-2",1,2,"1",1,3,-1,"D"
1966-10-08,1966,"Toulouse FC","RC Strasbourg","1-1",1,1,"1",1,2,0,"D"
1966-10-08,1966,"Lille OSC","CS Sedan","2-2",2,2,"1",1,4,0,"D"
1966-10-08,1966,"Stade Reims","Girondins Bordeaux","4-1",4,1,"1",1,5,3,"H"
1966-10-08,1966,"FC Sochaux","AS Monaco","0-0",0,0,"1",1,0,0,"D"
1966-10-08,1966,"FC Rouen","Stade Rennes","1-0",1,0,"1",1,1,1,"H"
1966-10-09,1966,"AS Saint-Etienne","FC Nantes","3-3",3,3,"1",1,6,0,"D"
1966-10-09,1966,"Angers SCO","Olympique Lyon","0-2",0,2,"1",1,2,-2,"D"
1966-10-09,1966,"OGC Nice","Olympique Marseille","0-0",0,0,"1",1,0,0,"D"
1966-10-09,1966,"Stade de Paris FC","US Valenciennes-Anzin","0-2",0,2,"1",1,2,-2,"D"
1966-10-12,1966,"FC Nantes","Stade Reims","6-2",6,2,"1",1,8,4,"H"
1966-10-12,1966,"RC Lens","AS Saint-Etienne","2-0",2,0,"1",1,2,2,"H"
1966-10-12,1966,"AS Monaco","Angers SCO","1-5",1,5,"1",1,6,-4,"D"
1966-10-12,1966,"Olympique Lyon","Toulouse FC","1-1",1,1,"1",1,2,0,"D"
1966-10-12,1966,"Girondins Bordeaux","Lille OSC","1-3",1,3,"1",1,4,-2,"D"
1966-10-12,1966,"Olympique Marseille","FC Rouen","0-0",0,0,"1",1,0,0,"D"
1966-10-12,1966,"Stade Rennes","Stade de Paris FC","2-1",2,1,"1",1,3,1,"H"
1966-10-12,1966,"US Valenciennes-Anzin","FC Sochaux","2-0",2,0,"1",1,2,2,"H"
1966-10-12,1966,"CS Sedan","Nimes Olympique","2-2",2,2,"1",1,4,0,"D"
1966-10-15,1966,"FC Rouen","RC Lens","0-2",0,2,"1",1,2,-2,"D"
1966-10-15,1966,"AS Saint-Etienne","US Valenciennes-Anzin","3-1",3,1,"1",1,4,2,"H"
1966-10-15,1966,"Stade Reims","Stade Rennes","2-4",2,4,"1",1,6,-2,"D"
1966-10-15,1966,"FC Sochaux","Stade de Paris FC","3-0",3,0,"1",1,3,3,"H"
1966-10-16,1966,"Lille OSC","FC Nantes","2-4",2,4,"1",1,6,-2,"D"
1966-10-16,1966,"Olympique Marseille","RC Strasbourg","0-1",0,1,"1",1,1,-1,"D"
1966-10-16,1966,"Angers SCO","CS Sedan","2-5",2,5,"1",1,7,-3,"D"
1966-10-16,1966,"OGC Nice","Olympique Lyon","4-3",4,3,"1",1,7,1,"H"
1966-10-16,1966,"Toulouse FC","Girondins Bordeaux","2-1",2,1,"1",1,3,1,"H"
1966-10-16,1966,"Nimes Olympique","AS Monaco","3-2",3,2,"1",1,5,1,"H"
1966-10-28,1966,"FC Nantes","Nimes Olympique","5-3",5,3,"1",1,8,2,"H"
1966-10-28,1966,"RC Strasbourg","FC Rouen","1-0",1,0,"1",1,1,1,"H"
1966-10-30,1966,"RC Lens","OGC Nice","1-3",1,3,"1",1,4,-2,"D"
1966-10-30,1966,"Stade de Paris FC","AS Saint-Etienne","1-1",1,1,"1",1,2,0,"D"
1966-10-30,1966,"Girondins Bordeaux","Angers SCO","1-4",1,4,"1",1,5,-3,"D"
1966-10-30,1966,"Olympique Lyon","Olympique Marseille","2-2",2,2,"1",1,4,0,"D"
1966-10-30,1966,"CS Sedan","Toulouse FC","1-0",1,0,"1",1,1,1,"H"
1966-10-30,1966,"Stade Rennes","FC Sochaux","1-1",1,1,"1",1,2,0,"D"
1966-10-30,1966,"US Valenciennes-Anzin","Stade Reims","2-0",2,0,"1",1,2,2,"H"
1966-10-30,1966,"AS Monaco","Lille OSC","3-0",3,0,"1",1,3,3,"H"
1966-11-01,1966,"Angers SCO","FC Nantes","1-1",1,1,"1",1,2,0,"D"
1966-11-01,1966,"AS Saint-Etienne","FC Sochaux","1-0",1,0,"1",1,1,1,"H"
1966-11-01,1966,"RC Strasbourg","Girondins Bordeaux","0-3",0,3,"1",1,3,-3,"D"
1966-11-01,1966,"Nimes Olympique","Stade de Paris FC","0-1",0,1,"1",1,1,-1,"D"
1966-11-01,1966,"OGC Nice","CS Sedan","5-1",5,1,"1",1,6,4,"H"
1966-11-01,1966,"Stade Reims","AS Monaco","2-0",2,0,"1",1,2,2,"H"
1966-11-02,1966,"Olympique Marseille","RC Lens","1-0",1,0,"1",1,1,1,"H"
1966-11-02,1966,"FC Rouen","Olympique Lyon","3-2",3,2,"1",1,5,1,"H"
1966-11-02,1966,"Lille OSC","US Valenciennes-Anzin","1-0",1,0,"1",1,1,1,"H"
1966-11-02,1966,"Toulouse FC","Stade Rennes","1-1",1,1,"1",1,2,0,"D"
1966-11-06,1966,"FC Nantes","Toulouse FC","2-2",2,2,"1",1,4,0,"D"
1966-11-06,1966,"RC Lens","Angers SCO","1-1",1,1,"1",1,2,0,"D"
1966-11-06,1966,"Olympique Lyon","RC Strasbourg","2-1",2,1,"1",1,3,1,"H"
1966-11-06,1966,"Stade de Paris FC","Lille OSC","0-2",0,2,"1",1,2,-2,"D"
1966-11-06,1966,"Girondins Bordeaux","Olympique Marseille","2-0",2,0,"1",1,2,2,"H"
1966-11-06,1966,"CS Sedan","FC Rouen","1-0",1,0,"1",1,1,1,"H"
1966-11-06,1966,"Stade Rennes","OGC Nice","0-1",0,1,"1",1,1,-1,"D"
1966-11-06,1966,"US Valenciennes-Anzin","Nimes Olympique","2-0",2,0,"1",1,2,2,"H"
1966-11-06,1966,"FC Sochaux","Stade Reims","1-1",1,1,"1",1,2,0,"D"
1966-11-13,1966,"AS Saint-Etienne","Nimes Olympique","3-1",3,1,"1",1,4,2,"H"
1966-11-13,1966,"Olympique Lyon","Stade Rennes","2-2",2,2,"1",1,4,0,"D"
1966-11-13,1966,"Toulouse FC","AS Monaco","3-0",3,0,"1",1,3,3,"H"
1966-11-13,1966,"Olympique Marseille","CS Sedan","1-1",1,1,"1",1,2,0,"D"
1966-11-13,1966,"Stade Reims","Stade de Paris FC","1-0",1,0,"1",1,1,1,"H"
1966-11-15,1966,"OGC Nice","FC Nantes","3-1",3,1,"1",1,4,2,"H"
1966-11-15,1966,"Angers SCO","US Valenciennes-Anzin","3-1",3,1,"1",1,4,2,"H"
1966-11-15,1966,"RC Strasbourg","RC Lens","1-0",1,0,"1",1,1,1,"H"
1966-11-15,1966,"Lille OSC","FC Sochaux","6-0",6,0,"1",1,6,6,"H"
1966-11-15,1966,"FC Rouen","Girondins Bordeaux","1-1",1,1,"1",1,2,0,"D"
1966-11-19,1966,"AS Monaco","OGC Nice","0-0",0,0,"1",1,0,0,"D"
1966-11-20,1966,"FC Nantes","FC Rouen","0-0",0,0,"1",1,0,0,"D"
1966-11-20,1966,"AS Saint-Etienne","Lille OSC","4-1",4,1,"1",1,5,3,"H"
1966-11-20,1966,"RC Lens","Stade Reims","5-2",5,2,"1",1,7,3,"H"
1966-11-20,1966,"Stade de Paris FC","Angers SCO","1-1",1,1,"1",1,2,0,"D"
1966-11-20,1966,"CS Sedan","RC Strasbourg","3-0",3,0,"1",1,3,3,"H"
1966-11-20,1966,"Girondins Bordeaux","Olympique Lyon","4-1",4,1,"1",1,5,3,"H"
1966-11-20,1966,"Stade Rennes","Olympique Marseille","2-1",2,1,"1",1,3,1,"H"
1966-11-20,1966,"US Valenciennes-Anzin","Toulouse FC","2-0",2,0,"1",1,2,2,"H"
1966-11-20,1966,"FC Sochaux","Nimes Olympique","2-2",2,2,"1",1,4,0,"D"
1966-11-29,1966,"AS Monaco","AS Saint-Etienne","1-0",1,0,"1",1,1,1,"H"
1966-12-04,1966,"Stade Reims","AS Saint-Etienne","1-2",1,2,"1",1,3,-1,"D"
1966-12-04,1966,"Olympique Marseille","FC Nantes","1-0",1,0,"1",1,1,1,"H"
1966-12-04,1966,"Girondins Bordeaux","RC Lens","1-1",1,1,"1",1,2,0,"D"
1966-12-04,1966,"Angers SCO","FC Sochaux","1-1",1,1,"1",1,2,0,"D"
1966-12-04,1966,"Lille OSC","Nimes Olympique","4-0",4,0,"1",1,4,4,"H"
1966-12-04,1966,"RC Strasbourg","Stade Rennes","5-3",5,3,"1",1,8,2,"H"
1966-12-04,1966,"Olympique Lyon","CS Sedan","0-3",0,3,"1",1,3,-3,"D"
1966-12-04,1966,"OGC Nice","US Valenciennes-Anzin","5-2",5,2,"1",1,7,3,"H"
1966-12-04,1966,"Toulouse FC","Stade de Paris FC","0-0",0,0,"1",1,0,0,"D"
1966-12-04,1966,"FC Rouen","AS Monaco","0-0",0,0,"1",1,0,0,"D"
1966-12-11,1966,"AS Saint-Etienne","Angers SCO","4-2",4,2,"1",1,6,2,"H"
1966-12-11,1966,"FC Nantes","RC Strasbourg","4-0",4,0,"1",1,4,4,"H"
1966-12-11,1966,"RC Lens","Olympique Lyon","4-1",4,1,"1",1,5,3,"H"
1966-12-11,1966,"Stade Rennes","Lille OSC","1-2",1,2,"1",1,3,-1,"D"
1966-12-11,1966,"CS Sedan","Girondins Bordeaux","0-3",0,3,"1",1,3,-3,"D"
1966-12-11,1966,"AS Monaco","Olympique Marseille","0-1",0,1,"1",1,1,-1,"D"
1966-12-11,1966,"Stade de Paris FC","OGC Nice","2-0",2,0,"1",1,2,2,"H"
1966-12-11,1966,"US Valenciennes-Anzin","FC Rouen","3-0",3,0,"1",1,3,3,"H"
1966-12-11,1966,"FC Sochaux","Toulouse FC","1-0",1,0,"1",1,1,1,"H"
1966-12-11,1966,"Nimes Olympique","Stade Reims","2-2",2,2,"1",1,4,0,"D"
1966-12-14,1966,"RC Strasbourg","OGC Nice","3-1",3,1,"1",1,4,2,"H"
1966-12-18,1966,"AS Saint-Etienne","Toulouse FC","3-0",3,0,"1",1,3,3,"H"
1966-12-18,1966,"Olympique Lyon","FC Nantes","1-2",1,2,"1",1,3,-1,"D"
1966-12-18,1966,"CS Sedan","RC Lens","3-0",3,0,"1",1,3,3,"H"
1966-12-18,1966,"Nimes Olympique","Angers SCO","1-4",1,4,"1",1,5,-3,"D"
1966-12-18,1966,"Lille OSC","Stade Reims","1-1",1,1,"1",1,2,0,"D"
1966-12-18,1966,"AS Monaco","RC Strasbourg","1-1",1,1,"1",1,2,0,"D"
1966-12-18,1966,"Stade Rennes","Girondins Bordeaux","0-1",0,1,"1",1,1,-1,"D"
1966-12-18,1966,"US Valenciennes-Anzin","Olympique Marseille","2-1",2,1,"1",1,3,1,"H"
1966-12-18,1966,"FC Sochaux","OGC Nice","4-0",4,0,"1",1,4,4,"H"
1966-12-18,1966,"Stade de Paris FC","FC Rouen","1-2",1,2,"1",1,3,-1,"D"
1967-01-08,1966,"Olympique Marseille","AS Saint-Etienne","2-2",2,2,"1",1,4,0,"D"
1967-01-08,1966,"RC Lens","FC Nantes","4-0",4,0,"1",1,4,4,"H"
1967-01-08,1966,"Angers SCO","Lille OSC","2-1",2,1,"1",1,3,1,"H"
1967-01-08,1966,"RC Strasbourg","Stade de Paris FC","1-0",1,0,"1",1,1,1,"H"
1967-01-08,1966,"CS Sedan","Stade Rennes","4-0",4,0,"1",1,4,4,"H"
1967-01-08,1966,"Girondins Bordeaux","US Valenciennes-Anzin","0-0",0,0,"1",1,0,0,"D"
1967-01-08,1966,"OGC Nice","Nimes Olympique","4-1",4,1,"1",1,5,3,"H"
1967-01-22,1966,"AS Saint-Etienne","OGC Nice","7-0",7,0,"1",1,7,7,"H"
1967-01-22,1966,"FC Nantes","CS Sedan","3-1",3,1,"1",1,4,2,"H"
1967-01-22,1966,"Stade Reims","Angers SCO","0-3",0,3,"1",1,3,-3,"D"
1967-01-22,1966,"Stade Rennes","RC Lens","3-0",3,0,"1",1,3,3,"H"
1967-01-22,1966,"Lille OSC","Toulouse FC","3-1",3,1,"1",1,4,2,"H"
1967-01-22,1966,"US Valenciennes-Anzin","RC Strasbourg","1-0",1,0,"1",1,1,1,"H"
1967-01-22,1966,"AS Monaco","Girondins Bordeaux","1-1",1,1,"1",1,2,0,"D"
1967-01-22,1966,"FC Sochaux","Olympique Lyon","1-1",1,1,"1",1,2,0,"D"
1967-01-22,1966,"Nimes Olympique","FC Rouen","1-0",1,0,"1",1,1,1,"H"
1967-01-28,1966,"OGC Nice","Stade Reims","1-0",1,0,"1",1,1,1,"H"
1967-01-29,1966,"Girondins Bordeaux","AS Saint-Etienne","1-0",1,0,"1",1,1,1,"H"
1967-01-29,1966,"Stade Rennes","FC Nantes","2-2",2,2,"1",1,4,0,"D"
1967-01-29,1966,"RC Strasbourg","Angers SCO","0-0",0,0,"1",1,0,0,"D"
1967-01-29,1966,"RC Lens","US Valenciennes-Anzin","0-0",0,0,"1",1,0,0,"D"
1967-01-29,1966,"FC Rouen","Lille OSC","3-0",3,0,"1",1,3,3,"H"
1967-01-29,1966,"CS Sedan","AS Monaco","1-1",1,1,"1",1,2,0,"D"
1967-01-29,1966,"Olympique Marseille","FC Sochaux","1-0",1,0,"1",1,1,1,"H"
1967-01-29,1966,"Olympique Lyon","Stade de Paris FC","0-0",0,0,"1",1,0,0,"D"
1967-01-29,1966,"Toulouse FC","Nimes Olympique","0-1",0,1,"1",1,1,-1,"D"
1967-02-05,1966,"AS Saint-Etienne","RC Strasbourg","2-1",2,1,"1",1,3,1,"H"
1967-02-05,1966,"FC Nantes","Girondins Bordeaux","1-1",1,1,"1",1,2,0,"D"
1967-02-05,1966,"Angers SCO","Toulouse FC","1-1",1,1,"1",1,2,0,"D"
1967-02-05,1966,"Stade de Paris FC","RC Lens","0-1",0,1,"1",1,1,-1,"D"
1967-02-05,1966,"Lille OSC","OGC Nice","3-0",3,0,"1",1,3,3,"H"
1967-02-05,1966,"US Valenciennes-Anzin","Olympique Lyon","0-0",0,0,"1",1,0,0,"D"
1967-02-05,1966,"FC Sochaux","CS Sedan","1-0",1,0,"1",1,1,1,"H"
1967-02-05,1966,"Nimes Olympique","Olympique Marseille","0-1",0,1,"1",1,1,-1,"D"
1967-02-05,1966,"Stade Reims","FC Rouen","1-0",1,0,"1",1,1,1,"H"
1967-02-05,1966,"AS Monaco","Stade Rennes","0-0",0,0,"1",1,0,0,"D"
1967-02-12,1966,"Toulouse FC","Stade Reims","1-0",1,0,"1",1,1,1,"H"
1967-02-19,1966,"FC Rouen","AS Saint-Etienne","0-1",0,1,"1",1,1,-1,"D"
1967-02-19,1966,"OGC Nice","Angers SCO","3-1",3,1,"1",1,4,2,"H"
1967-02-19,1966,"Girondins Bordeaux","FC Sochaux","1-0",1,0,"1",1,1,1,"H"
1967-02-19,1966,"Olympique Marseille","Lille OSC","2-1",2,1,"1",1,3,1,"H"
1967-02-19,1966,"CS Sedan","Stade de Paris FC","0-0",0,0,"1",1,0,0,"D"
1967-02-19,1966,"RC Strasbourg","Nimes Olympique","1-2",1,2,"1",1,3,-1,"D"
1967-02-19,1966,"Stade Rennes","US Valenciennes-Anzin","1-0",1,0,"1",1,1,1,"H"
1967-02-19,1966,"Olympique Lyon","Stade Reims","3-1",3,1,"1",1,4,2,"H"
1967-02-26,1966,"AS Saint-Etienne","Stade Rennes","4-1",4,1,"1",1,5,3,"H"
1967-02-26,1966,"FC Sochaux","FC Nantes","1-1",1,1,"1",1,2,0,"D"
1967-02-26,1966,"Angers SCO","FC Rouen","5-2",5,2,"1",1,7,3,"H"
1967-02-26,1966,"Stade de Paris FC","Girondins Bordeaux","0-0",0,0,"1",1,0,0,"D"
1967-02-26,1966,"AS Monaco","RC Lens","2-1",2,1,"1",1,3,1,"H"
1967-02-26,1966,"Lille OSC","RC Strasbourg","2-1",2,1,"1",1,3,1,"H"
1967-02-26,1966,"US Valenciennes-Anzin","CS Sedan","0-0",0,0,"1",1,0,0,"D"
1967-02-26,1966,"Stade Reims","Olympique Marseille","1-0",1,0,"1",1,1,1,"H"
1967-02-26,1966,"Toulouse FC","OGC Nice","3-0",3,0,"1",1,3,3,"H"
1967-02-26,1966,"Nimes Olympique","Olympique Lyon","1-0",1,0,"1",1,1,1,"H"
1967-03-04,1966,"CS Sedan","AS Saint-Etienne","1-0",1,0,"1",1,1,1,"H"
1967-03-04,1966,"FC Nantes","Stade de Paris FC","3-0",3,0,"1",1,3,3,"H"
1967-03-05,1966,"Olympique Marseille","Angers SCO","1-1",1,1,"1",1,2,0,"D"
1967-03-05,1966,"Olympique Lyon","Lille OSC","0-1",0,1,"1",1,1,-1,"D"
1967-03-05,1966,"Girondins Bordeaux","OGC Nice","1-1",1,1,"1",1,2,0,"D"
1967-03-05,1966,"RC Lens","FC Sochaux","1-1",1,1,"1",1,2,0,"D"
1967-03-05,1966,"RC Strasbourg","Stade Reims","5-0",5,0,"1",1,5,5,"H"
1967-03-05,1966,"AS Monaco","US Valenciennes-Anzin","2-2",2,2,"1",1,4,0,"D"
1967-03-05,1966,"Stade Rennes","Nimes Olympique","3-0",3,0,"1",1,3,3,"H"
1967-03-05,1966,"FC Rouen","Toulouse FC","0-2",0,2,"1",1,2,-2,"D"
1967-03-17,1966,"Toulouse FC","Olympique Marseille","1-0",1,0,"1",1,1,1,"H"
1967-03-18,1966,"FC Sochaux","RC Strasbourg","1-0",1,0,"1",1,1,1,"H"
1967-03-19,1966,"AS Saint-Etienne","Olympique Lyon","2-1",2,1,"1",1,3,1,"H"
1967-03-19,1966,"US Valenciennes-Anzin","FC Nantes","0-0",0,0,"1",1,0,0,"D"
1967-03-19,1966,"Angers SCO","Stade Rennes","0-0",0,0,"1",1,0,0,"D"
1967-03-19,1966,"Lille OSC","RC Lens","2-1",2,1,"1",1,3,1,"H"
1967-03-19,1966,"Nimes Olympique","Girondins Bordeaux","1-2",1,2,"1",1,3,-1,"D"
1967-03-19,1966,"Stade Reims","CS Sedan","1-4",1,4,"1",1,5,-3,"D"
1967-03-19,1966,"OGC Nice","FC Rouen","2-0",2,0,"1",1,2,2,"H"
1967-03-19,1966,"Stade de Paris FC","AS Monaco","1-1",1,1,"1",1,2,0,"D"
1967-03-23,1966,"RC Strasbourg","Toulouse FC","4-0",4,0,"1",1,4,4,"H"
1967-03-24,1966,"Girondins Bordeaux","Stade Reims","1-0",1,0,"1",1,1,1,"H"
1967-03-24,1966,"US Valenciennes-Anzin","Stade de Paris FC","2-0",2,0,"1",1,2,2,"H"
1967-03-25,1966,"FC Nantes","AS Saint-Etienne","4-1",4,1,"1",1,5,3,"H"
1967-03-25,1966,"Olympique Lyon","Angers SCO","1-1",1,1,"1",1,2,0,"D"
1967-03-25,1966,"CS Sedan","Lille OSC","4-1",4,1,"1",1,5,3,"H"
1967-03-25,1966,"RC Lens","Nimes Olympique","2-1",2,1,"1",1,3,1,"H"
1967-03-25,1966,"Olympique Marseille","OGC Nice","1-1",1,1,"1",1,2,0,"D"
1967-03-25,1966,"Stade Rennes","FC Rouen","2-1",2,1,"1",1,3,1,"H"
1967-03-26,1966,"AS Monaco","FC Sochaux","3-0",3,0,"1",1,3,3,"H"
1967-04-05,1966,"Olympique Lyon","AS Monaco","1-0",1,0,"1",1,1,1,"H"
1967-04-07,1966,"OGC Nice","RC Strasbourg","2-1",2,1,"1",1,3,1,"H"
1967-04-08,1966,"AS Saint-Etienne","RC Lens","4-0",4,0,"1",1,4,4,"H"
1967-04-08,1966,"Stade Reims","FC Nantes","1-1",1,1,"1",1,2,0,"D"
1967-04-08,1966,"Lille OSC","Girondins Bordeaux","1-2",1,2,"1",1,3,-1,"D"
1967-04-08,1966,"Nimes Olympique","CS Sedan","2-2",2,2,"1",1,4,0,"D"
1967-04-08,1966,"FC Sochaux","US Valenciennes-Anzin","0-1",0,1,"1",1,1,-1,"D"
1967-04-08,1966,"FC Rouen","Olympique Marseille","5-1",5,1,"1",1,6,4,"H"
1967-04-08,1966,"Toulouse FC","Olympique Lyon","2-2",2,2,"1",1,4,0,"D"
1967-04-09,1966,"Angers SCO","AS Monaco","0-0",0,0,"1",1,0,0,"D"
1967-04-09,1966,"Stade de Paris FC","Stade Rennes","0-2",0,2,"1",1,2,-2,"D"
1967-04-14,1966,"Olympique Lyon","OGC Nice","1-0",1,0,"1",1,1,1,"H"
1967-04-15,1966,"FC Nantes","Lille OSC","4-0",4,0,"1",1,4,4,"H"
1967-04-15,1966,"Girondins Bordeaux","Toulouse FC","2-1",2,1,"1",1,3,1,"H"
1967-04-15,1966,"RC Lens","FC Rouen","1-1",1,1,"1",1,2,0,"D"
1967-04-15,1966,"Stade Rennes","Stade Reims","3-0",3,0,"1",1,3,3,"H"
1967-04-15,1966,"AS Monaco","Nimes Olympique","0-1",0,1,"1",1,1,-1,"D"
1967-04-16,1966,"US Valenciennes-Anzin","AS Saint-Etienne","0-3",0,3,"1",1,3,-3,"D"
1967-04-16,1966,"CS Sedan","Angers SCO","1-1",1,1,"1",1,2,0,"D"
1967-04-16,1966,"RC Strasbourg","Olympique Marseille","2-1",2,1,"1",1,3,1,"H"
1967-04-16,1966,"Stade de Paris FC","FC Sochaux","0-3",0,3,"1",1,3,-3,"D"
1967-04-22,1966,"RC Lens","Toulouse FC","0-0",0,0,"1",1,0,0,"D"
1967-04-23,1966,"Stade de Paris FC","Olympique Marseille","0-2",0,2,"1",1,2,-2,"D"
1967-04-23,1966,"FC Nantes","AS Monaco","2-1",2,1,"1",1,3,1,"H"
1967-04-25,1966,"FC Rouen","FC Sochaux","3-0",3,0,"1",1,3,3,"H"
1967-04-28,1966,"AS Saint-Etienne","Stade de Paris FC","7-1",7,1,"1",1,8,6,"H"
1967-04-28,1966,"Toulouse FC","CS Sedan","2-3",2,3,"1",1,5,-1,"D"
1967-04-28,1966,"Lille OSC","AS Monaco","2-1",2,1,"1",1,3,1,"H"
1967-04-28,1966,"OGC Nice","RC Lens","1-0",1,0,"1",1,1,1,"H"
1967-04-28,1966,"Olympique Marseille","Olympique Lyon","4-1",4,1,"1",1,5,3,"H"
1967-04-29,1966,"Nimes Olympique","FC Nantes","1-0",1,0,"1",1,1,1,"H"
1967-04-29,1966,"Angers SCO","Girondins Bordeaux","2-0",2,0,"1",1,2,2,"H"
1967-04-29,1966,"FC Rouen","RC Strasbourg","0-0",0,0,"1",1,0,0,"D"
1967-04-29,1966,"Stade Reims","US Valenciennes-Anzin","1-0",1,0,"1",1,1,1,"H"
1967-05-03,1966,"FC Sochaux","AS Saint-Etienne","0-3",0,3,"1",1,3,-3,"D"
1967-05-03,1966,"FC Nantes","Angers SCO","2-1",2,1,"1",1,3,1,"H"
1967-05-03,1966,"Girondins Bordeaux","RC Strasbourg","4-1",4,1,"1",1,5,3,"H"
1967-05-03,1966,"CS Sedan","OGC Nice","0-1",0,1,"1",1,1,-1,"D"
1967-05-03,1966,"RC Lens","Olympique Marseille","2-2",2,2,"1",1,4,0,"D"
1967-05-03,1966,"Stade Rennes","Toulouse FC","1-2",1,2,"1",1,3,-1,"D"
1967-05-03,1966,"Stade de Paris FC","Nimes Olympique","1-2",1,2,"1",1,3,-1,"D"
1967-05-03,1966,"AS Monaco","Stade Reims","5-0",5,0,"1",1,5,5,"H"
1967-05-04,1966,"US Valenciennes-Anzin","Lille OSC","3-0",3,0,"1",1,3,3,"H"
1967-05-06,1966,"Toulouse FC","FC Nantes","2-2",2,2,"1",1,4,0,"D"
1967-05-06,1966,"Olympique Marseille","Girondins Bordeaux","3-2",3,2,"1",1,5,1,"H"
1967-05-06,1966,"Angers SCO","RC Lens","2-0",2,0,"1",1,2,2,"H"
1967-05-06,1966,"FC Rouen","CS Sedan","3-0",3,0,"1",1,3,3,"H"
1967-05-06,1966,"Nimes Olympique","US Valenciennes-Anzin","1-2",1,2,"1",1,3,-1,"D"
1967-05-06,1966,"Lille OSC","Stade de Paris FC","0-0",0,0,"1",1,0,0,"D"
1967-05-06,1966,"RC Strasbourg","Olympique Lyon","0-0",0,0,"1",1,0,0,"D"
1967-05-06,1966,"Stade Reims","FC Sochaux","1-1",1,1,"1",1,2,0,"D"
1967-05-07,1966,"AS Saint-Etienne","AS Monaco","1-3",1,3,"1",1,4,-2,"D"
1967-05-07,1966,"OGC Nice","Stade Rennes","4-0",4,0,"1",1,4,4,"H"
1967-05-12,1966,"Girondins Bordeaux","FC Rouen","3-0",3,0,"1",1,3,3,"H"
1967-05-12,1966,"US Valenciennes-Anzin","Angers SCO","0-0",0,0,"1",1,0,0,"D"
1967-05-12,1966,"FC Sochaux","Lille OSC","1-0",1,0,"1",1,1,1,"H"
1967-05-13,1966,"Nimes Olympique","AS Saint-Etienne","1-1",1,1,"1",1,2,0,"D"
1967-05-13,1966,"FC Nantes","OGC Nice","4-1",4,1,"1",1,5,3,"H"
1967-05-13,1966,"CS Sedan","Olympique Marseille","0-0",0,0,"1",1,0,0,"D"
1967-05-13,1966,"RC Lens","RC Strasbourg","2-1",2,1,"1",1,3,1,"H"
1967-05-13,1966,"Stade Rennes","Olympique Lyon","4-0",4,0,"1",1,4,4,"H"
1967-05-13,1966,"AS Monaco","Toulouse FC","1-0",1,0,"1",1,1,1,"H"
1967-05-14,1966,"Stade de Paris FC","Stade Reims","0-1",0,1,"1",1,1,-1,"D"
1967-05-19,1966,"Toulouse FC","US Valenciennes-Anzin","0-2",0,2,"1",1,2,-2,"D"
1967-05-19,1966,"Olympique Marseille","Stade Rennes","1-1",1,1,"1",1,2,0,"D"
1967-05-19,1966,"Stade Reims","RC Lens","4-0",4,0,"1",1,4,4,"H"
1967-05-20,1966,"Lille OSC","AS Saint-Etienne","0-1",0,1,"1",1,1,-1,"D"
1967-05-20,1966,"FC Rouen","FC Nantes","3-3",3,3,"1",1,6,0,"D"
1967-05-20,1966,"Angers SCO","Stade de Paris FC","1-1",1,1,"1",1,2,0,"D"
1967-05-20,1966,"RC Strasbourg","CS Sedan","0-0",0,0,"1",1,0,0,"D"
1967-05-21,1966,"OGC Nice","AS Monaco","0-0",0,0,"1",1,0,0,"D"
1967-05-24,1966,"Nimes Olympique","FC Sochaux","3-0",3,0,"1",1,3,3,"H"
1967-05-24,1966,"Olympique Lyon","Girondins Bordeaux","1-0",1,0,"1",1,1,1,"H"
1967-05-27,1966,"RC Lens","Girondins Bordeaux","3-2",3,2,"1",1,5,1,"H"
1967-05-27,1966,"Stade Rennes","RC Strasbourg","4-3",4,3,"1",1,7,1,"H"
1967-05-28,1966,"AS Saint-Etienne","Stade Reims","3-0",3,0,"1",1,3,3,"H"
1967-05-28,1966,"FC Nantes","Olympique Marseille","3-3",3,3,"1",1,6,0,"D"
1967-05-28,1966,"FC Sochaux","Angers SCO","2-5",2,5,"1",1,7,-3,"D"
1967-05-28,1966,"CS Sedan","Olympique Lyon","0-0",0,0,"1",1,0,0,"D"
1967-05-28,1966,"US Valenciennes-Anzin","OGC Nice","0-1",0,1,"1",1,1,-1,"D"
1967-05-28,1966,"Nimes Olympique","Lille OSC","0-0",0,0,"1",1,0,0,"D"
1967-05-28,1966,"AS Monaco","FC Rouen","0-0",0,0,"1",1,0,0,"D"
1967-05-28,1966,"Stade de Paris FC","Toulouse FC","0-0",0,0,"1",1,0,0,"D"
1967-06-02,1966,"Olympique Lyon","FC Rouen","1-1",1,1,"1",1,2,0,"D"
1967-06-07,1966,"FC Sochaux","Stade Rennes","3-1",3,1,"1",1,4,2,"H"
1967-06-09,1966,"OGC Nice","Stade de Paris FC","0-0",0,0,"1",1,0,0,"D"
1967-06-10,1966,"RC Strasbourg","FC Nantes","1-1",1,1,"1",1,2,0,"D"
1967-06-10,1966,"Girondins Bordeaux","CS Sedan","2-5",2,5,"1",1,7,-3,"D"
1967-06-10,1966,"FC Rouen","US Valenciennes-Anzin","1-1",1,1,"1",1,2,0,"D"
1967-06-10,1966,"Olympique Lyon","RC Lens","0-0",0,0,"1",1,0,0,"D"
1967-06-10,1966,"Olympique Marseille","AS Monaco","1-2",1,2,"1",1,3,-1,"D"
1967-06-10,1966,"Lille OSC","Stade Rennes","0-0",0,0,"1",1,0,0,"D"
1967-06-10,1966,"Toulouse FC","FC Sochaux","1-2",1,2,"1",1,3,-1,"D"
1967-06-10,1966,"Stade Reims","Nimes Olympique","1-1",1,1,"1",1,2,0,"D"
1967-06-11,1966,"Angers SCO","AS Saint-Etienne","0-3",0,3,"1",1,3,-3,"D"
1967-08-17,1967,"Olympique Marseille","FC Nantes","1-0",1,0,"1",1,1,1,"H"
1967-08-18,1967,"Olympique Lyon","AC Ajaccio","2-1",2,1,"1",1,3,1,"H"
1967-08-18,1967,"RC Strasbourg","AS Saint-Etienne","0-1",0,1,"1",1,1,-1,"D"
1967-08-18,1967,"Lille OSC","AS Aixoise","2-1",2,1,"1",1,3,1,"H"
1967-08-19,1967,"Angers SCO","FC Rouen","3-0",3,0,"1",1,3,3,"H"
1967-08-19,1967,"FC Sochaux","OGC Nice","0-2",0,2,"1",1,2,-2,"D"
1967-08-19,1967,"Stade Rennes","RC Lens","1-0",1,0,"1",1,1,1,"H"
1967-08-19,1967,"CS Sedan","US Valenciennes-Anzin","1-1",1,1,"1",1,2,0,"D"
1967-08-19,1967,"FC Metz","Red Star FC","1-1",1,1,"1",1,2,0,"D"
1967-08-20,1967,"AS Monaco","Girondins Bordeaux","1-2",1,2,"1",1,3,-1,"D"
1967-08-24,1967,"Lille OSC","Olympique Lyon","1-1",1,1,"1",1,2,0,"D"
1967-08-25,1967,"AS Saint-Etienne","RC Lens","3-0",3,0,"1",1,3,3,"H"
1967-08-25,1967,"OGC Nice","CS Sedan","1-0",1,0,"1",1,1,1,"H"
1967-08-25,1967,"Girondins Bordeaux","Olympique Marseille","1-2",1,2,"1",1,3,-1,"D"
1967-08-25,1967,"AS Aixoise","Angers SCO","1-3",1,3,"1",1,4,-2,"D"
1967-08-26,1967,"US Valenciennes-Anzin","FC Metz","1-2",1,2,"1",1,3,-1,"D"
1967-08-26,1967,"FC Nantes","RC Strasbourg","3-0",3,0,"1",1,3,3,"H"
1967-08-26,1967,"FC Rouen","FC Sochaux","1-0",1,0,"1",1,1,1,"H"
1967-08-27,1967,"AC Ajaccio","Stade Rennes","2-0",2,0,"1",1,2,2,"H"
1967-08-27,1967,"Red Star FC","AS Monaco","2-0",2,0,"1",1,2,2,"H"
1967-08-30,1967,"Angers SCO","AC Ajaccio","3-0",3,0,"1",1,3,3,"H"
1967-08-30,1967,"AS Saint-Etienne","Girondins Bordeaux","1-0",1,0,"1",1,1,1,"H"
1967-08-30,1967,"Olympique Marseille","OGC Nice","0-2",0,2,"1",1,2,-2,"D"
1967-08-30,1967,"RC Lens","FC Nantes","1-3",1,3,"1",1,4,-2,"D"
1967-08-30,1967,"CS Sedan","Lille OSC","1-1",1,1,"1",1,2,0,"D"
1967-08-30,1967,"FC Metz","FC Rouen","1-1",1,1,"1",1,2,0,"D"
1967-08-30,1967,"Stade Rennes","Olympique Lyon","1-0",1,0,"1",1,1,1,"H"
1967-08-30,1967,"RC Strasbourg","Red Star FC","2-1",2,1,"1",1,3,1,"H"
1967-08-30,1967,"AS Monaco","US Valenciennes-Anzin","0-1",0,1,"1",1,1,-1,"D"
1967-08-30,1967,"FC Sochaux","AS Aixoise","1-1",1,1,"1",1,2,0,"D"
1967-09-02,1967,"FC Nantes","AS Saint-Etienne","1-1",1,1,"1",1,2,0,"D"
1967-09-02,1967,"Lille OSC","Stade Rennes","2-0",2,0,"1",1,2,2,"H"
1967-09-02,1967,"Olympique Lyon","Angers SCO","8-0",8,0,"1",1,8,8,"H"
1967-09-02,1967,"Girondins Bordeaux","RC Lens","6-1",6,1,"1",1,7,5,"H"
1967-09-02,1967,"US Valenciennes-Anzin","RC Strasbourg","0-1",0,1,"1",1,1,-1,"D"
1967-09-02,1967,"FC Rouen","CS Sedan","0-0",0,0,"1",1,0,0,"D"
1967-09-02,1967,"AS Aixoise","AS Monaco","0-0",0,0,"1",1,0,0,"D"
1967-09-03,1967,"OGC Nice","FC Metz","4-1",4,1,"1",1,5,3,"H"
1967-09-03,1967,"Red Star FC","Olympique Marseille","2-0",2,0,"1",1,2,2,"H"
1967-09-03,1967,"AC Ajaccio","FC Sochaux","1-1",1,1,"1",1,2,0,"D"
1967-09-08,1967,"AS Saint-Etienne","Red Star FC","1-1",1,1,"1",1,2,0,"D"
1967-09-08,1967,"Olympique Marseille","Lille OSC","0-0",0,0,"1",1,0,0,"D"
1967-09-08,1967,"RC Strasbourg","Girondins Bordeaux","0-1",0,1,"1",1,1,-1,"D"
1967-09-09,1967,"FC Nantes","FC Rouen","0-0",0,0,"1",1,0,0,"D"
1967-09-09,1967,"FC Metz","AS Aixoise","3-1",3,1,"1",1,4,2,"H"
1967-09-09,1967,"FC Sochaux","Olympique Lyon","3-1",3,1,"1",1,4,2,"H"
1967-09-09,1967,"CS Sedan","AC Ajaccio","2-0",2,0,"1",1,2,2,"H"
1967-09-10,1967,"AS Monaco","OGC Nice","2-2",2,2,"1",1,4,0,"D"
1967-09-10,1967,"Angers SCO","Stade Rennes","1-1",1,1,"1",1,2,0,"D"
1967-09-10,1967,"RC Lens","US Valenciennes-Anzin","1-0",1,0,"1",1,1,1,"H"
1967-09-22,1967,"Lille OSC","Angers SCO","2-1",2,1,"1",1,3,1,"H"
1967-09-23,1967,"Girondins Bordeaux","FC Nantes","6-2",6,2,"1",1,8,4,"H"
1967-09-23,1967,"FC Rouen","Olympique Marseille","1-2",1,2,"1",1,3,-1,"D"
1967-09-23,1967,"Stade Rennes","FC Sochaux","1-1",1,1,"1",1,2,0,"D"
1967-09-23,1967,"Olympique Lyon","AS Monaco","1-2",1,2,"1",1,3,-1,"D"
1967-09-24,1967,"OGC Nice","RC Strasbourg","2-0",2,0,"1",1,2,2,"H"
1967-09-24,1967,"US Valenciennes-Anzin","AS Saint-Etienne","1-2",1,2,"1",1,3,-1,"D"
1967-09-24,1967,"Red Star FC","RC Lens","3-2",3,2,"1",1,5,1,"H"
1967-09-24,1967,"AC Ajaccio","FC Metz","2-1",2,1,"1",1,3,1,"H"
1967-09-24,1967,"AS Aixoise","CS Sedan","4-2",4,2,"1",1,6,2,"H"
1967-09-30,1967,"RC Lens","OGC Nice","0-0",0,0,"1",1,0,0,"D"
1967-09-30,1967,"AS Saint-Etienne","AS Aixoise","3-1",3,1,"1",1,4,2,"H"
1967-09-30,1967,"Girondins Bordeaux","Lille OSC","2-1",2,1,"1",1,3,1,"H"
1967-09-30,1967,"FC Nantes","Red Star FC","4-2",4,2,"1",1,6,2,"H"
1967-09-30,1967,"FC Metz","Olympique Lyon","3-1",3,1,"1",1,4,2,"H"
1967-09-30,1967,"CS Sedan","Stade Rennes","3-0",3,0,"1",1,3,3,"H"
1967-09-30,1967,"FC Sochaux","Angers SCO","2-0",2,0,"1",1,2,2,"H"
1967-09-30,1967,"AS Monaco","AC Ajaccio","0-1",0,1,"1",1,1,-1,"D"
1967-10-01,1967,"Olympique Marseille","US Valenciennes-Anzin","2-0",2,0,"1",1,2,2,"H"
1967-10-04,1967,"Red Star FC","Girondins Bordeaux","1-0",1,0,"1",1,1,1,"H"
1967-10-04,1967,"AC Ajaccio","Olympique Marseille","2-2",2,2,"1",1,4,0,"D"
1967-10-04,1967,"Lille OSC","FC Sochaux","0-1",0,1,"1",1,1,-1,"D"
1967-10-04,1967,"Stade Rennes","FC Metz","0-0",0,0,"1",1,0,0,"D"
1967-10-04,1967,"Angers SCO","AS Monaco","3-0",3,0,"1",1,3,3,"H"
1967-10-04,1967,"US Valenciennes-Anzin","FC Nantes","2-1",2,1,"1",1,3,1,"H"
1967-10-04,1967,"AS Aixoise","RC Strasbourg","0-3",0,3,"1",1,3,-3,"D"
1967-10-04,1967,"FC Rouen","RC Lens","0-1",0,1,"1",1,1,-1,"D"
1967-10-07,1967,"FC Nantes","OGC Nice","0-0",0,0,"1",1,0,0,"D"
1967-10-07,1967,"Olympique Marseille","Olympique Lyon","2-1",2,1,"1",1,3,1,"H"
1967-10-07,1967,"FC Metz","Angers SCO","1-1",1,1,"1",1,2,0,"D"
1967-10-07,1967,"RC Strasbourg","Stade Rennes","1-1",1,1,"1",1,2,0,"D"
1967-10-08,1967,"AS Saint-Etienne","FC Rouen","3-0",3,0,"1",1,3,3,"H"
1967-10-08,1967,"Red Star FC","AC Ajaccio","4-1",4,1,"1",1,5,3,"H"
1967-10-08,1967,"Girondins Bordeaux","US Valenciennes-Anzin","0-1",0,1,"1",1,1,-1,"D"
1967-10-08,1967,"CS Sedan","FC Sochaux","2-0",2,0,"1",1,2,2,"H"
1967-10-08,1967,"AS Monaco","Lille OSC","3-1",3,1,"1",1,4,2,"H"
1967-10-08,1967,"RC Lens","AS Aixoise","4-1",4,1,"1",1,5,3,"H"
1967-10-13,1967,"Lille OSC","RC Lens","0-1",0,1,"1",1,1,-1,"D"
1967-10-14,1967,"FC Sochaux","FC Metz","3-2",3,2,"1",1,5,1,"H"
1967-10-14,1967,"FC Rouen","AS Monaco","2-1",2,1,"1",1,3,1,"H"
1967-10-15,1967,"Olympique Lyon","AS Saint-Etienne","1-1",1,1,"1",1,2,0,"D"
1967-10-15,1967,"OGC Nice","Girondins Bordeaux","1-1",1,1,"1",1,2,0,"D"
1967-10-15,1967,"AS Aixoise","Olympique Marseille","1-2",1,2,"1",1,3,-1,"D"
1967-10-15,1967,"US Valenciennes-Anzin","Red Star FC","1-0",1,0,"1",1,1,1,"H"
1967-10-15,1967,"Angers SCO","CS Sedan","2-3",2,3,"1",1,5,-1,"D"
1967-10-15,1967,"Stade Rennes","FC Nantes","1-1",1,1,"1",1,2,0,"D"
1967-10-15,1967,"AC Ajaccio","RC Strasbourg","1-0",1,0,"1",1,1,1,"H"
1967-10-21,1967,"FC Rouen","Red Star FC","0-2",0,2,"1",1,2,-2,"D"
1967-10-21,1967,"Stade Rennes","Olympique Marseille","3-1",3,1,"1",1,4,2,"H"
1967-10-21,1967,"FC Sochaux","FC Nantes","1-0",1,0,"1",1,1,1,"H"
1967-10-21,1967,"Lille OSC","FC Metz","0-0",0,0,"1",1,0,0,"D"
1967-10-22,1967,"OGC Nice","US Valenciennes-Anzin","2-1",2,1,"1",1,3,1,"H"
1967-10-22,1967,"Angers SCO","AS Saint-Etienne","1-0",1,0,"1",1,1,1,"H"
1967-10-22,1967,"CS Sedan","AS Monaco","3-0",3,0,"1",1,3,3,"H"
1967-10-22,1967,"AC Ajaccio","RC Lens","2-0",2,0,"1",1,2,2,"H"
1967-10-22,1967,"AS Aixoise","Girondins Bordeaux","5-1",5,1,"1",1,6,4,"H"
1967-10-22,1967,"Olympique Lyon","RC Strasbourg","0-0",0,0,"1",1,0,0,"D"
1967-10-25,1967,"RC Strasbourg","FC Rouen","2-1",2,1,"1",1,3,1,"H"
1967-11-01,1967,"OGC Nice","FC Rouen","4-0",4,0,"1",1,4,4,"H"
1967-11-01,1967,"AS Saint-Etienne","Stade Rennes","3-0",3,0,"1",1,3,3,"H"
1967-11-01,1967,"Red Star FC","AS Aixoise","2-1",2,1,"1",1,3,1,"H"
1967-11-01,1967,"Olympique Marseille","CS Sedan","1-0",1,0,"1",1,1,1,"H"
1967-11-01,1967,"RC Strasbourg","FC Sochaux","1-4",1,4,"1",1,5,-3,"D"
1967-11-01,1967,"Girondins Bordeaux","AC Ajaccio","3-0",3,0,"1",1,3,3,"H"
1967-11-01,1967,"FC Nantes","Olympique Lyon","1-0",1,0,"1",1,1,1,"H"
1967-11-01,1967,"RC Lens","Angers SCO","4-2",4,2,"1",1,6,2,"H"
1967-11-01,1967,"US Valenciennes-Anzin","Lille OSC","3-0",3,0,"1",1,3,3,"H"
1967-11-01,1967,"AS Monaco","FC Metz","3-1",3,1,"1",1,4,2,"H"
1967-11-05,1967,"AS Aixoise","OGC Nice","3-1",3,1,"1",1,4,2,"H"
1967-11-05,1967,"CS Sedan","AS Saint-Etienne","5-2",5,2,"1",1,7,3,"H"
1967-11-05,1967,"Lille OSC","Red Star FC","1-1",1,1,"1",1,2,0,"D"
1967-11-05,1967,"FC Sochaux","RC Lens","4-1",4,1,"1",1,5,3,"H"
1967-11-05,1967,"FC Metz","Olympique Marseille","3-0",3,0,"1",1,3,3,"H"
1967-11-05,1967,"Angers SCO","RC Strasbourg","1-0",1,0,"1",1,1,1,"H"
1967-11-05,1967,"AC Ajaccio","FC Nantes","5-3",5,3,"1",1,8,2,"H"
1967-11-05,1967,"Olympique Lyon","Girondins Bordeaux","2-0",2,0,"1",1,2,2,"H"
1967-11-05,1967,"FC Rouen","US Valenciennes-Anzin","1-2",1,2,"1",1,3,-1,"D"
1967-11-05,1967,"Stade Rennes","AS Monaco","1-1",1,1,"1",1,2,0,"D"
1967-11-08,1967,"Olympique Lyon","CS Sedan","0-2",0,2,"1",1,2,-2,"D"
1967-11-11,1967,"AS Saint-Etienne","FC Sochaux","2-0",2,0,"1",1,2,2,"H"
1967-11-11,1967,"Olympique Marseille","AS Monaco","2-1",2,1,"1",1,3,1,"H"
1967-11-11,1967,"RC Lens","CS Sedan","3-0",3,0,"1",1,3,3,"H"
1967-11-11,1967,"FC Nantes","Angers SCO","0-1",0,1,"1",1,1,-1,"D"
1967-11-11,1967,"RC Strasbourg","FC Metz","0-0",0,0,"1",1,0,0,"D"
1967-11-12,1967,"OGC Nice","Lille OSC","3-1",3,1,"1",1,4,2,"H"
1967-11-12,1967,"Red Star FC","Olympique Lyon","1-1",1,1,"1",1,2,0,"D"
1967-11-12,1967,"Girondins Bordeaux","Stade Rennes","6-2",6,2,"1",1,8,4,"H"
1967-11-12,1967,"US Valenciennes-Anzin","AS Aixoise","1-0",1,0,"1",1,1,1,"H"
1967-11-12,1967,"FC Rouen","AC Ajaccio","3-1",3,1,"1",1,4,2,"H"
1967-11-18,1967,"FC Sochaux","Olympique Marseille","1-1",1,1,"1",1,2,0,"D"
1967-11-19,1967,"AS Monaco","AS Saint-Etienne","0-3",0,3,"1",1,3,-3,"D"
1967-11-19,1967,"AC Ajaccio","OGC Nice","2-1",2,1,"1",1,3,1,"H"
1967-11-19,1967,"CS Sedan","RC Strasbourg","3-1",3,1,"1",1,4,2,"H"
1967-11-19,1967,"Stade Rennes","Red Star FC","3-0",3,0,"1",1,3,3,"H"
1967-11-19,1967,"Angers SCO","Girondins Bordeaux","0-0",0,0,"1",1,0,0,"D"
1967-11-19,1967,"FC Metz","RC Lens","2-1",2,1,"1",1,3,1,"H"
1967-11-19,1967,"Olympique Lyon","US Valenciennes-Anzin","0-0",0,0,"1",1,0,0,"D"
1967-11-19,1967,"Lille OSC","FC Nantes","2-0",2,0,"1",1,2,2,"H"
1967-11-19,1967,"AS Aixoise","FC Rouen","4-1",4,1,"1",1,5,3,"H"
1967-11-25,1967,"AS Saint-Etienne","FC Metz","4-0",4,0,"1",1,4,4,"H"
1967-11-26,1967,"FC Nantes","CS Sedan","1-1",1,1,"1",1,2,0,"D"
1967-11-26,1967,"OGC Nice","Olympique Lyon","0-3",0,3,"1",1,3,-3,"D"
1967-11-26,1967,"Red Star FC","Angers SCO","3-3",3,3,"1",1,6,0,"D"
1967-11-26,1967,"RC Strasbourg","Olympique Marseille","1-0",1,0,"1",1,1,1,"H"
1967-11-26,1967,"Girondins Bordeaux","FC Sochaux","3-0",3,0,"1",1,3,3,"H"
1967-11-26,1967,"US Valenciennes-Anzin","AC Ajaccio","0-0",0,0,"1",1,0,0,"D"
1967-11-26,1967,"AS Aixoise","Stade Rennes","2-3",2,3,"1",1,5,-1,"D"
1967-11-26,1967,"FC Rouen","Lille OSC","1-0",1,0,"1",1,1,1,"H"
1967-11-26,1967,"RC Lens","AS Monaco","1-3",1,3,"1",1,4,-2,"D"
1967-12-03,1967,"AS Saint-Etienne","AC Ajaccio","4-0",4,0,"1",1,4,4,"H"
1967-12-03,1967,"FC Metz","CS Sedan","1-5",1,5,"1",1,6,-4,"D"
1967-12-03,1967,"Red Star FC","OGC Nice","1-1",1,1,"1",1,2,0,"D"
1967-12-03,1967,"Olympique Marseille","Angers SCO","3-1",3,1,"1",1,4,2,"H"
1967-12-03,1967,"Girondins Bordeaux","FC Rouen","1-0",1,0,"1",1,1,1,"H"
1967-12-03,1967,"US Valenciennes-Anzin","Stade Rennes","2-1",2,1,"1",1,3,1,"H"
1967-12-03,1967,"AS Monaco","FC Sochaux","1-0",1,0,"1",1,1,1,"H"
1967-12-03,1967,"FC Nantes","AS Aixoise","5-1",5,1,"1",1,6,4,"H"
1967-12-03,1967,"RC Strasbourg","Lille OSC","2-0",2,0,"1",1,2,2,"H"
1967-12-03,1967,"RC Lens","Olympique Lyon","1-0",1,0,"1",1,1,1,"H"
1967-12-09,1967,"FC Sochaux","Red Star FC","1-0",1,0,"1",1,1,1,"H"
1967-12-10,1967,"Lille OSC","AS Saint-Etienne","2-2",2,2,"1",1,4,0,"D"
1967-12-10,1967,"Olympique Marseille","RC Lens","2-0",2,0,"1",1,2,2,"H"
1967-12-10,1967,"CS Sedan","Girondins Bordeaux","1-2",1,2,"1",1,3,-1,"D"
1967-12-10,1967,"Stade Rennes","OGC Nice","4-0",4,0,"1",1,4,4,"H"
1967-12-10,1967,"AC Ajaccio","AS Aixoise","8-2",8,2,"1",1,10,6,"H"
1967-12-10,1967,"FC Metz","FC Nantes","1-1",1,1,"1",1,2,0,"D"
1967-12-10,1967,"Olympique Lyon","FC Rouen","2-1",2,1,"1",1,3,1,"H"
1967-12-10,1967,"AS Monaco","RC Strasbourg","2-1",2,1,"1",1,3,1,"H"
1967-12-13,1967,"OGC Nice","AS Saint-Etienne","1-2",1,2,"1",1,3,-1,"D"
1967-12-17,1967,"AS Saint-Etienne","Olympique Marseille","2-0",2,0,"1",1,2,2,"H"
1967-12-17,1967,"Girondins Bordeaux","FC Metz","1-0",1,0,"1",1,1,1,"H"
1967-12-17,1967,"OGC Nice","Angers SCO","2-1",2,1,"1",1,3,1,"H"
1967-12-17,1967,"Red Star FC","CS Sedan","3-0",3,0,"1",1,3,3,"H"
1967-12-17,1967,"US Valenciennes-Anzin","FC Sochaux","0-0",0,0,"1",1,0,0,"D"
1967-12-17,1967,"AC Ajaccio","Lille OSC","2-1",2,1,"1",1,3,1,"H"
1967-12-17,1967,"FC Nantes","AS Monaco","0-0",0,0,"1",1,0,0,"D"
1967-12-17,1967,"RC Lens","RC Strasbourg","1-0",1,0,"1",1,1,1,"H"
1967-12-17,1967,"AS Aixoise","Olympique Lyon","2-0",2,0,"1",1,2,2,"H"
1968-01-07,1967,"Girondins Bordeaux","AS Saint-Etienne","1-2",1,2,"1",1,3,-1,"D"
1968-01-07,1967,"OGC Nice","Olympique Marseille","1-1",1,1,"1",1,2,0,"D"
1968-01-07,1967,"AC Ajaccio","Angers SCO","4-0",4,0,"1",1,4,4,"H"
1968-01-07,1967,"Lille OSC","CS Sedan","2-0",2,0,"1",1,2,2,"H"
1968-01-07,1967,"Red Star FC","RC Strasbourg","0-1",0,1,"1",1,1,-1,"D"
1968-01-07,1967,"AS Aixoise","FC Sochaux","0-0",0,0,"1",1,0,0,"D"
1968-01-07,1967,"FC Nantes","RC Lens","1-0",1,0,"1",1,1,1,"H"
1968-01-07,1967,"Olympique Lyon","Stade Rennes","2-1",2,1,"1",1,3,1,"H"
1968-01-07,1967,"FC Rouen","FC Metz","0-0",0,0,"1",1,0,0,"D"
1968-01-21,1967,"AS Saint-Etienne","FC Nantes","1-2",1,2,"1",1,3,-1,"D"
1968-01-21,1967,"Olympique Marseille","Red Star FC","2-0",2,0,"1",1,2,2,"H"
1968-01-21,1967,"CS Sedan","FC Rouen","2-0",2,0,"1",1,2,2,"H"
1968-01-21,1967,"FC Sochaux","AC Ajaccio","3-1",3,1,"1",1,4,2,"H"
1968-01-21,1967,"RC Strasbourg","US Valenciennes-Anzin","0-1",0,1,"1",1,1,-1,"D"
1968-01-21,1967,"Stade Rennes","Lille OSC","4-1",4,1,"1",1,5,3,"H"
1968-01-21,1967,"Angers SCO","Olympique Lyon","3-1",3,1,"1",1,4,2,"H"
1968-01-21,1967,"AS Monaco","AS Aixoise","1-1",1,1,"1",1,2,0,"D"
1968-01-28,1967,"Red Star FC","AS Saint-Etienne","1-1",1,1,"1",1,2,0,"D"
1968-01-28,1967,"Lille OSC","Olympique Marseille","2-0",2,0,"1",1,2,2,"H"
1968-01-28,1967,"Olympique Lyon","FC Sochaux","2-2",2,2,"1",1,4,0,"D"
1968-01-28,1967,"AC Ajaccio","CS Sedan","2-0",2,0,"1",1,2,2,"H"
1968-01-28,1967,"Girondins Bordeaux","RC Strasbourg","1-2",1,2,"1",1,3,-1,"D"
1968-01-28,1967,"OGC Nice","AS Monaco","0-2",0,2,"1",1,2,-2,"D"
1968-01-28,1967,"US Valenciennes-Anzin","RC Lens","1-1",1,1,"1",1,2,0,"D"
1968-01-28,1967,"FC Rouen","FC Nantes","1-2",1,2,"1",1,3,-1,"D"
1968-01-28,1967,"Stade Rennes","Angers SCO","1-1",1,1,"1",1,2,0,"D"
1968-02-03,1967,"FC Sochaux","Stade Rennes","1-2",1,2,"1",1,3,-1,"D"
1968-02-04,1967,"AS Saint-Etienne","US Valenciennes-Anzin","3-0",3,0,"1",1,3,3,"H"
1968-02-04,1967,"Olympique Marseille","FC Rouen","2-2",2,2,"1",1,4,0,"D"
1968-02-04,1967,"CS Sedan","AS Aixoise","3-0",3,0,"1",1,3,3,"H"
1968-02-04,1967,"FC Nantes","Girondins Bordeaux","1-1",1,1,"1",1,2,0,"D"
1968-02-04,1967,"RC Lens","Red Star FC","2-4",2,4,"1",1,6,-2,"D"
1968-02-04,1967,"RC Strasbourg","OGC Nice","0-0",0,0,"1",1,0,0,"D"
1968-02-04,1967,"FC Metz","AC Ajaccio","3-0",3,0,"1",1,3,3,"H"
1968-02-04,1967,"AS Monaco","Olympique Lyon","2-1",2,1,"1",1,3,1,"H"
1968-02-04,1967,"Angers SCO","Lille OSC","1-3",1,3,"1",1,4,-2,"D"
1968-02-17,1967,"AS Aixoise","AS Saint-Etienne","1-1",1,1,"1",1,2,0,"D"
1968-02-17,1967,"Lille OSC","Girondins Bordeaux","1-2",1,2,"1",1,3,-1,"D"
1968-02-17,1967,"Stade Rennes","CS Sedan","1-1",1,1,"1",1,2,0,"D"
1968-02-17,1967,"US Valenciennes-Anzin","Olympique Marseille","1-0",1,0,"1",1,1,1,"H"
1968-02-17,1967,"Angers SCO","FC Sochaux","1-1",1,1,"1",1,2,0,"D"
1968-02-17,1967,"Olympique Lyon","FC Metz","3-1",3,1,"1",1,4,2,"H"
1968-02-17,1967,"OGC Nice","RC Lens","0-0",0,0,"1",1,0,0,"D"
1968-02-17,1967,"Red Star FC","FC Nantes","0-1",0,1,"1",1,1,-1,"D"
1968-02-24,1967,"FC Sochaux","Lille OSC","2-1",2,1,"1",1,3,1,"H"
1968-02-25,1967,"AS Saint-Etienne","OGC Nice","3-1",3,1,"1",1,4,2,"H"
1968-02-25,1967,"Girondins Bordeaux","Red Star FC","1-0",1,0,"1",1,1,1,"H"
1968-02-25,1967,"Olympique Marseille","AC Ajaccio","2-0",2,0,"1",1,2,2,"H"
1968-02-25,1967,"CS Sedan","Olympique Lyon","2-3",2,3,"1",1,5,-1,"D"
1968-02-25,1967,"FC Nantes","US Valenciennes-Anzin","0-2",0,2,"1",1,2,-2,"D"
1968-02-25,1967,"FC Metz","Stade Rennes","6-1",6,1,"1",1,7,5,"H"
1968-02-25,1967,"AS Monaco","Angers SCO","5-0",5,0,"1",1,5,5,"H"
1968-02-25,1967,"RC Strasbourg","AS Aixoise","1-0",1,0,"1",1,1,1,"H"
1968-02-25,1967,"RC Lens","FC Rouen","2-1",2,1,"1",1,3,1,"H"
1968-03-02,1967,"Olympique Lyon","Olympique Marseille","3-2",3,2,"1",1,5,1,"H"
1968-03-03,1967,"FC Rouen","AS Saint-Etienne","3-0",3,0,"1",1,3,3,"H"
1968-03-03,1967,"FC Sochaux","CS Sedan","3-0",3,0,"1",1,3,3,"H"
1968-03-03,1967,"US Valenciennes-Anzin","Girondins Bordeaux","2-0",2,0,"1",1,2,2,"H"
1968-03-03,1967,"OGC Nice","FC Nantes","5-1",5,1,"1",1,6,4,"H"
1968-03-03,1967,"AC Ajaccio","Red Star FC","0-0",0,0,"1",1,0,0,"D"
1968-03-03,1967,"Stade Rennes","RC Strasbourg","2-1",2,1,"1",1,3,1,"H"
1968-03-03,1967,"Lille OSC","AS Monaco","0-1",0,1,"1",1,1,-1,"D"
1968-03-03,1967,"Angers SCO","FC Metz","0-0",0,0,"1",1,0,0,"D"
1968-03-03,1967,"AS Aixoise","RC Lens","2-2",2,2,"1",1,4,0,"D"
1968-03-10,1967,"AC Ajaccio","AS Monaco","1-2",1,2,"1",1,3,-1,"D"
1968-03-16,1967,"FC Metz","FC Sochaux","2-0",2,0,"1",1,2,2,"H"
1968-03-16,1967,"CS Sedan","Angers SCO","3-1",3,1,"1",1,4,2,"H"
1968-03-16,1967,"RC Strasbourg","AC Ajaccio","0-0",0,0,"1",1,0,0,"D"
1968-03-16,1967,"Girondins Bordeaux","OGC Nice","4-0",4,0,"1",1,4,4,"H"
1968-03-17,1967,"AS Saint-Etienne","Olympique Lyon","1-1",1,1,"1",1,2,0,"D"
1968-03-17,1967,"Olympique Marseille","AS Aixoise","3-2",3,2,"1",1,5,1,"H"
1968-03-17,1967,"Red Star FC","US Valenciennes-Anzin","1-0",1,0,"1",1,1,1,"H"
1968-03-17,1967,"FC Nantes","Stade Rennes","2-0",2,0,"1",1,2,2,"H"
1968-03-17,1967,"AS Monaco","FC Rouen","1-3",1,3,"1",1,4,-2,"D"
1968-03-17,1967,"RC Lens","Lille OSC","1-1",1,1,"1",1,2,0,"D"
1968-03-22,1967,"Lille OSC","RC Strasbourg","0-0",0,0,"1",1,0,0,"D"
1968-03-23,1967,"Angers SCO","Olympique Marseille","2-2",2,2,"1",1,4,0,"D"
1968-03-23,1967,"FC Rouen","Girondins Bordeaux","3-0",3,0,"1",1,3,3,"H"
1968-03-23,1967,"CS Sedan","FC Metz","3-0",3,0,"1",1,3,3,"H"
1968-03-23,1967,"FC Sochaux","AS Monaco","0-0",0,0,"1",1,0,0,"D"
1968-03-23,1967,"Stade Rennes","US Valenciennes-Anzin","1-1",1,1,"1",1,2,0,"D"
1968-03-24,1967,"AC Ajaccio","AS Saint-Etienne","1-1",1,1,"1",1,2,0,"D"
1968-03-24,1967,"AS Aixoise","FC Nantes","2-6",2,6,"1",1,8,-4,"D"
1968-03-24,1967,"OGC Nice","Red Star FC","2-1",2,1,"1",1,3,1,"H"
1968-03-24,1967,"Olympique Lyon","RC Lens","3-0",3,0,"1",1,3,3,"H"
1968-03-30,1967,"Stade Rennes","FC Rouen","0-1",0,1,"1",1,1,-1,"D"
1968-03-31,1967,"US Valenciennes-Anzin","AS Monaco","1-1",1,1,"1",1,2,0,"D"
1968-04-06,1967,"FC Metz","Lille OSC","1-0",1,0,"1",1,1,1,"H"
1968-04-07,1967,"RC Lens","AC Ajaccio","1-2",1,2,"1",1,3,-1,"D"
1968-04-07,1967,"Red Star FC","FC Rouen","0-2",0,2,"1",1,2,-2,"D"
1968-04-09,1967,"AS Saint-Etienne","Angers SCO","3-0",3,0,"1",1,3,3,"H"
1968-04-09,1967,"Girondins Bordeaux","AS Aixoise","3-0",3,0,"1",1,3,3,"H"
1968-04-09,1967,"FC Nantes","FC Sochaux","1-1",1,1,"1",1,2,0,"D"
1968-04-09,1967,"US Valenciennes-Anzin","OGC Nice","0-1",0,1,"1",1,1,-1,"D"
1968-04-09,1967,"AS Monaco","CS Sedan","2-1",2,1,"1",1,3,1,"H"
1968-04-09,1967,"RC Strasbourg","Olympique Lyon","0-1",0,1,"1",1,1,-1,"D"
1968-04-12,1967,"Stade Rennes","AS Saint-Etienne","0-3",0,3,"1",1,3,-3,"D"
1968-04-12,1967,"Olympique Lyon","FC Nantes","0-3",0,3,"1",1,3,-3,"D"
1968-04-12,1967,"FC Sochaux","RC Strasbourg","1-1",1,1,"1",1,2,0,"D"
1968-04-12,1967,"FC Rouen","OGC Nice","1-0",1,0,"1",1,1,1,"H"
1968-04-13,1967,"Lille OSC","US Valenciennes-Anzin","0-3",0,3,"1",1,3,-3,"D"
1968-04-13,1967,"CS Sedan","Olympique Marseille","1-1",1,1,"1",1,2,0,"D"
1968-04-13,1967,"FC Metz","AS Monaco","2-0",2,0,"1",1,2,2,"H"
1968-04-13,1967,"AS Aixoise","Red Star FC","0-0",0,0,"1",1,0,0,"D"
1968-04-13,1967,"Angers SCO","RC Lens","1-2",1,2,"1",1,3,-1,"D"
1968-04-14,1967,"AC Ajaccio","Girondins Bordeaux","3-0",3,0,"1",1,3,3,"H"
1968-04-20,1967,"Angers SCO","US Valenciennes-Anzin","1-0",1,0,"1",1,1,1,"H"
1968-04-26,1967,"Olympique Marseille","FC Metz","2-0",2,0,"1",1,2,2,"H"
1968-04-26,1967,"OGC Nice","AS Aixoise","1-0",1,0,"1",1,1,1,"H"
1968-04-26,1967,"RC Strasbourg","Angers SCO","5-1",5,1,"1",1,6,4,"H"
1968-04-27,1967,"AS Saint-Etienne","CS Sedan","2-1",2,1,"1",1,3,1,"H"
1968-04-27,1967,"FC Nantes","AC Ajaccio","1-0",1,0,"1",1,1,1,"H"
1968-04-27,1967,"RC Lens","FC Sochaux","0-2",0,2,"1",1,2,-2,"D"
1968-04-27,1967,"Girondins Bordeaux","Olympique Lyon","0-0",0,0,"1",1,0,0,"D"
1968-04-27,1967,"US Valenciennes-Anzin","FC Rouen","0-2",0,2,"1",1,2,-2,"D"
1968-04-27,1967,"AS Monaco","Stade Rennes","2-1",2,1,"1",1,3,1,"H"
1968-04-28,1967,"Red Star FC","Lille OSC","0-2",0,2,"1",1,2,-2,"D"
1968-04-30,1967,"Olympique Marseille","Stade Rennes","3-1",3,1,"1",1,4,2,"H"
1968-05-01,1967,"AS Aixoise","FC Metz","0-1",0,1,"1",1,1,-1,"D"
1968-05-03,1967,"Lille OSC","OGC Nice","0-2",0,2,"1",1,2,-2,"D"
1968-05-03,1967,"Olympique Lyon","Red Star FC","0-0",0,0,"1",1,0,0,"D"
1968-05-04,1967,"FC Sochaux","AS Saint-Etienne","0-4",0,4,"1",1,4,-4,"D"
1968-05-04,1967,"AS Monaco","Olympique Marseille","1-0",1,0,"1",1,1,1,"H"
1968-05-04,1967,"Stade Rennes","Girondins Bordeaux","1-0",1,0,"1",1,1,1,"H"
1968-05-04,1967,"CS Sedan","RC Lens","1-1",1,1,"1",1,2,0,"D"
1968-05-04,1967,"FC Metz","RC Strasbourg","1-0",1,0,"1",1,1,1,"H"
1968-05-05,1967,"Angers SCO","FC Nantes","1-3",1,3,"1",1,4,-2,"D"
1968-05-05,1967,"AS Aixoise","US Valenciennes-Anzin","1-1",1,1,"1",1,2,0,"D"
1968-05-05,1967,"AC Ajaccio","FC Rouen","5-3",5,3,"1",1,8,2,"H"
1968-05-11,1967,"FC Metz","OGC Nice","1-2",1,2,"1",1,3,-1,"D"
1968-05-11,1967,"FC Rouen","RC Strasbourg","3-2",3,2,"1",1,5,1,"H"
1968-05-17,1967,"AS Saint-Etienne","AS Monaco","1-0",1,0,"1",1,1,1,"H"
1968-05-17,1967,"OGC Nice","AC Ajaccio","1-0",1,0,"1",1,1,1,"H"
1968-05-17,1967,"RC Strasbourg","CS Sedan","0-2",0,2,"1",1,2,-2,"D"
1968-05-17,1967,"Girondins Bordeaux","Angers SCO","1-2",1,2,"1",1,3,-1,"D"
1968-05-17,1967,"FC Rouen","AS Aixoise","5-0",5,0,"1",1,5,5,"H"
1968-05-18,1967,"FC Nantes","Lille OSC","2-1",2,1,"1",1,3,1,"H"
1968-05-18,1967,"Olympique Marseille","FC Sochaux","0-1",0,1,"1",1,1,-1,"D"
1968-05-18,1967,"US Valenciennes-Anzin","Olympique Lyon","2-0",2,0,"1",1,2,2,"H"
1968-05-18,1967,"RC Lens","FC Metz","1-1",1,1,"1",1,2,0,"D"
1968-05-19,1967,"Red Star FC","Stade Rennes","3-1",3,1,"1",1,4,2,"H"
1968-05-22,1967,"FC Metz","AS Saint-Etienne","1-1",1,1,"1",1,2,0,"D"
1968-05-22,1967,"CS Sedan","FC Nantes","1-0",1,0,"1",1,1,1,"H"
1968-05-22,1967,"Lille OSC","FC Rouen","1-0",1,0,"1",1,1,1,"H"
1968-06-12,1967,"Olympique Lyon","OGC Nice","1-1",1,1,"1",1,2,0,"D"
1968-06-12,1967,"AC Ajaccio","US Valenciennes-Anzin","1-4",1,4,"1",1,5,-3,"D"
1968-06-12,1967,"Olympique Marseille","RC Strasbourg","0-0",0,0,"1",1,0,0,"D"
1968-06-12,1967,"FC Sochaux","Girondins Bordeaux","0-1",0,1,"1",1,1,-1,"D"
1968-06-12,1967,"AS Monaco","RC Lens","2-3",2,3,"1",1,5,-1,"D"
1968-06-12,1967,"Angers SCO","Red Star FC","2-2",2,2,"1",1,4,0,"D"
1968-06-12,1967,"Stade Rennes","AS Aixoise","4-0",4,0,"1",1,4,4,"H"
1968-06-14,1967,"AS Saint-Etienne","Lille OSC","3-0",3,0,"1",1,3,3,"H"
1968-06-15,1967,"FC Nantes","FC Metz","1-1",1,1,"1",1,2,0,"D"
1968-06-15,1967,"US Valenciennes-Anzin","Angers SCO","2-1",2,1,"1",1,3,1,"H"
1968-06-15,1967,"Girondins Bordeaux","CS Sedan","2-0",2,0,"1",1,2,2,"H"
1968-06-15,1967,"RC Lens","Olympique Marseille","5-1",5,1,"1",1,6,4,"H"
1968-06-15,1967,"AS Aixoise","AC Ajaccio","2-4",2,4,"1",1,6,-2,"D"
1968-06-15,1967,"RC Strasbourg","AS Monaco","2-0",2,0,"1",1,2,2,"H"
1968-06-15,1967,"FC Rouen","Olympique Lyon","3-1",3,1,"1",1,4,2,"H"
1968-06-16,1967,"OGC Nice","Stade Rennes","0-3",0,3,"1",1,3,-3,"D"
1968-06-16,1967,"Red Star FC","FC Sochaux","1-2",1,2,"1",1,3,-1,"D"
1968-06-19,1967,"RC Lens","Girondins Bordeaux","2-1",2,1,"1",1,3,1,"H"
1968-06-19,1967,"Olympique Marseille","AS Saint-Etienne","2-1",2,1,"1",1,3,1,"H"
1968-06-21,1967,"AS Monaco","FC Nantes","3-0",3,0,"1",1,3,3,"H"
1968-06-21,1967,"Lille OSC","AC Ajaccio","1-2",1,2,"1",1,3,-1,"D"
1968-06-21,1967,"FC Rouen","Stade Rennes","2-0",2,0,"1",1,2,2,"H"
1968-06-21,1967,"Olympique Lyon","AS Aixoise","4-3",4,3,"1",1,7,1,"H"
1968-06-22,1967,"Angers SCO","OGC Nice","1-1",1,1,"1",1,2,0,"D"
1968-06-22,1967,"FC Metz","Girondins Bordeaux","2-0",2,0,"1",1,2,2,"H"
1968-06-22,1967,"CS Sedan","Red Star FC","0-0",0,0,"1",1,0,0,"D"
1968-06-22,1967,"FC Sochaux","US Valenciennes-Anzin","3-1",3,1,"1",1,4,2,"H"
1968-06-23,1967,"RC Strasbourg","RC Lens","1-0",1,0,"1",1,1,1,"H"
1968-06-28,1967,"AS Saint-Etienne","RC Strasbourg","4-0",4,0,"1",1,4,4,"H"
1968-06-28,1967,"OGC Nice","FC Sochaux","1-0",1,0,"1",1,1,1,"H"
1968-06-28,1967,"US Valenciennes-Anzin","CS Sedan","3-1",3,1,"1",1,4,2,"H"
1968-06-28,1967,"FC Nantes","Olympique Marseille","1-1",1,1,"1",1,2,0,"D"
1968-06-28,1967,"Girondins Bordeaux","AS Monaco","3-0",3,0,"1",1,3,3,"H"
1968-06-28,1967,"Red Star FC","FC Metz","0-1",0,1,"1",1,1,-1,"D"
1968-06-28,1967,"AC Ajaccio","Olympique Lyon","2-2",2,2,"1",1,4,0,"D"
1968-06-28,1967,"FC Rouen","Angers SCO","0-1",0,1,"1",1,1,-1,"D"
1968-06-28,1967,"RC Lens","Stade Rennes","1-1",1,1,"1",1,2,0,"D"
1968-06-28,1967,"AS Aixoise","Lille OSC","2-1",2,1,"1",1,3,1,"H"
1968-07-03,1967,"CS Sedan","OGC Nice","0-1",0,1,"1",1,1,-1,"D"
1968-07-03,1967,"Olympique Marseille","Girondins Bordeaux","2-0",2,0,"1",1,2,2,"H"
1968-07-05,1967,"RC Lens","AS Saint-Etienne","1-3",1,3,"1",1,4,-2,"D"
1968-07-05,1967,"FC Sochaux","FC Rouen","3-0",3,0,"1",1,3,3,"H"
1968-07-05,1967,"FC Metz","US Valenciennes-Anzin","2-0",2,0,"1",1,2,2,"H"
1968-07-05,1967,"RC Strasbourg","FC Nantes","3-1",3,1,"1",1,4,2,"H"
1968-07-05,1967,"Stade Rennes","AC Ajaccio","1-0",1,0,"1",1,1,1,"H"
1968-07-05,1967,"AS Monaco","Red Star FC","0-1",0,1,"1",1,1,-1,"D"
1968-07-05,1967,"Olympique Lyon","Lille OSC","1-1",1,1,"1",1,2,0,"D"
1968-07-05,1967,"Angers SCO","AS Aixoise","9-1",9,1,"1",1,10,8,"H"
1968-09-01,1968,"AC Ajaccio","AS Monaco","4-3",4,3,"1",1,7,1,"H"
1968-09-01,1968,"FC Nantes","CS Sedan","3-2",3,2,"1",1,5,1,"H"
1968-09-03,1968,"Stade Rennes","Nimes Olympique","1-0",1,0,"1",1,1,1,"H"
1968-09-03,1968,"Olympique Marseille","Girondins Bordeaux","3-3",3,3,"1",1,6,0,"D"
1968-09-03,1968,"OGC Nice","SC Bastia","2-2",2,2,"1",1,4,0,"D"
1968-09-03,1968,"RC Strasbourg","Olympique Lyon","2-2",2,2,"1",1,4,0,"D"
1968-09-03,1968,"FC Rouen","Red Star FC","1-1",1,1,"1",1,2,0,"D"
1968-09-04,1968,"AS Saint-Etienne","FC Sochaux","4-1",4,1,"1",1,5,3,"H"
1968-09-04,1968,"US Valenciennes-Anzin","FC Metz","1-1",1,1,"1",1,2,0,"D"
1968-09-06,1968,"Olympique Lyon","Nimes Olympique","1-1",1,1,"1",1,2,0,"D"
1968-09-07,1968,"FC Sochaux","AC Ajaccio","0-1",0,1,"1",1,1,-1,"D"
1968-09-07,1968,"FC Metz","FC Rouen","7-3",7,3,"1",1,10,4,"H"
1968-09-07,1968,"CS Sedan","AS Saint-Etienne","0-0",0,0,"1",1,0,0,"D"
1968-09-07,1968,"Girondins Bordeaux","US Valenciennes-Anzin","1-0",1,0,"1",1,1,1,"H"
1968-09-07,1968,"SC Bastia","RC Strasbourg","2-1",2,1,"1",1,3,1,"H"
1968-09-08,1968,"FC Nantes","Olympique Marseille","2-1",2,1,"1",1,3,1,"H"
1968-09-08,1968,"Red Star FC","OGC Nice","0-2",0,2,"1",1,2,-2,"D"
1968-09-08,1968,"AS Monaco","Stade Rennes","2-2",2,2,"1",1,4,0,"D"
1968-09-13,1968,"AS Saint-Etienne","FC Nantes","3-1",3,1,"1",1,4,2,"H"
1968-09-13,1968,"OGC Nice","Olympique Lyon","2-1",2,1,"1",1,3,1,"H"
1968-09-13,1968,"RC Strasbourg","Red Star FC","1-0",1,0,"1",1,1,1,"H"
1968-09-14,1968,"Stade Rennes","FC Metz","2-0",2,0,"1",1,2,2,"H"
1968-09-14,1968,"FC Rouen","Girondins Bordeaux","2-1",2,1,"1",1,3,1,"H"
1968-09-14,1968,"Nimes Olympique","SC Bastia","2-1",2,1,"1",1,3,1,"H"
1968-09-14,1968,"US Valenciennes-Anzin","FC Sochaux","2-1",2,1,"1",1,3,1,"H"
1968-09-15,1968,"AC Ajaccio","CS Sedan","2-0",2,0,"1",1,2,2,"H"
1968-09-15,1968,"Olympique Marseille","AS Monaco","0-1",0,1,"1",1,1,-1,"D"
1968-09-20,1968,"AS Monaco","US Valenciennes-Anzin","0-0",0,0,"1",1,0,0,"D"
1968-09-21,1968,"AS Saint-Etienne","FC Rouen","2-0",2,0,"1",1,2,2,"H"
1968-09-21,1968,"FC Nantes","AC Ajaccio","0-0",0,0,"1",1,0,0,"D"
1968-09-21,1968,"SC Bastia","Stade Rennes","1-2",1,2,"1",1,3,-1,"D"
1968-09-21,1968,"FC Metz","RC Strasbourg","2-0",2,0,"1",1,2,2,"H"
1968-09-21,1968,"CS Sedan","OGC Nice","2-1",2,1,"1",1,3,1,"H"
1968-09-21,1968,"Girondins Bordeaux","Nimes Olympique","2-1",2,1,"1",1,3,1,"H"
1968-09-21,1968,"Red Star FC","Olympique Lyon","1-2",1,2,"1",1,3,-1,"D"
1968-09-23,1968,"FC Sochaux","Olympique Marseille","3-1",3,1,"1",1,4,2,"H"
1968-09-27,1968,"Olympique Lyon","SC Bastia","8-3",8,3,"1",1,11,5,"H"
1968-09-27,1968,"RC Strasbourg","AS Monaco","5-0",5,0,"1",1,5,5,"H"
1968-09-27,1968,"OGC Nice","Girondins Bordeaux","2-2",2,2,"1",1,4,0,"D"
1968-09-28,1968,"Stade Rennes","Red Star FC","1-1",1,1,"1",1,2,0,"D"
1968-09-28,1968,"Nimes Olympique","FC Metz","0-0",0,0,"1",1,0,0,"D"
1968-09-28,1968,"US Valenciennes-Anzin","FC Nantes","0-0",0,0,"1",1,0,0,"D"
1968-09-28,1968,"FC Rouen","FC Sochaux","2-1",2,1,"1",1,3,1,"H"
1968-09-28,1968,"Olympique Marseille","CS Sedan","4-1",4,1,"1",1,5,3,"H"
1968-10-05,1968,"FC Sochaux","Stade Rennes","1-1",1,1,"1",1,2,0,"D"
1968-10-05,1968,"Girondins Bordeaux","RC Strasbourg","3-0",3,0,"1",1,3,3,"H"
1968-10-05,1968,"FC Metz","Olympique Lyon","1-1",1,1,"1",1,2,0,"D"
1968-10-05,1968,"FC Nantes","OGC Nice","0-0",0,0,"1",1,0,0,"D"
1968-10-05,1968,"CS Sedan","FC Rouen","1-1",1,1,"1",1,2,0,"D"
1968-10-05,1968,"AS Monaco","Nimes Olympique","0-0",0,0,"1",1,0,0,"D"
1968-10-06,1968,"Red Star FC","SC Bastia","1-1",1,1,"1",1,2,0,"D"
1968-10-06,1968,"AC Ajaccio","Olympique Marseille","1-1",1,1,"1",1,2,0,"D"
1968-10-06,1968,"AS Saint-Etienne","US Valenciennes-Anzin","4-0",4,0,"1",1,4,4,"H"
1968-10-11,1968,"OGC Nice","FC Sochaux","0-3",0,3,"1",1,3,-3,"D"
1968-10-11,1968,"RC Strasbourg","CS Sedan","1-2",1,2,"1",1,3,-1,"D"
1968-10-12,1968,"Stade Rennes","Girondins Bordeaux","0-1",0,1,"1",1,1,-1,"D"
1968-10-12,1968,"FC Rouen","AS Monaco","3-1",3,1,"1",1,4,2,"H"
1968-10-12,1968,"Nimes Olympique","Red Star FC","0-0",0,0,"1",1,0,0,"D"
1968-10-13,1968,"Olympique Marseille","AS Saint-Etienne","0-3",0,3,"1",1,3,-3,"D"
1968-10-13,1968,"Olympique Lyon","FC Nantes","3-1",3,1,"1",1,4,2,"H"
1968-10-13,1968,"SC Bastia","FC Metz","1-1",1,1,"1",1,2,0,"D"
1968-10-13,1968,"US Valenciennes-Anzin","AC Ajaccio","1-0",1,0,"1",1,1,1,"H"
1968-10-19,1968,"Girondins Bordeaux","SC Bastia","8-1",8,1,"1",1,9,7,"H"
1968-10-19,1968,"FC Metz","Red Star FC","3-1",3,1,"1",1,4,2,"H"
1968-10-19,1968,"FC Nantes","Nimes Olympique","3-1",3,1,"1",1,4,2,"H"
1968-10-19,1968,"FC Sochaux","RC Strasbourg","3-0",3,0,"1",1,3,3,"H"
1968-10-20,1968,"AS Saint-Etienne","Olympique Lyon","0-1",0,1,"1",1,1,-1,"D"
1968-10-20,1968,"AC Ajaccio","FC Rouen","0-1",0,1,"1",1,1,-1,"D"
1968-10-20,1968,"CS Sedan","Stade Rennes","3-0",3,0,"1",1,3,3,"H"
1968-10-20,1968,"US Valenciennes-Anzin","Olympique Marseille","3-1",3,1,"1",1,4,2,"H"
1968-10-20,1968,"AS Monaco","OGC Nice","0-0",0,0,"1",1,0,0,"D"
1968-10-25,1968,"RC Strasbourg","AC Ajaccio","3-0",3,0,"1",1,3,3,"H"
1968-10-25,1968,"Red Star FC","Girondins Bordeaux","1-2",1,2,"1",1,3,-1,"D"
1968-10-26,1968,"Olympique Lyon","FC Sochaux","6-3",6,3,"1",1,9,3,"H"
1968-10-26,1968,"Stade Rennes","FC Nantes","2-1",2,1,"1",1,3,1,"H"
1968-10-26,1968,"FC Rouen","US Valenciennes-Anzin","2-2",2,2,"1",1,4,0,"D"
1968-10-27,1968,"OGC Nice","AS Saint-Etienne","2-3",2,3,"1",1,5,-1,"D"
1968-10-27,1968,"Olympique Marseille","FC Metz","0-1",0,1,"1",1,1,-1,"D"
1968-10-27,1968,"Nimes Olympique","CS Sedan","1-0",1,0,"1",1,1,1,"H"
1968-10-27,1968,"SC Bastia","AS Monaco","4-0",4,0,"1",1,4,4,"H"
1968-10-31,1968,"Girondins Bordeaux","FC Metz","1-0",1,0,"1",1,1,1,"H"
1968-10-31,1968,"AS Saint-Etienne","RC Strasbourg","2-0",2,0,"1",1,2,2,"H"
1968-11-01,1968,"CS Sedan","Olympique Lyon","1-0",1,0,"1",1,1,1,"H"
1968-11-01,1968,"FC Nantes","FC Rouen","0-1",0,1,"1",1,1,-1,"D"
1968-11-01,1968,"US Valenciennes-Anzin","OGC Nice","3-0",3,0,"1",1,3,3,"H"
1968-11-01,1968,"Olympique Marseille","Stade Rennes","3-3",3,3,"1",1,6,0,"D"
1968-11-01,1968,"FC Sochaux","SC Bastia","2-2",2,2,"1",1,4,0,"D"
1968-11-01,1968,"AS Monaco","Red Star FC","1-1",1,1,"1",1,2,0,"D"
1968-11-03,1968,"AC Ajaccio","Nimes Olympique","1-0",1,0,"1",1,1,1,"H"
1968-11-10,1968,"Olympique Lyon","Girondins Bordeaux","0-2",0,2,"1",1,2,-2,"D"
1968-11-10,1968,"Red Star FC","AS Saint-Etienne","0-0",0,0,"1",1,0,0,"D"
1968-11-10,1968,"FC Rouen","Olympique Marseille","2-1",2,1,"1",1,3,1,"H"
1968-11-10,1968,"Stade Rennes","US Valenciennes-Anzin","1-2",1,2,"1",1,3,-1,"D"
1968-11-10,1968,"FC Metz","AS Monaco","0-0",0,0,"1",1,0,0,"D"
1968-11-10,1968,"OGC Nice","AC Ajaccio","0-3",0,3,"1",1,3,-3,"D"
1968-11-10,1968,"Nimes Olympique","FC Sochaux","3-1",3,1,"1",1,4,2,"H"
1968-11-10,1968,"RC Strasbourg","FC Nantes","1-0",1,0,"1",1,1,1,"H"
1968-11-11,1968,"SC Bastia","CS Sedan","0-0",0,0,"1",1,0,0,"D"
1968-11-16,1968,"US Valenciennes-Anzin","RC Strasbourg","1-1",1,1,"1",1,2,0,"D"
1968-11-16,1968,"AS Saint-Etienne","Nimes Olympique","1-0",1,0,"1",1,1,1,"H"
1968-11-17,1968,"AC Ajaccio","Olympique Lyon","4-1",4,1,"1",1,5,3,"H"
1968-11-17,1968,"FC Sochaux","FC Metz","5-2",5,2,"1",1,7,3,"H"
1968-11-17,1968,"CS Sedan","Red Star FC","0-0",0,0,"1",1,0,0,"D"
1968-11-17,1968,"FC Nantes","SC Bastia","3-0",3,0,"1",1,3,3,"H"
1968-11-17,1968,"Olympique Marseille","OGC Nice","3-1",3,1,"1",1,4,2,"H"
1968-11-19,1968,"AS Monaco","Girondins Bordeaux","2-4",2,4,"1",1,6,-2,"D"
1968-11-24,1968,"Girondins Bordeaux","FC Nantes","1-1",1,1,"1",1,2,0,"D"
1968-11-24,1968,"SC Bastia","AS Saint-Etienne","1-1",1,1,"1",1,2,0,"D"
1968-11-24,1968,"Nimes Olympique","US Valenciennes-Anzin","2-2",2,2,"1",1,4,0,"D"
1968-11-24,1968,"OGC Nice","FC Rouen","2-2",2,2,"1",1,4,0,"D"
1968-11-24,1968,"Olympique Lyon","AS Monaco","2-0",2,0,"1",1,2,2,"H"
1968-11-24,1968,"Stade Rennes","AC Ajaccio","5-0",5,0,"1",1,5,5,"H"
1968-11-24,1968,"FC Metz","CS Sedan","0-1",0,1,"1",1,1,-1,"D"
1968-11-24,1968,"Red Star FC","FC Sochaux","2-2",2,2,"1",1,4,0,"D"
1968-11-24,1968,"RC Strasbourg","Olympique Marseille","1-2",1,2,"1",1,3,-1,"D"
1968-11-30,1968,"AS Saint-Etienne","FC Metz","4-0",4,0,"1",1,4,4,"H"
1968-11-30,1968,"FC Sochaux","AS Monaco","0-0",0,0,"1",1,0,0,"D"
1968-12-01,1968,"CS Sedan","Girondins Bordeaux","0-1",0,1,"1",1,1,-1,"D"
1968-12-01,1968,"FC Rouen","RC Strasbourg","3-0",3,0,"1",1,3,3,"H"
1968-12-01,1968,"US Valenciennes-Anzin","Olympique Lyon","0-0",0,0,"1",1,0,0,"D"
1968-12-01,1968,"AC Ajaccio","SC Bastia","4-0",4,0,"1",1,4,4,"H"
1968-12-01,1968,"OGC Nice","Stade Rennes","1-1",1,1,"1",1,2,0,"D"
1968-12-01,1968,"FC Nantes","Red Star FC","0-1",0,1,"1",1,1,-1,"D"
1968-12-01,1968,"Olympique Marseille","Nimes Olympique","4-0",4,0,"1",1,4,4,"H"
1968-12-05,1968,"AS Saint-Etienne","AC Ajaccio","2-0",2,0,"1",1,2,2,"H"
1968-12-07,1968,"RC Strasbourg","OGC Nice","1-0",1,0,"1",1,1,1,"H"
1968-12-08,1968,"Stade Rennes","AS Saint-Etienne","0-2",0,2,"1",1,2,-2,"D"
1968-12-08,1968,"Girondins Bordeaux","FC Sochaux","4-0",4,0,"1",1,4,4,"H"
1968-12-08,1968,"Nimes Olympique","FC Rouen","0-0",0,0,"1",1,0,0,"D"
1968-12-08,1968,"Olympique Lyon","Olympique Marseille","2-3",2,3,"1",1,5,-1,"D"
1968-12-08,1968,"Red Star FC","AC Ajaccio","1-0",1,0,"1",1,1,1,"H"
1968-12-08,1968,"FC Metz","FC Nantes","1-0",1,0,"1",1,1,1,"H"
1968-12-08,1968,"AS Monaco","CS Sedan","0-0",0,0,"1",1,0,0,"D"
1968-12-12,1968,"FC Rouen","Stade Rennes","1-0",1,0,"1",1,1,1,"H"
1968-12-15,1968,"AS Saint-Etienne","Girondins Bordeaux","3-2",3,2,"1",1,5,1,"H"
1968-12-15,1968,"FC Rouen","Olympique Lyon","2-1",2,1,"1",1,3,1,"H"
1968-12-15,1968,"US Valenciennes-Anzin","Red Star FC","3-0",3,0,"1",1,3,3,"H"
1968-12-15,1968,"CS Sedan","FC Sochaux","2-0",2,0,"1",1,2,2,"H"
1968-12-15,1968,"AC Ajaccio","FC Metz","0-1",0,1,"1",1,1,-1,"D"
1968-12-15,1968,"RC Strasbourg","Stade Rennes","0-0",0,0,"1",1,0,0,"D"
1968-12-15,1968,"Olympique Marseille","SC Bastia","1-0",1,0,"1",1,1,1,"H"
1968-12-15,1968,"FC Nantes","AS Monaco","2-0",2,0,"1",1,2,2,"H"
1968-12-15,1968,"OGC Nice","Nimes Olympique","3-0",3,0,"1",1,3,3,"H"
1969-01-05,1968,"AS Monaco","AS Saint-Etienne","1-2",1,2,"1",1,3,-1,"D"
1969-01-05,1968,"Girondins Bordeaux","AC Ajaccio","5-0",5,0,"1",1,5,5,"H"
1969-01-05,1968,"SC Bastia","FC Rouen","1-1",1,1,"1",1,2,0,"D"
1969-01-05,1968,"CS Sedan","US Valenciennes-Anzin","1-0",1,0,"1",1,1,1,"H"
1969-01-05,1968,"FC Metz","OGC Nice","1-0",1,0,"1",1,1,1,"H"
1969-01-05,1968,"Olympique Lyon","Stade Rennes","1-0",1,0,"1",1,1,1,"H"
1969-01-05,1968,"Red Star FC","Olympique Marseille","1-1",1,1,"1",1,2,0,"D"
1969-01-05,1968,"FC Sochaux","FC Nantes","1-2",1,2,"1",1,3,-1,"D"
1969-01-05,1968,"Nimes Olympique","RC Strasbourg","0-0",0,0,"1",1,0,0,"D"
1969-01-18,1968,"Stade Rennes","AS Monaco","3-1",3,1,"1",1,4,2,"H"
1969-01-19,1968,"AS Saint-Etienne","CS Sedan","4-2",4,2,"1",1,6,2,"H"
1969-01-19,1968,"US Valenciennes-Anzin","Girondins Bordeaux","1-1",1,1,"1",1,2,0,"D"
1969-01-19,1968,"FC Rouen","FC Metz","1-0",1,0,"1",1,1,1,"H"
1969-01-19,1968,"Olympique Marseille","FC Nantes","3-1",3,1,"1",1,4,2,"H"
1969-01-19,1968,"RC Strasbourg","SC Bastia","4-0",4,0,"1",1,4,4,"H"
1969-01-19,1968,"AC Ajaccio","FC Sochaux","0-2",0,2,"1",1,2,-2,"D"
1969-01-19,1968,"OGC Nice","Red Star FC","1-1",1,1,"1",1,2,0,"D"
1969-01-26,1968,"FC Nantes","AS Saint-Etienne","3-0",3,0,"1",1,3,3,"H"
1969-01-26,1968,"Girondins Bordeaux","FC Rouen","2-1",2,1,"1",1,3,1,"H"
1969-01-26,1968,"CS Sedan","AC Ajaccio","4-0",4,0,"1",1,4,4,"H"
1969-01-26,1968,"FC Metz","Stade Rennes","3-0",3,0,"1",1,3,3,"H"
1969-01-26,1968,"Olympique Lyon","OGC Nice","3-1",3,1,"1",1,4,2,"H"
1969-01-26,1968,"FC Sochaux","US Valenciennes-Anzin","2-0",2,0,"1",1,2,2,"H"
1969-01-26,1968,"AS Monaco","Olympique Marseille","1-0",1,0,"1",1,1,1,"H"
1969-01-26,1968,"Red Star FC","RC Strasbourg","2-1",2,1,"1",1,3,1,"H"
1969-01-26,1968,"SC Bastia","Nimes Olympique","2-2",2,2,"1",1,4,0,"D"
1969-02-01,1968,"Stade Rennes","SC Bastia","3-1",3,1,"1",1,4,2,"H"
1969-02-02,1968,"FC Rouen","AS Saint-Etienne","1-5",1,5,"1",1,6,-4,"D"
1969-02-02,1968,"Nimes Olympique","Girondins Bordeaux","1-3",1,3,"1",1,4,-2,"D"
1969-02-02,1968,"US Valenciennes-Anzin","AS Monaco","4-2",4,2,"1",1,6,2,"H"
1969-02-02,1968,"RC Strasbourg","FC Metz","1-1",1,1,"1",1,2,0,"D"
1969-02-02,1968,"Olympique Lyon","Red Star FC","0-0",0,0,"1",1,0,0,"D"
1969-02-02,1968,"OGC Nice","CS Sedan","2-1",2,1,"1",1,3,1,"H"
1969-02-02,1968,"Olympique Marseille","FC Sochaux","4-0",4,0,"1",1,4,4,"H"
1969-02-02,1968,"AC Ajaccio","FC Nantes","1-0",1,0,"1",1,1,1,"H"
1969-02-16,1968,"AC Ajaccio","AS Saint-Etienne","0-2",0,2,"1",1,2,-2,"D"
1969-02-16,1968,"FC Nantes","US Valenciennes-Anzin","3-2",3,2,"1",1,5,1,"H"
1969-02-16,1968,"SC Bastia","Olympique Lyon","4-0",4,0,"1",1,4,4,"H"
1969-02-16,1968,"AS Monaco","RC Strasbourg","2-1",2,1,"1",1,3,1,"H"
1969-02-23,1968,"US Valenciennes-Anzin","AS Saint-Etienne","1-1",1,1,"1",1,2,0,"D"
1969-02-23,1968,"RC Strasbourg","Girondins Bordeaux","1-1",1,1,"1",1,2,0,"D"
1969-02-23,1968,"FC Rouen","CS Sedan","0-1",0,1,"1",1,1,-1,"D"
1969-02-23,1968,"Olympique Lyon","FC Metz","0-1",0,1,"1",1,1,-1,"D"
1969-02-23,1968,"Olympique Marseille","AC Ajaccio","3-0",3,0,"1",1,3,3,"H"
1969-02-23,1968,"Stade Rennes","FC Sochaux","3-2",3,2,"1",1,5,1,"H"
1969-02-23,1968,"SC Bastia","Red Star FC","2-1",2,1,"1",1,3,1,"H"
1969-03-02,1968,"SC Bastia","US Valenciennes-Anzin","3-0",3,0,"1",1,3,3,"H"
1969-03-02,1968,"FC Sochaux","FC Rouen","2-0",2,0,"1",1,2,2,"H"
1969-03-02,1968,"Nimes Olympique","AS Monaco","1-1",1,1,"1",1,2,0,"D"
1969-03-15,1968,"FC Metz","SC Bastia","2-0",2,0,"1",1,2,2,"H"
1969-03-15,1968,"FC Nantes","Olympique Lyon","2-1",2,1,"1",1,3,1,"H"
1969-03-15,1968,"FC Sochaux","OGC Nice","3-0",3,0,"1",1,3,3,"H"
1969-03-16,1968,"AS Saint-Etienne","Olympique Marseille","1-0",1,0,"1",1,1,1,"H"
1969-03-16,1968,"Girondins Bordeaux","Stade Rennes","3-2",3,2,"1",1,5,1,"H"
1969-03-16,1968,"AS Monaco","FC Rouen","1-1",1,1,"1",1,2,0,"D"
1969-03-16,1968,"CS Sedan","RC Strasbourg","1-1",1,1,"1",1,2,0,"D"
1969-03-16,1968,"AC Ajaccio","US Valenciennes-Anzin","1-1",1,1,"1",1,2,0,"D"
1969-03-16,1968,"Red Star FC","Nimes Olympique","0-2",0,2,"1",1,2,-2,"D"
1969-03-21,1968,"FC Rouen","AC Ajaccio","1-1",1,1,"1",1,2,0,"D"
1969-03-21,1968,"Olympique Marseille","US Valenciennes-Anzin","1-0",1,0,"1",1,1,1,"H"
1969-03-21,1968,"RC Strasbourg","FC Sochaux","1-0",1,0,"1",1,1,1,"H"
1969-03-22,1968,"Nimes Olympique","FC Nantes","1-2",1,2,"1",1,3,-1,"D"
1969-03-22,1968,"Stade Rennes","CS Sedan","1-3",1,3,"1",1,4,-2,"D"
1969-03-23,1968,"Olympique Lyon","AS Saint-Etienne","1-2",1,2,"1",1,3,-1,"D"
1969-03-23,1968,"SC Bastia","Girondins Bordeaux","1-0",1,0,"1",1,1,1,"H"
1969-03-23,1968,"Red Star FC","FC Metz","1-0",1,0,"1",1,1,1,"H"
1969-03-23,1968,"OGC Nice","AS Monaco","1-0",1,0,"1",1,1,1,"H"
1969-03-29,1968,"FC Metz","Nimes Olympique","0-0",0,0,"1",1,0,0,"D"
1969-03-29,1968,"OGC Nice","FC Nantes","0-0",0,0,"1",1,0,0,"D"
1969-04-04,1968,"AS Saint-Etienne","OGC Nice","2-0",2,0,"1",1,2,2,"H"
1969-04-04,1968,"US Valenciennes-Anzin","FC Rouen","0-1",0,1,"1",1,1,-1,"D"
1969-04-04,1968,"FC Sochaux","Olympique Lyon","2-1",2,1,"1",1,3,1,"H"
1969-04-04,1968,"AS Monaco","SC Bastia","2-0",2,0,"1",1,2,2,"H"
1969-04-05,1968,"FC Nantes","Stade Rennes","3-2",3,2,"1",1,5,1,"H"
1969-04-05,1968,"AC Ajaccio","RC Strasbourg","1-1",1,1,"1",1,2,0,"D"
1969-04-06,1968,"CS Sedan","Nimes Olympique","3-1",3,1,"1",1,4,2,"H"
1969-04-09,1968,"Girondins Bordeaux","Red Star FC","6-1",6,1,"1",1,7,5,"H"
1969-04-09,1968,"FC Metz","Olympique Marseille","3-0",3,0,"1",1,3,3,"H"
1969-04-11,1968,"OGC Nice","US Valenciennes-Anzin","1-1",1,1,"1",1,2,0,"D"
1969-04-12,1968,"Olympique Lyon","CS Sedan","1-0",1,0,"1",1,1,1,"H"
1969-04-12,1968,"Stade Rennes","Olympique Marseille","2-1",2,1,"1",1,3,1,"H"
1969-04-12,1968,"SC Bastia","FC Sochaux","1-0",1,0,"1",1,1,1,"H"
1969-04-12,1968,"Nimes Olympique","AC Ajaccio","3-2",3,2,"1",1,5,1,"H"
1969-04-13,1968,"RC Strasbourg","AS Saint-Etienne","0-2",0,2,"1",1,2,-2,"D"
1969-04-13,1968,"FC Metz","Girondins Bordeaux","1-0",1,0,"1",1,1,1,"H"
1969-04-13,1968,"FC Rouen","FC Nantes","3-0",3,0,"1",1,3,3,"H"
1969-04-13,1968,"Red Star FC","AS Monaco","1-0",1,0,"1",1,1,1,"H"
1969-04-16,1968,"Girondins Bordeaux","OGC Nice","5-0",5,0,"1",1,5,5,"H"
1969-04-18,1968,"Olympique Marseille","FC Rouen","1-0",1,0,"1",1,1,1,"H"
1969-04-18,1968,"FC Sochaux","Nimes Olympique","1-1",1,1,"1",1,2,0,"D"
1969-04-19,1968,"AS Saint-Etienne","Red Star FC","3-1",3,1,"1",1,4,2,"H"
1969-04-19,1968,"AS Monaco","FC Metz","1-1",1,1,"1",1,2,0,"D"
1969-04-19,1968,"US Valenciennes-Anzin","Stade Rennes","4-1",4,1,"1",1,5,3,"H"
1969-04-20,1968,"AC Ajaccio","OGC Nice","1-0",1,0,"1",1,1,1,"H"
1969-04-20,1968,"Girondins Bordeaux","Olympique Lyon","2-1",2,1,"1",1,3,1,"H"
1969-04-25,1968,"Nimes Olympique","Olympique Lyon","1-2",1,2,"1",1,3,-1,"D"
1969-04-27,1968,"Red Star FC","Stade Rennes","2-1",2,1,"1",1,3,1,"H"
1969-05-02,1968,"RC Strasbourg","US Valenciennes-Anzin","0-1",0,1,"1",1,1,-1,"D"
1969-05-02,1968,"Olympique Lyon","AC Ajaccio","3-2",3,2,"1",1,5,1,"H"
1969-05-03,1968,"Nimes Olympique","AS Saint-Etienne","1-0",1,0,"1",1,1,1,"H"
1969-05-03,1968,"FC Metz","FC Sochaux","3-0",3,0,"1",1,3,3,"H"
1969-05-03,1968,"Stade Rennes","FC Rouen","0-1",0,1,"1",1,1,-1,"D"
1969-05-03,1968,"SC Bastia","FC Nantes","3-1",3,1,"1",1,4,2,"H"
1969-05-07,1968,"Girondins Bordeaux","AS Monaco","2-1",2,1,"1",1,3,1,"H"
1969-05-07,1968,"OGC Nice","Olympique Marseille","2-3",2,3,"1",1,5,-1,"D"
1969-05-07,1968,"Red Star FC","CS Sedan","2-1",2,1,"1",1,3,1,"H"
1969-05-09,1968,"AS Saint-Etienne","SC Bastia","7-2",7,2,"1",1,9,5,"H"
1969-05-10,1968,"FC Nantes","Girondins Bordeaux","1-2",1,2,"1",1,3,-1,"D"
1969-05-10,1968,"US Valenciennes-Anzin","Nimes Olympique","0-0",0,0,"1",1,0,0,"D"
1969-05-10,1968,"Olympique Marseille","RC Strasbourg","0-0",0,0,"1",1,0,0,"D"
1969-05-10,1968,"FC Sochaux","Red Star FC","3-3",3,3,"1",1,6,0,"D"
1969-05-10,1968,"AC Ajaccio","Stade Rennes","2-2",2,2,"1",1,4,0,"D"
1969-05-11,1968,"CS Sedan","FC Metz","0-0",0,0,"1",1,0,0,"D"
1969-05-11,1968,"AS Monaco","Olympique Lyon","0-2",0,2,"1",1,2,-2,"D"
1969-05-13,1968,"FC Rouen","OGC Nice","4-0",4,0,"1",1,4,4,"H"
1969-05-14,1968,"Olympique Lyon","US Valenciennes-Anzin","1-0",1,0,"1",1,1,1,"H"
1969-05-15,1968,"Red Star FC","FC Nantes","2-3",2,3,"1",1,5,-1,"D"
1969-05-18,1968,"FC Metz","AS Saint-Etienne","0-1",0,1,"1",1,1,-1,"D"
1969-05-18,1968,"RC Strasbourg","FC Rouen","2-0",2,0,"1",1,2,2,"H"
1969-05-18,1968,"Stade Rennes","OGC Nice","4-2",4,2,"1",1,6,2,"H"
1969-05-18,1968,"SC Bastia","AC Ajaccio","1-0",1,0,"1",1,1,1,"H"
1969-05-18,1968,"AS Monaco","FC Sochaux","2-1",2,1,"1",1,3,1,"H"
1969-05-21,1968,"CS Sedan","SC Bastia","5-1",5,1,"1",1,6,4,"H"
1969-05-22,1968,"Olympique Marseille","Olympique Lyon","2-2",2,2,"1",1,4,0,"D"
1969-05-23,1968,"AS Saint-Etienne","Stade Rennes","3-1",3,1,"1",1,4,2,"H"
1969-05-23,1968,"FC Sochaux","Girondins Bordeaux","0-1",0,1,"1",1,1,-1,"D"
1969-05-23,1968,"FC Rouen","Nimes Olympique","1-0",1,0,"1",1,1,1,"H"
1969-05-23,1968,"OGC Nice","RC Strasbourg","1-0",1,0,"1",1,1,1,"H"
1969-05-24,1968,"FC Nantes","FC Metz","1-2",1,2,"1",1,3,-1,"D"
1969-05-24,1968,"CS Sedan","AS Monaco","2-2",2,2,"1",1,4,0,"D"
1969-05-24,1968,"US Valenciennes-Anzin","SC Bastia","0-1",0,1,"1",1,1,-1,"D"
1969-05-24,1968,"AC Ajaccio","Red Star FC","3-1",3,1,"1",1,4,2,"H"
1969-05-27,1968,"Girondins Bordeaux","CS Sedan","0-2",0,2,"1",1,2,-2,"D"
1969-05-27,1968,"Nimes Olympique","Olympique Marseille","0-0",0,0,"1",1,0,0,"D"
1969-05-30,1968,"Olympique Lyon","FC Rouen","0-1",0,1,"1",1,1,-1,"D"
1969-05-31,1968,"FC Metz","AC Ajaccio","0-0",0,0,"1",1,0,0,"D"
1969-05-31,1968,"FC Sochaux","CS Sedan","3-1",3,1,"1",1,4,2,"H"
1969-05-31,1968,"Red Star FC","US Valenciennes-Anzin","1-2",1,2,"1",1,3,-1,"D"
1969-05-31,1968,"SC Bastia","Olympique Marseille","3-1",3,1,"1",1,4,2,"H"
1969-05-31,1968,"AS Monaco","FC Nantes","2-0",2,0,"1",1,2,2,"H"
1969-05-31,1968,"Stade Rennes","RC Strasbourg","1-0",1,0,"1",1,1,1,"H"
1969-05-31,1968,"Nimes Olympique","OGC Nice","2-0",2,0,"1",1,2,2,"H"
1969-06-01,1968,"Girondins Bordeaux","AS Saint-Etienne","2-0",2,0,"1",1,2,2,"H"
1969-06-04,1968,"CS Sedan","Olympique Marseille","3-1",3,1,"1",1,4,2,"H"
1969-06-04,1968,"FC Nantes","RC Strasbourg","4-0",4,0,"1",1,4,4,"H"
1969-06-06,1968,"FC Rouen","SC Bastia","1-3",1,3,"1",1,4,-2,"D"
1969-06-06,1968,"US Valenciennes-Anzin","CS Sedan","1-1",1,1,"1",1,2,0,"D"
1969-06-07,1968,"AS Saint-Etienne","AS Monaco","1-1",1,1,"1",1,2,0,"D"
1969-06-07,1968,"AC Ajaccio","Girondins Bordeaux","2-2",2,2,"1",1,4,0,"D"
1969-06-07,1968,"OGC Nice","FC Metz","1-2",1,2,"1",1,3,-1,"D"
1969-06-07,1968,"Stade Rennes","Olympique Lyon","2-1",2,1,"1",1,3,1,"H"
1969-06-07,1968,"Olympique Marseille","Red Star FC","0-0",0,0,"1",1,0,0,"D"
1969-06-07,1968,"FC Nantes","FC Sochaux","0-0",0,0,"1",1,0,0,"D"
1969-06-07,1968,"RC Strasbourg","Nimes Olympique","1-0",1,0,"1",1,1,1,"H"
1969-06-13,1968,"Girondins Bordeaux","Olympique Marseille","2-2",2,2,"1",1,4,0,"D"
1969-06-13,1968,"Nimes Olympique","Stade Rennes","5-1",5,1,"1",1,6,4,"H"
1969-06-14,1968,"FC Sochaux","AS Saint-Etienne","1-0",1,0,"1",1,1,1,"H"
1969-06-14,1968,"FC Metz","US Valenciennes-Anzin","1-0",1,0,"1",1,1,1,"H"
1969-06-14,1968,"Red Star FC","FC Rouen","4-0",4,0,"1",1,4,4,"H"
1969-06-14,1968,"CS Sedan","FC Nantes","3-1",3,1,"1",1,4,2,"H"
1969-06-14,1968,"SC Bastia","OGC Nice","2-0",2,0,"1",1,2,2,"H"
1969-06-14,1968,"Olympique Lyon","RC Strasbourg","2-3",2,3,"1",1,5,-1,"D"
1969-06-14,1968,"AS Monaco","AC Ajaccio","3-0",3,0,"1",1,3,3,"H"
1969-08-05,1969,"AS Saint-Etienne","AC Ajaccio","3-1",3,1,"1",1,4,2,"H"
1969-08-05,1969,"Olympique Marseille","FC Sochaux","0-0",0,0,"1",1,0,0,"D"
1969-08-06,1969,"SC Bastia","Olympique Lyon","2-4",2,4,"1",1,6,-2,"D"
1969-08-06,1969,"Red Star FC","Angers SCO","3-4",3,4,"1",1,7,-1,"D"
1969-08-06,1969,"RC Strasbourg","FC Rouen","3-2",3,2,"1",1,5,1,"H"
1969-08-06,1969,"FC Nantes","FC Metz","1-0",1,0,"1",1,1,1,"H"
1969-08-06,1969,"AS Angouleme","Nimes Olympique","1-0",1,0,"1",1,1,1,"H"
1969-08-06,1969,"Stade Rennes","US Valenciennes-Anzin","1-1",1,1,"1",1,2,0,"D"
1969-08-06,1969,"CS Sedan","Girondins Bordeaux","1-1",1,1,"1",1,2,0,"D"
1969-08-09,1969,"Olympique Lyon","CS Sedan","4-2",4,2,"1",1,6,2,"H"
1969-08-09,1969,"AS Saint-Etienne","FC Metz","2-0",2,0,"1",1,2,2,"H"
1969-08-09,1969,"US Valenciennes-Anzin","AS Angouleme","0-1",0,1,"1",1,1,-1,"D"
1969-08-09,1969,"Girondins Bordeaux","RC Strasbourg","4-2",4,2,"1",1,6,2,"H"
1969-08-09,1969,"FC Rouen","Stade Rennes","4-0",4,0,"1",1,4,4,"H"
1969-08-09,1969,"FC Sochaux","Red Star FC","0-3",0,3,"1",1,3,-3,"D"
1969-08-09,1969,"AC Ajaccio","FC Nantes","2-1",2,1,"1",1,3,1,"H"
1969-08-09,1969,"Nimes Olympique","Olympique Marseille","1-1",1,1,"1",1,2,0,"D"
1969-08-13,1969,"Olympique Lyon","Nimes Olympique","3-0",3,0,"1",1,3,3,"H"
1969-08-13,1969,"FC Nantes","AS Saint-Etienne","2-2",2,2,"1",1,4,0,"D"
1969-08-13,1969,"AS Angouleme","FC Rouen","1-1",1,1,"1",1,2,0,"D"
1969-08-13,1969,"Red Star FC","FC Metz","3-1",3,1,"1",1,4,2,"H"
1969-08-13,1969,"Olympique Marseille","Girondins Bordeaux","3-1",3,1,"1",1,4,2,"H"
1969-08-13,1969,"RC Strasbourg","US Valenciennes-Anzin","4-2",4,2,"1",1,6,2,"H"
1969-08-13,1969,"Stade Rennes","AC Ajaccio","0-1",0,1,"1",1,1,-1,"D"
1969-08-13,1969,"CS Sedan","Angers SCO","2-2",2,2,"1",1,4,0,"D"
1969-08-13,1969,"SC Bastia","FC Sochaux","2-0",2,0,"1",1,2,2,"H"
1969-08-17,1969,"Angers SCO","SC Bastia","5-0",5,0,"1",1,5,5,"H"
1969-08-20,1969,"AS Saint-Etienne","Stade Rennes","8-2",8,2,"1",1,10,6,"H"
1969-08-20,1969,"Angers SCO","Olympique Lyon","3-2",3,2,"1",1,5,1,"H"
1969-08-20,1969,"Nimes Olympique","Red Star FC","1-3",1,3,"1",1,4,-2,"D"
1969-08-20,1969,"US Valenciennes-Anzin","Olympique Marseille","0-2",0,2,"1",1,2,-2,"D"
1969-08-20,1969,"AC Ajaccio","AS Angouleme","0-0",0,0,"1",1,0,0,"D"
1969-08-20,1969,"FC Rouen","FC Nantes","1-0",1,0,"1",1,1,1,"H"
1969-08-20,1969,"FC Sochaux","CS Sedan","1-0",1,0,"1",1,1,1,"H"
1969-08-20,1969,"Girondins Bordeaux","SC Bastia","1-0",1,0,"1",1,1,1,"H"
1969-08-21,1969,"FC Metz","RC Strasbourg","2-2",2,2,"1",1,4,0,"D"
1969-08-27,1969,"Olympique Marseille","AS Saint-Etienne","2-3",2,3,"1",1,5,-1,"D"
1969-08-27,1969,"Olympique Lyon","FC Sochaux","2-2",2,2,"1",1,4,0,"D"
1969-08-27,1969,"SC Bastia","Nimes Olympique","2-5",2,5,"1",1,7,-3,"D"
1969-08-27,1969,"Stade Rennes","FC Metz","2-0",2,0,"1",1,2,2,"H"
1969-08-29,1969,"Angers SCO","US Valenciennes-Anzin","0-1",0,1,"1",1,1,-1,"D"
1969-08-29,1969,"RC Strasbourg","AC Ajaccio","2-0",2,0,"1",1,2,2,"H"
1969-08-30,1969,"Red Star FC","Girondins Bordeaux","1-1",1,1,"1",1,2,0,"D"
1969-08-30,1969,"AS Angouleme","FC Nantes","2-2",2,2,"1",1,4,0,"D"
1969-08-30,1969,"CS Sedan","FC Rouen","1-0",1,0,"1",1,1,1,"H"
1969-09-03,1969,"AS Saint-Etienne","RC Strasbourg","3-0",3,0,"1",1,3,3,"H"
1969-09-03,1969,"FC Sochaux","Angers SCO","1-1",1,1,"1",1,2,0,"D"
1969-09-03,1969,"AC Ajaccio","Red Star FC","2-2",2,2,"1",1,4,0,"D"
1969-09-03,1969,"Girondins Bordeaux","Olympique Lyon","3-0",3,0,"1",1,3,3,"H"
1969-09-03,1969,"FC Rouen","Olympique Marseille","1-1",1,1,"1",1,2,0,"D"
1969-09-03,1969,"FC Metz","AS Angouleme","3-2",3,2,"1",1,5,1,"H"
1969-09-03,1969,"FC Nantes","Stade Rennes","6-1",6,1,"1",1,7,5,"H"
1969-09-03,1969,"Nimes Olympique","CS Sedan","5-1",5,1,"1",1,6,4,"H"
1969-09-03,1969,"US Valenciennes-Anzin","SC Bastia","2-0",2,0,"1",1,2,2,"H"
1969-09-17,1969,"Olympique Lyon","FC Rouen","3-0",3,0,"1",1,3,3,"H"
1969-09-19,1969,"RC Strasbourg","FC Nantes","2-1",2,1,"1",1,3,1,"H"
1969-09-20,1969,"Angers SCO","Girondins Bordeaux","3-1",3,1,"1",1,4,2,"H"
1969-09-20,1969,"Olympique Marseille","AC Ajaccio","1-0",1,0,"1",1,1,1,"H"
1969-09-20,1969,"AS Angouleme","Stade Rennes","3-0",3,0,"1",1,3,3,"H"
1969-09-20,1969,"FC Sochaux","Nimes Olympique","2-2",2,2,"1",1,4,0,"D"
1969-09-20,1969,"CS Sedan","US Valenciennes-Anzin","0-0",0,0,"1",1,0,0,"D"
1969-09-20,1969,"SC Bastia","FC Metz","2-2",2,2,"1",1,4,0,"D"
1969-09-21,1969,"Red Star FC","AS Saint-Etienne","1-5",1,5,"1",1,6,-4,"D"
1969-09-24,1969,"AS Saint-Etienne","AS Angouleme","1-1",1,1,"1",1,2,0,"D"
1969-09-24,1969,"Girondins Bordeaux","FC Sochaux","3-0",3,0,"1",1,3,3,"H"
1969-09-24,1969,"FC Metz","Olympique Marseille","2-1",2,1,"1",1,3,1,"H"
1969-09-24,1969,"FC Rouen","SC Bastia","3-0",3,0,"1",1,3,3,"H"
1969-09-24,1969,"AC Ajaccio","CS Sedan","0-1",0,1,"1",1,1,-1,"D"
1969-09-27,1969,"Nimes Olympique","Angers SCO","1-1",1,1,"1",1,2,0,"D"
1969-09-27,1969,"Stade Rennes","RC Strasbourg","4-5",4,5,"1",1,9,-1,"D"
1969-09-27,1969,"FC Nantes","Olympique Lyon","5-2",5,2,"1",1,7,3,"H"
1969-09-27,1969,"US Valenciennes-Anzin","Red Star FC","2-0",2,0,"1",1,2,2,"H"
1969-10-01,1969,"RC Strasbourg","AS Angouleme","3-1",3,1,"1",1,4,2,"H"
1969-10-04,1969,"Girondins Bordeaux","Nimes Olympique","1-0",1,0,"1",1,1,1,"H"
1969-10-04,1969,"Angers SCO","FC Nantes","0-3",0,3,"1",1,3,-3,"D"
1969-10-04,1969,"Red Star FC","FC Rouen","2-0",2,0,"1",1,2,2,"H"
1969-10-04,1969,"FC Sochaux","US Valenciennes-Anzin","6-1",6,1,"1",1,7,5,"H"
1969-10-04,1969,"CS Sedan","FC Metz","0-0",0,0,"1",1,0,0,"D"
1969-10-05,1969,"Olympique Lyon","AS Saint-Etienne","1-7",1,7,"1",1,8,-6,"D"
1969-10-05,1969,"Olympique Marseille","Stade Rennes","1-0",1,0,"1",1,1,1,"H"
1969-10-05,1969,"SC Bastia","AC Ajaccio","2-0",2,0,"1",1,2,2,"H"
1969-10-18,1969,"FC Nantes","SC Bastia","2-1",2,1,"1",1,3,1,"H"
1969-10-18,1969,"FC Metz","Angers SCO","2-1",2,1,"1",1,3,1,"H"
1969-10-18,1969,"Stade Rennes","Red Star FC","2-2",2,2,"1",1,4,0,"D"
1969-10-18,1969,"FC Rouen","FC Sochaux","1-3",1,3,"1",1,4,-2,"D"
1969-10-19,1969,"AC Ajaccio","Olympique Lyon","2-0",2,0,"1",1,2,2,"H"
1969-10-19,1969,"US Valenciennes-Anzin","Girondins Bordeaux","1-4",1,4,"1",1,5,-3,"D"
1969-10-21,1969,"AS Saint-Etienne","CS Sedan","3-1",3,1,"1",1,4,2,"H"
1969-10-22,1969,"AS Angouleme","Olympique Marseille","1-3",1,3,"1",1,4,-2,"D"
1969-10-22,1969,"Nimes Olympique","RC Strasbourg","3-2",3,2,"1",1,5,1,"H"
1969-10-24,1969,"Olympique Lyon","US Valenciennes-Anzin","1-0",1,0,"1",1,1,1,"H"
1969-10-25,1969,"FC Sochaux","AS Saint-Etienne","3-3",3,3,"1",1,6,0,"D"
1969-10-25,1969,"Girondins Bordeaux","FC Rouen","1-1",1,1,"1",1,2,0,"D"
1969-10-25,1969,"Angers SCO","AC Ajaccio","3-2",3,2,"1",1,5,1,"H"
1969-10-26,1969,"Olympique Marseille","RC Strasbourg","2-0",2,0,"1",1,2,2,"H"
1969-10-26,1969,"CS Sedan","FC Nantes","4-0",4,0,"1",1,4,4,"H"
1969-10-26,1969,"Red Star FC","AS Angouleme","0-0",0,0,"1",1,0,0,"D"
1969-10-26,1969,"Nimes Olympique","FC Metz","2-1",2,1,"1",1,3,1,"H"
1969-10-26,1969,"SC Bastia","Stade Rennes","4-0",4,0,"1",1,4,4,"H"
1969-11-02,1969,"US Valenciennes-Anzin","Nimes Olympique","0-2",0,2,"1",1,2,-2,"D"
1969-11-04,1969,"FC Metz","Girondins Bordeaux","4-1",4,1,"1",1,5,3,"H"
1969-11-04,1969,"Stade Rennes","CS Sedan","3-3",3,3,"1",1,6,0,"D"
1969-11-05,1969,"AS Saint-Etienne","SC Bastia","4-2",4,2,"1",1,6,2,"H"
1969-11-05,1969,"FC Nantes","Olympique Marseille","2-1",2,1,"1",1,3,1,"H"
1969-11-05,1969,"RC Strasbourg","Red Star FC","5-0",5,0,"1",1,5,5,"H"
1969-11-05,1969,"FC Rouen","Angers SCO","5-0",5,0,"1",1,5,5,"H"
1969-11-05,1969,"AS Angouleme","Olympique Lyon","1-1",1,1,"1",1,2,0,"D"
1969-11-05,1969,"AC Ajaccio","FC Sochaux","1-0",1,0,"1",1,1,1,"H"
1969-11-08,1969,"Olympique Lyon","Stade Rennes","4-4",4,4,"1",1,8,0,"D"
1969-11-09,1969,"Girondins Bordeaux","AC Ajaccio","2-1",2,1,"1",1,3,1,"H"
1969-11-09,1969,"Nimes Olympique","FC Rouen","6-1",6,1,"1",1,7,5,"H"
1969-11-09,1969,"SC Bastia","RC Strasbourg","2-1",2,1,"1",1,3,1,"H"
1969-11-09,1969,"CS Sedan","AS Angouleme","2-0",2,0,"1",1,2,2,"H"
1969-11-09,1969,"US Valenciennes-Anzin","FC Metz","0-0",0,0,"1",1,0,0,"D"
1969-11-15,1969,"FC Nantes","Red Star FC","1-1",1,1,"1",1,2,0,"D"
1969-11-15,1969,"FC Rouen","US Valenciennes-Anzin","3-3",3,3,"1",1,6,0,"D"
1969-11-16,1969,"AS Saint-Etienne","Girondins Bordeaux","2-0",2,0,"1",1,2,2,"H"
1969-11-16,1969,"Olympique Marseille","Olympique Lyon","4-1",4,1,"1",1,5,3,"H"
1969-11-16,1969,"AC Ajaccio","Nimes Olympique","1-0",1,0,"1",1,1,1,"H"
1969-11-16,1969,"RC Strasbourg","CS Sedan","2-3",2,3,"1",1,5,-1,"D"
1969-11-16,1969,"AS Angouleme","SC Bastia","5-1",5,1,"1",1,6,4,"H"
1969-11-16,1969,"FC Metz","FC Sochaux","1-2",1,2,"1",1,3,-1,"D"
1969-11-16,1969,"Stade Rennes","Angers SCO","1-0",1,0,"1",1,1,1,"H"
1969-11-20,1969,"Nimes Olympique","AS Saint-Etienne","1-3",1,3,"1",1,4,-2,"D"
1969-11-22,1969,"CS Sedan","Olympique Marseille","0-0",0,0,"1",1,0,0,"D"
1969-11-22,1969,"FC Sochaux","Stade Rennes","2-2",2,2,"1",1,4,0,"D"
1969-11-23,1969,"Girondins Bordeaux","FC Nantes","3-0",3,0,"1",1,3,3,"H"
1969-11-23,1969,"Olympique Lyon","RC Strasbourg","0-1",0,1,"1",1,1,-1,"D"
1969-11-23,1969,"Angers SCO","AS Angouleme","2-2",2,2,"1",1,4,0,"D"
1969-11-23,1969,"FC Rouen","FC Metz","1-1",1,1,"1",1,2,0,"D"
1969-11-23,1969,"SC Bastia","Red Star FC","3-0",3,0,"1",1,3,3,"H"
1969-11-23,1969,"US Valenciennes-Anzin","AC Ajaccio","2-1",2,1,"1",1,3,1,"H"
1969-11-29,1969,"FC Nantes","Nimes Olympique","1-0",1,0,"1",1,1,1,"H"
1969-11-30,1969,"AS Saint-Etienne","US Valenciennes-Anzin","1-0",1,0,"1",1,1,1,"H"
1969-11-30,1969,"Stade Rennes","Girondins Bordeaux","0-0",0,0,"1",1,0,0,"D"
1969-11-30,1969,"Olympique Marseille","SC Bastia","3-3",3,3,"1",1,6,0,"D"
1969-11-30,1969,"RC Strasbourg","Angers SCO","4-1",4,1,"1",1,5,3,"H"
1969-11-30,1969,"Red Star FC","CS Sedan","0-2",0,2,"1",1,2,-2,"D"
1969-11-30,1969,"AS Angouleme","FC Sochaux","4-0",4,0,"1",1,4,4,"H"
1969-11-30,1969,"FC Metz","Olympique Lyon","4-0",4,0,"1",1,4,4,"H"
1969-11-30,1969,"AC Ajaccio","FC Rouen","1-0",1,0,"1",1,1,1,"H"
1969-12-07,1969,"FC Rouen","AS Saint-Etienne","0-2",0,2,"1",1,2,-2,"D"
1969-12-07,1969,"Girondins Bordeaux","AS Angouleme","5-1",5,1,"1",1,6,4,"H"
1969-12-07,1969,"Angers SCO","Olympique Marseille","2-1",2,1,"1",1,3,1,"H"
1969-12-07,1969,"FC Sochaux","RC Strasbourg","2-0",2,0,"1",1,2,2,"H"
1969-12-07,1969,"CS Sedan","SC Bastia","0-2",0,2,"1",1,2,-2,"D"
1969-12-07,1969,"US Valenciennes-Anzin","FC Nantes","2-1",2,1,"1",1,3,1,"H"
1969-12-07,1969,"AC Ajaccio","FC Metz","0-0",0,0,"1",1,0,0,"D"
1969-12-07,1969,"Nimes Olympique","Stade Rennes","2-3",2,3,"1",1,5,-1,"D"
1969-12-07,1969,"Olympique Lyon","Red Star FC","2-0",2,0,"1",1,2,2,"H"
1969-12-13,1969,"FC Sochaux","SC Bastia","2-1",2,1,"1",1,3,1,"H"
1969-12-14,1969,"Girondins Bordeaux","Olympique Marseille","2-2",2,2,"1",1,4,0,"D"
1969-12-14,1969,"Angers SCO","CS Sedan","1-3",1,3,"1",1,4,-2,"D"
1969-12-14,1969,"US Valenciennes-Anzin","RC Strasbourg","2-0",2,0,"1",1,2,2,"H"
1969-12-14,1969,"Nimes Olympique","Olympique Lyon","5-2",5,2,"1",1,7,3,"H"
1969-12-14,1969,"AC Ajaccio","Stade Rennes","4-2",4,2,"1",1,6,2,"H"
1969-12-21,1969,"Stade Rennes","AS Saint-Etienne","1-0",1,0,"1",1,1,1,"H"
1969-12-21,1969,"SC Bastia","Girondins Bordeaux","2-2",2,2,"1",1,4,0,"D"
1969-12-21,1969,"Olympique Marseille","US Valenciennes-Anzin","3-1",3,1,"1",1,4,2,"H"
1969-12-21,1969,"AS Angouleme","AC Ajaccio","2-1",2,1,"1",1,3,1,"H"
1969-12-21,1969,"Red Star FC","Nimes Olympique","3-0",3,0,"1",1,3,3,"H"
1969-12-21,1969,"FC Nantes","FC Rouen","0-2",0,2,"1",1,2,-2,"D"
1969-12-21,1969,"Olympique Lyon","Angers SCO","2-1",2,1,"1",1,3,1,"H"
1970-01-18,1969,"FC Rouen","AS Angouleme","0-2",0,2,"1",1,2,-2,"D"
1970-01-25,1969,"FC Metz","AS Saint-Etienne","1-2",1,2,"1",1,3,-1,"D"
1970-01-25,1969,"Olympique Marseille","Nimes Olympique","4-0",4,0,"1",1,4,4,"H"
1970-01-25,1969,"AS Angouleme","US Valenciennes-Anzin","6-1",6,1,"1",1,7,5,"H"
1970-01-25,1969,"CS Sedan","Olympique Lyon","1-0",1,0,"1",1,1,1,"H"
1970-01-25,1969,"FC Nantes","AC Ajaccio","6-0",6,0,"1",1,6,6,"H"
1970-01-25,1969,"Red Star FC","FC Sochaux","1-0",1,0,"1",1,1,1,"H"
1970-01-25,1969,"SC Bastia","Angers SCO","3-1",3,1,"1",1,4,2,"H"
1970-01-25,1969,"Stade Rennes","FC Rouen","1-1",1,1,"1",1,2,0,"D"
1970-02-01,1969,"AS Saint-Etienne","Olympique Marseille","2-1",2,1,"1",1,3,1,"H"
1970-02-01,1969,"Girondins Bordeaux","Red Star FC","0-1",0,1,"1",1,1,-1,"D"
1970-02-01,1969,"FC Nantes","AS Angouleme","1-1",1,1,"1",1,2,0,"D"
1970-02-01,1969,"FC Rouen","CS Sedan","0-0",0,0,"1",1,0,0,"D"
1970-02-01,1969,"Nimes Olympique","SC Bastia","4-1",4,1,"1",1,5,3,"H"
1970-02-01,1969,"AC Ajaccio","RC Strasbourg","1-0",1,0,"1",1,1,1,"H"
1970-02-01,1969,"US Valenciennes-Anzin","Angers SCO","0-2",0,2,"1",1,2,-2,"D"
1970-02-01,1969,"FC Sochaux","Olympique Lyon","0-2",0,2,"1",1,2,-2,"D"
1970-02-01,1969,"FC Metz","Stade Rennes","2-0",2,0,"1",1,2,2,"H"
1970-02-15,1969,"RC Strasbourg","AS Saint-Etienne","1-1",1,1,"1",1,2,0,"D"
1970-02-15,1969,"Olympique Marseille","FC Rouen","2-0",2,0,"1",1,2,2,"H"
1970-02-15,1969,"Olympique Lyon","Girondins Bordeaux","1-3",1,3,"1",1,4,-2,"D"
1970-02-15,1969,"CS Sedan","Nimes Olympique","1-0",1,0,"1",1,1,1,"H"
1970-02-15,1969,"Stade Rennes","FC Nantes","1-2",1,2,"1",1,3,-1,"D"
1970-02-15,1969,"Red Star FC","AC Ajaccio","4-1",4,1,"1",1,5,3,"H"
1970-02-15,1969,"Angers SCO","FC Sochaux","2-2",2,2,"1",1,4,0,"D"
1970-02-22,1969,"AS Saint-Etienne","Red Star FC","0-0",0,0,"1",1,0,0,"D"
1970-02-22,1969,"AC Ajaccio","Olympique Marseille","2-4",2,4,"1",1,6,-2,"D"
1970-02-22,1969,"Girondins Bordeaux","Angers SCO","1-0",1,0,"1",1,1,1,"H"
1970-02-22,1969,"US Valenciennes-Anzin","CS Sedan","1-3",1,3,"1",1,4,-2,"D"
1970-02-22,1969,"Stade Rennes","AS Angouleme","2-0",2,0,"1",1,2,2,"H"
1970-02-22,1969,"FC Nantes","RC Strasbourg","0-1",0,1,"1",1,1,-1,"D"
1970-02-22,1969,"Nimes Olympique","FC Sochaux","2-0",2,0,"1",1,2,2,"H"
1970-02-22,1969,"FC Metz","SC Bastia","3-0",3,0,"1",1,3,3,"H"
1970-02-22,1969,"FC Rouen","Olympique Lyon","1-0",1,0,"1",1,1,1,"H"
1970-03-06,1969,"RC Strasbourg","Stade Rennes","1-1",1,1,"1",1,2,0,"D"
1970-03-08,1969,"AS Angouleme","AS Saint-Etienne","0-1",0,1,"1",1,1,-1,"D"
1970-03-08,1969,"Olympique Marseille","FC Metz","3-2",3,2,"1",1,5,1,"H"
1970-03-08,1969,"Olympique Lyon","FC Nantes","2-5",2,5,"1",1,7,-3,"D"
1970-03-08,1969,"Red Star FC","US Valenciennes-Anzin","1-1",1,1,"1",1,2,0,"D"
1970-03-08,1969,"Angers SCO","Nimes Olympique","1-0",1,0,"1",1,1,1,"H"
1970-03-08,1969,"SC Bastia","FC Rouen","0-2",0,2,"1",1,2,-2,"D"
1970-03-14,1969,"Nimes Olympique","Girondins Bordeaux","3-0",3,0,"1",1,3,3,"H"
1970-03-14,1969,"FC Nantes","Angers SCO","1-0",1,0,"1",1,1,1,"H"
1970-03-14,1969,"FC Rouen","Red Star FC","2-0",2,0,"1",1,2,2,"H"
1970-03-15,1969,"AS Saint-Etienne","Olympique Lyon","6-0",6,0,"1",1,6,6,"H"
1970-03-15,1969,"Stade Rennes","Olympique Marseille","1-1",1,1,"1",1,2,0,"D"
1970-03-15,1969,"FC Metz","CS Sedan","0-2",0,2,"1",1,2,-2,"D"
1970-03-15,1969,"AS Angouleme","RC Strasbourg","1-1",1,1,"1",1,2,0,"D"
1970-03-15,1969,"US Valenciennes-Anzin","FC Sochaux","0-1",0,1,"1",1,1,-1,"D"
1970-03-15,1969,"AC Ajaccio","SC Bastia","2-0",2,0,"1",1,2,2,"H"
1970-03-20,1969,"RC Strasbourg","Girondins Bordeaux","3-1",3,1,"1",1,4,2,"H"
1970-03-22,1969,"Red Star FC","Olympique Marseille","1-6",1,6,"1",1,7,-5,"D"
1970-03-22,1969,"CS Sedan","FC Sochaux","3-0",3,0,"1",1,3,3,"H"
1970-03-27,1969,"FC Sochaux","Girondins Bordeaux","3-2",3,2,"1",1,5,1,"H"
1970-03-28,1969,"CS Sedan","AC Ajaccio","2-0",2,0,"1",1,2,2,"H"
1970-04-01,1969,"Olympique Marseille","AS Angouleme","1-1",1,1,"1",1,2,0,"D"
1970-04-01,1969,"Girondins Bordeaux","US Valenciennes-Anzin","0-2",0,2,"1",1,2,-2,"D"
1970-04-01,1969,"SC Bastia","FC Nantes","3-2",3,2,"1",1,5,1,"H"
1970-04-01,1969,"Angers SCO","FC Metz","0-0",0,0,"1",1,0,0,"D"
1970-04-01,1969,"Olympique Lyon","AC Ajaccio","2-1",2,1,"1",1,3,1,"H"
1970-04-04,1969,"FC Sochaux","FC Rouen","1-1",1,1,"1",1,2,0,"D"
1970-04-05,1969,"Red Star FC","Stade Rennes","2-4",2,4,"1",1,6,-2,"D"
1970-04-11,1969,"RC Strasbourg","Nimes Olympique","4-1",4,1,"1",1,5,3,"H"
1970-04-14,1969,"FC Metz","Nimes Olympique","3-1",3,1,"1",1,4,2,"H"
1970-04-15,1969,"AS Saint-Etienne","FC Sochaux","2-0",2,0,"1",1,2,2,"H"
1970-04-15,1969,"FC Nantes","CS Sedan","2-2",2,2,"1",1,4,0,"D"
1970-04-15,1969,"FC Rouen","Girondins Bordeaux","0-0",0,0,"1",1,0,0,"D"
1970-04-15,1969,"AC Ajaccio","Angers SCO","0-1",0,1,"1",1,1,-1,"D"
1970-04-15,1969,"Stade Rennes","SC Bastia","3-1",3,1,"1",1,4,2,"H"
1970-04-15,1969,"US Valenciennes-Anzin","Olympique Lyon","1-1",1,1,"1",1,2,0,"D"
1970-04-18,1969,"RC Strasbourg","Olympique Marseille","2-3",2,3,"1",1,5,-1,"D"
1970-04-18,1969,"AS Angouleme","Red Star FC","1-1",1,1,"1",1,2,0,"D"
1970-04-22,1969,"SC Bastia","AS Saint-Etienne","0-1",0,1,"1",1,1,-1,"D"
1970-04-22,1969,"Olympique Marseille","FC Nantes","4-2",4,2,"1",1,6,2,"H"
1970-04-22,1969,"CS Sedan","Stade Rennes","3-2",3,2,"1",1,5,1,"H"
1970-04-22,1969,"Girondins Bordeaux","FC Metz","1-0",1,0,"1",1,1,1,"H"
1970-04-22,1969,"Olympique Lyon","AS Angouleme","1-2",1,2,"1",1,3,-1,"D"
1970-04-22,1969,"Red Star FC","RC Strasbourg","2-1",2,1,"1",1,3,1,"H"
1970-04-22,1969,"Angers SCO","FC Rouen","1-1",1,1,"1",1,2,0,"D"
1970-04-22,1969,"Nimes Olympique","US Valenciennes-Anzin","2-1",2,1,"1",1,3,1,"H"
1970-04-22,1969,"FC Sochaux","AC Ajaccio","0-2",0,2,"1",1,2,-2,"D"
1970-04-25,1969,"FC Metz","Red Star FC","2-1",2,1,"1",1,3,1,"H"
1970-05-03,1969,"SC Bastia","US Valenciennes-Anzin","3-1",3,1,"1",1,4,2,"H"
1970-05-03,1969,"AS Angouleme","FC Metz","2-1",2,1,"1",1,3,1,"H"
1970-05-09,1969,"RC Strasbourg","FC Metz","2-0",2,0,"1",1,2,2,"H"
1970-05-12,1969,"Girondins Bordeaux","AS Saint-Etienne","1-4",1,4,"1",1,5,-3,"D"
1970-05-12,1969,"Angers SCO","Stade Rennes","1-0",1,0,"1",1,1,1,"H"
1970-05-13,1969,"Olympique Lyon","Olympique Marseille","1-0",1,0,"1",1,1,1,"H"
1970-05-13,1969,"CS Sedan","RC Strasbourg","2-1",2,1,"1",1,3,1,"H"
1970-05-13,1969,"SC Bastia","AS Angouleme","1-1",1,1,"1",1,2,0,"D"
1970-05-13,1969,"US Valenciennes-Anzin","FC Rouen","1-3",1,3,"1",1,4,-2,"D"
1970-05-13,1969,"Red Star FC","FC Nantes","3-0",3,0,"1",1,3,3,"H"
1970-05-13,1969,"Nimes Olympique","AC Ajaccio","2-0",2,0,"1",1,2,2,"H"
1970-05-16,1969,"FC Sochaux","FC Metz","4-1",4,1,"1",1,5,3,"H"
1970-05-20,1969,"AS Saint-Etienne","Nimes Olympique","2-1",2,1,"1",1,3,1,"H"
1970-05-20,1969,"Olympique Marseille","CS Sedan","2-0",2,0,"1",1,2,2,"H"
1970-05-20,1969,"FC Nantes","Girondins Bordeaux","1-1",1,1,"1",1,2,0,"D"
1970-05-20,1969,"Red Star FC","SC Bastia","2-1",2,1,"1",1,3,1,"H"
1970-05-20,1969,"Stade Rennes","FC Sochaux","2-4",2,4,"1",1,6,-2,"D"
1970-05-22,1969,"AC Ajaccio","US Valenciennes-Anzin","3-1",3,1,"1",1,4,2,"H"
1970-05-23,1969,"AS Angouleme","Angers SCO","1-1",1,1,"1",1,2,0,"D"
1970-05-23,1969,"RC Strasbourg","Olympique Lyon","2-1",2,1,"1",1,3,1,"H"
1970-05-23,1969,"FC Metz","FC Rouen","2-0",2,0,"1",1,2,2,"H"
1970-05-27,1969,"US Valenciennes-Anzin","AS Saint-Etienne","0-3",0,3,"1",1,3,-3,"D"
1970-05-27,1969,"SC Bastia","Olympique Marseille","3-2",3,2,"1",1,5,1,"H"
1970-05-27,1969,"Girondins Bordeaux","Stade Rennes","1-1",1,1,"1",1,2,0,"D"
1970-05-27,1969,"Angers SCO","RC Strasbourg","4-1",4,1,"1",1,5,3,"H"
1970-05-27,1969,"FC Rouen","AC Ajaccio","2-0",2,0,"1",1,2,2,"H"
1970-05-27,1969,"Nimes Olympique","FC Nantes","4-2",4,2,"1",1,6,2,"H"
1970-05-27,1969,"Olympique Lyon","FC Metz","2-4",2,4,"1",1,6,-2,"D"
1970-05-30,1969,"CS Sedan","Red Star FC","3-0",3,0,"1",1,3,3,"H"
1970-05-30,1969,"FC Sochaux","AS Angouleme","1-0",1,0,"1",1,1,1,"H"
1970-06-03,1969,"AS Saint-Etienne","FC Rouen","5-0",5,0,"1",1,5,5,"H"
1970-06-03,1969,"Olympique Marseille","Angers SCO","5-2",5,2,"1",1,7,3,"H"
1970-06-03,1969,"SC Bastia","CS Sedan","2-3",2,3,"1",1,5,-1,"D"
1970-06-03,1969,"RC Strasbourg","FC Sochaux","2-2",2,2,"1",1,4,0,"D"
1970-06-03,1969,"Stade Rennes","Nimes Olympique","1-1",1,1,"1",1,2,0,"D"
1970-06-03,1969,"Red Star FC","Olympique Lyon","1-5",1,5,"1",1,6,-4,"D"
1970-06-03,1969,"FC Nantes","US Valenciennes-Anzin","1-2",1,2,"1",1,3,-1,"D"
1970-06-05,1969,"AS Angouleme","Girondins Bordeaux","3-2",3,2,"1",1,5,1,"H"
1970-06-06,1969,"FC Sochaux","FC Nantes","0-3",0,3,"1",1,3,-3,"D"
1970-06-06,1969,"Angers SCO","AS Saint-Etienne","0-0",0,0,"1",1,0,0,"D"
1970-06-06,1969,"CS Sedan","AS Saint-Etienne","1-2",1,2,"1",1,3,-1,"D"
1970-06-06,1969,"FC Metz","AC Ajaccio","1-0",1,0,"1",1,1,1,"H"
1970-06-06,1969,"Olympique Marseille","Red Star FC","4-0",4,0,"1",1,4,4,"H"
1970-06-09,1969,"FC Rouen","RC Strasbourg","1-1",1,1,"1",1,2,0,"D"
1970-06-10,1969,"AC Ajaccio","AS Saint-Etienne","1-2",1,2,"1",1,3,-1,"D"
1970-06-10,1969,"Nimes Olympique","AS Angouleme","2-2",2,2,"1",1,4,0,"D"
1970-06-10,1969,"Angers SCO","Red Star FC","5-1",5,1,"1",1,6,4,"H"
1970-06-10,1969,"FC Metz","FC Nantes","2-2",2,2,"1",1,4,0,"D"
1970-06-10,1969,"Olympique Lyon","SC Bastia","2-1",2,1,"1",1,3,1,"H"
1970-06-10,1969,"US Valenciennes-Anzin","Stade Rennes","0-1",0,1,"1",1,1,-1,"D"
1970-06-13,1969,"AS Saint-Etienne","FC Nantes","2-3",2,3,"1",1,5,-1,"D"
1970-06-13,1969,"FC Sochaux","Olympique Marseille","2-2",2,2,"1",1,4,0,"D"
1970-06-13,1969,"Girondins Bordeaux","CS Sedan","4-1",4,1,"1",1,5,3,"H"
1970-06-17,1969,"AS Saint-Etienne","Angers SCO","1-2",1,2,"1",1,3,-1,"D"
1970-06-17,1969,"RC Strasbourg","SC Bastia","4-0",4,0,"1",1,4,4,"H"
1970-06-17,1969,"AC Ajaccio","Girondins Bordeaux","1-1",1,1,"1",1,2,0,"D"
1970-06-17,1969,"FC Nantes","FC Sochaux","1-2",1,2,"1",1,3,-1,"D"
1970-06-17,1969,"FC Rouen","Nimes Olympique","1-1",1,1,"1",1,2,0,"D"
1970-06-17,1969,"Stade Rennes","Olympique Lyon","4-3",4,3,"1",1,7,1,"H"
1970-06-20,1969,"AS Angouleme","CS Sedan","2-1",2,1,"1",1,3,1,"H"
1970-06-23,1969,"FC Metz","US Valenciennes-Anzin","3-0",3,0,"1",1,3,3,"H"
1970-08-12,1970,"AC Ajaccio","AS Nancy","5-0",5,0,"1",1,5,5,"H"
1970-08-12,1970,"CS Sedan","Angers SCO","6-2",6,2,"1",1,8,4,"H"
1970-08-12,1970,"Nimes Olympique","AS Angouleme","3-1",3,1,"1",1,4,2,"H"
1970-08-12,1970,"OGC Nice","Olympique Lyon","2-0",2,0,"1",1,2,2,"H"
1970-08-12,1970,"AS Saint-Etienne","FC Nantes","2-3",2,3,"1",1,5,-1,"D"
1970-08-12,1970,"Red Star FC","US Valenciennes-Anzin","3-2",3,2,"1",1,5,1,"H"
1970-08-12,1970,"RC Strasbourg","Olympique Marseille","1-2",1,2,"1",1,3,-1,"D"
1970-08-12,1970,"Girondins Bordeaux","FC Sochaux","1-2",1,2,"1",1,3,-1,"D"
1970-08-12,1970,"FC Metz","SC Bastia","1-0",1,0,"1",1,1,1,"H"
1970-08-12,1970,"Stade Rennes","Stade Reims","0-0",0,0,"1",1,0,0,"D"
1970-08-19,1970,"FC Nantes","CS Sedan","2-0",2,0,"1",1,2,2,"H"
1970-08-19,1970,"FC Sochaux","Red Star FC","2-1",2,1,"1",1,3,1,"H"
1970-08-19,1970,"Olympique Marseille","AC Ajaccio","1-0",1,0,"1",1,1,1,"H"
1970-08-19,1970,"Stade Reims","Girondins Bordeaux","3-0",3,0,"1",1,3,3,"H"
1970-08-19,1970,"FC Metz","OGC Nice","0-0",0,0,"1",1,0,0,"D"
1970-08-19,1970,"US Valenciennes-Anzin","Nimes Olympique","3-1",3,1,"1",1,4,2,"H"
1970-08-19,1970,"SC Bastia","Stade Rennes","2-2",2,2,"1",1,4,0,"D"
1970-08-19,1970,"Angers SCO","AS Nancy","2-1",2,1,"1",1,3,1,"H"
1970-08-19,1970,"AS Angouleme","AS Saint-Etienne","1-1",1,1,"1",1,2,0,"D"
1970-08-19,1970,"Olympique Lyon","RC Strasbourg","2-2",2,2,"1",1,4,0,"D"
1970-08-22,1970,"AS Nancy","FC Nantes","1-2",1,2,"1",1,3,-1,"D"
1970-08-22,1970,"OGC Nice","SC Bastia","2-0",2,0,"1",1,2,2,"H"
1970-08-22,1970,"Nimes Olympique","Olympique Marseille","3-0",3,0,"1",1,3,3,"H"
1970-08-22,1970,"AS Saint-Etienne","FC Sochaux","1-0",1,0,"1",1,1,1,"H"
1970-08-22,1970,"Stade Rennes","FC Metz","0-0",0,0,"1",1,0,0,"D"
1970-08-22,1970,"AC Ajaccio","Angers SCO","0-0",0,0,"1",1,0,0,"D"
1970-08-22,1970,"CS Sedan","AS Angouleme","1-1",1,1,"1",1,2,0,"D"
1970-08-22,1970,"RC Strasbourg","US Valenciennes-Anzin","0-0",0,0,"1",1,0,0,"D"
1970-08-22,1970,"Girondins Bordeaux","Olympique Lyon","3-0",3,0,"1",1,3,3,"H"
1970-08-23,1970,"Red Star FC","Stade Reims","2-1",2,1,"1",1,3,1,"H"
1970-08-26,1970,"FC Nantes","Angers SCO","1-0",1,0,"1",1,1,1,"H"
1970-08-26,1970,"Olympique Marseille","CS Sedan","5-0",5,0,"1",1,5,5,"H"
1970-08-26,1970,"Stade Reims","OGC Nice","1-1",1,1,"1",1,2,0,"D"
1970-08-26,1970,"FC Sochaux","RC Strasbourg","1-0",1,0,"1",1,1,1,"H"
1970-08-26,1970,"FC Metz","Girondins Bordeaux","1-0",1,0,"1",1,1,1,"H"
1970-08-26,1970,"Stade Rennes","Nimes Olympique","2-0",2,0,"1",1,2,2,"H"
1970-08-26,1970,"US Valenciennes-Anzin","AS Saint-Etienne","0-1",0,1,"1",1,1,-1,"D"
1970-08-26,1970,"SC Bastia","Red Star FC","2-1",2,1,"1",1,3,1,"H"
1970-08-26,1970,"AS Angouleme","AS Nancy","1-0",1,0,"1",1,1,1,"H"
1970-08-26,1970,"Olympique Lyon","AC Ajaccio","3-0",3,0,"1",1,3,3,"H"
1970-08-29,1970,"AC Ajaccio","FC Nantes","2-1",2,1,"1",1,3,1,"H"
1970-08-29,1970,"OGC Nice","Stade Rennes","0-1",0,1,"1",1,1,-1,"D"
1970-08-29,1970,"Angers SCO","AS Angouleme","1-4",1,4,"1",1,5,-3,"D"
1970-08-29,1970,"AS Nancy","FC Sochaux","2-1",2,1,"1",1,3,1,"H"
1970-08-29,1970,"Nimes Olympique","Olympique Lyon","1-1",1,1,"1",1,2,0,"D"
1970-08-29,1970,"CS Sedan","US Valenciennes-Anzin","0-1",0,1,"1",1,1,-1,"D"
1970-08-29,1970,"Girondins Bordeaux","SC Bastia","2-0",2,0,"1",1,2,2,"H"
1970-08-29,1970,"RC Strasbourg","Stade Reims","2-0",2,0,"1",1,2,2,"H"
1970-08-30,1970,"Red Star FC","FC Metz","0-0",0,0,"1",1,0,0,"D"
1970-09-09,1970,"Stade Rennes","Girondins Bordeaux","3-0",3,0,"1",1,3,3,"H"
1970-09-09,1970,"Olympique Marseille","Angers SCO","5-1",5,1,"1",1,6,4,"H"
1970-09-09,1970,"AS Angouleme","FC Nantes","1-0",1,0,"1",1,1,1,"H"
1970-09-09,1970,"FC Sochaux","CS Sedan","3-1",3,1,"1",1,4,2,"H"
1970-09-09,1970,"FC Metz","AS Saint-Etienne","2-2",2,2,"1",1,4,0,"D"
1970-09-09,1970,"OGC Nice","AC Ajaccio","2-3",2,3,"1",1,5,-1,"D"
1970-09-09,1970,"Stade Reims","Nimes Olympique","1-1",1,1,"1",1,2,0,"D"
1970-09-09,1970,"US Valenciennes-Anzin","AS Nancy","1-1",1,1,"1",1,2,0,"D"
1970-09-09,1970,"Olympique Lyon","Red Star FC","2-1",2,1,"1",1,3,1,"H"
1970-09-09,1970,"SC Bastia","RC Strasbourg","3-1",3,1,"1",1,4,2,"H"
1970-09-19,1970,"FC Nantes","FC Sochaux","1-1",1,1,"1",1,2,0,"D"
1970-09-19,1970,"AS Nancy","Olympique Marseille","2-0",2,0,"1",1,2,2,"H"
1970-09-19,1970,"Nimes Olympique","SC Bastia","2-0",2,0,"1",1,2,2,"H"
1970-09-19,1970,"AS Saint-Etienne","Stade Reims","3-1",3,1,"1",1,4,2,"H"
1970-09-19,1970,"RC Strasbourg","FC Metz","2-1",2,1,"1",1,3,1,"H"
1970-09-19,1970,"Angers SCO","US Valenciennes-Anzin","5-3",5,3,"1",1,8,2,"H"
1970-09-19,1970,"CS Sedan","Olympique Lyon","3-1",3,1,"1",1,4,2,"H"
1970-09-20,1970,"AC Ajaccio","AS Angouleme","0-0",0,0,"1",1,0,0,"D"
1970-09-20,1970,"Girondins Bordeaux","OGC Nice","3-1",3,1,"1",1,4,2,"H"
1970-09-20,1970,"Red Star FC","Stade Rennes","1-5",1,5,"1",1,6,-4,"D"
1970-09-23,1970,"Stade Rennes","RC Strasbourg","2-0",2,0,"1",1,2,2,"H"
1970-09-23,1970,"US Valenciennes-Anzin","FC Nantes","1-2",1,2,"1",1,3,-1,"D"
1970-09-23,1970,"Olympique Marseille","AS Angouleme","5-0",5,0,"1",1,5,5,"H"
1970-09-23,1970,"SC Bastia","AS Saint-Etienne","4-2",4,2,"1",1,6,2,"H"
1970-09-23,1970,"Olympique Lyon","AS Nancy","2-1",2,1,"1",1,3,1,"H"
1970-09-23,1970,"Stade Reims","Angers SCO","3-1",3,1,"1",1,4,2,"H"
1970-09-23,1970,"OGC Nice","Red Star FC","1-1",1,1,"1",1,2,0,"D"
1970-09-23,1970,"Girondins Bordeaux","CS Sedan","1-2",1,2,"1",1,3,-1,"D"
1970-09-26,1970,"FC Sochaux","AC Ajaccio","5-1",5,1,"1",1,6,4,"H"
1970-09-26,1970,"FC Metz","Nimes Olympique","4-2",4,2,"1",1,6,2,"H"
1970-10-03,1970,"Angers SCO","Stade Rennes","2-1",2,1,"1",1,3,1,"H"
1970-10-03,1970,"FC Nantes","Olympique Marseille","1-3",1,3,"1",1,4,-2,"D"
1970-10-03,1970,"Nimes Olympique","FC Sochaux","4-3",4,3,"1",1,7,1,"H"
1970-10-03,1970,"AS Nancy","FC Metz","1-1",1,1,"1",1,2,0,"D"
1970-10-03,1970,"AS Angouleme","US Valenciennes-Anzin","1-0",1,0,"1",1,1,1,"H"
1970-10-03,1970,"AS Saint-Etienne","Olympique Lyon","1-0",1,0,"1",1,1,1,"H"
1970-10-03,1970,"CS Sedan","Stade Reims","1-1",1,1,"1",1,2,0,"D"
1970-10-03,1970,"RC Strasbourg","OGC Nice","2-2",2,2,"1",1,4,0,"D"
1970-10-03,1970,"Red Star FC","Girondins Bordeaux","3-1",3,1,"1",1,4,2,"H"
1970-10-04,1970,"AC Ajaccio","SC Bastia","6-1",6,1,"1",1,7,5,"H"
1970-10-10,1970,"FC Sochaux","AS Angouleme","3-0",3,0,"1",1,3,3,"H"
1970-10-10,1970,"FC Metz","CS Sedan","1-0",1,0,"1",1,1,1,"H"
1970-10-10,1970,"Olympique Lyon","FC Nantes","2-0",2,0,"1",1,2,2,"H"
1970-10-10,1970,"Stade Reims","AC Ajaccio","1-0",1,0,"1",1,1,1,"H"
1970-10-10,1970,"OGC Nice","Nimes Olympique","3-0",3,0,"1",1,3,3,"H"
1970-10-10,1970,"Girondins Bordeaux","RC Strasbourg","1-4",1,4,"1",1,5,-3,"D"
1970-10-11,1970,"US Valenciennes-Anzin","Olympique Marseille","1-2",1,2,"1",1,3,-1,"D"
1970-10-11,1970,"Stade Rennes","AS Saint-Etienne","0-3",0,3,"1",1,3,-3,"D"
1970-10-11,1970,"Red Star FC","Angers SCO","0-5",0,5,"1",1,5,-5,"D"
1970-10-11,1970,"SC Bastia","AS Nancy","0-2",0,2,"1",1,2,-2,"D"
1970-10-18,1970,"AS Saint-Etienne","Olympique Marseille","2-1",2,1,"1",1,3,1,"H"
1970-10-24,1970,"FC Metz","Angers SCO","2-1",2,1,"1",1,3,1,"H"
1970-10-24,1970,"Stade Rennes","AS Nancy","5-1",5,1,"1",1,6,4,"H"
1970-10-24,1970,"FC Sochaux","US Valenciennes-Anzin","0-1",0,1,"1",1,1,-1,"D"
1970-10-24,1970,"Stade Reims","AS Angouleme","2-0",2,0,"1",1,2,2,"H"
1970-10-24,1970,"RC Strasbourg","Nimes Olympique","0-2",0,2,"1",1,2,-2,"D"
1970-10-25,1970,"OGC Nice","CS Sedan","2-0",2,0,"1",1,2,2,"H"
1970-10-25,1970,"Red Star FC","AC Ajaccio","3-0",3,0,"1",1,3,3,"H"
1970-10-25,1970,"SC Bastia","FC Nantes","1-0",1,0,"1",1,1,1,"H"
1970-10-25,1970,"Girondins Bordeaux","AS Saint-Etienne","1-2",1,2,"1",1,3,-1,"D"
1970-10-25,1970,"Olympique Lyon","Olympique Marseille","1-4",1,4,"1",1,5,-3,"D"
1970-10-28,1970,"AS Saint-Etienne","RC Strasbourg","2-1",2,1,"1",1,3,1,"H"
1970-10-28,1970,"FC Nantes","Stade Reims","3-0",3,0,"1",1,3,3,"H"
1970-10-30,1970,"AS Nancy","OGC Nice","0-0",0,0,"1",1,0,0,"D"
1970-10-31,1970,"AS Angouleme","SC Bastia","2-2",2,2,"1",1,4,0,"D"
1970-10-31,1970,"Nimes Olympique","Red Star FC","1-2",1,2,"1",1,3,-1,"D"
1970-11-01,1970,"Olympique Marseille","FC Metz","2-1",2,1,"1",1,3,1,"H"
1970-11-01,1970,"CS Sedan","Stade Rennes","0-1",0,1,"1",1,1,-1,"D"
1970-11-01,1970,"AC Ajaccio","Girondins Bordeaux","2-0",2,0,"1",1,2,2,"H"
1970-11-01,1970,"US Valenciennes-Anzin","Olympique Lyon","1-2",1,2,"1",1,3,-1,"D"
1970-11-12,1970,"Nimes Olympique","Girondins Bordeaux","1-1",1,1,"1",1,2,0,"D"
1970-11-12,1970,"Angers SCO","Olympique Lyon","3-2",3,2,"1",1,5,1,"H"
1970-11-12,1970,"CS Sedan","SC Bastia","5-1",5,1,"1",1,6,4,"H"
1970-11-14,1970,"Olympique Marseille","FC Sochaux","2-2",2,2,"1",1,4,0,"D"
1970-11-14,1970,"AS Saint-Etienne","OGC Nice","2-1",2,1,"1",1,3,1,"H"
1970-11-14,1970,"FC Nantes","FC Metz","0-0",0,0,"1",1,0,0,"D"
1970-11-14,1970,"RC Strasbourg","Red Star FC","2-1",2,1,"1",1,3,1,"H"
1970-11-14,1970,"AS Nancy","Stade Reims","2-2",2,2,"1",1,4,0,"D"
1970-11-18,1970,"AS Angouleme","Stade Rennes","1-0",1,0,"1",1,1,1,"H"
1970-11-18,1970,"AC Ajaccio","US Valenciennes-Anzin","1-0",1,0,"1",1,1,1,"H"
1970-11-18,1970,"SC Bastia","Olympique Marseille","0-3",0,3,"1",1,3,-3,"D"
1970-11-18,1970,"Red Star FC","AS Saint-Etienne","1-1",1,1,"1",1,2,0,"D"
1970-11-18,1970,"Stade Rennes","FC Nantes","4-0",4,0,"1",1,4,4,"H"
1970-11-18,1970,"FC Metz","AS Angouleme","1-0",1,0,"1",1,1,1,"H"
1970-11-18,1970,"OGC Nice","Angers SCO","2-1",2,1,"1",1,3,1,"H"
1970-11-18,1970,"Nimes Olympique","CS Sedan","4-0",4,0,"1",1,4,4,"H"
1970-11-18,1970,"Stade Reims","US Valenciennes-Anzin","2-0",2,0,"1",1,2,2,"H"
1970-11-18,1970,"Olympique Lyon","FC Sochaux","2-0",2,0,"1",1,2,2,"H"
1970-11-18,1970,"RC Strasbourg","AC Ajaccio","3-0",3,0,"1",1,3,3,"H"
1970-11-18,1970,"Girondins Bordeaux","AS Nancy","2-3",2,3,"1",1,5,-1,"D"
1970-11-22,1970,"Olympique Marseille","Stade Reims","1-0",1,0,"1",1,1,1,"H"
1970-11-22,1970,"AS Saint-Etienne","Nimes Olympique","0-0",0,0,"1",1,0,0,"D"
1970-11-22,1970,"AC Ajaccio","Stade Rennes","3-0",3,0,"1",1,3,3,"H"
1970-11-22,1970,"FC Sochaux","FC Metz","5-1",5,1,"1",1,6,4,"H"
1970-11-22,1970,"FC Nantes","OGC Nice","3-1",3,1,"1",1,4,2,"H"
1970-11-22,1970,"AS Angouleme","Olympique Lyon","2-2",2,2,"1",1,4,0,"D"
1970-11-22,1970,"AS Nancy","Red Star FC","0-0",0,0,"1",1,0,0,"D"
1970-11-22,1970,"CS Sedan","RC Strasbourg","1-0",1,0,"1",1,1,1,"H"
1970-11-22,1970,"Angers SCO","Girondins Bordeaux","0-3",0,3,"1",1,3,-3,"D"
1970-11-22,1970,"US Valenciennes-Anzin","SC Bastia","2-0",2,0,"1",1,2,2,"H"
1970-11-29,1970,"Stade Rennes","Olympique Marseille","2-2",2,2,"1",1,4,0,"D"
1970-11-29,1970,"AS Saint-Etienne","Angers SCO","3-1",3,1,"1",1,4,2,"H"
1970-11-29,1970,"FC Metz","US Valenciennes-Anzin","2-2",2,2,"1",1,4,0,"D"
1970-11-29,1970,"Nimes Olympique","AC Ajaccio","4-0",4,0,"1",1,4,4,"H"
1970-11-29,1970,"Girondins Bordeaux","FC Nantes","2-3",2,3,"1",1,5,-1,"D"
1970-11-29,1970,"SC Bastia","FC Sochaux","2-2",2,2,"1",1,4,0,"D"
1970-11-29,1970,"OGC Nice","AS Angouleme","3-1",3,1,"1",1,4,2,"H"
1970-11-29,1970,"Stade Reims","Olympique Lyon","1-0",1,0,"1",1,1,1,"H"
1970-11-29,1970,"Red Star FC","CS Sedan","4-2",4,2,"1",1,6,2,"H"
1970-11-29,1970,"RC Strasbourg","AS Nancy","0-2",0,2,"1",1,2,-2,"D"
1970-12-05,1970,"AS Nancy","Nimes Olympique","2-0",2,0,"1",1,2,2,"H"
1970-12-05,1970,"AS Angouleme","Girondins Bordeaux","1-1",1,1,"1",1,2,0,"D"
1970-12-06,1970,"Olympique Marseille","OGC Nice","4-0",4,0,"1",1,4,4,"H"
1970-12-06,1970,"CS Sedan","AS Saint-Etienne","3-1",3,1,"1",1,4,2,"H"
1970-12-06,1970,"US Valenciennes-Anzin","Stade Rennes","0-0",0,0,"1",1,0,0,"D"
1970-12-06,1970,"FC Sochaux","Stade Reims","2-1",2,1,"1",1,3,1,"H"
1970-12-06,1970,"FC Nantes","Red Star FC","1-1",1,1,"1",1,2,0,"D"
1970-12-06,1970,"AC Ajaccio","FC Metz","2-0",2,0,"1",1,2,2,"H"
1970-12-06,1970,"Olympique Lyon","SC Bastia","1-1",1,1,"1",1,2,0,"D"
1970-12-06,1970,"Angers SCO","RC Strasbourg","1-3",1,3,"1",1,4,-2,"D"
1970-12-09,1970,"Angers SCO","FC Sochaux","1-0",1,0,"1",1,1,1,"H"
1970-12-13,1970,"Girondins Bordeaux","Olympique Marseille","3-1",3,1,"1",1,4,2,"H"
1970-12-13,1970,"AS Saint-Etienne","AS Nancy","4-1",4,1,"1",1,5,3,"H"
1970-12-13,1970,"Stade Rennes","FC Sochaux","4-0",4,0,"1",1,4,4,"H"
1970-12-13,1970,"FC Metz","Olympique Lyon","6-1",6,1,"1",1,7,5,"H"
1970-12-13,1970,"RC Strasbourg","FC Nantes","2-2",2,2,"1",1,4,0,"D"
1970-12-13,1970,"SC Bastia","Stade Reims","0-6",0,6,"1",1,6,-6,"D"
1970-12-13,1970,"OGC Nice","US Valenciennes-Anzin","4-2",4,2,"1",1,6,2,"H"
1970-12-13,1970,"Nimes Olympique","Angers SCO","0-1",0,1,"1",1,1,-1,"D"
1970-12-13,1970,"CS Sedan","AC Ajaccio","3-1",3,1,"1",1,4,2,"H"
1970-12-13,1970,"Red Star FC","AS Angouleme","0-0",0,0,"1",1,0,0,"D"
1970-12-20,1970,"AS Angouleme","RC Strasbourg","0-1",0,1,"1",1,1,-1,"D"
1970-12-20,1970,"Olympique Marseille","Red Star FC","1-1",1,1,"1",1,2,0,"D"
1970-12-20,1970,"AC Ajaccio","AS Saint-Etienne","1-1",1,1,"1",1,2,0,"D"
1970-12-20,1970,"Olympique Lyon","Stade Rennes","3-2",3,2,"1",1,5,1,"H"
1970-12-20,1970,"FC Nantes","Nimes Olympique","5-1",5,1,"1",1,6,4,"H"
1970-12-20,1970,"Stade Reims","FC Metz","1-1",1,1,"1",1,2,0,"D"
1970-12-20,1970,"FC Sochaux","OGC Nice","1-0",1,0,"1",1,1,1,"H"
1970-12-20,1970,"AS Nancy","CS Sedan","1-0",1,0,"1",1,1,1,"H"
1970-12-20,1970,"Angers SCO","SC Bastia","3-0",3,0,"1",1,3,3,"H"
1970-12-20,1970,"US Valenciennes-Anzin","Girondins Bordeaux","1-1",1,1,"1",1,2,0,"D"
1971-01-30,1970,"AS Nancy","Angers SCO","0-1",0,1,"1",1,1,-1,"D"
1971-01-31,1970,"AC Ajaccio","Olympique Marseille","1-2",1,2,"1",1,3,-1,"D"
1971-01-31,1970,"AS Saint-Etienne","AS Angouleme","1-0",1,0,"1",1,1,1,"H"
1971-01-31,1970,"Stade Rennes","SC Bastia","3-2",3,2,"1",1,5,1,"H"
1971-01-31,1970,"OGC Nice","FC Metz","0-1",0,1,"1",1,1,-1,"D"
1971-01-31,1970,"CS Sedan","FC Nantes","0-0",0,0,"1",1,0,0,"D"
1971-01-31,1970,"Red Star FC","FC Sochaux","0-0",0,0,"1",1,0,0,"D"
1971-01-31,1970,"Girondins Bordeaux","Stade Reims","3-1",3,1,"1",1,4,2,"H"
1971-01-31,1970,"Nimes Olympique","US Valenciennes-Anzin","4-1",4,1,"1",1,5,3,"H"
1971-01-31,1970,"RC Strasbourg","Olympique Lyon","0-1",0,1,"1",1,1,-1,"D"
1971-02-14,1970,"Olympique Marseille","Nimes Olympique","2-2",2,2,"1",1,4,0,"D"
1971-02-14,1970,"FC Sochaux","AS Saint-Etienne","1-1",1,1,"1",1,2,0,"D"
1971-02-14,1970,"FC Metz","Stade Rennes","2-1",2,1,"1",1,3,1,"H"
1971-02-14,1970,"FC Nantes","AS Nancy","7-0",7,0,"1",1,7,7,"H"
1971-02-14,1970,"Olympique Lyon","Girondins Bordeaux","2-2",2,2,"1",1,4,0,"D"
1971-02-14,1970,"Angers SCO","AC Ajaccio","1-1",1,1,"1",1,2,0,"D"
1971-02-14,1970,"SC Bastia","OGC Nice","3-1",3,1,"1",1,4,2,"H"
1971-02-14,1970,"AS Angouleme","CS Sedan","1-0",1,0,"1",1,1,1,"H"
1971-02-14,1970,"US Valenciennes-Anzin","RC Strasbourg","3-0",3,0,"1",1,3,3,"H"
1971-02-20,1970,"OGC Nice","Stade Reims","2-0",2,0,"1",1,2,2,"H"
1971-02-21,1970,"CS Sedan","Olympique Marseille","1-2",1,2,"1",1,3,-1,"D"
1971-02-21,1970,"AS Saint-Etienne","US Valenciennes-Anzin","4-0",4,0,"1",1,4,4,"H"
1971-02-21,1970,"Angers SCO","FC Nantes","0-1",0,1,"1",1,1,-1,"D"
1971-02-21,1970,"Girondins Bordeaux","FC Metz","1-1",1,1,"1",1,2,0,"D"
1971-02-21,1970,"Nimes Olympique","Stade Rennes","3-2",3,2,"1",1,5,1,"H"
1971-02-21,1970,"RC Strasbourg","FC Sochaux","2-1",2,1,"1",1,3,1,"H"
1971-02-21,1970,"AC Ajaccio","Olympique Lyon","0-0",0,0,"1",1,0,0,"D"
1971-02-21,1970,"Red Star FC","SC Bastia","1-1",1,1,"1",1,2,0,"D"
1971-02-21,1970,"AS Nancy","AS Angouleme","2-1",2,1,"1",1,3,1,"H"
1971-03-06,1970,"Olympique Marseille","AS Saint-Etienne","2-2",2,2,"1",1,4,0,"D"
1971-03-06,1970,"FC Nantes","AC Ajaccio","3-0",3,0,"1",1,3,3,"H"
1971-03-06,1970,"FC Metz","Red Star FC","2-2",2,2,"1",1,4,0,"D"
1971-03-06,1970,"Stade Reims","RC Strasbourg","1-0",1,0,"1",1,1,1,"H"
1971-03-07,1970,"Stade Rennes","OGC Nice","1-3",1,3,"1",1,4,-2,"D"
1971-03-07,1970,"FC Sochaux","AS Nancy","1-0",1,0,"1",1,1,1,"H"
1971-03-07,1970,"Olympique Lyon","Nimes Olympique","0-1",0,1,"1",1,1,-1,"D"
1971-03-07,1970,"AS Angouleme","Angers SCO","1-1",1,1,"1",1,2,0,"D"
1971-03-10,1970,"Angers SCO","Olympique Marseille","2-1",2,1,"1",1,3,1,"H"
1971-03-10,1970,"Girondins Bordeaux","Stade Rennes","0-1",0,1,"1",1,1,-1,"D"
1971-03-10,1970,"Nimes Olympique","Stade Reims","1-1",1,1,"1",1,2,0,"D"
1971-03-10,1970,"Red Star FC","Olympique Lyon","1-3",1,3,"1",1,4,-2,"D"
1971-03-11,1970,"FC Nantes","AS Angouleme","0-0",0,0,"1",1,0,0,"D"
1971-03-12,1970,"AS Nancy","US Valenciennes-Anzin","0-2",0,2,"1",1,2,-2,"D"
1971-03-19,1970,"US Valenciennes-Anzin","Angers SCO","1-3",1,3,"1",1,4,-2,"D"
1971-03-20,1970,"Olympique Marseille","AS Nancy","3-0",3,0,"1",1,3,3,"H"
1971-03-20,1970,"Stade Reims","AS Saint-Etienne","2-2",2,2,"1",1,4,0,"D"
1971-03-20,1970,"FC Sochaux","FC Nantes","2-0",2,0,"1",1,2,2,"H"
1971-03-20,1970,"SC Bastia","Nimes Olympique","2-2",2,2,"1",1,4,0,"D"
1971-03-20,1970,"Olympique Lyon","CS Sedan","0-0",0,0,"1",1,0,0,"D"
1971-03-20,1970,"OGC Nice","Girondins Bordeaux","0-1",0,1,"1",1,1,-1,"D"
1971-03-20,1970,"AS Angouleme","AC Ajaccio","2-0",2,0,"1",1,2,2,"H"
1971-03-21,1970,"FC Metz","RC Strasbourg","2-1",2,1,"1",1,3,1,"H"
1971-03-21,1970,"Stade Rennes","Red Star FC","3-0",3,0,"1",1,3,3,"H"
1971-03-24,1970,"AS Angouleme","Olympique Marseille","0-0",0,0,"1",1,0,0,"D"
1971-03-24,1970,"AS Saint-Etienne","SC Bastia","6-0",6,0,"1",1,6,6,"H"
1971-03-24,1970,"FC Nantes","US Valenciennes-Anzin","2-0",2,0,"1",1,2,2,"H"
1971-03-24,1970,"RC Strasbourg","Stade Rennes","3-4",3,4,"1",1,7,-1,"D"
1971-03-24,1970,"AC Ajaccio","FC Sochaux","1-0",1,0,"1",1,1,1,"H"
1971-03-24,1970,"Angers SCO","Stade Reims","0-3",0,3,"1",1,3,-3,"D"
1971-03-24,1970,"AS Nancy","Olympique Lyon","0-0",0,0,"1",1,0,0,"D"
1971-03-24,1970,"Red Star FC","OGC Nice","0-0",0,0,"1",1,0,0,"D"
1971-03-24,1970,"CS Sedan","Girondins Bordeaux","0-2",0,2,"1",1,2,-2,"D"
1971-03-26,1970,"Nimes Olympique","FC Metz","4-0",4,0,"1",1,4,4,"H"
1971-03-28,1970,"RC Strasbourg","SC Bastia","2-2",2,2,"1",1,4,0,"D"
1971-03-28,1970,"Olympique Lyon","AS Saint-Etienne","1-2",1,2,"1",1,3,-1,"D"
1971-04-03,1970,"Olympique Marseille","FC Nantes","2-2",2,2,"1",1,4,0,"D"
1971-04-03,1970,"Stade Rennes","Angers SCO","1-0",1,0,"1",1,1,1,"H"
1971-04-03,1970,"FC Metz","AS Nancy","1-1",1,1,"1",1,2,0,"D"
1971-04-03,1970,"FC Sochaux","Nimes Olympique","3-0",3,0,"1",1,3,3,"H"
1971-04-03,1970,"Stade Reims","CS Sedan","2-1",2,1,"1",1,3,1,"H"
1971-04-03,1970,"OGC Nice","RC Strasbourg","1-0",1,0,"1",1,1,1,"H"
1971-04-03,1970,"US Valenciennes-Anzin","AS Angouleme","2-1",2,1,"1",1,3,1,"H"
1971-04-03,1970,"Girondins Bordeaux","Red Star FC","4-1",4,1,"1",1,5,3,"H"
1971-04-04,1970,"SC Bastia","AC Ajaccio","1-4",1,4,"1",1,5,-3,"D"
1971-04-09,1970,"US Valenciennes-Anzin","CS Sedan","0-0",0,0,"1",1,0,0,"D"
1971-04-14,1970,"AS Saint-Etienne","Stade Rennes","1-0",1,0,"1",1,1,1,"H"
1971-04-14,1970,"Olympique Marseille","US Valenciennes-Anzin","5-2",5,2,"1",1,7,3,"H"
1971-04-14,1970,"FC Nantes","Olympique Lyon","1-1",1,1,"1",1,2,0,"D"
1971-04-14,1970,"CS Sedan","FC Metz","1-0",1,0,"1",1,1,1,"H"
1971-04-14,1970,"Nimes Olympique","OGC Nice","1-1",1,1,"1",1,2,0,"D"
1971-04-14,1970,"AS Angouleme","FC Sochaux","1-0",1,0,"1",1,1,1,"H"
1971-04-14,1970,"AC Ajaccio","Stade Reims","1-0",1,0,"1",1,1,1,"H"
1971-04-14,1970,"Angers SCO","Red Star FC","3-1",3,1,"1",1,4,2,"H"
1971-04-14,1970,"RC Strasbourg","Girondins Bordeaux","0-1",0,1,"1",1,1,-1,"D"
1971-04-14,1970,"AS Nancy","SC Bastia","3-0",3,0,"1",1,3,3,"H"
1971-04-17,1970,"FC Sochaux","Olympique Marseille","1-1",1,1,"1",1,2,0,"D"
1971-04-17,1970,"FC Metz","FC Nantes","0-0",0,0,"1",1,0,0,"D"
1971-04-17,1970,"Stade Rennes","AS Angouleme","0-0",0,0,"1",1,0,0,"D"
1971-04-17,1970,"Stade Reims","AS Nancy","2-1",2,1,"1",1,3,1,"H"
1971-04-17,1970,"Girondins Bordeaux","Nimes Olympique","3-0",3,0,"1",1,3,3,"H"
1971-04-17,1970,"Olympique Lyon","Angers SCO","1-0",1,0,"1",1,1,1,"H"
1971-04-17,1970,"SC Bastia","CS Sedan","4-0",4,0,"1",1,4,4,"H"
1971-04-18,1970,"US Valenciennes-Anzin","AC Ajaccio","0-0",0,0,"1",1,0,0,"D"
1971-04-18,1970,"Red Star FC","RC Strasbourg","2-1",2,1,"1",1,3,1,"H"
1971-04-18,1970,"OGC Nice","AS Saint-Etienne","0-0",0,0,"1",1,0,0,"D"
1971-04-27,1970,"Olympique Lyon","US Valenciennes-Anzin","3-1",3,1,"1",1,4,2,"H"
1971-04-28,1970,"FC Metz","Olympique Marseille","2-1",2,1,"1",1,3,1,"H"
1971-04-28,1970,"Stade Reims","FC Nantes","0-0",0,0,"1",1,0,0,"D"
1971-04-28,1970,"Stade Rennes","CS Sedan","0-0",0,0,"1",1,0,0,"D"
1971-04-28,1970,"FC Sochaux","Angers SCO","0-0",0,0,"1",1,0,0,"D"
1971-04-28,1970,"OGC Nice","AS Nancy","0-0",0,0,"1",1,0,0,"D"
1971-04-28,1970,"Girondins Bordeaux","AC Ajaccio","2-2",2,2,"1",1,4,0,"D"
1971-04-28,1970,"SC Bastia","AS Angouleme","3-1",3,1,"1",1,4,2,"H"
1971-04-30,1970,"RC Strasbourg","AS Saint-Etienne","1-0",1,0,"1",1,1,1,"H"
1971-05-01,1970,"AC Ajaccio","OGC Nice","3-1",3,1,"1",1,4,2,"H"
1971-05-02,1970,"Red Star FC","Nimes Olympique","1-2",1,2,"1",1,3,-1,"D"
1971-05-04,1970,"AS Saint-Etienne","FC Metz","6-0",6,0,"1",1,6,6,"H"
1971-05-05,1970,"Stade Reims","Red Star FC","0-1",0,1,"1",1,1,-1,"D"
1971-05-08,1970,"AS Saint-Etienne","Girondins Bordeaux","2-3",2,3,"1",1,5,-1,"D"
1971-05-08,1970,"Olympique Marseille","Olympique Lyon","2-2",2,2,"1",1,4,0,"D"
1971-05-08,1970,"FC Nantes","SC Bastia","3-1",3,1,"1",1,4,2,"H"
1971-05-08,1970,"AS Nancy","Stade Rennes","5-0",5,0,"1",1,5,5,"H"
1971-05-08,1970,"Nimes Olympique","RC Strasbourg","3-0",3,0,"1",1,3,3,"H"
1971-05-08,1970,"Angers SCO","FC Metz","5-0",5,0,"1",1,5,5,"H"
1971-05-08,1970,"AS Angouleme","Stade Reims","1-3",1,3,"1",1,4,-2,"D"
1971-05-08,1970,"US Valenciennes-Anzin","FC Sochaux","4-0",4,0,"1",1,4,4,"H"
1971-05-08,1970,"CS Sedan","OGC Nice","0-1",0,1,"1",1,1,-1,"D"
1971-05-09,1970,"AC Ajaccio","Red Star FC","0-1",0,1,"1",1,1,-1,"D"
1971-05-12,1970,"SC Bastia","Girondins Bordeaux","2-0",2,0,"1",1,2,2,"H"
1971-05-12,1970,"CS Sedan","FC Sochaux","2-1",2,1,"1",1,3,1,"H"
1971-05-15,1970,"AS Saint-Etienne","Red Star FC","2-1",2,1,"1",1,3,1,"H"
1971-05-15,1970,"Olympique Marseille","SC Bastia","5-2",5,2,"1",1,7,3,"H"
1971-05-15,1970,"FC Nantes","Stade Rennes","1-0",1,0,"1",1,1,1,"H"
1971-05-15,1970,"CS Sedan","Nimes Olympique","1-1",1,1,"1",1,2,0,"D"
1971-05-15,1970,"AS Angouleme","FC Metz","1-0",1,0,"1",1,1,1,"H"
1971-05-15,1970,"US Valenciennes-Anzin","Stade Reims","3-1",3,1,"1",1,4,2,"H"
1971-05-15,1970,"AC Ajaccio","RC Strasbourg","4-0",4,0,"1",1,4,4,"H"
1971-05-15,1970,"FC Sochaux","Olympique Lyon","0-0",0,0,"1",1,0,0,"D"
1971-05-15,1970,"Angers SCO","OGC Nice","6-0",6,0,"1",1,6,6,"H"
1971-05-15,1970,"AS Nancy","Girondins Bordeaux","0-0",0,0,"1",1,0,0,"D"
1971-05-18,1970,"Stade Reims","Olympique Marseille","1-2",1,2,"1",1,3,-1,"D"
1971-05-18,1970,"Nimes Olympique","AS Saint-Etienne","5-3",5,3,"1",1,8,2,"H"
1971-05-18,1970,"OGC Nice","FC Nantes","3-1",3,1,"1",1,4,2,"H"
1971-05-18,1970,"Stade Rennes","AC Ajaccio","0-1",0,1,"1",1,1,-1,"D"
1971-05-18,1970,"Olympique Lyon","AS Angouleme","3-0",3,0,"1",1,3,3,"H"
1971-05-18,1970,"FC Metz","FC Sochaux","3-3",3,3,"1",1,6,0,"D"
1971-05-18,1970,"Girondins Bordeaux","Angers SCO","3-0",3,0,"1",1,3,3,"H"
1971-05-18,1970,"Red Star FC","AS Nancy","3-1",3,1,"1",1,4,2,"H"
1971-05-18,1970,"RC Strasbourg","CS Sedan","3-0",3,0,"1",1,3,3,"H"
1971-05-18,1970,"SC Bastia","US Valenciennes-Anzin","1-0",1,0,"1",1,1,1,"H"
1971-05-21,1970,"Olympique Lyon","Stade Reims","0-0",0,0,"1",1,0,0,"D"
1971-05-22,1970,"Angers SCO","AS Saint-Etienne","2-2",2,2,"1",1,4,0,"D"
1971-05-22,1970,"FC Nantes","Girondins Bordeaux","2-2",2,2,"1",1,4,0,"D"
1971-05-22,1970,"AC Ajaccio","Nimes Olympique","2-2",2,2,"1",1,4,0,"D"
1971-05-22,1970,"US Valenciennes-Anzin","FC Metz","2-2",2,2,"1",1,4,0,"D"
1971-05-22,1970,"FC Sochaux","SC Bastia","1-1",1,1,"1",1,2,0,"D"
1971-05-22,1970,"AS Angouleme","OGC Nice","1-1",1,1,"1",1,2,0,"D"
1971-05-22,1970,"AS Nancy","RC Strasbourg","3-2",3,2,"1",1,5,1,"H"
1971-05-22,1970,"CS Sedan","Red Star FC","5-0",5,0,"1",1,5,5,"H"
1971-05-23,1970,"Olympique Marseille","Stade Rennes","5-0",5,0,"1",1,5,5,"H"
1971-06-04,1970,"AS Saint-Etienne","CS Sedan","8-0",8,0,"1",1,8,8,"H"
1971-06-05,1970,"OGC Nice","Olympique Marseille","1-2",1,2,"1",1,3,-1,"D"
1971-06-05,1970,"Nimes Olympique","AS Nancy","1-0",1,0,"1",1,1,1,"H"
1971-06-05,1970,"FC Metz","AC Ajaccio","1-3",1,3,"1",1,4,-2,"D"
1971-06-05,1970,"Stade Reims","FC Sochaux","4-1",4,1,"1",1,5,3,"H"
1971-06-05,1970,"Girondins Bordeaux","AS Angouleme","1-0",1,0,"1",1,1,1,"H"
1971-06-05,1970,"Stade Rennes","US Valenciennes-Anzin","1-1",1,1,"1",1,2,0,"D"
1971-06-05,1970,"SC Bastia","Olympique Lyon","2-1",2,1,"1",1,3,1,"H"
1971-06-05,1970,"RC Strasbourg","Angers SCO","6-2",6,2,"1",1,8,4,"H"
1971-06-06,1970,"Red Star FC","FC Nantes","0-3",0,3,"1",1,3,-3,"D"
1971-06-11,1970,"Olympique Marseille","Girondins Bordeaux","3-0",3,0,"1",1,3,3,"H"
1971-06-11,1970,"AS Nancy","AS Saint-Etienne","1-1",1,1,"1",1,2,0,"D"
1971-06-11,1970,"Olympique Lyon","FC Metz","1-2",1,2,"1",1,3,-1,"D"
1971-06-12,1970,"FC Nantes","RC Strasbourg","1-2",1,2,"1",1,3,-1,"D"
1971-06-12,1970,"Angers SCO","Nimes Olympique","1-2",1,2,"1",1,3,-1,"D"
1971-06-12,1970,"AC Ajaccio","CS Sedan","1-0",1,0,"1",1,1,1,"H"
1971-06-12,1970,"Stade Reims","SC Bastia","5-2",5,2,"1",1,7,3,"H"
1971-06-12,1970,"FC Sochaux","Stade Rennes","4-2",4,2,"1",1,6,2,"H"
1971-06-12,1970,"US Valenciennes-Anzin","OGC Nice","3-1",3,1,"1",1,4,2,"H"
1971-06-12,1970,"AS Angouleme","Red Star FC","1-0",1,0,"1",1,1,1,"H"
1971-06-19,1970,"Red Star FC","Olympique Marseille","3-4",3,4,"1",1,7,-1,"D"
1971-06-19,1970,"AS Saint-Etienne","AC Ajaccio","5-2",5,2,"1",1,7,3,"H"
1971-06-19,1970,"Nimes Olympique","FC Nantes","2-2",2,2,"1",1,4,0,"D"
1971-06-19,1970,"FC Metz","Stade Reims","2-0",2,0,"1",1,2,2,"H"
1971-06-19,1970,"OGC Nice","FC Sochaux","4-5",4,5,"1",1,9,-1,"D"
1971-06-19,1970,"Girondins Bordeaux","US Valenciennes-Anzin","1-0",1,0,"1",1,1,1,"H"
1971-06-19,1970,"SC Bastia","Angers SCO","2-0",2,0,"1",1,2,2,"H"
1971-06-19,1970,"CS Sedan","AS Nancy","2-2",2,2,"1",1,4,0,"D"
1971-06-19,1970,"RC Strasbourg","AS Angouleme","2-1",2,1,"1",1,3,1,"H"
1971-06-23,1970,"Stade Rennes","Olympique Lyon","2-3",2,3,"1",1,5,-1,"D"
1971-06-26,1970,"Olympique Marseille","RC Strasbourg","6-3",6,3,"1",1,9,3,"H"
1971-06-26,1970,"FC Nantes","AS Saint-Etienne","2-1",2,1,"1",1,3,1,"H"
1971-06-26,1970,"AS Angouleme","Nimes Olympique","0-2",0,2,"1",1,2,-2,"D"
1971-06-26,1970,"FC Sochaux","Girondins Bordeaux","1-3",1,3,"1",1,4,-2,"D"
1971-06-26,1970,"AS Nancy","AC Ajaccio","3-1",3,1,"1",1,4,2,"H"
1971-06-26,1970,"Olympique Lyon","OGC Nice","2-1",2,1,"1",1,3,1,"H"
1971-06-26,1970,"SC Bastia","FC Metz","2-0",2,0,"1",1,2,2,"H"
1971-06-26,1970,"Stade Reims","Stade Rennes","1-1",1,1,"1",1,2,0,"D"
1971-06-26,1970,"Angers SCO","CS Sedan","3-1",3,1,"1",1,4,2,"H"
1971-06-26,1970,"US Valenciennes-Anzin","Red Star FC","1-2",1,2,"1",1,3,-1,"D"
1971-08-11,1971,"Olympique Marseille","Olympique Lyon","1-1",1,1,"1",1,2,0,"D"
1971-08-11,1971,"OGC Nice","FC Nantes","1-1",1,1,"1",1,2,0,"D"
1971-08-11,1971,"AS Saint-Etienne","Nimes Olympique","1-3",1,3,"1",1,4,-2,"D"
1971-08-11,1971,"Girondins Bordeaux","FC Metz","0-0",0,0,"1",1,0,0,"D"
1971-08-11,1971,"AS Nancy","Stade Reims","0-0",0,0,"1",1,0,0,"D"
1971-08-11,1971,"Stade Rennes","SC Bastia","1-0",1,0,"1",1,1,1,"H"
1971-08-11,1971,"Angers SCO","Paris Saint-Germain","2-0",2,0,"1",1,2,2,"H"
1971-08-11,1971,"Lille OSC","FC Sochaux","2-3",2,3,"1",1,5,-1,"D"
1971-08-11,1971,"AC Ajaccio","AS Monaco","3-0",3,0,"1",1,3,3,"H"
1971-08-11,1971,"Red Star FC","AS Angouleme","1-1",1,1,"1",1,2,0,"D"
1971-08-18,1971,"Olympique Lyon","Stade Rennes","0-2",0,2,"1",1,2,-2,"D"
1971-08-18,1971,"FC Sochaux","AS Nancy","2-1",2,1,"1",1,3,1,"H"
1971-08-18,1971,"AC Ajaccio","Olympique Marseille","1-1",1,1,"1",1,2,0,"D"
1971-08-18,1971,"Nimes Olympique","SC Bastia","6-2",6,2,"1",1,8,4,"H"
1971-08-18,1971,"AS Monaco","Angers SCO","3-0",3,0,"1",1,3,3,"H"
1971-08-18,1971,"FC Metz","Lille OSC","4-0",4,0,"1",1,4,4,"H"
1971-08-18,1971,"FC Nantes","AS Saint-Etienne","4-3",4,3,"1",1,7,1,"H"
1971-08-18,1971,"Paris Saint-Germain","Girondins Bordeaux","0-0",0,0,"1",1,0,0,"D"
1971-08-18,1971,"Stade Reims","Red Star FC","0-1",0,1,"1",1,1,-1,"D"
1971-08-18,1971,"AS Angouleme","OGC Nice","1-1",1,1,"1",1,2,0,"D"
1971-08-25,1971,"Red Star FC","FC Sochaux","2-1",2,1,"1",1,3,1,"H"
1971-08-25,1971,"Stade Rennes","Olympique Marseille","1-2",1,2,"1",1,3,-1,"D"
1971-08-25,1971,"OGC Nice","FC Metz","1-1",1,1,"1",1,2,0,"D"
1971-08-25,1971,"Girondins Bordeaux","AS Monaco","3-1",3,1,"1",1,4,2,"H"
1971-08-25,1971,"SC Bastia","FC Nantes","2-1",2,1,"1",1,3,1,"H"
1971-08-25,1971,"Lille OSC","AC Ajaccio","3-1",3,1,"1",1,4,2,"H"
1971-08-25,1971,"Angers SCO","Olympique Lyon","2-1",2,1,"1",1,3,1,"H"
1971-08-25,1971,"AS Nancy","Paris Saint-Germain","2-3",2,3,"1",1,5,-1,"D"
1971-08-25,1971,"AS Saint-Etienne","Stade Reims","9-1",9,1,"1",1,10,8,"H"
1971-08-25,1971,"Nimes Olympique","AS Angouleme","3-0",3,0,"1",1,3,3,"H"
1971-08-28,1971,"FC Nantes","Nimes Olympique","2-0",2,0,"1",1,2,2,"H"
1971-08-28,1971,"AS Monaco","Red Star FC","0-0",0,0,"1",1,0,0,"D"
1971-08-28,1971,"FC Metz","AS Nancy","0-1",0,1,"1",1,1,-1,"D"
1971-08-28,1971,"AC Ajaccio","Stade Rennes","1-2",1,2,"1",1,3,-1,"D"
1971-08-28,1971,"Olympique Lyon","Girondins Bordeaux","2-2",2,2,"1",1,4,0,"D"
1971-08-28,1971,"FC Sochaux","AS Saint-Etienne","0-2",0,2,"1",1,2,-2,"D"
1971-08-28,1971,"Stade Reims","OGC Nice","1-2",1,2,"1",1,3,-1,"D"
1971-08-28,1971,"Paris Saint-Germain","Lille OSC","4-1",4,1,"1",1,5,3,"H"
1971-08-28,1971,"AS Angouleme","SC Bastia","2-1",2,1,"1",1,3,1,"H"
1971-08-28,1971,"Olympique Marseille","Angers SCO","2-1",2,1,"1",1,3,1,"H"
1971-09-01,1971,"Girondins Bordeaux","Olympique Marseille","0-2",0,2,"1",1,2,-2,"D"
1971-09-01,1971,"Nimes Olympique","Stade Reims","2-1",2,1,"1",1,3,1,"H"
1971-09-01,1971,"Red Star FC","FC Metz","1-1",1,1,"1",1,2,0,"D"
1971-09-01,1971,"Angers SCO","Stade Rennes","1-1",1,1,"1",1,2,0,"D"
1971-09-01,1971,"FC Nantes","Paris Saint-Germain","6-0",6,0,"1",1,6,6,"H"
1971-09-01,1971,"OGC Nice","AC Ajaccio","2-0",2,0,"1",1,2,2,"H"
1971-09-01,1971,"AS Saint-Etienne","AS Angouleme","4-0",4,0,"1",1,4,4,"H"
1971-09-01,1971,"SC Bastia","FC Sochaux","6-1",6,1,"1",1,7,5,"H"
1971-09-01,1971,"AS Nancy","AS Monaco","3-0",3,0,"1",1,3,3,"H"
1971-09-01,1971,"Lille OSC","Olympique Lyon","0-1",0,1,"1",1,1,-1,"D"
1971-09-10,1971,"Olympique Marseille","Red Star FC","6-0",6,0,"1",1,6,6,"H"
1971-09-11,1971,"Stade Rennes","Girondins Bordeaux","2-0",2,0,"1",1,2,2,"H"
1971-09-11,1971,"Paris Saint-Germain","OGC Nice","1-1",1,1,"1",1,2,0,"D"
1971-09-11,1971,"AS Angouleme","FC Nantes","2-5",2,5,"1",1,7,-3,"D"
1971-09-11,1971,"FC Metz","AS Saint-Etienne","0-4",0,4,"1",1,4,-4,"D"
1971-09-11,1971,"Olympique Lyon","AS Nancy","3-2",3,2,"1",1,5,1,"H"
1971-09-11,1971,"Stade Reims","SC Bastia","0-2",0,2,"1",1,2,-2,"D"
1971-09-11,1971,"AS Monaco","Lille OSC","1-1",1,1,"1",1,2,0,"D"
1971-09-11,1971,"AC Ajaccio","Angers SCO","1-3",1,3,"1",1,4,-2,"D"
1971-09-18,1971,"AS Nancy","Olympique Marseille","1-2",1,2,"1",1,3,-1,"D"
1971-09-18,1971,"FC Nantes","Stade Reims","0-2",0,2,"1",1,2,-2,"D"
1971-09-18,1971,"Lille OSC","Stade Rennes","0-0",0,0,"1",1,0,0,"D"
1971-09-18,1971,"AS Saint-Etienne","Paris Saint-Germain","0-1",0,1,"1",1,1,-1,"D"
1971-09-18,1971,"OGC Nice","FC Sochaux","1-2",1,2,"1",1,3,-1,"D"
1971-09-18,1971,"Nimes Olympique","AS Monaco","5-1",5,1,"1",1,6,4,"H"
1971-09-18,1971,"SC Bastia","FC Metz","1-0",1,0,"1",1,1,1,"H"
1971-09-18,1971,"Girondins Bordeaux","Angers SCO","1-1",1,1,"1",1,2,0,"D"
1971-09-18,1971,"AS Angouleme","AC Ajaccio","1-3",1,3,"1",1,4,-2,"D"
1971-09-19,1971,"Red Star FC","Olympique Lyon","1-1",1,1,"1",1,2,0,"D"
1971-09-22,1971,"Olympique Marseille","Lille OSC","3-0",3,0,"1",1,3,3,"H"
1971-09-22,1971,"FC Metz","Nimes Olympique","3-1",3,1,"1",1,4,2,"H"
1971-09-22,1971,"Stade Rennes","AS Nancy","3-1",3,1,"1",1,4,2,"H"
1971-09-22,1971,"Olympique Lyon","OGC Nice","2-0",2,0,"1",1,2,2,"H"
1971-09-22,1971,"FC Sochaux","FC Nantes","2-0",2,0,"1",1,2,2,"H"
1971-09-22,1971,"AS Monaco","AS Saint-Etienne","1-2",1,2,"1",1,3,-1,"D"
1971-09-22,1971,"Paris Saint-Germain","SC Bastia","4-1",4,1,"1",1,5,3,"H"
1971-09-22,1971,"Angers SCO","Red Star FC","1-0",1,0,"1",1,1,1,"H"
1971-09-22,1971,"Stade Reims","AS Angouleme","3-1",3,1,"1",1,4,2,"H"
1971-09-22,1971,"AC Ajaccio","Girondins Bordeaux","3-1",3,1,"1",1,4,2,"H"
1971-10-01,1971,"Lille OSC","Girondins Bordeaux","0-0",0,0,"1",1,0,0,"D"
1971-10-02,1971,"AS Saint-Etienne","Stade Rennes","4-2",4,2,"1",1,6,2,"H"
1971-10-02,1971,"Nimes Olympique","Paris Saint-Germain","4-1",4,1,"1",1,5,3,"H"
1971-10-02,1971,"AS Nancy","Angers SCO","1-0",1,0,"1",1,1,1,"H"
1971-10-02,1971,"FC Nantes","FC Metz","5-1",5,1,"1",1,6,4,"H"
1971-10-02,1971,"Stade Reims","Olympique Lyon","0-0",0,0,"1",1,0,0,"D"
1971-10-02,1971,"SC Bastia","AS Monaco","1-2",1,2,"1",1,3,-1,"D"
1971-10-02,1971,"AS Angouleme","FC Sochaux","0-0",0,0,"1",1,0,0,"D"
1971-10-03,1971,"OGC Nice","Olympique Marseille","2-0",2,0,"1",1,2,2,"H"
1971-10-03,1971,"Red Star FC","AC Ajaccio","3-1",3,1,"1",1,4,2,"H"
1971-10-13,1971,"Olympique Marseille","Nimes Olympique","3-1",3,1,"1",1,4,2,"H"
1971-10-13,1971,"Stade Rennes","FC Nantes","1-1",1,1,"1",1,2,0,"D"
1971-10-13,1971,"Olympique Lyon","AS Saint-Etienne","2-0",2,0,"1",1,2,2,"H"
1971-10-13,1971,"Paris Saint-Germain","Red Star FC","4-1",4,1,"1",1,5,3,"H"
1971-10-13,1971,"AS Monaco","OGC Nice","0-2",0,2,"1",1,2,-2,"D"
1971-10-13,1971,"Angers SCO","Lille OSC","3-1",3,1,"1",1,4,2,"H"
1971-10-13,1971,"FC Sochaux","Stade Reims","1-1",1,1,"1",1,2,0,"D"
1971-10-13,1971,"Girondins Bordeaux","AS Nancy","1-0",1,0,"1",1,1,1,"H"
1971-10-13,1971,"FC Metz","AS Angouleme","1-0",1,0,"1",1,1,1,"H"
1971-10-16,1971,"Nimes Olympique","Olympique Lyon","2-0",2,0,"1",1,2,2,"H"
1971-10-16,1971,"FC Sochaux","Stade Rennes","3-2",3,2,"1",1,5,1,"H"
1971-10-16,1971,"FC Nantes","AS Monaco","1-1",1,1,"1",1,2,0,"D"
1971-10-16,1971,"AS Angouleme","Paris Saint-Germain","3-1",3,1,"1",1,4,2,"H"
1971-10-16,1971,"Stade Reims","FC Metz","0-1",0,1,"1",1,1,-1,"D"
1971-10-16,1971,"AS Nancy","Lille OSC","2-1",2,1,"1",1,3,1,"H"
1971-10-17,1971,"OGC Nice","Angers SCO","3-1",3,1,"1",1,4,2,"H"
1971-10-17,1971,"AS Saint-Etienne","AC Ajaccio","1-1",1,1,"1",1,2,0,"D"
1971-10-17,1971,"Red Star FC","Girondins Bordeaux","1-0",1,0,"1",1,1,1,"H"
1971-10-22,1971,"Olympique Lyon","SC Bastia","3-0",3,0,"1",1,3,3,"H"
1971-10-22,1971,"Lille OSC","Red Star FC","3-1",3,1,"1",1,4,2,"H"
1971-10-22,1971,"Stade Rennes","OGC Nice","2-2",2,2,"1",1,4,0,"D"
1971-10-22,1971,"Angers SCO","Nimes Olympique","0-0",0,0,"1",1,0,0,"D"
1971-10-22,1971,"Girondins Bordeaux","FC Nantes","2-2",2,2,"1",1,4,0,"D"
1971-10-23,1971,"FC Metz","FC Sochaux","0-1",0,1,"1",1,1,-1,"D"
1971-10-23,1971,"Paris Saint-Germain","Stade Reims","2-4",2,4,"1",1,6,-2,"D"
1971-10-24,1971,"Olympique Marseille","AS Saint-Etienne","2-3",2,3,"1",1,5,-1,"D"
1971-10-24,1971,"AC Ajaccio","AS Nancy","3-1",3,1,"1",1,4,2,"H"
1971-10-24,1971,"AS Monaco","AS Angouleme","1-0",1,0,"1",1,1,1,"H"
1971-10-27,1971,"FC Sochaux","Nimes Olympique","1-0",1,0,"1",1,1,1,"H"
1971-10-29,1971,"FC Nantes","Olympique Marseille","1-1",1,1,"1",1,2,0,"D"
1971-10-30,1971,"AS Saint-Etienne","Girondins Bordeaux","1-1",1,1,"1",1,2,0,"D"
1971-10-30,1971,"AS Angouleme","Olympique Lyon","2-0",2,0,"1",1,2,2,"H"
1971-10-30,1971,"SC Bastia","Angers SCO","3-1",3,1,"1",1,4,2,"H"
1971-10-30,1971,"Stade Reims","AS Monaco","1-1",1,1,"1",1,2,0,"D"
1971-10-30,1971,"FC Metz","Paris Saint-Germain","2-0",2,0,"1",1,2,2,"H"
1971-10-30,1971,"FC Sochaux","AC Ajaccio","3-1",3,1,"1",1,4,2,"H"
1971-10-30,1971,"Red Star FC","AS Nancy","1-1",1,1,"1",1,2,0,"D"
1971-10-30,1971,"Nimes Olympique","Stade Rennes","3-0",3,0,"1",1,3,3,"H"
1971-11-01,1971,"OGC Nice","Lille OSC","3-1",3,1,"1",1,4,2,"H"
1971-11-04,1971,"AC Ajaccio","SC Bastia","2-0",2,0,"1",1,2,2,"H"
1971-11-13,1971,"Paris Saint-Germain","FC Sochaux","1-0",1,0,"1",1,1,1,"H"
1971-11-13,1971,"Lille OSC","Nimes Olympique","1-1",1,1,"1",1,2,0,"D"
1971-11-13,1971,"Angers SCO","AS Saint-Etienne","1-1",1,1,"1",1,2,0,"D"
1971-11-14,1971,"Olympique Marseille","AS Angouleme","3-0",3,0,"1",1,3,3,"H"
1971-11-14,1971,"AS Nancy","OGC Nice","3-2",3,2,"1",1,5,1,"H"
1971-11-14,1971,"Olympique Lyon","FC Nantes","1-3",1,3,"1",1,4,-2,"D"
1971-11-14,1971,"Stade Rennes","Red Star FC","2-0",2,0,"1",1,2,2,"H"
1971-11-14,1971,"AS Monaco","FC Metz","3-2",3,2,"1",1,5,1,"H"
1971-11-14,1971,"Girondins Bordeaux","SC Bastia","2-1",2,1,"1",1,3,1,"H"
1971-11-14,1971,"AC Ajaccio","Stade Reims","2-2",2,2,"1",1,4,0,"D"
1971-11-17,1971,"Stade Reims","Olympique Marseille","1-3",1,3,"1",1,4,-2,"D"
1971-11-17,1971,"Nimes Olympique","Girondins Bordeaux","1-1",1,1,"1",1,2,0,"D"
1971-11-17,1971,"FC Sochaux","AS Monaco","3-1",3,1,"1",1,4,2,"H"
1971-11-17,1971,"FC Nantes","Angers SCO","1-0",1,0,"1",1,1,1,"H"
1971-11-17,1971,"OGC Nice","Red Star FC","1-0",1,0,"1",1,1,1,"H"
1971-11-17,1971,"AS Saint-Etienne","AS Nancy","1-3",1,3,"1",1,4,-2,"D"
1971-11-17,1971,"AS Angouleme","Stade Rennes","0-0",0,0,"1",1,0,0,"D"
1971-11-17,1971,"Paris Saint-Germain","Olympique Lyon","1-2",1,2,"1",1,3,-1,"D"
1971-11-17,1971,"FC Metz","AC Ajaccio","3-0",3,0,"1",1,3,3,"H"
1971-11-17,1971,"SC Bastia","Lille OSC","1-0",1,0,"1",1,1,1,"H"
1971-11-21,1971,"Olympique Marseille","FC Sochaux","3-0",3,0,"1",1,3,3,"H"
1971-11-21,1971,"Red Star FC","Nimes Olympique","1-5",1,5,"1",1,6,-4,"D"
1971-11-21,1971,"Girondins Bordeaux","OGC Nice","2-1",2,1,"1",1,3,1,"H"
1971-11-21,1971,"AC Ajaccio","FC Nantes","4-2",4,2,"1",1,6,2,"H"
1971-11-21,1971,"Olympique Lyon","FC Metz","2-1",2,1,"1",1,3,1,"H"
1971-11-21,1971,"Stade Rennes","Stade Reims","4-1",4,1,"1",1,5,3,"H"
1971-11-21,1971,"Lille OSC","AS Saint-Etienne","2-0",2,0,"1",1,2,2,"H"
1971-11-21,1971,"AS Nancy","SC Bastia","2-0",2,0,"1",1,2,2,"H"
1971-11-21,1971,"Angers SCO","AS Angouleme","8-1",8,1,"1",1,9,7,"H"
1971-11-21,1971,"AS Monaco","Paris Saint-Germain","2-1",2,1,"1",1,3,1,"H"
1971-11-27,1971,"AS Angouleme","Girondins Bordeaux","3-0",3,0,"1",1,3,3,"H"
1971-11-28,1971,"FC Metz","Olympique Marseille","1-3",1,3,"1",1,4,-2,"D"
1971-11-28,1971,"Nimes Olympique","AS Nancy","0-0",0,0,"1",1,0,0,"D"
1971-11-28,1971,"FC Sochaux","Olympique Lyon","4-0",4,0,"1",1,4,4,"H"
1971-11-28,1971,"FC Nantes","Lille OSC","2-1",2,1,"1",1,3,1,"H"
1971-11-28,1971,"AS Saint-Etienne","OGC Nice","2-2",2,2,"1",1,4,0,"D"
1971-11-28,1971,"AS Monaco","Stade Rennes","0-1",0,1,"1",1,1,-1,"D"
1971-11-28,1971,"Stade Reims","Angers SCO","2-1",2,1,"1",1,3,1,"H"
1971-11-28,1971,"Paris Saint-Germain","AC Ajaccio","1-1",1,1,"1",1,2,0,"D"
1971-11-28,1971,"SC Bastia","Red Star FC","2-0",2,0,"1",1,2,2,"H"
1971-12-08,1971,"SC Bastia","Olympique Marseille","2-1",2,1,"1",1,3,1,"H"
1971-12-12,1971,"Olympique Marseille","Paris Saint-Germain","4-2",4,2,"1",1,6,2,"H"
1971-12-12,1971,"AC Ajaccio","Nimes Olympique","0-0",0,0,"1",1,0,0,"D"
1971-12-12,1971,"Angers SCO","FC Sochaux","2-0",2,0,"1",1,2,2,"H"
1971-12-12,1971,"AS Nancy","FC Nantes","1-0",1,0,"1",1,1,1,"H"
1971-12-12,1971,"Stade Rennes","FC Metz","3-0",3,0,"1",1,3,3,"H"
1971-12-12,1971,"OGC Nice","SC Bastia","0-1",0,1,"1",1,1,-1,"D"
1971-12-12,1971,"Red Star FC","AS Saint-Etienne","1-2",1,2,"1",1,3,-1,"D"
1971-12-12,1971,"Olympique Lyon","AS Monaco","2-2",2,2,"1",1,4,0,"D"
1971-12-12,1971,"Girondins Bordeaux","Stade Reims","1-1",1,1,"1",1,2,0,"D"
1971-12-12,1971,"Lille OSC","AS Angouleme","4-2",4,2,"1",1,6,2,"H"
1971-12-19,1971,"AS Monaco","Olympique Marseille","0-1",0,1,"1",1,1,-1,"D"
1971-12-19,1971,"Nimes Olympique","OGC Nice","2-0",2,0,"1",1,2,2,"H"
1971-12-19,1971,"Paris Saint-Germain","Stade Rennes","1-1",1,1,"1",1,2,0,"D"
1971-12-19,1971,"FC Sochaux","Girondins Bordeaux","0-0",0,0,"1",1,0,0,"D"
1971-12-19,1971,"FC Nantes","Red Star FC","1-1",1,1,"1",1,2,0,"D"
1971-12-19,1971,"SC Bastia","AS Saint-Etienne","3-0",3,0,"1",1,3,3,"H"
1971-12-19,1971,"AS Angouleme","AS Nancy","1-1",1,1,"1",1,2,0,"D"
1971-12-19,1971,"Olympique Lyon","AC Ajaccio","2-1",2,1,"1",1,3,1,"H"
1971-12-19,1971,"FC Metz","Angers SCO","0-0",0,0,"1",1,0,0,"D"
1971-12-19,1971,"Stade Reims","Lille OSC","2-0",2,0,"1",1,2,2,"H"
1972-01-08,1971,"Stade Rennes","Olympique Lyon","0-0",0,0,"1",1,0,0,"D"
1972-01-09,1971,"Olympique Marseille","AC Ajaccio","1-1",1,1,"1",1,2,0,"D"
1972-01-09,1971,"Red Star FC","Stade Reims","2-2",2,2,"1",1,4,0,"D"
1972-01-09,1971,"SC Bastia","Nimes Olympique","1-0",1,0,"1",1,1,1,"H"
1972-01-09,1971,"AS Nancy","FC Sochaux","0-0",0,0,"1",1,0,0,"D"
1972-01-09,1971,"AS Saint-Etienne","FC Nantes","2-1",2,1,"1",1,3,1,"H"
1972-01-09,1971,"OGC Nice","AS Angouleme","3-0",3,0,"1",1,3,3,"H"
1972-01-09,1971,"Angers SCO","AS Monaco","4-1",4,1,"1",1,5,3,"H"
1972-01-09,1971,"Girondins Bordeaux","Paris Saint-Germain","2-0",2,0,"1",1,2,2,"H"
1972-01-09,1971,"Lille OSC","FC Metz","3-0",3,0,"1",1,3,3,"H"
1972-01-16,1971,"Olympique Marseille","Stade Rennes","1-1",1,1,"1",1,2,0,"D"
1972-01-16,1971,"AS Angouleme","Nimes Olympique","0-3",0,3,"1",1,3,-3,"D"
1972-01-16,1971,"FC Sochaux","Red Star FC","1-2",1,2,"1",1,3,-1,"D"
1972-01-16,1971,"FC Nantes","SC Bastia","4-0",4,0,"1",1,4,4,"H"
1972-01-16,1971,"Olympique Lyon","Angers SCO","1-2",1,2,"1",1,3,-1,"D"
1972-01-16,1971,"Stade Reims","AS Saint-Etienne","2-1",2,1,"1",1,3,1,"H"
1972-01-16,1971,"FC Metz","OGC Nice","1-0",1,0,"1",1,1,1,"H"
1972-01-16,1971,"Paris Saint-Germain","AS Nancy","1-4",1,4,"1",1,5,-3,"D"
1972-01-16,1971,"AS Monaco","Girondins Bordeaux","1-2",1,2,"1",1,3,-1,"D"
1972-01-16,1971,"AC Ajaccio","Lille OSC","0-1",0,1,"1",1,1,-1,"D"
1972-01-30,1971,"Angers SCO","Olympique Marseille","1-0",1,0,"1",1,1,1,"H"
1972-01-30,1971,"Nimes Olympique","FC Nantes","4-0",4,0,"1",1,4,4,"H"
1972-01-30,1971,"AS Saint-Etienne","FC Sochaux","0-1",0,1,"1",1,1,-1,"D"
1972-01-30,1971,"AS Nancy","FC Metz","1-1",1,1,"1",1,2,0,"D"
1972-01-30,1971,"OGC Nice","Stade Reims","3-0",3,0,"1",1,3,3,"H"
1972-01-30,1971,"Girondins Bordeaux","Olympique Lyon","0-3",0,3,"1",1,3,-3,"D"
1972-01-30,1971,"SC Bastia","AS Angouleme","2-0",2,0,"1",1,2,2,"H"
1972-01-30,1971,"Red Star FC","AS Monaco","1-0",1,0,"1",1,1,1,"H"
1972-01-30,1971,"Lille OSC","Paris Saint-Germain","1-3",1,3,"1",1,4,-2,"D"
1972-02-05,1971,"AS Angouleme","AS Saint-Etienne","3-4",3,4,"1",1,7,-1,"D"
1972-02-06,1971,"Olympique Marseille","Girondins Bordeaux","3-0",3,0,"1",1,3,3,"H"
1972-02-06,1971,"Stade Reims","Nimes Olympique","1-1",1,1,"1",1,2,0,"D"
1972-02-06,1971,"Stade Rennes","Angers SCO","3-1",3,1,"1",1,4,2,"H"
1972-02-06,1971,"FC Sochaux","SC Bastia","6-1",6,1,"1",1,7,5,"H"
1972-02-06,1971,"Paris Saint-Germain","FC Nantes","2-3",2,3,"1",1,5,-1,"D"
1972-02-06,1971,"AC Ajaccio","OGC Nice","0-0",0,0,"1",1,0,0,"D"
1972-02-06,1971,"AS Monaco","AS Nancy","4-2",4,2,"1",1,6,2,"H"
1972-02-06,1971,"Olympique Lyon","Lille OSC","1-0",1,0,"1",1,1,1,"H"
1972-02-06,1971,"FC Metz","Red Star FC","3-0",3,0,"1",1,3,3,"H"
1972-02-12,1971,"OGC Nice","Paris Saint-Germain","1-1",1,1,"1",1,2,0,"D"
1972-02-12,1971,"AS Saint-Etienne","FC Metz","2-0",2,0,"1",1,2,2,"H"
1972-02-13,1971,"Red Star FC","Olympique Marseille","2-4",2,4,"1",1,6,-2,"D"
1972-02-13,1971,"Nimes Olympique","FC Sochaux","2-1",2,1,"1",1,3,1,"H"
1972-02-13,1971,"Girondins Bordeaux","Stade Rennes","2-1",2,1,"1",1,3,1,"H"
1972-02-13,1971,"FC Nantes","AS Angouleme","5-0",5,0,"1",1,5,5,"H"
1972-02-13,1971,"AS Nancy","Olympique Lyon","2-2",2,2,"1",1,4,0,"D"
1972-02-13,1971,"Angers SCO","AC Ajaccio","2-1",2,1,"1",1,3,1,"H"
1972-02-13,1971,"SC Bastia","Stade Reims","3-1",3,1,"1",1,4,2,"H"
1972-02-13,1971,"Lille OSC","AS Monaco","1-1",1,1,"1",1,2,0,"D"
1972-02-27,1971,"Olympique Marseille","AS Nancy","1-1",1,1,"1",1,2,0,"D"
1972-02-27,1971,"AS Monaco","Nimes Olympique","1-1",1,1,"1",1,2,0,"D"
1972-02-27,1971,"FC Sochaux","OGC Nice","1-1",1,1,"1",1,2,0,"D"
1972-02-27,1971,"Stade Reims","FC Nantes","0-0",0,0,"1",1,0,0,"D"
1972-02-27,1971,"Stade Rennes","Lille OSC","5-2",5,2,"1",1,7,3,"H"
1972-02-27,1971,"Angers SCO","Girondins Bordeaux","3-1",3,1,"1",1,4,2,"H"
1972-02-27,1971,"Olympique Lyon","Red Star FC","5-1",5,1,"1",1,6,4,"H"
1972-02-27,1971,"Paris Saint-Germain","AS Saint-Etienne","1-3",1,3,"1",1,4,-2,"D"
1972-02-27,1971,"FC Metz","SC Bastia","2-1",2,1,"1",1,3,1,"H"
1972-02-27,1971,"AC Ajaccio","AS Angouleme","3-0",3,0,"1",1,3,3,"H"
1972-03-01,1971,"Stade Rennes","AC Ajaccio","1-1",1,1,"1",1,2,0,"D"
1972-03-04,1971,"FC Nantes","FC Sochaux","2-0",2,0,"1",1,2,2,"H"
1972-03-04,1971,"AS Nancy","Stade Rennes","3-1",3,1,"1",1,4,2,"H"
1972-03-04,1971,"OGC Nice","Olympique Lyon","2-1",2,1,"1",1,3,1,"H"
1972-03-04,1971,"Lille OSC","Olympique Marseille","0-2",0,2,"1",1,2,-2,"D"
1972-03-05,1971,"Nimes Olympique","FC Metz","1-1",1,1,"1",1,2,0,"D"
1972-03-05,1971,"Red Star FC","Angers SCO","2-1",2,1,"1",1,3,1,"H"
1972-03-05,1971,"AS Saint-Etienne","AS Monaco","3-2",3,2,"1",1,5,1,"H"
1972-03-05,1971,"SC Bastia","Paris Saint-Germain","1-0",1,0,"1",1,1,1,"H"
1972-03-05,1971,"Girondins Bordeaux","AC Ajaccio","1-0",1,0,"1",1,1,1,"H"
1972-03-05,1971,"AS Angouleme","Stade Reims","2-1",2,1,"1",1,3,1,"H"
1972-03-15,1971,"Angers SCO","AS Nancy","1-1",1,1,"1",1,2,0,"D"
1972-03-17,1971,"Girondins Bordeaux","Lille OSC","3-1",3,1,"1",1,4,2,"H"
1972-03-18,1971,"Stade Rennes","AS Saint-Etienne","2-4",2,4,"1",1,6,-2,"D"
1972-03-18,1971,"FC Metz","FC Nantes","3-0",3,0,"1",1,3,3,"H"
1972-03-18,1971,"Paris Saint-Germain","Nimes Olympique","1-1",1,1,"1",1,2,0,"D"
1972-03-18,1971,"FC Sochaux","AS Angouleme","4-1",4,1,"1",1,5,3,"H"
1972-03-19,1971,"Olympique Marseille","OGC Nice","1-0",1,0,"1",1,1,1,"H"
1972-03-19,1971,"Olympique Lyon","Stade Reims","5-0",5,0,"1",1,5,5,"H"
1972-03-19,1971,"AS Monaco","SC Bastia","0-1",0,1,"1",1,1,-1,"D"
1972-03-19,1971,"AC Ajaccio","Red Star FC","1-0",1,0,"1",1,1,1,"H"
1972-03-24,1971,"OGC Nice","AS Monaco","2-0",2,0,"1",1,2,2,"H"
1972-03-24,1971,"AS Nancy","Girondins Bordeaux","2-1",2,1,"1",1,3,1,"H"
1972-03-24,1971,"Lille OSC","Angers SCO","0-1",0,1,"1",1,1,-1,"D"
1972-03-24,1971,"AS Angouleme","FC Metz","1-0",1,0,"1",1,1,1,"H"
1972-03-25,1971,"Nimes Olympique","Olympique Marseille","1-3",1,3,"1",1,4,-2,"D"
1972-03-25,1971,"FC Nantes","Stade Rennes","4-0",4,0,"1",1,4,4,"H"
1972-03-25,1971,"Stade Reims","FC Sochaux","2-3",2,3,"1",1,5,-1,"D"
1972-03-26,1971,"AS Saint-Etienne","Olympique Lyon","0-1",0,1,"1",1,1,-1,"D"
1972-03-26,1971,"SC Bastia","AC Ajaccio","2-1",2,1,"1",1,3,1,"H"
1972-03-26,1971,"Red Star FC","Paris Saint-Germain","0-0",0,0,"1",1,0,0,"D"
1972-03-29,1971,"Olympique Marseille","SC Bastia","0-2",0,2,"1",1,2,-2,"D"
1972-03-29,1971,"Olympique Lyon","Nimes Olympique","3-2",3,2,"1",1,5,1,"H"
1972-03-29,1971,"Stade Rennes","FC Sochaux","0-2",0,2,"1",1,2,-2,"D"
1972-03-29,1971,"AS Monaco","FC Nantes","2-1",2,1,"1",1,3,1,"H"
1972-03-29,1971,"Angers SCO","OGC Nice","2-0",2,0,"1",1,2,2,"H"
1972-03-29,1971,"AC Ajaccio","AS Saint-Etienne","2-1",2,1,"1",1,3,1,"H"
1972-03-29,1971,"Lille OSC","AS Nancy","1-1",1,1,"1",1,2,0,"D"
1972-03-29,1971,"Girondins Bordeaux","Red Star FC","2-0",2,0,"1",1,2,2,"H"
1972-03-29,1971,"FC Metz","Stade Reims","3-0",3,0,"1",1,3,3,"H"
1972-03-29,1971,"Paris Saint-Germain","AS Angouleme","3-0",3,0,"1",1,3,3,"H"
1972-04-01,1971,"AS Saint-Etienne","Olympique Marseille","2-1",2,1,"1",1,3,1,"H"
1972-04-01,1971,"Nimes Olympique","Angers SCO","1-0",1,0,"1",1,1,1,"H"
1972-04-01,1971,"SC Bastia","Olympique Lyon","1-1",1,1,"1",1,2,0,"D"
1972-04-01,1971,"FC Sochaux","FC Metz","1-0",1,0,"1",1,1,1,"H"
1972-04-01,1971,"FC Nantes","Girondins Bordeaux","0-0",0,0,"1",1,0,0,"D"
1972-04-01,1971,"AS Nancy","AC Ajaccio","2-0",2,0,"1",1,2,2,"H"
1972-04-01,1971,"OGC Nice","Stade Rennes","0-0",0,0,"1",1,0,0,"D"
1972-04-01,1971,"Stade Reims","Paris Saint-Germain","3-3",3,3,"1",1,6,0,"D"
1972-04-01,1971,"Red Star FC","Lille OSC","0-0",0,0,"1",1,0,0,"D"
1972-04-01,1971,"AS Angouleme","AS Monaco","2-0",2,0,"1",1,2,2,"H"
1972-04-12,1971,"Olympique Marseille","FC Nantes","2-0",2,0,"1",1,2,2,"H"
1972-04-12,1971,"Stade Rennes","Nimes Olympique","0-2",0,2,"1",1,2,-2,"D"
1972-04-12,1971,"AC Ajaccio","FC Sochaux","1-2",1,2,"1",1,3,-1,"D"
1972-04-12,1971,"Olympique Lyon","AS Angouleme","2-0",2,0,"1",1,2,2,"H"
1972-04-12,1971,"Angers SCO","SC Bastia","2-0",2,0,"1",1,2,2,"H"
1972-04-12,1971,"AS Nancy","Red Star FC","1-1",1,1,"1",1,2,0,"D"
1972-04-12,1971,"Girondins Bordeaux","AS Saint-Etienne","0-2",0,2,"1",1,2,-2,"D"
1972-04-12,1971,"Lille OSC","OGC Nice","3-3",3,3,"1",1,6,0,"D"
1972-04-12,1971,"Paris Saint-Germain","FC Metz","3-1",3,1,"1",1,4,2,"H"
1972-04-12,1971,"AS Monaco","Stade Reims","1-1",1,1,"1",1,2,0,"D"
1972-04-21,1971,"AS Saint-Etienne","Angers SCO","0-1",0,1,"1",1,1,-1,"D"
1972-04-22,1971,"AS Angouleme","Olympique Marseille","2-3",2,3,"1",1,5,-1,"D"
1972-04-22,1971,"FC Sochaux","Paris Saint-Germain","0-2",0,2,"1",1,2,-2,"D"
1972-04-22,1971,"Nimes Olympique","Lille OSC","5-2",5,2,"1",1,7,3,"H"
1972-04-22,1971,"FC Nantes","Olympique Lyon","2-0",2,0,"1",1,2,2,"H"
1972-04-22,1971,"OGC Nice","AS Nancy","1-0",1,0,"1",1,1,1,"H"
1972-04-22,1971,"SC Bastia","Girondins Bordeaux","1-0",1,0,"1",1,1,1,"H"
1972-04-22,1971,"FC Metz","AS Monaco","4-0",4,0,"1",1,4,4,"H"
1972-04-22,1971,"Stade Reims","AC Ajaccio","3-1",3,1,"1",1,4,2,"H"
1972-04-23,1971,"Red Star FC","Stade Rennes","1-0",1,0,"1",1,1,1,"H"
1972-04-28,1971,"Olympique Marseille","Stade Reims","0-0",0,0,"1",1,0,0,"D"
1972-04-28,1971,"Girondins Bordeaux","Nimes Olympique","1-4",1,4,"1",1,5,-3,"D"
1972-04-28,1971,"Olympique Lyon","Paris Saint-Germain","3-1",3,1,"1",1,4,2,"H"
1972-04-28,1971,"Lille OSC","SC Bastia","1-0",1,0,"1",1,1,1,"H"
1972-04-28,1971,"AS Nancy","AS Saint-Etienne","3-1",3,1,"1",1,4,2,"H"
1972-04-28,1971,"Stade Rennes","AS Angouleme","2-2",2,2,"1",1,4,0,"D"
1972-04-28,1971,"AS Monaco","FC Sochaux","1-3",1,3,"1",1,4,-2,"D"
1972-04-29,1971,"Angers SCO","FC Nantes","2-1",2,1,"1",1,3,1,"H"
1972-04-29,1971,"AC Ajaccio","FC Metz","1-0",1,0,"1",1,1,1,"H"
1972-04-29,1971,"Red Star FC","OGC Nice","1-2",1,2,"1",1,3,-1,"D"
1972-05-03,1971,"FC Sochaux","Olympique Marseille","0-1",0,1,"1",1,1,-1,"D"
1972-05-03,1971,"Nimes Olympique","Red Star FC","2-0",2,0,"1",1,2,2,"H"
1972-05-03,1971,"FC Metz","Olympique Lyon","1-0",1,0,"1",1,1,1,"H"
1972-05-03,1971,"AS Angouleme","Angers SCO","1-0",1,0,"1",1,1,1,"H"
1972-05-03,1971,"SC Bastia","AS Nancy","2-0",2,0,"1",1,2,2,"H"
1972-05-03,1971,"OGC Nice","Girondins Bordeaux","5-1",5,1,"1",1,6,4,"H"
1972-05-03,1971,"FC Nantes","AC Ajaccio","2-0",2,0,"1",1,2,2,"H"
1972-05-03,1971,"AS Saint-Etienne","Lille OSC","4-0",4,0,"1",1,4,4,"H"
1972-05-03,1971,"Stade Reims","Stade Rennes","0-2",0,2,"1",1,2,-2,"D"
1972-05-03,1971,"Paris Saint-Germain","AS Monaco","0-0",0,0,"1",1,0,0,"D"
1972-05-06,1971,"Olympique Marseille","FC Metz","3-0",3,0,"1",1,3,3,"H"
1972-05-06,1971,"AS Nancy","Nimes Olympique","0-1",0,1,"1",1,1,-1,"D"
1972-05-06,1971,"Olympique Lyon","FC Sochaux","1-0",1,0,"1",1,1,1,"H"
1972-05-06,1971,"Angers SCO","Stade Reims","3-2",3,2,"1",1,5,1,"H"
1972-05-06,1971,"OGC Nice","AS Saint-Etienne","1-2",1,2,"1",1,3,-1,"D"
1972-05-06,1971,"Lille OSC","FC Nantes","3-0",3,0,"1",1,3,3,"H"
1972-05-06,1971,"Stade Rennes","AS Monaco","1-3",1,3,"1",1,4,-2,"D"
1972-05-06,1971,"Girondins Bordeaux","AS Angouleme","2-0",2,0,"1",1,2,2,"H"
1972-05-06,1971,"AC Ajaccio","Paris Saint-Germain","3-0",3,0,"1",1,3,3,"H"
1972-05-07,1971,"Red Star FC","SC Bastia","2-1",2,1,"1",1,3,1,"H"
1972-05-17,1971,"Paris Saint-Germain","Olympique Marseille","1-2",1,2,"1",1,3,-1,"D"
1972-05-17,1971,"Nimes Olympique","AC Ajaccio","2-0",2,0,"1",1,2,2,"H"
1972-05-17,1971,"FC Sochaux","Angers SCO","2-0",2,0,"1",1,2,2,"H"
1972-05-17,1971,"AS Monaco","Olympique Lyon","0-1",0,1,"1",1,1,-1,"D"
1972-05-17,1971,"AS Saint-Etienne","Red Star FC","5-1",5,1,"1",1,6,4,"H"
1972-05-17,1971,"SC Bastia","OGC Nice","3-3",3,3,"1",1,6,0,"D"
1972-05-17,1971,"FC Nantes","AS Nancy","2-2",2,2,"1",1,4,0,"D"
1972-05-17,1971,"FC Metz","Stade Rennes","1-2",1,2,"1",1,3,-1,"D"
1972-05-17,1971,"Stade Reims","Girondins Bordeaux","2-1",2,1,"1",1,3,1,"H"
1972-05-17,1971,"AS Angouleme","Lille OSC","3-3",3,3,"1",1,6,0,"D"
1972-05-20,1971,"Olympique Marseille","AS Monaco","4-2",4,2,"1",1,6,2,"H"
1972-05-20,1971,"OGC Nice","Nimes Olympique","4-0",4,0,"1",1,4,4,"H"
1972-05-20,1971,"AC Ajaccio","Olympique Lyon","2-0",2,0,"1",1,2,2,"H"
1972-05-20,1971,"Girondins Bordeaux","FC Sochaux","0-1",0,1,"1",1,1,-1,"D"
1972-05-20,1971,"AS Saint-Etienne","SC Bastia","5-3",5,3,"1",1,8,2,"H"
1972-05-20,1971,"Angers SCO","FC Metz","1-1",1,1,"1",1,2,0,"D"
1972-05-20,1971,"Red Star FC","FC Nantes","0-1",0,1,"1",1,1,-1,"D"
1972-05-20,1971,"AS Nancy","AS Angouleme","3-2",3,2,"1",1,5,1,"H"
1972-05-20,1971,"Stade Rennes","Paris Saint-Germain","1-1",1,1,"1",1,2,0,"D"
1972-05-20,1971,"Lille OSC","Stade Reims","0-0",0,0,"1",1,0,0,"D"
1972-05-26,1971,"Olympique Lyon","Olympique Marseille","3-3",3,3,"1",1,6,0,"D"
1972-05-26,1971,"FC Metz","Girondins Bordeaux","1-3",1,3,"1",1,4,-2,"D"
1972-05-27,1971,"Nimes Olympique","AS Saint-Etienne","4-0",4,0,"1",1,4,4,"H"
1972-05-27,1971,"FC Sochaux","Lille OSC","2-0",2,0,"1",1,2,2,"H"
1972-05-27,1971,"Paris Saint-Germain","Angers SCO","0-1",0,1,"1",1,1,-1,"D"
1972-05-27,1971,"FC Nantes","OGC Nice","4-0",4,0,"1",1,4,4,"H"
1972-05-27,1971,"Stade Reims","AS Nancy","3-2",3,2,"1",1,5,1,"H"
1972-05-27,1971,"SC Bastia","Stade Rennes","4-1",4,1,"1",1,5,3,"H"
1972-05-27,1971,"AS Monaco","AC Ajaccio","2-2",2,2,"1",1,4,0,"D"
1972-05-27,1971,"AS Angouleme","Red Star FC","0-2",0,2,"1",1,2,-2,"D"
1972-08-09,1972,"Angers SCO","AC Ajaccio","4-0",4,0,"1",1,4,4,"H"
1972-08-09,1972,"OGC Nice","FC Sochaux","4-1",4,1,"1",1,5,3,"H"
1972-08-09,1972,"RC Strasbourg","Stade Reims","4-1",4,1,"1",1,5,3,"H"
1972-08-09,1972,"FC Metz","Red Star FC","3-0",3,0,"1",1,3,3,"H"
1972-08-09,1972,"Olympique Lyon","Stade Rennes","3-1",3,1,"1",1,4,2,"H"
1972-08-09,1972,"CS Sedan","Olympique Marseille","0-2",0,2,"1",1,2,-2,"D"
1972-08-09,1972,"Paris FC","AS Nancy","3-2",3,2,"1",1,5,1,"H"
1972-08-09,1972,"Girondins Bordeaux","AS Saint-Etienne","1-1",1,1,"1",1,2,0,"D"
1972-08-09,1972,"Nimes Olympique","US Valenciennes-Anzin","1-1",1,1,"1",1,2,0,"D"
1972-08-09,1972,"SC Bastia","FC Nantes","0-0",0,0,"1",1,0,0,"D"
1972-08-16,1972,"Olympique Marseille","Olympique Lyon","5-2",5,2,"1",1,7,3,"H"
1972-08-16,1972,"Red Star FC","Angers SCO","1-2",1,2,"1",1,3,-1,"D"
1972-08-16,1972,"AC Ajaccio","RC Strasbourg","0-2",0,2,"1",1,2,-2,"D"
1972-08-16,1972,"Stade Reims","OGC Nice","2-3",2,3,"1",1,5,-1,"D"
1972-08-16,1972,"FC Metz","Girondins Bordeaux","1-1",1,1,"1",1,2,0,"D"
1972-08-16,1972,"AS Saint-Etienne","Nimes Olympique","3-1",3,1,"1",1,4,2,"H"
1972-08-16,1972,"FC Nantes","Paris FC","2-0",2,0,"1",1,2,2,"H"
1972-08-16,1972,"US Valenciennes-Anzin","AS Nancy","0-1",0,1,"1",1,1,-1,"D"
1972-08-16,1972,"Stade Rennes","SC Bastia","2-1",2,1,"1",1,3,1,"H"
1972-08-16,1972,"FC Sochaux","CS Sedan","1-0",1,0,"1",1,1,1,"H"
1972-08-23,1972,"OGC Nice","AC Ajaccio","5-3",5,3,"1",1,8,2,"H"
1972-08-23,1972,"Angers SCO","FC Metz","3-2",3,2,"1",1,5,1,"H"
1972-08-23,1972,"SC Bastia","Olympique Marseille","0-0",0,0,"1",1,0,0,"D"
1972-08-23,1972,"RC Strasbourg","AS Saint-Etienne","0-0",0,0,"1",1,0,0,"D"
1972-08-23,1972,"AS Nancy","FC Nantes","1-1",1,1,"1",1,2,0,"D"
1972-08-23,1972,"Stade Rennes","Paris FC","2-1",2,1,"1",1,3,1,"H"
1972-08-23,1972,"Nimes Olympique","FC Sochaux","3-0",3,0,"1",1,3,3,"H"
1972-08-23,1972,"Girondins Bordeaux","Red Star FC","1-1",1,1,"1",1,2,0,"D"
1972-08-23,1972,"Olympique Lyon","Stade Reims","1-1",1,1,"1",1,2,0,"D"
1972-08-23,1972,"CS Sedan","US Valenciennes-Anzin","3-1",3,1,"1",1,4,2,"H"
1972-08-26,1972,"Red Star FC","OGC Nice","1-1",1,1,"1",1,2,0,"D"
1972-08-26,1972,"Angers SCO","CS Sedan","2-2",2,2,"1",1,4,0,"D"
1972-08-26,1972,"Olympique Marseille","FC Nantes","1-0",1,0,"1",1,1,1,"H"
1972-08-26,1972,"FC Metz","RC Strasbourg","1-1",1,1,"1",1,2,0,"D"
1972-08-26,1972,"AS Saint-Etienne","Paris FC","3-0",3,0,"1",1,3,3,"H"
1972-08-26,1972,"Stade Rennes","AS Nancy","4-1",4,1,"1",1,5,3,"H"
1972-08-26,1972,"Stade Reims","Nimes Olympique","0-1",0,1,"1",1,1,-1,"D"
1972-08-26,1972,"AC Ajaccio","Girondins Bordeaux","2-2",2,2,"1",1,4,0,"D"
1972-08-26,1972,"FC Sochaux","Olympique Lyon","3-1",3,1,"1",1,4,2,"H"
1972-08-26,1972,"US Valenciennes-Anzin","SC Bastia","1-0",1,0,"1",1,1,1,"H"
1972-09-06,1972,"OGC Nice","FC Metz","6-0",6,0,"1",1,6,6,"H"
1972-09-06,1972,"Paris FC","Olympique Marseille","1-3",1,3,"1",1,4,-2,"D"
1972-09-06,1972,"Girondins Bordeaux","Angers SCO","1-2",1,2,"1",1,3,-1,"D"
1972-09-06,1972,"CS Sedan","AS Saint-Etienne","1-3",1,3,"1",1,4,-2,"D"
1972-09-06,1972,"RC Strasbourg","Red Star FC","2-2",2,2,"1",1,4,0,"D"
1972-09-06,1972,"Nimes Olympique","AC Ajaccio","2-1",2,1,"1",1,3,1,"H"
1972-09-06,1972,"FC Nantes","Stade Rennes","1-0",1,0,"1",1,1,1,"H"
1972-09-06,1972,"AS Nancy","Stade Reims","3-0",3,0,"1",1,3,3,"H"
1972-09-06,1972,"Olympique Lyon","US Valenciennes-Anzin","1-0",1,0,"1",1,1,1,"H"
1972-09-06,1972,"SC Bastia","FC Sochaux","3-1",3,1,"1",1,4,2,"H"
1972-09-15,1972,"AS Saint-Etienne","OGC Nice","0-1",0,1,"1",1,1,-1,"D"
1972-09-16,1972,"Olympique Marseille","Stade Rennes","3-0",3,0,"1",1,3,3,"H"
1972-09-16,1972,"Angers SCO","RC Strasbourg","1-0",1,0,"1",1,1,1,"H"
1972-09-16,1972,"Red Star FC","Nimes Olympique","1-1",1,1,"1",1,2,0,"D"
1972-09-16,1972,"US Valenciennes-Anzin","FC Nantes","1-1",1,1,"1",1,2,0,"D"
1972-09-16,1972,"FC Sochaux","AS Nancy","2-2",2,2,"1",1,4,0,"D"
1972-09-16,1972,"FC Metz","Olympique Lyon","2-2",2,2,"1",1,4,0,"D"
1972-09-16,1972,"Girondins Bordeaux","Paris FC","0-1",0,1,"1",1,1,-1,"D"
1972-09-16,1972,"Stade Reims","SC Bastia","2-0",2,0,"1",1,2,2,"H"
1972-09-16,1972,"AC Ajaccio","CS Sedan","2-1",2,1,"1",1,3,1,"H"
1972-09-20,1972,"OGC Nice","Angers SCO","2-4",2,4,"1",1,6,-2,"D"
1972-09-20,1972,"AS Nancy","Olympique Marseille","1-0",1,0,"1",1,1,1,"H"
1972-09-20,1972,"SC Bastia","AS Saint-Etienne","3-3",3,3,"1",1,6,0,"D"
1972-09-20,1972,"Nimes Olympique","FC Metz","0-0",0,0,"1",1,0,0,"D"
1972-09-20,1972,"FC Nantes","FC Sochaux","4-3",4,3,"1",1,7,1,"H"
1972-09-20,1972,"RC Strasbourg","Girondins Bordeaux","2-2",2,2,"1",1,4,0,"D"
1972-09-20,1972,"Stade Rennes","Stade Reims","1-0",1,0,"1",1,1,1,"H"
1972-09-20,1972,"Olympique Lyon","AC Ajaccio","1-0",1,0,"1",1,1,1,"H"
1972-09-20,1972,"CS Sedan","Red Star FC","0-1",0,1,"1",1,1,-1,"D"
1972-09-20,1972,"Paris FC","US Valenciennes-Anzin","1-1",1,1,"1",1,2,0,"D"
1972-09-29,1972,"Girondins Bordeaux","OGC Nice","0-1",0,1,"1",1,1,-1,"D"
1972-09-29,1972,"AS Saint-Etienne","AS Nancy","1-0",1,0,"1",1,1,1,"H"
1972-09-29,1972,"RC Strasbourg","SC Bastia","0-4",0,4,"1",1,4,-4,"D"
1972-09-30,1972,"Angers SCO","Nimes Olympique","0-1",0,1,"1",1,1,-1,"D"
1972-09-30,1972,"US Valenciennes-Anzin","Olympique Marseille","1-0",1,0,"1",1,1,1,"H"
1972-09-30,1972,"AC Ajaccio","FC Nantes","1-1",1,1,"1",1,2,0,"D"
1972-09-30,1972,"Red Star FC","Olympique Lyon","0-1",0,1,"1",1,1,-1,"D"
1972-09-30,1972,"FC Sochaux","Stade Rennes","2-1",2,1,"1",1,3,1,"H"
1972-09-30,1972,"FC Metz","CS Sedan","4-2",4,2,"1",1,6,2,"H"
1972-09-30,1972,"Stade Reims","Paris FC","1-1",1,1,"1",1,2,0,"D"
1972-10-04,1972,"OGC Nice","RC Strasbourg","3-0",3,0,"1",1,3,3,"H"
1972-10-04,1972,"Olympique Lyon","Angers SCO","2-1",2,1,"1",1,3,1,"H"
1972-10-04,1972,"Nimes Olympique","Girondins Bordeaux","2-0",2,0,"1",1,2,2,"H"
1972-10-04,1972,"Olympique Marseille","FC Sochaux","1-1",1,1,"1",1,2,0,"D"
1972-10-04,1972,"FC Nantes","AS Saint-Etienne","1-0",1,0,"1",1,1,1,"H"
1972-10-04,1972,"Stade Rennes","US Valenciennes-Anzin","2-0",2,0,"1",1,2,2,"H"
1972-10-04,1972,"AS Nancy","FC Metz","0-2",0,2,"1",1,2,-2,"D"
1972-10-04,1972,"SC Bastia","AC Ajaccio","1-0",1,0,"1",1,1,1,"H"
1972-10-04,1972,"Paris FC","Red Star FC","3-0",3,0,"1",1,3,3,"H"
1972-10-04,1972,"CS Sedan","Stade Reims","2-0",2,0,"1",1,2,2,"H"
1972-10-07,1972,"OGC Nice","FC Nantes","3-0",3,0,"1",1,3,3,"H"
1972-10-07,1972,"Angers SCO","Stade Rennes","0-2",0,2,"1",1,2,-2,"D"
1972-10-07,1972,"RC Strasbourg","Nimes Olympique","2-1",2,1,"1",1,3,1,"H"
1972-10-07,1972,"AS Saint-Etienne","Olympique Lyon","1-1",1,1,"1",1,2,0,"D"
1972-10-07,1972,"Stade Reims","Olympique Marseille","2-1",2,1,"1",1,3,1,"H"
1972-10-07,1972,"FC Metz","SC Bastia","3-2",3,2,"1",1,5,1,"H"
1972-10-07,1972,"Red Star FC","AS Nancy","0-1",0,1,"1",1,1,-1,"D"
1972-10-07,1972,"FC Sochaux","US Valenciennes-Anzin","3-0",3,0,"1",1,3,3,"H"
1972-10-07,1972,"AC Ajaccio","Paris FC","2-1",2,1,"1",1,3,1,"H"
1972-10-07,1972,"Girondins Bordeaux","CS Sedan","6-1",6,1,"1",1,7,5,"H"
1972-10-17,1972,"Nimes Olympique","OGC Nice","0-1",0,1,"1",1,1,-1,"D"
1972-10-17,1972,"Olympique Marseille","FC Metz","5-0",5,0,"1",1,5,5,"H"
1972-10-17,1972,"FC Nantes","Angers SCO","2-0",2,0,"1",1,2,2,"H"
1972-10-17,1972,"Stade Rennes","AS Saint-Etienne","2-2",2,2,"1",1,4,0,"D"
1972-10-17,1972,"Olympique Lyon","Girondins Bordeaux","0-1",0,1,"1",1,1,-1,"D"
1972-10-17,1972,"Paris FC","FC Sochaux","0-2",0,2,"1",1,2,-2,"D"
1972-10-17,1972,"AS Nancy","AC Ajaccio","2-1",2,1,"1",1,3,1,"H"
1972-10-17,1972,"SC Bastia","Red Star FC","3-0",3,0,"1",1,3,3,"H"
1972-10-17,1972,"CS Sedan","RC Strasbourg","0-0",0,0,"1",1,0,0,"D"
1972-10-17,1972,"US Valenciennes-Anzin","Stade Reims","1-2",1,2,"1",1,3,-1,"D"
1972-10-20,1972,"RC Strasbourg","Olympique Lyon","0-2",0,2,"1",1,2,-2,"D"
1972-10-20,1972,"Angers SCO","AS Nancy","0-0",0,0,"1",1,0,0,"D"
1972-10-20,1972,"Girondins Bordeaux","SC Bastia","1-1",1,1,"1",1,2,0,"D"
1972-10-20,1972,"Stade Reims","FC Sochaux","1-0",1,0,"1",1,1,1,"H"
1972-10-20,1972,"Nimes Olympique","CS Sedan","2-1",2,1,"1",1,3,1,"H"
1972-10-21,1972,"FC Metz","FC Nantes","0-2",0,2,"1",1,2,-2,"D"
1972-10-22,1972,"OGC Nice","Paris FC","3-2",3,2,"1",1,5,1,"H"
1972-10-22,1972,"AS Saint-Etienne","US Valenciennes-Anzin","3-2",3,2,"1",1,5,1,"H"
1972-10-22,1972,"AC Ajaccio","Olympique Marseille","1-0",1,0,"1",1,1,1,"H"
1972-10-22,1972,"Red Star FC","Stade Rennes","2-0",2,0,"1",1,2,2,"H"
1972-10-27,1972,"Olympique Lyon","Nimes Olympique","1-0",1,0,"1",1,1,1,"H"
1972-10-27,1972,"AS Nancy","Girondins Bordeaux","2-1",2,1,"1",1,3,1,"H"
1972-10-27,1972,"Paris FC","RC Strasbourg","1-1",1,1,"1",1,2,0,"D"
1972-10-28,1972,"CS Sedan","OGC Nice","0-5",0,5,"1",1,5,-5,"D"
1972-10-28,1972,"FC Nantes","Stade Reims","0-0",0,0,"1",1,0,0,"D"
1972-10-28,1972,"Olympique Marseille","Red Star FC","3-0",3,0,"1",1,3,3,"H"
1972-10-28,1972,"FC Sochaux","AS Saint-Etienne","2-1",2,1,"1",1,3,1,"H"
1972-10-28,1972,"SC Bastia","Angers SCO","2-0",2,0,"1",1,2,2,"H"
1972-10-28,1972,"Stade Rennes","AC Ajaccio","1-1",1,1,"1",1,2,0,"D"
1972-10-28,1972,"US Valenciennes-Anzin","FC Metz","1-0",1,0,"1",1,1,1,"H"
1972-11-01,1972,"Angers SCO","Olympique Marseille","0-2",0,2,"1",1,2,-2,"D"
1972-11-01,1972,"Girondins Bordeaux","FC Nantes","2-1",2,1,"1",1,3,1,"H"
1972-11-01,1972,"CS Sedan","SC Bastia","2-1",2,1,"1",1,3,1,"H"
1972-11-01,1972,"AC Ajaccio","FC Sochaux","2-0",2,0,"1",1,2,2,"H"
1972-11-04,1972,"Nimes Olympique","Paris FC","2-0",2,0,"1",1,2,2,"H"
1972-11-04,1972,"RC Strasbourg","AS Nancy","1-1",1,1,"1",1,2,0,"D"
1972-11-05,1972,"OGC Nice","Olympique Lyon","2-2",2,2,"1",1,4,0,"D"
1972-11-05,1972,"AS Saint-Etienne","Stade Reims","2-1",2,1,"1",1,3,1,"H"
1972-11-05,1972,"FC Metz","Stade Rennes","2-1",2,1,"1",1,3,1,"H"
1972-11-05,1972,"Red Star FC","US Valenciennes-Anzin","1-0",1,0,"1",1,1,1,"H"
1972-11-18,1972,"FC Nantes","RC Strasbourg","6-2",6,2,"1",1,8,4,"H"
1972-11-19,1972,"AS Nancy","OGC Nice","3-0",3,0,"1",1,3,3,"H"
1972-11-19,1972,"Olympique Marseille","AS Saint-Etienne","3-1",3,1,"1",1,4,2,"H"
1972-11-19,1972,"Olympique Lyon","CS Sedan","1-2",1,2,"1",1,3,-1,"D"
1972-11-19,1972,"SC Bastia","Nimes Olympique","3-0",3,0,"1",1,3,3,"H"
1972-11-19,1972,"Stade Rennes","Girondins Bordeaux","3-0",3,0,"1",1,3,3,"H"
1972-11-19,1972,"Paris FC","Angers SCO","1-2",1,2,"1",1,3,-1,"D"
1972-11-19,1972,"FC Sochaux","Red Star FC","1-0",1,0,"1",1,1,1,"H"
1972-11-19,1972,"Stade Reims","FC Metz","0-0",0,0,"1",1,0,0,"D"
1972-11-19,1972,"US Valenciennes-Anzin","AC Ajaccio","3-2",3,2,"1",1,5,1,"H"
1972-11-25,1972,"Olympique Lyon","FC Nantes","2-4",2,4,"1",1,6,-2,"D"
1972-11-26,1972,"OGC Nice","SC Bastia","1-0",1,0,"1",1,1,1,"H"
1972-11-26,1972,"Girondins Bordeaux","Olympique Marseille","2-1",2,1,"1",1,3,1,"H"
1972-11-26,1972,"Nimes Olympique","AS Nancy","2-1",2,1,"1",1,3,1,"H"
1972-11-26,1972,"Angers SCO","US Valenciennes-Anzin","5-1",5,1,"1",1,6,4,"H"
1972-11-26,1972,"AC Ajaccio","AS Saint-Etienne","2-0",2,0,"1",1,2,2,"H"
1972-11-26,1972,"FC Metz","FC Sochaux","2-1",2,1,"1",1,3,1,"H"
1972-11-26,1972,"RC Strasbourg","Stade Rennes","2-1",2,1,"1",1,3,1,"H"
1972-11-26,1972,"Red Star FC","Stade Reims","1-2",1,2,"1",1,3,-1,"D"
1972-11-26,1972,"CS Sedan","Paris FC","3-1",3,1,"1",1,4,2,"H"
1972-12-09,1972,"FC Metz","AS Saint-Etienne","1-2",1,2,"1",1,3,-1,"D"
1972-12-10,1972,"OGC Nice","Olympique Marseille","1-1",1,1,"1",1,2,0,"D"
1972-12-10,1972,"CS Sedan","FC Nantes","0-3",0,3,"1",1,3,-3,"D"
1972-12-10,1972,"Angers SCO","Stade Reims","1-1",1,1,"1",1,2,0,"D"
1972-12-10,1972,"Olympique Lyon","AS Nancy","2-2",2,2,"1",1,4,0,"D"
1972-12-10,1972,"Nimes Olympique","Stade Rennes","1-1",1,1,"1",1,2,0,"D"
1972-12-10,1972,"SC Bastia","Paris FC","1-0",1,0,"1",1,1,1,"H"
1972-12-10,1972,"Girondins Bordeaux","FC Sochaux","1-1",1,1,"1",1,2,0,"D"
1972-12-10,1972,"RC Strasbourg","US Valenciennes-Anzin","1-1",1,1,"1",1,2,0,"D"
1972-12-10,1972,"Red Star FC","AC Ajaccio","3-0",3,0,"1",1,3,3,"H"
1972-12-16,1972,"Stade Rennes","CS Sedan","1-1",1,1,"1",1,2,0,"D"
1972-12-17,1972,"US Valenciennes-Anzin","OGC Nice","1-1",1,1,"1",1,2,0,"D"
1972-12-17,1972,"FC Nantes","Red Star FC","3-1",3,1,"1",1,4,2,"H"
1972-12-17,1972,"Olympique Marseille","Nimes Olympique","1-2",1,2,"1",1,3,-1,"D"
1972-12-17,1972,"AS Saint-Etienne","Angers SCO","5-0",5,0,"1",1,5,5,"H"
1972-12-17,1972,"AS Nancy","SC Bastia","3-2",3,2,"1",1,5,1,"H"
1972-12-17,1972,"Paris FC","Olympique Lyon","5-1",5,1,"1",1,6,4,"H"
1972-12-17,1972,"AC Ajaccio","FC Metz","0-0",0,0,"1",1,0,0,"D"
1972-12-17,1972,"FC Sochaux","RC Strasbourg","1-1",1,1,"1",1,2,0,"D"
1972-12-17,1972,"Stade Reims","Girondins Bordeaux","3-1",3,1,"1",1,4,2,"H"
1973-01-07,1972,"OGC Nice","Stade Reims","2-2",2,2,"1",1,4,0,"D"
1973-01-07,1972,"Paris FC","FC Nantes","1-2",1,2,"1",1,3,-1,"D"
1973-01-07,1972,"Olympique Lyon","Olympique Marseille","4-4",4,4,"1",1,8,0,"D"
1973-01-07,1972,"Nimes Olympique","AS Saint-Etienne","4-0",4,0,"1",1,4,4,"H"
1973-01-07,1972,"AS Nancy","US Valenciennes-Anzin","1-1",1,1,"1",1,2,0,"D"
1973-01-07,1972,"Angers SCO","Red Star FC","1-0",1,0,"1",1,1,1,"H"
1973-01-07,1972,"SC Bastia","Stade Rennes","4-0",4,0,"1",1,4,4,"H"
1973-01-07,1972,"CS Sedan","FC Sochaux","1-1",1,1,"1",1,2,0,"D"
1973-01-07,1972,"Girondins Bordeaux","FC Metz","2-0",2,0,"1",1,2,2,"H"
1973-01-07,1972,"RC Strasbourg","AC Ajaccio","6-0",6,0,"1",1,6,6,"H"
1973-01-14,1972,"AC Ajaccio","OGC Nice","0-3",0,3,"1",1,3,-3,"D"
1973-01-14,1972,"FC Nantes","AS Nancy","2-1",2,1,"1",1,3,1,"H"
1973-01-14,1972,"Olympique Marseille","SC Bastia","1-0",1,0,"1",1,1,1,"H"
1973-01-14,1972,"FC Sochaux","Nimes Olympique","0-0",0,0,"1",1,0,0,"D"
1973-01-14,1972,"AS Saint-Etienne","RC Strasbourg","5-1",5,1,"1",1,6,4,"H"
1973-01-14,1972,"FC Metz","Angers SCO","2-0",2,0,"1",1,2,2,"H"
1973-01-14,1972,"Stade Reims","Olympique Lyon","2-1",2,1,"1",1,3,1,"H"
1973-01-14,1972,"US Valenciennes-Anzin","CS Sedan","5-1",5,1,"1",1,6,4,"H"
1973-01-14,1972,"Red Star FC","Girondins Bordeaux","3-1",3,1,"1",1,4,2,"H"
1973-01-17,1972,"Paris FC","Stade Rennes","2-2",2,2,"1",1,4,0,"D"
1973-01-21,1972,"OGC Nice","Red Star FC","1-1",1,1,"1",1,2,0,"D"
1973-01-21,1972,"FC Nantes","Olympique Marseille","1-2",1,2,"1",1,3,-1,"D"
1973-01-21,1972,"Nimes Olympique","Stade Reims","2-1",2,1,"1",1,3,1,"H"
1973-01-21,1972,"Paris FC","AS Saint-Etienne","1-1",1,1,"1",1,2,0,"D"
1973-01-21,1972,"RC Strasbourg","FC Metz","0-1",0,1,"1",1,1,-1,"D"
1973-01-21,1972,"SC Bastia","US Valenciennes-Anzin","2-0",2,0,"1",1,2,2,"H"
1973-01-21,1972,"CS Sedan","Angers SCO","2-2",2,2,"1",1,4,0,"D"
1973-01-21,1972,"Olympique Lyon","FC Sochaux","2-0",2,0,"1",1,2,2,"H"
1973-01-21,1972,"Girondins Bordeaux","AC Ajaccio","3-0",3,0,"1",1,3,3,"H"
1973-02-04,1972,"FC Metz","OGC Nice","1-0",1,0,"1",1,1,1,"H"
1973-02-04,1972,"Stade Rennes","FC Nantes","0-0",0,0,"1",1,0,0,"D"
1973-02-04,1972,"Olympique Marseille","Paris FC","0-0",0,0,"1",1,0,0,"D"
1973-02-04,1972,"AC Ajaccio","Nimes Olympique","1-1",1,1,"1",1,2,0,"D"
1973-02-04,1972,"AS Saint-Etienne","CS Sedan","2-0",2,0,"1",1,2,2,"H"
1973-02-04,1972,"Stade Reims","AS Nancy","2-3",2,3,"1",1,5,-1,"D"
1973-02-04,1972,"Angers SCO","Girondins Bordeaux","3-1",3,1,"1",1,4,2,"H"
1973-02-04,1972,"US Valenciennes-Anzin","Olympique Lyon","1-2",1,2,"1",1,3,-1,"D"
1973-02-04,1972,"FC Sochaux","SC Bastia","3-2",3,2,"1",1,5,1,"H"
1973-02-04,1972,"Red Star FC","RC Strasbourg","0-0",0,0,"1",1,0,0,"D"
1973-02-11,1972,"FC Nantes","US Valenciennes-Anzin","1-0",1,0,"1",1,1,1,"H"
1973-02-11,1972,"OGC Nice","AS Saint-Etienne","1-1",1,1,"1",1,2,0,"D"
1973-02-11,1972,"Stade Rennes","Olympique Marseille","2-3",2,3,"1",1,5,-1,"D"
1973-02-11,1972,"Nimes Olympique","Red Star FC","1-1",1,1,"1",1,2,0,"D"
1973-02-11,1972,"AS Nancy","FC Sochaux","4-2",4,2,"1",1,6,2,"H"
1973-02-11,1972,"Olympique Lyon","FC Metz","3-0",3,0,"1",1,3,3,"H"
1973-02-11,1972,"RC Strasbourg","Angers SCO","0-0",0,0,"1",1,0,0,"D"
1973-02-11,1972,"SC Bastia","Stade Reims","1-1",1,1,"1",1,2,0,"D"
1973-02-11,1972,"Paris FC","Girondins Bordeaux","4-3",4,3,"1",1,7,1,"H"
1973-02-11,1972,"CS Sedan","AC Ajaccio","5-0",5,0,"1",1,5,5,"H"
1973-02-25,1972,"FC Sochaux","FC Nantes","0-1",0,1,"1",1,1,-1,"D"
1973-02-25,1972,"Angers SCO","OGC Nice","0-0",0,0,"1",1,0,0,"D"
1973-02-25,1972,"Olympique Marseille","AS Nancy","0-0",0,0,"1",1,0,0,"D"
1973-02-25,1972,"FC Metz","Nimes Olympique","0-1",0,1,"1",1,1,-1,"D"
1973-02-25,1972,"AS Saint-Etienne","SC Bastia","2-1",2,1,"1",1,3,1,"H"
1973-02-25,1972,"AC Ajaccio","Olympique Lyon","4-3",4,3,"1",1,7,1,"H"
1973-02-25,1972,"Stade Reims","Stade Rennes","1-1",1,1,"1",1,2,0,"D"
1973-02-25,1972,"Girondins Bordeaux","RC Strasbourg","2-1",2,1,"1",1,3,1,"H"
1973-02-25,1972,"US Valenciennes-Anzin","Paris FC","1-1",1,1,"1",1,2,0,"D"
1973-02-25,1972,"Red Star FC","CS Sedan","1-1",1,1,"1",1,2,0,"D"
1973-03-09,1972,"Stade Rennes","OGC Nice","1-0",1,0,"1",1,1,1,"H"
1973-03-09,1972,"AS Nancy","CS Sedan","1-1",1,1,"1",1,2,0,"D"
1973-03-17,1972,"FC Nantes","AC Ajaccio","6-1",6,1,"1",1,7,5,"H"
1973-03-17,1972,"Stade Rennes","FC Sochaux","0-0",0,0,"1",1,0,0,"D"
1973-03-17,1972,"CS Sedan","FC Metz","1-1",1,1,"1",1,2,0,"D"
1973-03-18,1972,"OGC Nice","Girondins Bordeaux","0-1",0,1,"1",1,1,-1,"D"
1973-03-18,1972,"Olympique Marseille","US Valenciennes-Anzin","1-0",1,0,"1",1,1,1,"H"
1973-03-18,1972,"Nimes Olympique","Angers SCO","2-2",2,2,"1",1,4,0,"D"
1973-03-18,1972,"AS Nancy","AS Saint-Etienne","4-0",4,0,"1",1,4,4,"H"
1973-03-18,1972,"Olympique Lyon","Red Star FC","1-2",1,2,"1",1,3,-1,"D"
1973-03-18,1972,"SC Bastia","RC Strasbourg","3-0",3,0,"1",1,3,3,"H"
1973-03-18,1972,"Paris FC","Stade Reims","0-0",0,0,"1",1,0,0,"D"
1973-03-23,1972,"AS Saint-Etienne","FC Nantes","1-2",1,2,"1",1,3,-1,"D"
1973-03-23,1972,"RC Strasbourg","OGC Nice","0-1",0,1,"1",1,1,-1,"D"
1973-03-23,1972,"Girondins Bordeaux","Nimes Olympique","0-1",0,1,"1",1,1,-1,"D"
1973-03-23,1972,"Red Star FC","Paris FC","2-3",2,3,"1",1,5,-1,"D"
1973-03-24,1972,"FC Sochaux","Olympique Marseille","1-2",1,2,"1",1,3,-1,"D"
1973-03-24,1972,"FC Metz","AS Nancy","1-0",1,0,"1",1,1,1,"H"
1973-03-24,1972,"Angers SCO","Olympique Lyon","1-0",1,0,"1",1,1,1,"H"
1973-03-24,1972,"Stade Reims","CS Sedan","5-1",5,1,"1",1,6,4,"H"
1973-03-24,1972,"US Valenciennes-Anzin","Stade Rennes","2-0",2,0,"1",1,2,2,"H"
1973-03-25,1972,"AC Ajaccio","SC Bastia","0-1",0,1,"1",1,1,-1,"D"
1973-03-27,1972,"Nimes Olympique","RC Strasbourg","3-0",3,0,"1",1,3,3,"H"
1973-03-28,1972,"FC Nantes","OGC Nice","2-2",2,2,"1",1,4,0,"D"
1973-03-28,1972,"Olympique Marseille","Stade Reims","3-1",3,1,"1",1,4,2,"H"
1973-03-28,1972,"AS Nancy","Red Star FC","2-1",2,1,"1",1,3,1,"H"
1973-03-28,1972,"Stade Rennes","Angers SCO","1-2",1,2,"1",1,3,-1,"D"
1973-03-28,1972,"SC Bastia","FC Metz","4-0",4,0,"1",1,4,4,"H"
1973-03-28,1972,"Olympique Lyon","AS Saint-Etienne","2-0",2,0,"1",1,2,2,"H"
1973-03-28,1972,"US Valenciennes-Anzin","FC Sochaux","0-0",0,0,"1",1,0,0,"D"
1973-03-28,1972,"CS Sedan","Girondins Bordeaux","1-0",1,0,"1",1,1,1,"H"
1973-03-28,1972,"Paris FC","AC Ajaccio","3-1",3,1,"1",1,4,2,"H"
1973-03-31,1972,"Angers SCO","FC Nantes","1-0",1,0,"1",1,1,1,"H"
1973-03-31,1972,"OGC Nice","Nimes Olympique","2-0",2,0,"1",1,2,2,"H"
1973-03-31,1972,"FC Metz","Olympique Marseille","2-0",2,0,"1",1,2,2,"H"
1973-03-31,1972,"AS Saint-Etienne","Stade Rennes","2-0",2,0,"1",1,2,2,"H"
1973-03-31,1972,"Red Star FC","SC Bastia","2-2",2,2,"1",1,4,0,"D"
1973-03-31,1972,"Girondins Bordeaux","Olympique Lyon","1-0",1,0,"1",1,1,1,"H"
1973-03-31,1972,"Stade Reims","US Valenciennes-Anzin","1-0",1,0,"1",1,1,1,"H"
1973-03-31,1972,"FC Sochaux","Paris FC","1-1",1,1,"1",1,2,0,"D"
1973-03-31,1972,"RC Strasbourg","CS Sedan","2-1",2,1,"1",1,3,1,"H"
1973-04-01,1972,"AC Ajaccio","AS Nancy","2-2",2,2,"1",1,4,0,"D"
1973-04-04,1972,"FC Nantes","Nimes Olympique","2-1",2,1,"1",1,3,1,"H"
1973-04-04,1972,"Olympique Marseille","RC Strasbourg","3-1",3,1,"1",1,4,2,"H"
1973-04-04,1972,"SC Bastia","Olympique Lyon","1-1",1,1,"1",1,2,0,"D"
1973-04-04,1972,"Paris FC","FC Metz","1-3",1,3,"1",1,4,-2,"D"
1973-04-04,1972,"AS Saint-Etienne","Red Star FC","1-1",1,1,"1",1,2,0,"D"
1973-04-06,1972,"AS Nancy","Angers SCO","0-0",0,0,"1",1,0,0,"D"
1973-04-07,1972,"FC Nantes","FC Metz","0-0",0,0,"1",1,0,0,"D"
1973-04-07,1972,"Olympique Marseille","AC Ajaccio","3-0",3,0,"1",1,3,3,"H"
1973-04-07,1972,"Paris FC","OGC Nice","2-0",2,0,"1",1,2,2,"H"
1973-04-07,1972,"CS Sedan","Nimes Olympique","2-1",2,1,"1",1,3,1,"H"
1973-04-07,1972,"US Valenciennes-Anzin","AS Saint-Etienne","0-1",0,1,"1",1,1,-1,"D"
1973-04-07,1972,"Olympique Lyon","RC Strasbourg","4-0",4,0,"1",1,4,4,"H"
1973-04-07,1972,"SC Bastia","Girondins Bordeaux","1-1",1,1,"1",1,2,0,"D"
1973-04-07,1972,"FC Sochaux","Stade Reims","2-1",2,1,"1",1,3,1,"H"
1973-04-07,1972,"Stade Rennes","Red Star FC","1-1",1,1,"1",1,2,0,"D"
1973-04-10,1972,"FC Metz","US Valenciennes-Anzin","1-1",1,1,"1",1,2,0,"D"
1973-04-11,1972,"Red Star FC","Olympique Marseille","1-2",1,2,"1",1,3,-1,"D"
1973-04-11,1972,"Stade Reims","FC Nantes","2-1",2,1,"1",1,3,1,"H"
1973-04-11,1972,"Nimes Olympique","Olympique Lyon","3-1",3,1,"1",1,4,2,"H"
1973-04-11,1972,"Angers SCO","SC Bastia","3-0",3,0,"1",1,3,3,"H"
1973-04-11,1972,"Girondins Bordeaux","AS Nancy","3-1",3,1,"1",1,4,2,"H"
1973-04-11,1972,"AC Ajaccio","Stade Rennes","2-3",2,3,"1",1,5,-1,"D"
1973-04-11,1972,"RC Strasbourg","Paris FC","2-0",2,0,"1",1,2,2,"H"
1973-04-13,1972,"OGC Nice","CS Sedan","4-2",4,2,"1",1,6,2,"H"
1973-04-14,1972,"Stade Reims","AC Ajaccio","0-0",0,0,"1",1,0,0,"D"
1973-04-14,1972,"US Valenciennes-Anzin","Girondins Bordeaux","3-0",3,0,"1",1,3,3,"H"
1973-04-14,1972,"FC Sochaux","Angers SCO","1-1",1,1,"1",1,2,0,"D"
1973-04-14,1972,"AS Nancy","Stade Rennes","4-0",4,0,"1",1,4,4,"H"
1973-04-20,1972,"Olympique Lyon","OGC Nice","1-2",1,2,"1",1,3,-1,"D"
1973-04-20,1972,"AS Nancy","RC Strasbourg","2-1",2,1,"1",1,3,1,"H"
1973-04-20,1972,"Stade Rennes","FC Metz","1-0",1,0,"1",1,1,1,"H"
1973-04-20,1972,"FC Sochaux","AC Ajaccio","4-0",4,0,"1",1,4,4,"H"
1973-04-21,1972,"Olympique Marseille","Angers SCO","3-2",3,2,"1",1,5,1,"H"
1973-04-21,1972,"FC Nantes","Girondins Bordeaux","3-0",3,0,"1",1,3,3,"H"
1973-04-21,1972,"Paris FC","Nimes Olympique","3-1",3,1,"1",1,4,2,"H"
1973-04-21,1972,"SC Bastia","CS Sedan","3-0",3,0,"1",1,3,3,"H"
1973-04-21,1972,"US Valenciennes-Anzin","Red Star FC","0-0",0,0,"1",1,0,0,"D"
1973-04-24,1972,"Stade Reims","AS Saint-Etienne","0-0",0,0,"1",1,0,0,"D"
1973-04-27,1972,"RC Strasbourg","FC Nantes","0-3",0,3,"1",1,3,-3,"D"
1973-04-27,1972,"OGC Nice","AS Nancy","1-0",1,0,"1",1,1,1,"H"
1973-04-27,1972,"Nimes Olympique","SC Bastia","2-1",2,1,"1",1,3,1,"H"
1973-04-27,1972,"Girondins Bordeaux","Stade Rennes","1-1",1,1,"1",1,2,0,"D"
1973-04-28,1972,"AS Saint-Etienne","Olympique Marseille","2-1",2,1,"1",1,3,1,"H"
1973-04-28,1972,"Angers SCO","Paris FC","1-1",1,1,"1",1,2,0,"D"
1973-04-28,1972,"FC Metz","Stade Reims","1-2",1,2,"1",1,3,-1,"D"
1973-04-28,1972,"Red Star FC","FC Sochaux","3-3",3,3,"1",1,6,0,"D"
1973-04-28,1972,"AC Ajaccio","US Valenciennes-Anzin","3-1",3,1,"1",1,4,2,"H"
1973-04-28,1972,"CS Sedan","Olympique Lyon","4-1",4,1,"1",1,5,3,"H"
1973-05-01,1972,"FC Nantes","Olympique Lyon","3-0",3,0,"1",1,3,3,"H"
1973-05-02,1972,"Olympique Marseille","Girondins Bordeaux","1-1",1,1,"1",1,2,0,"D"
1973-05-02,1972,"SC Bastia","OGC Nice","3-0",3,0,"1",1,3,3,"H"
1973-05-02,1972,"AS Nancy","Nimes Olympique","2-1",2,1,"1",1,3,1,"H"
1973-05-02,1972,"AS Saint-Etienne","AC Ajaccio","3-1",3,1,"1",1,4,2,"H"
1973-05-02,1972,"US Valenciennes-Anzin","Angers SCO","3-0",3,0,"1",1,3,3,"H"
1973-05-02,1972,"Stade Reims","Red Star FC","3-0",3,0,"1",1,3,3,"H"
1973-05-02,1972,"FC Sochaux","FC Metz","4-1",4,1,"1",1,5,3,"H"
1973-05-02,1972,"Stade Rennes","RC Strasbourg","1-0",1,0,"1",1,1,1,"H"
1973-05-02,1972,"Paris FC","CS Sedan","2-1",2,1,"1",1,3,1,"H"
1973-05-05,1972,"Nimes Olympique","FC Nantes","1-1",1,1,"1",1,2,0,"D"
1973-05-05,1972,"OGC Nice","Stade Rennes","2-0",2,0,"1",1,2,2,"H"
1973-05-05,1972,"RC Strasbourg","Olympique Marseille","1-1",1,1,"1",1,2,0,"D"
1973-05-05,1972,"Red Star FC","AS Saint-Etienne","0-3",0,3,"1",1,3,-3,"D"
1973-05-05,1972,"CS Sedan","AS Nancy","1-0",1,0,"1",1,1,1,"H"
1973-05-05,1972,"Angers SCO","FC Sochaux","1-0",1,0,"1",1,1,1,"H"
1973-05-05,1972,"AC Ajaccio","Stade Reims","2-3",2,3,"1",1,5,-1,"D"
1973-05-05,1972,"Olympique Lyon","SC Bastia","2-0",2,0,"1",1,2,2,"H"
1973-05-05,1972,"FC Metz","Paris FC","0-1",0,1,"1",1,1,-1,"D"
1973-05-05,1972,"Girondins Bordeaux","US Valenciennes-Anzin","2-0",2,0,"1",1,2,2,"H"
1973-05-08,1972,"AS Saint-Etienne","FC Sochaux","2-2",2,2,"1",1,4,0,"D"
1973-05-11,1972,"AS Saint-Etienne","FC Metz","1-0",1,0,"1",1,1,1,"H"
1973-05-11,1972,"AS Nancy","Olympique Lyon","4-1",4,1,"1",1,5,3,"H"
1973-05-11,1972,"Paris FC","SC Bastia","2-0",2,0,"1",1,2,2,"H"
1973-05-12,1972,"FC Nantes","CS Sedan","1-0",1,0,"1",1,1,1,"H"
1973-05-12,1972,"Olympique Marseille","OGC Nice","1-1",1,1,"1",1,2,0,"D"
1973-05-12,1972,"Stade Rennes","Nimes Olympique","1-0",1,0,"1",1,1,1,"H"
1973-05-12,1972,"Stade Reims","Angers SCO","3-2",3,2,"1",1,5,1,"H"
1973-05-12,1972,"FC Sochaux","Girondins Bordeaux","0-0",0,0,"1",1,0,0,"D"
1973-05-12,1972,"US Valenciennes-Anzin","RC Strasbourg","1-2",1,2,"1",1,3,-1,"D"
1973-05-12,1972,"AC Ajaccio","Red Star FC","2-2",2,2,"1",1,4,0,"D"
1973-05-29,1972,"Red Star FC","FC Nantes","1-3",1,3,"1",1,4,-2,"D"
1973-05-29,1972,"OGC Nice","US Valenciennes-Anzin","4-1",4,1,"1",1,5,3,"H"
1973-05-29,1972,"Nimes Olympique","Olympique Marseille","1-1",1,1,"1",1,2,0,"D"
1973-05-29,1972,"Angers SCO","AS Saint-Etienne","2-0",2,0,"1",1,2,2,"H"
1973-05-29,1972,"SC Bastia","AS Nancy","3-1",3,1,"1",1,4,2,"H"
1973-05-29,1972,"Girondins Bordeaux","Stade Reims","2-0",2,0,"1",1,2,2,"H"
1973-05-29,1972,"CS Sedan","Stade Rennes","2-3",2,3,"1",1,5,-1,"D"
1973-05-29,1972,"RC Strasbourg","FC Sochaux","4-2",4,2,"1",1,6,2,"H"
1973-05-29,1972,"Olympique Lyon","Paris FC","5-2",5,2,"1",1,7,3,"H"
1973-05-29,1972,"FC Metz","AC Ajaccio","7-0",7,0,"1",1,7,7,"H"
1973-06-02,1972,"FC Nantes","SC Bastia","1-0",1,0,"1",1,1,1,"H"
1973-06-02,1972,"FC Sochaux","OGC Nice","5-1",5,1,"1",1,6,4,"H"
1973-06-02,1972,"Olympique Marseille","CS Sedan","0-1",0,1,"1",1,1,-1,"D"
1973-06-02,1972,"AS Saint-Etienne","Girondins Bordeaux","6-2",6,2,"1",1,8,4,"H"
1973-06-02,1972,"AC Ajaccio","Angers SCO","1-1",1,1,"1",1,2,0,"D"
1973-06-02,1972,"AS Nancy","Paris FC","1-2",1,2,"1",1,3,-1,"D"
1973-06-02,1972,"US Valenciennes-Anzin","Nimes Olympique","1-0",1,0,"1",1,1,1,"H"
1973-06-02,1972,"Stade Reims","RC Strasbourg","1-0",1,0,"1",1,1,1,"H"
1973-06-02,1972,"Stade Rennes","Olympique Lyon","3-2",3,2,"1",1,5,1,"H"
1973-06-02,1972,"Red Star FC","FC Metz","1-0",1,0,"1",1,1,1,"H"
1973-08-07,1973,"Olympique Lyon","AS Nancy","4-0",4,0,"1",1,4,4,"H"
1973-08-07,1973,"FC Sochaux","Girondins Bordeaux","4-1",4,1,"1",1,5,3,"H"
1973-08-07,1973,"Olympique Marseille","AS Saint-Etienne","0-2",0,2,"1",1,2,-2,"D"
1973-08-07,1973,"Stade Rennes","OGC Nice","1-0",1,0,"1",1,1,1,"H"
1973-08-07,1973,"RC Lens","Nimes Olympique","0-1",0,1,"1",1,1,-1,"D"
1973-08-07,1973,"AS Monaco","Stade Reims","3-3",3,3,"1",1,6,0,"D"
1973-08-07,1973,"Troyes AF","CS Sedan","2-2",2,2,"1",1,4,0,"D"
1973-08-07,1973,"Angers SCO","Paris FC","1-1",1,1,"1",1,2,0,"D"
1973-08-07,1973,"FC Metz","FC Nantes","1-1",1,1,"1",1,2,0,"D"
1973-08-07,1973,"SC Bastia","RC Strasbourg","0-0",0,0,"1",1,0,0,"D"
1973-08-10,1973,"Troyes AF","Olympique Lyon","1-2",1,2,"1",1,3,-1,"D"
1973-08-10,1973,"AS Saint-Etienne","FC Metz","2-0",2,0,"1",1,2,2,"H"
1973-08-10,1973,"Stade Reims","Paris FC","4-0",4,0,"1",1,4,4,"H"
1973-08-10,1973,"Nimes Olympique","FC Sochaux","1-1",1,1,"1",1,2,0,"D"
1973-08-10,1973,"FC Nantes","AS Monaco","2-1",2,1,"1",1,3,1,"H"
1973-08-10,1973,"CS Sedan","Stade Rennes","1-1",1,1,"1",1,2,0,"D"
1973-08-10,1973,"OGC Nice","RC Lens","2-4",2,4,"1",1,6,-2,"D"
1973-08-10,1973,"RC Strasbourg","Angers SCO","2-2",2,2,"1",1,4,0,"D"
1973-08-10,1973,"AS Nancy","SC Bastia","2-0",2,0,"1",1,2,2,"H"
1973-08-10,1973,"Girondins Bordeaux","Olympique Marseille","0-0",0,0,"1",1,0,0,"D"
1973-08-14,1973,"Olympique Lyon","CS Sedan","2-0",2,0,"1",1,2,2,"H"
1973-08-14,1973,"AS Monaco","AS Saint-Etienne","2-3",2,3,"1",1,5,-1,"D"
1973-08-14,1973,"Paris FC","FC Nantes","2-5",2,5,"1",1,7,-3,"D"
1973-08-14,1973,"Stade Rennes","Troyes AF","2-1",2,1,"1",1,3,1,"H"
1973-08-14,1973,"Angers SCO","Stade Reims","3-1",3,1,"1",1,4,2,"H"
1973-08-14,1973,"RC Lens","AS Nancy","1-0",1,0,"1",1,1,1,"H"
1973-08-14,1973,"FC Metz","Nimes Olympique","1-1",1,1,"1",1,2,0,"D"
1973-08-14,1973,"Olympique Marseille","RC Strasbourg","6-1",6,1,"1",1,7,5,"H"
1973-08-14,1973,"FC Sochaux","OGC Nice","0-1",0,1,"1",1,1,-1,"D"
1973-08-14,1973,"SC Bastia","Girondins Bordeaux","2-0",2,0,"1",1,2,2,"H"
1973-08-17,1973,"AS Saint-Etienne","Paris FC","4-0",4,0,"1",1,4,4,"H"
1973-08-17,1973,"FC Nantes","Angers SCO","1-0",1,0,"1",1,1,1,"H"
1973-08-17,1973,"OGC Nice","Olympique Lyon","4-1",4,1,"1",1,5,3,"H"
1973-08-17,1973,"Nimes Olympique","Olympique Marseille","4-1",4,1,"1",1,5,3,"H"
1973-08-17,1973,"Stade Rennes","SC Bastia","1-2",1,2,"1",1,3,-1,"D"
1973-08-17,1973,"AS Nancy","Stade Reims","2-2",2,2,"1",1,4,0,"D"
1973-08-17,1973,"CS Sedan","FC Sochaux","1-1",1,1,"1",1,2,0,"D"
1973-08-17,1973,"Troyes AF","RC Lens","4-1",4,1,"1",1,5,3,"H"
1973-08-17,1973,"RC Strasbourg","AS Monaco","3-1",3,1,"1",1,4,2,"H"
1973-08-17,1973,"Girondins Bordeaux","FC Metz","3-1",3,1,"1",1,4,2,"H"
1973-08-24,1973,"Angers SCO","AS Saint-Etienne","4-0",4,0,"1",1,4,4,"H"
1973-08-24,1973,"Olympique Lyon","Stade Rennes","2-2",2,2,"1",1,4,0,"D"
1973-08-24,1973,"Stade Reims","FC Nantes","4-2",4,2,"1",1,6,2,"H"
1973-08-24,1973,"SC Bastia","OGC Nice","1-0",1,0,"1",1,1,1,"H"
1973-08-24,1973,"FC Sochaux","Troyes AF","2-0",2,0,"1",1,2,2,"H"
1973-08-24,1973,"Paris FC","Nimes Olympique","3-1",3,1,"1",1,4,2,"H"
1973-08-24,1973,"RC Lens","CS Sedan","4-2",4,2,"1",1,6,2,"H"
1973-08-24,1973,"Olympique Marseille","AS Nancy","2-2",2,2,"1",1,4,0,"D"
1973-08-24,1973,"FC Metz","RC Strasbourg","2-0",2,0,"1",1,2,2,"H"
1973-08-24,1973,"AS Monaco","Girondins Bordeaux","1-1",1,1,"1",1,2,0,"D"
1973-09-01,1973,"Olympique Lyon","Angers SCO","3-1",3,1,"1",1,4,2,"H"
1973-09-01,1973,"AS Saint-Etienne","FC Nantes","1-1",1,1,"1",1,2,0,"D"
1973-09-01,1973,"AS Nancy","FC Sochaux","0-1",0,1,"1",1,1,-1,"D"
1973-09-01,1973,"Nimes Olympique","AS Monaco","4-3",4,3,"1",1,7,1,"H"
1973-09-01,1973,"Stade Rennes","RC Lens","0-1",0,1,"1",1,1,-1,"D"
1973-09-01,1973,"CS Sedan","SC Bastia","1-0",1,0,"1",1,1,1,"H"
1973-09-01,1973,"OGC Nice","Olympique Marseille","3-0",3,0,"1",1,3,3,"H"
1973-09-01,1973,"Girondins Bordeaux","Paris FC","6-1",6,1,"1",1,7,5,"H"
1973-09-01,1973,"RC Strasbourg","Stade Reims","4-1",4,1,"1",1,5,3,"H"
1973-09-01,1973,"Troyes AF","FC Metz","2-0",2,0,"1",1,2,2,"H"
1973-09-12,1973,"Stade Reims","AS Saint-Etienne","0-1",0,1,"1",1,1,-1,"D"
1973-09-12,1973,"FC Sochaux","Stade Rennes","4-1",4,1,"1",1,5,3,"H"
1973-09-12,1973,"RC Lens","Olympique Lyon","1-1",1,1,"1",1,2,0,"D"
1973-09-12,1973,"FC Nantes","Nimes Olympique","0-2",0,2,"1",1,2,-2,"D"
1973-09-12,1973,"SC Bastia","Troyes AF","1-0",1,0,"1",1,1,1,"H"
1973-09-12,1973,"Angers SCO","Girondins Bordeaux","4-3",4,3,"1",1,7,1,"H"
1973-09-12,1973,"Olympique Marseille","CS Sedan","4-0",4,0,"1",1,4,4,"H"
1973-09-12,1973,"FC Metz","OGC Nice","2-0",2,0,"1",1,2,2,"H"
1973-09-12,1973,"Paris FC","RC Strasbourg","3-0",3,0,"1",1,3,3,"H"
1973-09-12,1973,"AS Monaco","AS Nancy","3-3",3,3,"1",1,6,0,"D"
1973-09-22,1973,"Olympique Lyon","FC Sochaux","2-1",2,1,"1",1,3,1,"H"
1973-09-22,1973,"Nimes Olympique","SC Bastia","3-1",3,1,"1",1,4,2,"H"
1973-09-22,1973,"RC Strasbourg","AS Saint-Etienne","1-1",1,1,"1",1,2,0,"D"
1973-09-22,1973,"RC Lens","AS Monaco","2-1",2,1,"1",1,3,1,"H"
1973-09-22,1973,"Stade Rennes","Angers SCO","1-2",1,2,"1",1,3,-1,"D"
1973-09-22,1973,"OGC Nice","Stade Reims","3-0",3,0,"1",1,3,3,"H"
1973-09-22,1973,"Girondins Bordeaux","FC Nantes","2-1",2,1,"1",1,3,1,"H"
1973-09-22,1973,"CS Sedan","FC Metz","1-2",1,2,"1",1,3,-1,"D"
1973-09-22,1973,"Troyes AF","Olympique Marseille","2-1",2,1,"1",1,3,1,"H"
1973-09-22,1973,"AS Nancy","Paris FC","1-1",1,1,"1",1,2,0,"D"
1973-09-25,1973,"Angers SCO","Nimes Olympique","1-2",1,2,"1",1,3,-1,"D"
1973-09-25,1973,"AS Saint-Etienne","Girondins Bordeaux","0-0",0,0,"1",1,0,0,"D"
1973-09-25,1973,"FC Sochaux","RC Lens","2-3",2,3,"1",1,5,-1,"D"
1973-09-25,1973,"SC Bastia","Olympique Lyon","5-1",5,1,"1",1,6,4,"H"
1973-09-25,1973,"FC Nantes","RC Strasbourg","3-0",3,0,"1",1,3,3,"H"
1973-09-25,1973,"FC Metz","AS Nancy","3-3",3,3,"1",1,6,0,"D"
1973-09-25,1973,"Paris FC","OGC Nice","3-2",3,2,"1",1,5,1,"H"
1973-09-25,1973,"Olympique Marseille","Stade Rennes","2-1",2,1,"1",1,3,1,"H"
1973-09-25,1973,"AS Monaco","Troyes AF","1-1",1,1,"1",1,2,0,"D"
1973-09-25,1973,"Stade Reims","CS Sedan","0-1",0,1,"1",1,1,-1,"D"
1973-10-06,1973,"Nimes Olympique","AS Saint-Etienne","1-2",1,2,"1",1,3,-1,"D"
1973-10-06,1973,"RC Lens","SC Bastia","3-1",3,1,"1",1,4,2,"H"
1973-10-06,1973,"Olympique Lyon","Olympique Marseille","2-2",2,2,"1",1,4,0,"D"
1973-10-06,1973,"OGC Nice","Angers SCO","4-0",4,0,"1",1,4,4,"H"
1973-10-06,1973,"FC Sochaux","Stade Reims","1-2",1,2,"1",1,3,-1,"D"
1973-10-06,1973,"Troyes AF","Paris FC","4-1",4,1,"1",1,5,3,"H"
1973-10-06,1973,"Girondins Bordeaux","RC Strasbourg","2-2",2,2,"1",1,4,0,"D"
1973-10-06,1973,"AS Nancy","FC Nantes","1-0",1,0,"1",1,1,1,"H"
1973-10-06,1973,"Stade Rennes","FC Metz","1-0",1,0,"1",1,1,1,"H"
1973-10-06,1973,"CS Sedan","AS Monaco","0-2",0,2,"1",1,2,-2,"D"
1973-10-17,1973,"AS Saint-Etienne","Stade Rennes","0-0",0,0,"1",1,0,0,"D"
1973-10-17,1973,"FC Metz","Olympique Lyon","0-2",0,2,"1",1,2,-2,"D"
1973-10-17,1973,"Olympique Marseille","RC Lens","5-2",5,2,"1",1,7,3,"H"
1973-10-17,1973,"RC Strasbourg","Nimes Olympique","2-0",2,0,"1",1,2,2,"H"
1973-10-17,1973,"SC Bastia","FC Sochaux","2-0",2,0,"1",1,2,2,"H"
1973-10-17,1973,"FC Nantes","Troyes AF","3-0",3,0,"1",1,3,3,"H"
1973-10-17,1973,"Angers SCO","AS Nancy","1-0",1,0,"1",1,1,1,"H"
1973-10-17,1973,"AS Monaco","OGC Nice","1-1",1,1,"1",1,2,0,"D"
1973-10-17,1973,"Stade Reims","Girondins Bordeaux","2-0",2,0,"1",1,2,2,"H"
1973-10-17,1973,"Paris FC","CS Sedan","3-1",3,1,"1",1,4,2,"H"
1973-10-27,1973,"RC Lens","FC Metz","2-1",2,1,"1",1,3,1,"H"
1973-10-27,1973,"OGC Nice","AS Saint-Etienne","4-1",4,1,"1",1,5,3,"H"
1973-10-27,1973,"SC Bastia","Olympique Marseille","4-0",4,0,"1",1,4,4,"H"
1973-10-27,1973,"Nimes Olympique","Girondins Bordeaux","0-0",0,0,"1",1,0,0,"D"
1973-10-27,1973,"Olympique Lyon","AS Monaco","0-1",0,1,"1",1,1,-1,"D"
1973-10-27,1973,"CS Sedan","FC Nantes","0-1",0,1,"1",1,1,-1,"D"
1973-10-27,1973,"FC Sochaux","Angers SCO","4-2",4,2,"1",1,6,2,"H"
1973-10-27,1973,"Troyes AF","Stade Reims","0-2",0,2,"1",1,2,-2,"D"
1973-10-27,1973,"AS Nancy","RC Strasbourg","3-1",3,1,"1",1,4,2,"H"
1973-10-27,1973,"Stade Rennes","Paris FC","1-0",1,0,"1",1,1,1,"H"
1973-10-30,1973,"AS Saint-Etienne","CS Sedan","4-1",4,1,"1",1,5,3,"H"
1973-10-30,1973,"Angers SCO","RC Lens","3-1",3,1,"1",1,4,2,"H"
1973-10-30,1973,"FC Nantes","OGC Nice","1-1",1,1,"1",1,2,0,"D"
1973-10-30,1973,"FC Metz","SC Bastia","3-0",3,0,"1",1,3,3,"H"
1973-10-30,1973,"Stade Reims","Nimes Olympique","1-0",1,0,"1",1,1,1,"H"
1973-10-30,1973,"Paris FC","Olympique Lyon","2-0",2,0,"1",1,2,2,"H"
1973-10-30,1973,"Olympique Marseille","FC Sochaux","1-1",1,1,"1",1,2,0,"D"
1973-10-30,1973,"Girondins Bordeaux","AS Nancy","1-1",1,1,"1",1,2,0,"D"
1973-10-30,1973,"RC Strasbourg","Troyes AF","2-0",2,0,"1",1,2,2,"H"
1973-10-30,1973,"AS Monaco","Stade Rennes","2-0",2,0,"1",1,2,2,"H"
1973-11-02,1973,"RC Lens","Paris FC","3-2",3,2,"1",1,5,1,"H"
1973-11-02,1973,"Troyes AF","AS Saint-Etienne","1-0",1,0,"1",1,1,1,"H"
1973-11-02,1973,"OGC Nice","Girondins Bordeaux","2-1",2,1,"1",1,3,1,"H"
1973-11-02,1973,"Stade Rennes","FC Nantes","0-0",0,0,"1",1,0,0,"D"
1973-11-02,1973,"SC Bastia","Angers SCO","0-0",0,0,"1",1,0,0,"D"
1973-11-02,1973,"AS Nancy","Nimes Olympique","1-1",1,1,"1",1,2,0,"D"
1973-11-02,1973,"Olympique Lyon","Stade Reims","4-4",4,4,"1",1,8,0,"D"
1973-11-02,1973,"FC Sochaux","FC Metz","1-0",1,0,"1",1,1,1,"H"
1973-11-02,1973,"Olympique Marseille","AS Monaco","0-2",0,2,"1",1,2,-2,"D"
1973-11-02,1973,"CS Sedan","RC Strasbourg","2-1",2,1,"1",1,3,1,"H"
1973-11-10,1973,"AS Saint-Etienne","AS Nancy","6-0",6,0,"1",1,6,6,"H"
1973-11-10,1973,"Stade Reims","RC Lens","3-1",3,1,"1",1,4,2,"H"
1973-11-10,1973,"RC Strasbourg","OGC Nice","0-4",0,4,"1",1,4,-4,"D"
1973-11-10,1973,"FC Nantes","Olympique Lyon","1-2",1,2,"1",1,3,-1,"D"
1973-11-10,1973,"Paris FC","FC Sochaux","2-3",2,3,"1",1,5,-1,"D"
1973-11-10,1973,"Angers SCO","CS Sedan","4-0",4,0,"1",1,4,4,"H"
1973-11-10,1973,"AS Monaco","SC Bastia","3-3",3,3,"1",1,6,0,"D"
1973-11-10,1973,"Nimes Olympique","Troyes AF","1-1",1,1,"1",1,2,0,"D"
1973-11-10,1973,"Girondins Bordeaux","Stade Rennes","0-1",0,1,"1",1,1,-1,"D"
1973-11-10,1973,"FC Metz","Olympique Marseille","1-0",1,0,"1",1,1,1,"H"
1973-11-16,1973,"Olympique Lyon","AS Saint-Etienne","0-0",0,0,"1",1,0,0,"D"
1973-11-16,1973,"OGC Nice","AS Nancy","1-1",1,1,"1",1,2,0,"D"
1973-11-16,1973,"FC Sochaux","AS Monaco","1-0",1,0,"1",1,1,1,"H"
1973-11-16,1973,"RC Lens","FC Nantes","0-1",0,1,"1",1,1,-1,"D"
1973-11-16,1973,"Olympique Marseille","Angers SCO","2-2",2,2,"1",1,4,0,"D"
1973-11-16,1973,"SC Bastia","Paris FC","1-1",1,1,"1",1,2,0,"D"
1973-11-16,1973,"FC Metz","Stade Reims","1-0",1,0,"1",1,1,1,"H"
1973-11-16,1973,"CS Sedan","Nimes Olympique","2-0",2,0,"1",1,2,2,"H"
1973-11-16,1973,"Stade Rennes","RC Strasbourg","2-1",2,1,"1",1,3,1,"H"
1973-11-16,1973,"Troyes AF","Girondins Bordeaux","3-1",3,1,"1",1,4,2,"H"
1973-12-02,1973,"AS Saint-Etienne","RC Lens","2-1",2,1,"1",1,3,1,"H"
1973-12-02,1973,"RC Strasbourg","Olympique Lyon","1-2",1,2,"1",1,3,-1,"D"
1973-12-02,1973,"Nimes Olympique","OGC Nice","0-0",0,0,"1",1,0,0,"D"
1973-12-02,1973,"Angers SCO","Troyes AF","6-1",6,1,"1",1,7,5,"H"
1973-12-02,1973,"FC Nantes","FC Sochaux","2-1",2,1,"1",1,3,1,"H"
1973-12-02,1973,"Stade Reims","SC Bastia","1-0",1,0,"1",1,1,1,"H"
1973-12-02,1973,"AS Monaco","FC Metz","2-1",2,1,"1",1,3,1,"H"
1973-12-02,1973,"Paris FC","Olympique Marseille","0-1",0,1,"1",1,1,-1,"D"
1973-12-02,1973,"Girondins Bordeaux","CS Sedan","2-1",2,1,"1",1,3,1,"H"
1973-12-09,1973,"FC Sochaux","AS Saint-Etienne","0-2",0,2,"1",1,2,-2,"D"
1973-12-09,1973,"Olympique Lyon","Girondins Bordeaux","2-0",2,0,"1",1,2,2,"H"
1973-12-09,1973,"AS Monaco","Angers SCO","1-2",1,2,"1",1,3,-1,"D"
1973-12-09,1973,"SC Bastia","FC Nantes","0-1",0,1,"1",1,1,-1,"D"
1973-12-09,1973,"RC Lens","RC Strasbourg","3-1",3,1,"1",1,4,2,"H"
1973-12-09,1973,"CS Sedan","OGC Nice","2-0",2,0,"1",1,2,2,"H"
1973-12-09,1973,"Stade Rennes","Nimes Olympique","1-2",1,2,"1",1,3,-1,"D"
1973-12-09,1973,"Olympique Marseille","Stade Reims","1-0",1,0,"1",1,1,1,"H"
1973-12-09,1973,"FC Metz","Paris FC","4-0",4,0,"1",1,4,4,"H"
1973-12-09,1973,"Troyes AF","AS Nancy","4-4",4,4,"1",1,8,0,"D"
1973-12-16,1973,"AS Saint-Etienne","SC Bastia","2-0",2,0,"1",1,2,2,"H"
1973-12-16,1973,"Angers SCO","FC Metz","2-1",2,1,"1",1,3,1,"H"
1973-12-16,1973,"FC Nantes","Olympique Marseille","4-1",4,1,"1",1,5,3,"H"
1973-12-16,1973,"Nimes Olympique","Olympique Lyon","0-0",0,0,"1",1,0,0,"D"
1973-12-16,1973,"Girondins Bordeaux","RC Lens","1-1",1,1,"1",1,2,0,"D"
1973-12-16,1973,"OGC Nice","Troyes AF","1-1",1,1,"1",1,2,0,"D"
1973-12-16,1973,"Stade Reims","Stade Rennes","4-0",4,0,"1",1,4,4,"H"
1973-12-16,1973,"RC Strasbourg","FC Sochaux","2-2",2,2,"1",1,4,0,"D"
1973-12-16,1973,"AS Nancy","CS Sedan","4-1",4,1,"1",1,5,3,"H"
1973-12-16,1973,"Paris FC","AS Monaco","4-0",4,0,"1",1,4,4,"H"
1973-12-22,1973,"FC Metz","AS Saint-Etienne","5-1",5,1,"1",1,6,4,"H"
1973-12-22,1973,"FC Sochaux","Nimes Olympique","0-1",0,1,"1",1,1,-1,"D"
1973-12-22,1973,"Stade Rennes","CS Sedan","1-1",1,1,"1",1,2,0,"D"
1973-12-23,1973,"Olympique Lyon","Troyes AF","2-0",2,0,"1",1,2,2,"H"
1973-12-23,1973,"Angers SCO","RC Strasbourg","3-3",3,3,"1",1,6,0,"D"
1973-12-23,1973,"RC Lens","OGC Nice","2-0",2,0,"1",1,2,2,"H"
1973-12-23,1973,"Paris FC","Stade Reims","3-0",3,0,"1",1,3,3,"H"
1973-12-23,1973,"SC Bastia","AS Nancy","3-2",3,2,"1",1,5,1,"H"
1973-12-23,1973,"Olympique Marseille","Girondins Bordeaux","3-1",3,1,"1",1,4,2,"H"
1974-01-06,1973,"AS Saint-Etienne","AS Monaco","3-2",3,2,"1",1,5,1,"H"
1974-01-06,1973,"CS Sedan","Olympique Lyon","1-1",1,1,"1",1,2,0,"D"
1974-01-06,1973,"FC Nantes","Paris FC","3-0",3,0,"1",1,3,3,"H"
1974-01-06,1973,"Stade Reims","Angers SCO","4-2",4,2,"1",1,6,2,"H"
1974-01-06,1973,"Nimes Olympique","FC Metz","0-0",0,0,"1",1,0,0,"D"
1974-01-06,1973,"AS Nancy","RC Lens","3-2",3,2,"1",1,5,1,"H"
1974-01-06,1973,"OGC Nice","FC Sochaux","2-2",2,2,"1",1,4,0,"D"
1974-01-06,1973,"Girondins Bordeaux","SC Bastia","3-1",3,1,"1",1,4,2,"H"
1974-01-06,1973,"RC Strasbourg","Olympique Marseille","2-2",2,2,"1",1,4,0,"D"
1974-01-06,1973,"Troyes AF","Stade Rennes","1-2",1,2,"1",1,3,-1,"D"
1974-01-13,1973,"Paris FC","AS Saint-Etienne","0-1",0,1,"1",1,1,-1,"D"
1974-01-13,1973,"Olympique Lyon","OGC Nice","5-2",5,2,"1",1,7,3,"H"
1974-01-13,1973,"Angers SCO","FC Nantes","2-3",2,3,"1",1,5,-1,"D"
1974-01-13,1973,"Olympique Marseille","Nimes Olympique","1-2",1,2,"1",1,3,-1,"D"
1974-01-13,1973,"RC Lens","Troyes AF","0-0",0,0,"1",1,0,0,"D"
1974-01-13,1973,"FC Sochaux","CS Sedan","3-0",3,0,"1",1,3,3,"H"
1974-01-13,1973,"Stade Reims","AS Nancy","1-2",1,2,"1",1,3,-1,"D"
1974-01-13,1973,"FC Metz","Girondins Bordeaux","1-0",1,0,"1",1,1,1,"H"
1974-01-13,1973,"SC Bastia","Stade Rennes","1-0",1,0,"1",1,1,1,"H"
1974-01-13,1973,"AS Monaco","RC Strasbourg","1-1",1,1,"1",1,2,0,"D"
1974-01-20,1973,"AS Saint-Etienne","Angers SCO","3-2",3,2,"1",1,5,1,"H"
1974-01-20,1973,"FC Nantes","Stade Reims","2-1",2,1,"1",1,3,1,"H"
1974-01-20,1973,"Stade Rennes","Olympique Lyon","1-0",1,0,"1",1,1,1,"H"
1974-01-20,1973,"Nimes Olympique","Paris FC","1-1",1,1,"1",1,2,0,"D"
1974-01-20,1973,"CS Sedan","RC Lens","1-1",1,1,"1",1,2,0,"D"
1974-01-20,1973,"OGC Nice","SC Bastia","3-0",3,0,"1",1,3,3,"H"
1974-01-20,1973,"Troyes AF","FC Sochaux","3-0",3,0,"1",1,3,3,"H"
1974-01-20,1973,"RC Strasbourg","FC Metz","2-1",2,1,"1",1,3,1,"H"
1974-01-20,1973,"AS Nancy","Olympique Marseille","0-0",0,0,"1",1,0,0,"D"
1974-01-20,1973,"Girondins Bordeaux","AS Monaco","1-2",1,2,"1",1,3,-1,"D"
1974-01-27,1973,"FC Nantes","AS Saint-Etienne","3-1",3,1,"1",1,4,2,"H"
1974-01-27,1973,"Angers SCO","Olympique Lyon","1-0",1,0,"1",1,1,1,"H"
1974-01-27,1973,"AS Monaco","Nimes Olympique","0-2",0,2,"1",1,2,-2,"D"
1974-01-27,1973,"RC Lens","Stade Rennes","3-0",3,0,"1",1,3,3,"H"
1974-01-27,1973,"FC Sochaux","AS Nancy","4-1",4,1,"1",1,5,3,"H"
1974-01-27,1973,"Stade Reims","RC Strasbourg","3-2",3,2,"1",1,5,1,"H"
1974-01-27,1973,"Olympique Marseille","OGC Nice","2-0",2,0,"1",1,2,2,"H"
1974-01-27,1973,"SC Bastia","CS Sedan","2-0",2,0,"1",1,2,2,"H"
1974-01-27,1973,"FC Metz","Troyes AF","1-1",1,1,"1",1,2,0,"D"
1974-01-27,1973,"Paris FC","Girondins Bordeaux","2-2",2,2,"1",1,4,0,"D"
1974-02-10,1973,"AS Saint-Etienne","Stade Reims","2-2",2,2,"1",1,4,0,"D"
1974-02-10,1973,"Nimes Olympique","FC Nantes","0-0",0,0,"1",1,0,0,"D"
1974-02-10,1973,"Olympique Lyon","RC Lens","4-2",4,2,"1",1,6,2,"H"
1974-02-10,1973,"Girondins Bordeaux","Angers SCO","0-2",0,2,"1",1,2,-2,"D"
1974-02-10,1973,"Stade Rennes","FC Sochaux","0-2",0,2,"1",1,2,-2,"D"
1974-02-10,1973,"OGC Nice","FC Metz","4-0",4,0,"1",1,4,4,"H"
1974-02-10,1973,"Troyes AF","SC Bastia","1-1",1,1,"1",1,2,0,"D"
1974-02-10,1973,"AS Nancy","AS Monaco","2-1",2,1,"1",1,3,1,"H"
1974-02-10,1973,"CS Sedan","Olympique Marseille","3-1",3,1,"1",1,4,2,"H"
1974-02-10,1973,"RC Strasbourg","Paris FC","1-1",1,1,"1",1,2,0,"D"
1974-02-17,1973,"FC Nantes","Girondins Bordeaux","3-1",3,1,"1",1,4,2,"H"
1974-02-17,1973,"AS Saint-Etienne","RC Strasbourg","3-3",3,3,"1",1,6,0,"D"
1974-02-17,1973,"FC Sochaux","Olympique Lyon","1-1",1,1,"1",1,2,0,"D"
1974-02-17,1973,"Angers SCO","Stade Rennes","0-1",0,1,"1",1,1,-1,"D"
1974-02-17,1973,"AS Monaco","RC Lens","4-2",4,2,"1",1,6,2,"H"
1974-02-17,1973,"Stade Reims","OGC Nice","2-2",2,2,"1",1,4,0,"D"
1974-02-17,1973,"FC Metz","CS Sedan","4-1",4,1,"1",1,5,3,"H"
1974-02-17,1973,"Olympique Marseille","Troyes AF","2-3",2,3,"1",1,5,-1,"D"
1974-02-17,1973,"Paris FC","AS Nancy","4-2",4,2,"1",1,6,2,"H"
1974-02-23,1973,"OGC Nice","Paris FC","2-1",2,1,"1",1,3,1,"H"
1974-02-24,1973,"Girondins Bordeaux","AS Saint-Etienne","0-5",0,5,"1",1,5,-5,"D"
1974-02-24,1973,"RC Strasbourg","FC Nantes","3-2",3,2,"1",1,5,1,"H"
1974-02-24,1973,"Olympique Lyon","SC Bastia","1-0",1,0,"1",1,1,1,"H"
1974-02-24,1973,"Nimes Olympique","Angers SCO","0-0",0,0,"1",1,0,0,"D"
1974-02-24,1973,"RC Lens","FC Sochaux","1-1",1,1,"1",1,2,0,"D"
1974-02-24,1973,"CS Sedan","Stade Reims","4-1",4,1,"1",1,5,3,"H"
1974-02-24,1973,"AS Nancy","FC Metz","2-1",2,1,"1",1,3,1,"H"
1974-02-24,1973,"Stade Rennes","Olympique Marseille","3-1",3,1,"1",1,4,2,"H"
1974-02-24,1973,"Troyes AF","AS Monaco","0-2",0,2,"1",1,2,-2,"D"
1974-03-13,1973,"AS Saint-Etienne","Nimes Olympique","2-1",2,1,"1",1,3,1,"H"
1974-03-13,1973,"FC Nantes","AS Nancy","0-0",0,0,"1",1,0,0,"D"
1974-03-13,1973,"Olympique Marseille","Olympique Lyon","1-1",1,1,"1",1,2,0,"D"
1974-03-13,1973,"Angers SCO","OGC Nice","4-1",4,1,"1",1,5,3,"H"
1974-03-13,1973,"SC Bastia","RC Lens","0-0",0,0,"1",1,0,0,"D"
1974-03-13,1973,"Stade Reims","FC Sochaux","1-0",1,0,"1",1,1,1,"H"
1974-03-13,1973,"FC Metz","Stade Rennes","4-0",4,0,"1",1,4,4,"H"
1974-03-13,1973,"Paris FC","Troyes AF","0-2",0,2,"1",1,2,-2,"D"
1974-03-13,1973,"AS Monaco","CS Sedan","3-0",3,0,"1",1,3,3,"H"
1974-03-13,1973,"RC Strasbourg","Girondins Bordeaux","0-0",0,0,"1",1,0,0,"D"
1974-03-16,1973,"Stade Rennes","AS Saint-Etienne","1-0",1,0,"1",1,1,1,"H"
1974-03-16,1973,"Olympique Lyon","FC Metz","2-0",2,0,"1",1,2,2,"H"
1974-03-16,1973,"Troyes AF","FC Nantes","1-0",1,0,"1",1,1,1,"H"
1974-03-16,1973,"AS Nancy","Angers SCO","0-3",0,3,"1",1,3,-3,"D"
1974-03-16,1973,"OGC Nice","AS Monaco","3-2",3,2,"1",1,5,1,"H"
1974-03-16,1973,"FC Sochaux","SC Bastia","1-0",1,0,"1",1,1,1,"H"
1974-03-16,1973,"Nimes Olympique","RC Strasbourg","1-2",1,2,"1",1,3,-1,"D"
1974-03-16,1973,"RC Lens","Olympique Marseille","2-3",2,3,"1",1,5,-1,"D"
1974-03-16,1973,"Girondins Bordeaux","Stade Reims","3-0",3,0,"1",1,3,3,"H"
1974-03-16,1973,"CS Sedan","Paris FC","2-2",2,2,"1",1,4,0,"D"
1974-03-22,1973,"AS Nancy","Stade Rennes","1-2",1,2,"1",1,3,-1,"D"
1974-03-26,1973,"FC Metz","RC Lens","1-0",1,0,"1",1,1,1,"H"
1974-03-26,1973,"RC Strasbourg","AS Nancy","2-1",2,1,"1",1,3,1,"H"
1974-03-27,1973,"AS Saint-Etienne","OGC Nice","1-0",1,0,"1",1,1,1,"H"
1974-03-27,1973,"FC Nantes","CS Sedan","1-0",1,0,"1",1,1,1,"H"
1974-03-27,1973,"AS Monaco","Olympique Lyon","1-1",1,1,"1",1,2,0,"D"
1974-03-27,1973,"Angers SCO","FC Sochaux","2-4",2,4,"1",1,6,-2,"D"
1974-03-27,1973,"Girondins Bordeaux","Nimes Olympique","1-1",1,1,"1",1,2,0,"D"
1974-03-27,1973,"Stade Reims","Troyes AF","3-2",3,2,"1",1,5,1,"H"
1974-03-27,1973,"Paris FC","Stade Rennes","0-0",0,0,"1",1,0,0,"D"
1974-03-27,1973,"Olympique Marseille","SC Bastia","2-1",2,1,"1",1,3,1,"H"
1974-04-09,1973,"RC Lens","Angers SCO","1-1",1,1,"1",1,2,0,"D"
1974-04-09,1973,"FC Sochaux","Olympique Marseille","2-0",2,0,"1",1,2,2,"H"
1974-04-09,1973,"Nimes Olympique","Stade Reims","2-0",2,0,"1",1,2,2,"H"
1974-04-09,1973,"Stade Rennes","AS Monaco","1-1",1,1,"1",1,2,0,"D"
1974-04-09,1973,"SC Bastia","FC Metz","0-0",0,0,"1",1,0,0,"D"
1974-04-09,1973,"Troyes AF","RC Strasbourg","1-3",1,3,"1",1,4,-2,"D"
1974-04-09,1973,"AS Nancy","Girondins Bordeaux","0-2",0,2,"1",1,2,-2,"D"
1974-04-09,1973,"CS Sedan","AS Saint-Etienne","0-0",0,0,"1",1,0,0,"D"
1974-04-09,1973,"Olympique Lyon","Paris FC","5-4",5,4,"1",1,9,1,"H"
1974-04-09,1973,"OGC Nice","FC Nantes","1-1",1,1,"1",1,2,0,"D"
1974-04-12,1973,"AS Saint-Etienne","Troyes AF","2-0",2,0,"1",1,2,2,"H"
1974-04-12,1973,"Stade Reims","Olympique Lyon","0-0",0,0,"1",1,0,0,"D"
1974-04-12,1973,"FC Nantes","Stade Rennes","1-1",1,1,"1",1,2,0,"D"
1974-04-12,1973,"Nimes Olympique","AS Nancy","1-0",1,0,"1",1,1,1,"H"
1974-04-12,1973,"Angers SCO","SC Bastia","1-2",1,2,"1",1,3,-1,"D"
1974-04-12,1973,"FC Metz","FC Sochaux","3-2",3,2,"1",1,5,1,"H"
1974-04-12,1973,"Paris FC","RC Lens","1-3",1,3,"1",1,4,-2,"D"
1974-04-12,1973,"Girondins Bordeaux","OGC Nice","4-0",4,0,"1",1,4,4,"H"
1974-04-12,1973,"RC Strasbourg","CS Sedan","2-0",2,0,"1",1,2,2,"H"
1974-04-12,1973,"AS Monaco","Olympique Marseille","1-1",1,1,"1",1,2,0,"D"
1974-04-16,1973,"AS Nancy","AS Saint-Etienne","1-1",1,1,"1",1,2,0,"D"
1974-04-16,1973,"Olympique Lyon","FC Nantes","3-1",3,1,"1",1,4,2,"H"
1974-04-16,1973,"CS Sedan","Angers SCO","0-4",0,4,"1",1,4,-4,"D"
1974-04-16,1973,"FC Sochaux","Paris FC","2-1",2,1,"1",1,3,1,"H"
1974-04-16,1973,"Troyes AF","Nimes Olympique","0-0",0,0,"1",1,0,0,"D"
1974-04-16,1973,"RC Lens","Stade Reims","2-1",2,1,"1",1,3,1,"H"
1974-04-16,1973,"OGC Nice","RC Strasbourg","3-2",3,2,"1",1,5,1,"H"
1974-04-16,1973,"Stade Rennes","Girondins Bordeaux","4-2",4,2,"1",1,6,2,"H"
1974-04-16,1973,"Olympique Marseille","FC Metz","3-1",3,1,"1",1,4,2,"H"
1974-04-16,1973,"SC Bastia","AS Monaco","4-0",4,0,"1",1,4,4,"H"
1974-04-19,1973,"AS Saint-Etienne","Olympique Lyon","2-0",2,0,"1",1,2,2,"H"
1974-04-19,1973,"FC Nantes","RC Lens","4-0",4,0,"1",1,4,4,"H"
1974-04-19,1973,"Angers SCO","Olympique Marseille","3-0",3,0,"1",1,3,3,"H"
1974-04-19,1973,"Nimes Olympique","CS Sedan","2-0",2,0,"1",1,2,2,"H"
1974-04-19,1973,"AS Monaco","FC Sochaux","2-1",2,1,"1",1,3,1,"H"
1974-04-19,1973,"AS Nancy","OGC Nice","0-1",0,1,"1",1,1,-1,"D"
1974-04-19,1973,"Stade Reims","FC Metz","4-0",4,0,"1",1,4,4,"H"
1974-04-19,1973,"RC Strasbourg","Stade Rennes","2-1",2,1,"1",1,3,1,"H"
1974-04-19,1973,"Paris FC","SC Bastia","0-1",0,1,"1",1,1,-1,"D"
1974-04-19,1973,"Girondins Bordeaux","Troyes AF","4-1",4,1,"1",1,5,3,"H"
1974-04-26,1973,"SC Bastia","Nimes Olympique","2-0",2,0,"1",1,2,2,"H"
1974-04-30,1973,"RC Lens","AS Saint-Etienne","2-3",2,3,"1",1,5,-1,"D"
1974-04-30,1973,"Olympique Lyon","RC Strasbourg","3-2",3,2,"1",1,5,1,"H"
1974-04-30,1973,"FC Sochaux","FC Nantes","2-0",2,0,"1",1,2,2,"H"
1974-04-30,1973,"OGC Nice","Nimes Olympique","2-2",2,2,"1",1,4,0,"D"
1974-04-30,1973,"Troyes AF","Angers SCO","3-2",3,2,"1",1,5,1,"H"
1974-04-30,1973,"SC Bastia","Stade Reims","1-1",1,1,"1",1,2,0,"D"
1974-04-30,1973,"Stade Rennes","AS Nancy","3-0",3,0,"1",1,3,3,"H"
1974-04-30,1973,"FC Metz","AS Monaco","3-2",3,2,"1",1,5,1,"H"
1974-04-30,1973,"Olympique Marseille","Paris FC","3-0",3,0,"1",1,3,3,"H"
1974-04-30,1973,"CS Sedan","Girondins Bordeaux","2-2",2,2,"1",1,4,0,"D"
1974-05-11,1973,"AS Saint-Etienne","FC Sochaux","2-0",2,0,"1",1,2,2,"H"
1974-05-11,1973,"Girondins Bordeaux","Olympique Lyon","3-0",3,0,"1",1,3,3,"H"
1974-05-11,1973,"FC Nantes","SC Bastia","3-0",3,0,"1",1,3,3,"H"
1974-05-11,1973,"Angers SCO","AS Monaco","2-2",2,2,"1",1,4,0,"D"
1974-05-11,1973,"Nimes Olympique","Stade Rennes","0-2",0,2,"1",1,2,-2,"D"
1974-05-11,1973,"OGC Nice","CS Sedan","7-2",7,2,"1",1,9,5,"H"
1974-05-11,1973,"Stade Reims","Olympique Marseille","1-0",1,0,"1",1,1,1,"H"
1974-05-11,1973,"RC Strasbourg","RC Lens","3-0",3,0,"1",1,3,3,"H"
1974-05-11,1973,"Paris FC","FC Metz","3-2",3,2,"1",1,5,1,"H"
1974-05-11,1973,"AS Nancy","Troyes AF","0-0",0,0,"1",1,0,0,"D"
1974-05-14,1973,"AS Monaco","FC Nantes","1-4",1,4,"1",1,5,-3,"D"
1974-05-22,1973,"SC Bastia","AS Saint-Etienne","1-6",1,6,"1",1,7,-5,"D"
1974-05-22,1973,"Olympique Lyon","Nimes Olympique","2-0",2,0,"1",1,2,2,"H"
1974-05-22,1973,"Olympique Marseille","FC Nantes","3-0",3,0,"1",1,3,3,"H"
1974-05-22,1973,"FC Metz","Angers SCO","0-1",0,1,"1",1,1,-1,"D"
1974-05-22,1973,"FC Sochaux","RC Strasbourg","1-0",1,0,"1",1,1,1,"H"
1974-05-22,1973,"Troyes AF","OGC Nice","2-2",2,2,"1",1,4,0,"D"
1974-05-22,1973,"Stade Rennes","Stade Reims","2-0",2,0,"1",1,2,2,"H"
1974-05-22,1973,"RC Lens","Girondins Bordeaux","0-1",0,1,"1",1,1,-1,"D"
1974-05-22,1973,"AS Monaco","Paris FC","3-0",3,0,"1",1,3,3,"H"
1974-05-22,1973,"CS Sedan","AS Nancy","2-3",2,3,"1",1,5,-1,"D"
1974-05-25,1973,"AS Saint-Etienne","Olympique Marseille","3-1",3,1,"1",1,4,2,"H"
1974-05-25,1973,"FC Nantes","FC Metz","2-2",2,2,"1",1,4,0,"D"
1974-05-25,1973,"AS Nancy","Olympique Lyon","3-1",3,1,"1",1,4,2,"H"
1974-05-25,1973,"Paris FC","Angers SCO","2-2",2,2,"1",1,4,0,"D"
1974-05-25,1973,"OGC Nice","Stade Rennes","3-1",3,1,"1",1,4,2,"H"
1974-05-25,1973,"Girondins Bordeaux","FC Sochaux","1-1",1,1,"1",1,2,0,"D"
1974-05-25,1973,"Nimes Olympique","RC Lens","1-1",1,1,"1",1,2,0,"D"
1974-05-25,1973,"Stade Reims","AS Monaco","8-4",8,4,"1",1,12,4,"H"
1974-05-25,1973,"RC Strasbourg","SC Bastia","3-1",3,1,"1",1,4,2,"H"
1974-05-25,1973,"CS Sedan","Troyes AF","4-3",4,3,"1",1,7,1,"H"
1974-08-02,1974,"Angers SCO","OGC Nice","1-3",1,3,"1",1,4,-2,"D"
1974-08-02,1974,"SC Bastia","Lille OSC","2-0",2,0,"1",1,2,2,"H"
1974-08-02,1974,"Girondins Bordeaux","FC Nantes","2-1",2,1,"1",1,3,1,"H"
1974-08-02,1974,"Troyes AF","AS Saint-Etienne","1-0",1,0,"1",1,1,1,"H"
1974-08-02,1974,"FC Sochaux","Paris Saint-Germain","0-1",0,1,"1",1,1,-1,"D"
1974-08-02,1974,"Olympique Lyon","Stade Reims","3-3",3,3,"1",1,6,0,"D"
1974-08-02,1974,"AS Monaco","Nimes Olympique","3-3",3,3,"1",1,6,0,"D"
1974-08-02,1974,"Olympique Marseille","RC Strasbourg","1-1",1,1,"1",1,2,0,"D"
1974-08-02,1974,"RC Lens","Red Star FC","0-0",0,0,"1",1,0,0,"D"
1974-08-02,1974,"Stade Rennes","FC Metz","0-0",0,0,"1",1,0,0,"D"
1974-08-09,1974,"OGC Nice","Stade Rennes","4-1",4,1,"1",1,5,3,"H"
1974-08-09,1974,"FC Metz","SC Bastia","0-2",0,2,"1",1,2,-2,"D"
1974-08-09,1974,"Stade Reims","Paris Saint-Germain","6-1",6,1,"1",1,7,5,"H"
1974-08-09,1974,"Angers SCO","Olympique Lyon","0-2",0,2,"1",1,2,-2,"D"
1974-08-09,1974,"FC Nantes","Nimes Olympique","0-1",0,1,"1",1,1,-1,"D"
1974-08-09,1974,"RC Strasbourg","Girondins Bordeaux","1-0",1,0,"1",1,1,1,"H"
1974-08-09,1974,"Red Star FC","Troyes AF","2-1",2,1,"1",1,3,1,"H"
1974-08-09,1974,"FC Sochaux","RC Lens","0-1",0,1,"1",1,1,-1,"D"
1974-08-09,1974,"AS Saint-Etienne","AS Monaco","3-2",3,2,"1",1,5,1,"H"
1974-08-09,1974,"Lille OSC","Olympique Marseille","1-0",1,0,"1",1,1,1,"H"
1974-08-13,1974,"SC Bastia","Stade Reims","0-1",0,1,"1",1,1,-1,"D"
1974-08-13,1974,"Olympique Lyon","OGC Nice","0-0",0,0,"1",1,0,0,"D"
1974-08-13,1974,"Nimes Olympique","Red Star FC","3-0",3,0,"1",1,3,3,"H"
1974-08-13,1974,"RC Lens","RC Strasbourg","0-1",0,1,"1",1,1,-1,"D"
1974-08-13,1974,"Girondins Bordeaux","AS Saint-Etienne","1-0",1,0,"1",1,1,1,"H"
1974-08-13,1974,"Troyes AF","Lille OSC","0-1",0,1,"1",1,1,-1,"D"
1974-08-13,1974,"Olympique Marseille","FC Sochaux","2-0",2,0,"1",1,2,2,"H"
1974-08-13,1974,"Stade Rennes","Angers SCO","2-0",2,0,"1",1,2,2,"H"
1974-08-13,1974,"Paris Saint-Germain","FC Metz","2-2",2,2,"1",1,4,0,"D"
1974-08-13,1974,"AS Monaco","FC Nantes","1-3",1,3,"1",1,4,-2,"D"
1974-08-16,1974,"Stade Reims","Girondins Bordeaux","2-1",2,1,"1",1,3,1,"H"
1974-08-16,1974,"Lille OSC","Paris Saint-Germain","5-0",5,0,"1",1,5,5,"H"
1974-08-16,1974,"RC Strasbourg","AS Monaco","2-2",2,2,"1",1,4,0,"D"
1974-08-16,1974,"OGC Nice","Olympique Marseille","1-3",1,3,"1",1,4,-2,"D"
1974-08-16,1974,"AS Saint-Etienne","Nimes Olympique","4-0",4,0,"1",1,4,4,"H"
1974-08-16,1974,"Stade Rennes","RC Lens","1-0",1,0,"1",1,1,1,"H"
1974-08-16,1974,"FC Metz","Olympique Lyon","3-1",3,1,"1",1,4,2,"H"
1974-08-16,1974,"Angers SCO","SC Bastia","3-0",3,0,"1",1,3,3,"H"
1974-08-16,1974,"FC Sochaux","Troyes AF","0-1",0,1,"1",1,1,-1,"D"
1974-08-16,1974,"Red Star FC","FC Nantes","4-4",4,4,"1",1,8,0,"D"
1974-08-23,1974,"RC Lens","Stade Reims","1-0",1,0,"1",1,1,1,"H"
1974-08-23,1974,"Olympique Marseille","FC Metz","1-0",1,0,"1",1,1,1,"H"
1974-08-23,1974,"Nimes Olympique","Lille OSC","2-1",2,1,"1",1,3,1,"H"
1974-08-23,1974,"Olympique Lyon","Stade Rennes","4-1",4,1,"1",1,5,3,"H"
1974-08-23,1974,"SC Bastia","OGC Nice","2-0",2,0,"1",1,2,2,"H"
1974-08-23,1974,"Troyes AF","RC Strasbourg","2-0",2,0,"1",1,2,2,"H"
1974-08-23,1974,"Girondins Bordeaux","FC Sochaux","2-1",2,1,"1",1,3,1,"H"
1974-08-23,1974,"FC Nantes","AS Saint-Etienne","2-1",2,1,"1",1,3,1,"H"
1974-08-23,1974,"Paris Saint-Germain","Angers SCO","3-2",3,2,"1",1,5,1,"H"
1974-08-23,1974,"AS Monaco","Red Star FC","4-3",4,3,"1",1,7,1,"H"
1974-08-27,1974,"Stade Reims","Olympique Marseille","4-3",4,3,"1",1,7,1,"H"
1974-08-27,1974,"Lille OSC","AS Saint-Etienne","2-0",2,0,"1",1,2,2,"H"
1974-08-27,1974,"Red Star FC","Girondins Bordeaux","1-2",1,2,"1",1,3,-1,"D"
1974-08-27,1974,"RC Strasbourg","FC Nantes","2-0",2,0,"1",1,2,2,"H"
1974-08-27,1974,"OGC Nice","Paris Saint-Germain","4-2",4,2,"1",1,6,2,"H"
1974-08-27,1974,"Stade Rennes","SC Bastia","1-1",1,1,"1",1,2,0,"D"
1974-08-27,1974,"Angers SCO","Troyes AF","1-1",1,1,"1",1,2,0,"D"
1974-08-27,1974,"FC Sochaux","Nimes Olympique","2-0",2,0,"1",1,2,2,"H"
1974-08-27,1974,"Olympique Lyon","AS Monaco","1-3",1,3,"1",1,4,-2,"D"
1974-08-27,1974,"FC Metz","RC Lens","2-1",2,1,"1",1,3,1,"H"
1974-08-31,1974,"Troyes AF","FC Metz","4-1",4,1,"1",1,5,3,"H"
1974-09-01,1974,"SC Bastia","Olympique Lyon","2-0",2,0,"1",1,2,2,"H"
1974-09-02,1974,"AS Monaco","Stade Reims","2-3",2,3,"1",1,5,-1,"D"
1974-09-02,1974,"Girondins Bordeaux","Lille OSC","4-2",4,2,"1",1,6,2,"H"
1974-09-02,1974,"Nimes Olympique","RC Strasbourg","6-0",6,0,"1",1,6,6,"H"
1974-09-02,1974,"Olympique Marseille","Angers SCO","3-1",3,1,"1",1,4,2,"H"
1974-09-02,1974,"RC Lens","OGC Nice","4-2",4,2,"1",1,6,2,"H"
1974-09-02,1974,"FC Nantes","FC Sochaux","1-0",1,0,"1",1,1,1,"H"
1974-09-02,1974,"Paris Saint-Germain","Stade Rennes","2-1",2,1,"1",1,3,1,"H"
1974-09-02,1974,"AS Saint-Etienne","Red Star FC","2-0",2,0,"1",1,2,2,"H"
1974-09-13,1974,"Stade Reims","Nimes Olympique","2-1",2,1,"1",1,3,1,"H"
1974-09-13,1974,"SC Bastia","Girondins Bordeaux","1-0",1,0,"1",1,1,1,"H"
1974-09-13,1974,"Lille OSC","AS Monaco","2-0",2,0,"1",1,2,2,"H"
1974-09-13,1974,"Stade Rennes","Olympique Marseille","1-0",1,0,"1",1,1,1,"H"
1974-09-13,1974,"OGC Nice","Troyes AF","2-1",2,1,"1",1,3,1,"H"
1974-09-13,1974,"Angers SCO","RC Lens","1-2",1,2,"1",1,3,-1,"D"
1974-09-13,1974,"RC Strasbourg","Red Star FC","1-1",1,1,"1",1,2,0,"D"
1974-09-13,1974,"FC Metz","FC Nantes","4-0",4,0,"1",1,4,4,"H"
1974-09-13,1974,"Olympique Lyon","Paris Saint-Germain","4-4",4,4,"1",1,8,0,"D"
1974-09-13,1974,"FC Sochaux","AS Saint-Etienne","1-1",1,1,"1",1,2,0,"D"
1974-09-23,1974,"Paris Saint-Germain","SC Bastia","1-1",1,1,"1",1,2,0,"D"
1974-09-24,1974,"Troyes AF","Stade Reims","2-0",2,0,"1",1,2,2,"H"
1974-09-24,1974,"Girondins Bordeaux","FC Metz","3-2",3,2,"1",1,5,1,"H"
1974-09-24,1974,"Nimes Olympique","Angers SCO","4-0",4,0,"1",1,4,4,"H"
1974-09-24,1974,"RC Lens","Lille OSC","1-0",1,0,"1",1,1,1,"H"
1974-09-24,1974,"Olympique Marseille","Olympique Lyon","0-1",0,1,"1",1,1,-1,"D"
1974-09-24,1974,"AS Saint-Etienne","RC Strasbourg","2-1",2,1,"1",1,3,1,"H"
1974-09-24,1974,"AS Monaco","OGC Nice","3-2",3,2,"1",1,5,1,"H"
1974-09-24,1974,"FC Nantes","Stade Rennes","1-1",1,1,"1",1,2,0,"D"
1974-09-24,1974,"Red Star FC","FC Sochaux","0-1",0,1,"1",1,1,-1,"D"
1974-09-27,1974,"Stade Reims","AS Saint-Etienne","0-2",0,2,"1",1,2,-2,"D"
1974-09-27,1974,"SC Bastia","Olympique Marseille","2-2",2,2,"1",1,4,0,"D"
1974-09-27,1974,"Angers SCO","Girondins Bordeaux","2-2",2,2,"1",1,4,0,"D"
1974-09-27,1974,"Lille OSC","Red Star FC","1-0",1,0,"1",1,1,1,"H"
1974-09-27,1974,"Stade Rennes","Troyes AF","1-1",1,1,"1",1,2,0,"D"
1974-09-27,1974,"Olympique Lyon","RC Lens","5-1",5,1,"1",1,6,4,"H"
1974-09-27,1974,"FC Metz","AS Monaco","1-0",1,0,"1",1,1,1,"H"
1974-09-27,1974,"Paris Saint-Germain","FC Nantes","2-3",2,3,"1",1,5,-1,"D"
1974-09-27,1974,"FC Sochaux","RC Strasbourg","0-0",0,0,"1",1,0,0,"D"
1974-10-05,1974,"FC Nantes","Stade Reims","0-1",0,1,"1",1,1,-1,"D"
1974-10-05,1974,"Girondins Bordeaux","OGC Nice","2-0",2,0,"1",1,2,2,"H"
1974-10-05,1974,"RC Lens","SC Bastia","3-3",3,3,"1",1,6,0,"D"
1974-10-05,1974,"Nimes Olympique","FC Metz","2-0",2,0,"1",1,2,2,"H"
1974-10-05,1974,"AS Saint-Etienne","Angers SCO","2-0",2,0,"1",1,2,2,"H"
1974-10-05,1974,"Troyes AF","Olympique Lyon","0-0",0,0,"1",1,0,0,"D"
1974-10-05,1974,"Olympique Marseille","Paris Saint-Germain","4-2",4,2,"1",1,6,2,"H"
1974-10-05,1974,"RC Strasbourg","Lille OSC","3-0",3,0,"1",1,3,3,"H"
1974-10-05,1974,"Red Star FC","Stade Rennes","0-2",0,2,"1",1,2,-2,"D"
1974-10-05,1974,"AS Monaco","FC Sochaux","3-1",3,1,"1",1,4,2,"H"
1974-10-18,1974,"Stade Reims","RC Strasbourg","2-0",2,0,"1",1,2,2,"H"
1974-10-18,1974,"SC Bastia","Troyes AF","5-1",5,1,"1",1,6,4,"H"
1974-10-18,1974,"Olympique Lyon","Girondins Bordeaux","1-0",1,0,"1",1,1,1,"H"
1974-10-18,1974,"Olympique Marseille","AS Monaco","4-1",4,1,"1",1,5,3,"H"
1974-10-18,1974,"Lille OSC","FC Sochaux","4-0",4,0,"1",1,4,4,"H"
1974-10-18,1974,"OGC Nice","AS Saint-Etienne","1-1",1,1,"1",1,2,0,"D"
1974-10-18,1974,"Stade Rennes","Nimes Olympique","2-1",2,1,"1",1,3,1,"H"
1974-10-18,1974,"FC Metz","Red Star FC","2-1",2,1,"1",1,3,1,"H"
1974-10-18,1974,"Paris Saint-Germain","RC Lens","3-1",3,1,"1",1,4,2,"H"
1974-10-18,1974,"Angers SCO","FC Nantes","0-0",0,0,"1",1,0,0,"D"
1974-10-26,1974,"FC Sochaux","Stade Reims","1-0",1,0,"1",1,1,1,"H"
1974-10-26,1974,"Girondins Bordeaux","Stade Rennes","1-0",1,0,"1",1,1,1,"H"
1974-10-26,1974,"AS Saint-Etienne","FC Metz","5-0",5,0,"1",1,5,5,"H"
1974-10-26,1974,"AS Monaco","SC Bastia","1-0",1,0,"1",1,1,1,"H"
1974-10-26,1974,"Nimes Olympique","Olympique Lyon","1-2",1,2,"1",1,3,-1,"D"
1974-10-26,1974,"RC Lens","Olympique Marseille","2-2",2,2,"1",1,4,0,"D"
1974-10-26,1974,"FC Nantes","Lille OSC","1-0",1,0,"1",1,1,1,"H"
1974-10-26,1974,"RC Strasbourg","Angers SCO","1-0",1,0,"1",1,1,1,"H"
1974-10-26,1974,"Troyes AF","Paris Saint-Germain","1-3",1,3,"1",1,4,-2,"D"
1974-10-26,1974,"Red Star FC","OGC Nice","4-1",4,1,"1",1,5,3,"H"
1974-10-29,1974,"Stade Reims","Lille OSC","4-3",4,3,"1",1,7,1,"H"
1974-10-29,1974,"SC Bastia","Nimes Olympique","4-0",4,0,"1",1,4,4,"H"
1974-10-29,1974,"Olympique Lyon","FC Nantes","1-1",1,1,"1",1,2,0,"D"
1974-10-29,1974,"RC Lens","Girondins Bordeaux","3-0",3,0,"1",1,3,3,"H"
1974-10-29,1974,"Stade Rennes","AS Saint-Etienne","3-1",3,1,"1",1,4,2,"H"
1974-10-29,1974,"Olympique Marseille","Troyes AF","0-0",0,0,"1",1,0,0,"D"
1974-10-29,1974,"Paris Saint-Germain","AS Monaco","0-1",0,1,"1",1,1,-1,"D"
1974-10-29,1974,"OGC Nice","RC Strasbourg","2-1",2,1,"1",1,3,1,"H"
1974-10-29,1974,"FC Metz","FC Sochaux","0-1",0,1,"1",1,1,-1,"D"
1974-10-29,1974,"Angers SCO","Red Star FC","1-1",1,1,"1",1,2,0,"D"
1974-11-01,1974,"FC Nantes","SC Bastia","0-0",0,0,"1",1,0,0,"D"
1974-11-01,1974,"Red Star FC","Stade Reims","2-1",2,1,"1",1,3,1,"H"
1974-11-01,1974,"AS Saint-Etienne","Olympique Lyon","1-0",1,0,"1",1,1,1,"H"
1974-11-01,1974,"Girondins Bordeaux","Paris Saint-Germain","1-2",1,2,"1",1,3,-1,"D"
1974-11-01,1974,"Troyes AF","RC Lens","0-1",0,1,"1",1,1,-1,"D"
1974-11-01,1974,"Nimes Olympique","Olympique Marseille","3-1",3,1,"1",1,4,2,"H"
1974-11-01,1974,"AS Monaco","Stade Rennes","2-0",2,0,"1",1,2,2,"H"
1974-11-01,1974,"RC Strasbourg","FC Metz","3-0",3,0,"1",1,3,3,"H"
1974-11-01,1974,"Lille OSC","Angers SCO","1-5",1,5,"1",1,6,-4,"D"
1974-11-01,1974,"FC Sochaux","OGC Nice","1-1",1,1,"1",1,2,0,"D"
1974-11-05,1974,"OGC Nice","Nimes Olympique","2-0",2,0,"1",1,2,2,"H"
1974-11-08,1974,"Red Star FC","Olympique Lyon","4-0",4,0,"1",1,4,4,"H"
1974-11-09,1974,"SC Bastia","AS Saint-Etienne","1-1",1,1,"1",1,2,0,"D"
1974-11-09,1974,"FC Metz","Stade Reims","1-1",1,1,"1",1,2,0,"D"
1974-11-09,1974,"RC Lens","AS Monaco","6-3",6,3,"1",1,9,3,"H"
1974-11-09,1974,"Olympique Marseille","Girondins Bordeaux","3-0",3,0,"1",1,3,3,"H"
1974-11-09,1974,"Stade Rennes","RC Strasbourg","5-1",5,1,"1",1,6,4,"H"
1974-11-09,1974,"OGC Nice","Lille OSC","2-1",2,1,"1",1,3,1,"H"
1974-11-09,1974,"Paris Saint-Germain","Nimes Olympique","1-1",1,1,"1",1,2,0,"D"
1974-11-09,1974,"Troyes AF","FC Nantes","0-0",0,0,"1",1,0,0,"D"
1974-11-09,1974,"Angers SCO","FC Sochaux","1-1",1,1,"1",1,2,0,"D"
1974-11-20,1974,"AS Saint-Etienne","Paris Saint-Germain","3-2",3,2,"1",1,5,1,"H"
1974-11-20,1974,"Red Star FC","SC Bastia","0-0",0,0,"1",1,0,0,"D"
1974-11-20,1974,"Stade Reims","OGC Nice","1-1",1,1,"1",1,2,0,"D"
1974-11-20,1974,"Girondins Bordeaux","Troyes AF","6-0",6,0,"1",1,6,6,"H"
1974-11-20,1974,"Nimes Olympique","RC Lens","3-1",3,1,"1",1,4,2,"H"
1974-11-20,1974,"FC Nantes","Olympique Marseille","2-0",2,0,"1",1,2,2,"H"
1974-11-20,1974,"FC Sochaux","Stade Rennes","2-1",2,1,"1",1,3,1,"H"
1974-11-20,1974,"RC Strasbourg","Olympique Lyon","2-0",2,0,"1",1,2,2,"H"
1974-11-20,1974,"Lille OSC","FC Metz","4-0",4,0,"1",1,4,4,"H"
1974-11-23,1974,"Angers SCO","Stade Reims","1-2",1,2,"1",1,3,-1,"D"
1974-11-23,1974,"Girondins Bordeaux","AS Monaco","0-0",0,0,"1",1,0,0,"D"
1974-11-23,1974,"Stade Rennes","Lille OSC","3-0",3,0,"1",1,3,3,"H"
1974-11-23,1974,"RC Lens","FC Nantes","2-2",2,2,"1",1,4,0,"D"
1974-11-23,1974,"Troyes AF","Nimes Olympique","1-1",1,1,"1",1,2,0,"D"
1974-11-23,1974,"Olympique Lyon","FC Sochaux","1-0",1,0,"1",1,1,1,"H"
1974-11-24,1974,"Olympique Marseille","AS Saint-Etienne","1-2",1,2,"1",1,3,-1,"D"
1974-11-24,1974,"SC Bastia","RC Strasbourg","2-1",2,1,"1",1,3,1,"H"
1974-11-24,1974,"OGC Nice","FC Metz","1-0",1,0,"1",1,1,1,"H"
1974-11-24,1974,"Paris Saint-Germain","Red Star FC","2-0",2,0,"1",1,2,2,"H"
1974-12-01,1974,"AS Saint-Etienne","RC Lens","3-2",3,2,"1",1,5,1,"H"
1974-12-01,1974,"Stade Reims","Stade Rennes","2-1",2,1,"1",1,3,1,"H"
1974-12-01,1974,"FC Sochaux","SC Bastia","3-0",3,0,"1",1,3,3,"H"
1974-12-01,1974,"Nimes Olympique","Girondins Bordeaux","2-1",2,1,"1",1,3,1,"H"
1974-12-01,1974,"Lille OSC","Olympique Lyon","1-2",1,2,"1",1,3,-1,"D"
1974-12-01,1974,"FC Nantes","OGC Nice","2-0",2,0,"1",1,2,2,"H"
1974-12-01,1974,"RC Strasbourg","Paris Saint-Germain","2-1",2,1,"1",1,3,1,"H"
1974-12-01,1974,"Red Star FC","Olympique Marseille","0-0",0,0,"1",1,0,0,"D"
1974-12-01,1974,"AS Monaco","Troyes AF","3-1",3,1,"1",1,4,2,"H"
1974-12-01,1974,"FC Metz","Angers SCO","2-0",2,0,"1",1,2,2,"H"
1974-12-08,1974,"AS Monaco","AS Saint-Etienne","3-1",3,1,"1",1,4,2,"H"
1974-12-08,1974,"Paris Saint-Germain","Stade Reims","3-0",3,0,"1",1,3,3,"H"
1974-12-08,1974,"SC Bastia","FC Metz","0-0",0,0,"1",1,0,0,"D"
1974-12-08,1974,"Nimes Olympique","FC Nantes","0-2",0,2,"1",1,2,-2,"D"
1974-12-08,1974,"Girondins Bordeaux","RC Strasbourg","4-1",4,1,"1",1,5,3,"H"
1974-12-08,1974,"RC Lens","FC Sochaux","3-2",3,2,"1",1,5,1,"H"
1974-12-08,1974,"Olympique Lyon","Angers SCO","0-0",0,0,"1",1,0,0,"D"
1974-12-08,1974,"Olympique Marseille","Lille OSC","2-0",2,0,"1",1,2,2,"H"
1974-12-08,1974,"Stade Rennes","OGC Nice","0-0",0,0,"1",1,0,0,"D"
1974-12-08,1974,"Troyes AF","Red Star FC","2-1",2,1,"1",1,3,1,"H"
1974-12-15,1974,"AS Saint-Etienne","Girondins Bordeaux","2-0",2,0,"1",1,2,2,"H"
1974-12-15,1974,"Stade Reims","SC Bastia","0-1",0,1,"1",1,1,-1,"D"
1974-12-15,1974,"FC Nantes","AS Monaco","4-2",4,2,"1",1,6,2,"H"
1974-12-15,1974,"Red Star FC","Nimes Olympique","0-1",0,1,"1",1,1,-1,"D"
1974-12-15,1974,"Angers SCO","Stade Rennes","1-2",1,2,"1",1,3,-1,"D"
1974-12-15,1974,"OGC Nice","Olympique Lyon","2-2",2,2,"1",1,4,0,"D"
1974-12-15,1974,"FC Sochaux","Olympique Marseille","1-1",1,1,"1",1,2,0,"D"
1974-12-15,1974,"RC Strasbourg","RC Lens","2-1",2,1,"1",1,3,1,"H"
1974-12-15,1974,"FC Metz","Paris Saint-Germain","1-3",1,3,"1",1,4,-2,"D"
1974-12-15,1974,"Lille OSC","Troyes AF","2-0",2,0,"1",1,2,2,"H"
1974-12-18,1974,"AS Monaco","Angers SCO","1-0",1,0,"1",1,1,1,"H"
1974-12-22,1974,"Nimes Olympique","AS Saint-Etienne","0-0",0,0,"1",1,0,0,"D"
1974-12-22,1974,"SC Bastia","Angers SCO","3-0",3,0,"1",1,3,3,"H"
1974-12-22,1974,"FC Nantes","Red Star FC","0-0",0,0,"1",1,0,0,"D"
1974-12-22,1974,"Girondins Bordeaux","Stade Reims","2-0",2,0,"1",1,2,2,"H"
1974-12-22,1974,"Olympique Lyon","FC Metz","2-0",2,0,"1",1,2,2,"H"
1974-12-22,1974,"AS Monaco","RC Strasbourg","1-0",1,0,"1",1,1,1,"H"
1974-12-22,1974,"RC Lens","Stade Rennes","1-0",1,0,"1",1,1,1,"H"
1974-12-22,1974,"Paris Saint-Germain","Lille OSC","0-0",0,0,"1",1,0,0,"D"
1974-12-22,1974,"Troyes AF","FC Sochaux","2-2",2,2,"1",1,4,0,"D"
1975-01-12,1974,"AS Saint-Etienne","FC Nantes","2-0",2,0,"1",1,2,2,"H"
1975-01-12,1974,"OGC Nice","SC Bastia","2-1",2,1,"1",1,3,1,"H"
1975-01-12,1974,"Stade Reims","RC Lens","5-1",5,1,"1",1,6,4,"H"
1975-01-12,1974,"Stade Rennes","Olympique Lyon","0-0",0,0,"1",1,0,0,"D"
1975-01-12,1974,"Lille OSC","Nimes Olympique","1-1",1,1,"1",1,2,0,"D"
1975-01-12,1974,"Red Star FC","AS Monaco","3-0",3,0,"1",1,3,3,"H"
1975-01-12,1974,"FC Sochaux","Girondins Bordeaux","5-2",5,2,"1",1,7,3,"H"
1975-01-12,1974,"RC Strasbourg","Troyes AF","1-0",1,0,"1",1,1,1,"H"
1975-01-12,1974,"Angers SCO","Paris Saint-Germain","3-1",3,1,"1",1,4,2,"H"
1975-01-12,1974,"FC Metz","Olympique Marseille","1-0",1,0,"1",1,1,1,"H"
1975-01-19,1974,"AS Saint-Etienne","Lille OSC","4-1",4,1,"1",1,5,3,"H"
1975-01-19,1974,"SC Bastia","Stade Rennes","3-0",3,0,"1",1,3,3,"H"
1975-01-19,1974,"Olympique Marseille","Stade Reims","1-1",1,1,"1",1,2,0,"D"
1975-01-19,1974,"FC Nantes","RC Strasbourg","3-1",3,1,"1",1,4,2,"H"
1975-01-19,1974,"Nimes Olympique","FC Sochaux","1-0",1,0,"1",1,1,1,"H"
1975-01-19,1974,"AS Monaco","Olympique Lyon","3-1",3,1,"1",1,4,2,"H"
1975-01-19,1974,"Girondins Bordeaux","Red Star FC","2-1",2,1,"1",1,3,1,"H"
1975-01-19,1974,"RC Lens","FC Metz","3-1",3,1,"1",1,4,2,"H"
1975-01-19,1974,"Troyes AF","Angers SCO","4-0",4,0,"1",1,4,4,"H"
1975-01-21,1974,"Paris Saint-Germain","OGC Nice","2-1",2,1,"1",1,3,1,"H"
1975-01-26,1974,"Red Star FC","AS Saint-Etienne","1-2",1,2,"1",1,3,-1,"D"
1975-01-26,1974,"Olympique Lyon","SC Bastia","8-1",8,1,"1",1,9,7,"H"
1975-01-26,1974,"FC Sochaux","FC Nantes","0-1",0,1,"1",1,1,-1,"D"
1975-01-26,1974,"Stade Reims","AS Monaco","2-3",2,3,"1",1,5,-1,"D"
1975-01-26,1974,"RC Strasbourg","Nimes Olympique","1-1",1,1,"1",1,2,0,"D"
1975-01-26,1974,"Lille OSC","Girondins Bordeaux","2-0",2,0,"1",1,2,2,"H"
1975-01-26,1974,"Stade Rennes","Paris Saint-Germain","2-1",2,1,"1",1,3,1,"H"
1975-01-26,1974,"OGC Nice","RC Lens","2-1",2,1,"1",1,3,1,"H"
1975-01-26,1974,"Angers SCO","Olympique Marseille","1-2",1,2,"1",1,3,-1,"D"
1975-01-26,1974,"FC Metz","Troyes AF","1-1",1,1,"1",1,2,0,"D"
1975-02-09,1974,"AS Saint-Etienne","FC Sochaux","1-0",1,0,"1",1,1,1,"H"
1975-02-09,1974,"AS Monaco","Lille OSC","1-0",1,0,"1",1,1,1,"H"
1975-02-09,1974,"Nimes Olympique","Stade Reims","2-0",2,0,"1",1,2,2,"H"
1975-02-09,1974,"Paris Saint-Germain","Olympique Lyon","2-2",2,2,"1",1,4,0,"D"
1975-02-09,1974,"Olympique Marseille","Stade Rennes","3-1",3,1,"1",1,4,2,"H"
1975-02-09,1974,"RC Lens","Angers SCO","0-0",0,0,"1",1,0,0,"D"
1975-02-09,1974,"Red Star FC","RC Strasbourg","0-1",0,1,"1",1,1,-1,"D"
1975-02-09,1974,"Troyes AF","OGC Nice","3-1",3,1,"1",1,4,2,"H"
1975-02-16,1974,"RC Strasbourg","AS Saint-Etienne","0-0",0,0,"1",1,0,0,"D"
1975-02-16,1974,"OGC Nice","AS Monaco","2-3",2,3,"1",1,5,-1,"D"
1975-02-16,1974,"Stade Rennes","FC Nantes","0-0",0,0,"1",1,0,0,"D"
1975-02-16,1974,"Stade Reims","Troyes AF","3-0",3,0,"1",1,3,3,"H"
1975-02-16,1974,"Angers SCO","Nimes Olympique","2-0",2,0,"1",1,2,2,"H"
1975-02-16,1974,"Olympique Lyon","Olympique Marseille","0-1",0,1,"1",1,1,-1,"D"
1975-02-16,1974,"Lille OSC","RC Lens","1-1",1,1,"1",1,2,0,"D"
1975-02-16,1974,"FC Metz","Girondins Bordeaux","3-3",3,3,"1",1,6,0,"D"
1975-02-16,1974,"FC Sochaux","Red Star FC","0-0",0,0,"1",1,0,0,"D"
1975-02-23,1974,"AS Saint-Etienne","Stade Reims","3-1",3,1,"1",1,4,2,"H"
1975-02-23,1974,"AS Monaco","FC Metz","1-2",1,2,"1",1,3,-1,"D"
1975-02-23,1974,"Nimes Olympique","OGC Nice","2-1",2,1,"1",1,3,1,"H"
1975-02-23,1974,"FC Nantes","Paris Saint-Germain","0-0",0,0,"1",1,0,0,"D"
1975-02-23,1974,"Olympique Marseille","SC Bastia","3-1",3,1,"1",1,4,2,"H"
1975-02-23,1974,"RC Lens","Olympique Lyon","4-0",4,0,"1",1,4,4,"H"
1975-02-23,1974,"RC Strasbourg","FC Sochaux","1-1",1,1,"1",1,2,0,"D"
1975-02-23,1974,"Girondins Bordeaux","Angers SCO","1-1",1,1,"1",1,2,0,"D"
1975-02-23,1974,"Troyes AF","Stade Rennes","2-0",2,0,"1",1,2,2,"H"
1975-02-23,1974,"Red Star FC","Lille OSC","2-1",2,1,"1",1,3,1,"H"
1975-03-04,1974,"AS Monaco","Olympique Marseille","0-2",0,2,"1",1,2,-2,"D"
1975-03-11,1974,"FC Sochaux","AS Monaco","4-2",4,2,"1",1,6,2,"H"
1975-03-11,1974,"FC Metz","Nimes Olympique","3-0",3,0,"1",1,3,3,"H"
1975-03-11,1974,"OGC Nice","Girondins Bordeaux","0-0",0,0,"1",1,0,0,"D"
1975-03-12,1974,"Angers SCO","AS Saint-Etienne","0-1",0,1,"1",1,1,-1,"D"
1975-03-12,1974,"Paris Saint-Germain","Olympique Marseille","1-1",1,1,"1",1,2,0,"D"
1975-03-12,1974,"Stade Reims","FC Nantes","2-1",2,1,"1",1,3,1,"H"
1975-03-12,1974,"SC Bastia","RC Lens","0-0",0,0,"1",1,0,0,"D"
1975-03-12,1974,"Olympique Lyon","Troyes AF","2-1",2,1,"1",1,3,1,"H"
1975-03-12,1974,"Lille OSC","RC Strasbourg","2-1",2,1,"1",1,3,1,"H"
1975-03-12,1974,"Stade Rennes","Red Star FC","0-2",0,2,"1",1,2,-2,"D"
1975-03-15,1974,"Olympique Marseille","OGC Nice","4-1",4,1,"1",1,5,3,"H"
1975-03-15,1974,"FC Nantes","Angers SCO","1-0",1,0,"1",1,1,1,"H"
1975-03-15,1974,"Nimes Olympique","Stade Rennes","0-0",0,0,"1",1,0,0,"D"
1975-03-15,1974,"RC Lens","Paris Saint-Germain","3-2",3,2,"1",1,5,1,"H"
1975-03-15,1974,"Girondins Bordeaux","Olympique Lyon","1-1",1,1,"1",1,2,0,"D"
1975-03-15,1974,"RC Strasbourg","Stade Reims","3-0",3,0,"1",1,3,3,"H"
1975-03-15,1974,"Troyes AF","SC Bastia","2-1",2,1,"1",1,3,1,"H"
1975-03-15,1974,"FC Sochaux","Lille OSC","1-1",1,1,"1",1,2,0,"D"
1975-03-15,1974,"Red Star FC","FC Metz","1-1",1,1,"1",1,2,0,"D"
1975-03-20,1974,"Olympique Marseille","RC Lens","4-0",4,0,"1",1,4,4,"H"
1975-03-20,1974,"Olympique Lyon","Nimes Olympique","2-2",2,2,"1",1,4,0,"D"
1975-03-20,1974,"Stade Reims","FC Sochaux","2-1",2,1,"1",1,3,1,"H"
1975-03-20,1974,"Lille OSC","FC Nantes","3-0",3,0,"1",1,3,3,"H"
1975-03-20,1974,"SC Bastia","AS Monaco","1-0",1,0,"1",1,1,1,"H"
1975-03-20,1974,"Stade Rennes","Girondins Bordeaux","1-1",1,1,"1",1,2,0,"D"
1975-03-20,1974,"Angers SCO","RC Strasbourg","5-1",5,1,"1",1,6,4,"H"
1975-03-20,1974,"Paris Saint-Germain","Troyes AF","0-0",0,0,"1",1,0,0,"D"
1975-03-20,1974,"OGC Nice","Red Star FC","2-1",2,1,"1",1,3,1,"H"
1975-03-22,1974,"FC Metz","AS Saint-Etienne","3-0",3,0,"1",1,3,3,"H"
1975-03-29,1974,"SC Bastia","Paris Saint-Germain","0-2",0,2,"1",1,2,-2,"D"
1975-04-01,1974,"AS Saint-Etienne","Stade Rennes","3-0",3,0,"1",1,3,3,"H"
1975-04-01,1974,"Troyes AF","Olympique Marseille","1-2",1,2,"1",1,3,-1,"D"
1975-04-01,1974,"FC Nantes","Olympique Lyon","3-1",3,1,"1",1,4,2,"H"
1975-04-01,1974,"Nimes Olympique","SC Bastia","3-3",3,3,"1",1,6,0,"D"
1975-04-01,1974,"AS Monaco","Paris Saint-Germain","3-0",3,0,"1",1,3,3,"H"
1975-04-01,1974,"Lille OSC","Stade Reims","2-1",2,1,"1",1,3,1,"H"
1975-04-01,1974,"Girondins Bordeaux","RC Lens","2-0",2,0,"1",1,2,2,"H"
1975-04-01,1974,"RC Strasbourg","OGC Nice","2-1",2,1,"1",1,3,1,"H"
1975-04-01,1974,"FC Sochaux","FC Metz","1-1",1,1,"1",1,2,0,"D"
1975-04-01,1974,"Red Star FC","Angers SCO","2-5",2,5,"1",1,7,-3,"D"
1975-04-04,1974,"Olympique Lyon","AS Saint-Etienne","1-0",1,0,"1",1,1,1,"H"
1975-04-05,1974,"Olympique Marseille","Nimes Olympique","1-1",1,1,"1",1,2,0,"D"
1975-04-05,1974,"SC Bastia","FC Nantes","1-0",1,0,"1",1,1,1,"H"
1975-04-05,1974,"Stade Rennes","AS Monaco","1-1",1,1,"1",1,2,0,"D"
1975-04-05,1974,"Stade Reims","Red Star FC","1-1",1,1,"1",1,2,0,"D"
1975-04-05,1974,"RC Lens","Troyes AF","1-0",1,0,"1",1,1,1,"H"
1975-04-05,1974,"Paris Saint-Germain","Girondins Bordeaux","1-0",1,0,"1",1,1,1,"H"
1975-04-05,1974,"FC Metz","RC Strasbourg","2-1",2,1,"1",1,3,1,"H"
1975-04-05,1974,"OGC Nice","FC Sochaux","5-1",5,1,"1",1,6,4,"H"
1975-04-05,1974,"Angers SCO","Lille OSC","4-1",4,1,"1",1,5,3,"H"
1975-04-19,1974,"Girondins Bordeaux","Olympique Marseille","1-0",1,0,"1",1,1,1,"H"
1975-04-19,1974,"FC Nantes","Troyes AF","4-1",4,1,"1",1,5,3,"H"
1975-04-19,1974,"Nimes Olympique","Paris Saint-Germain","2-1",2,1,"1",1,3,1,"H"
1975-04-19,1974,"AS Monaco","RC Lens","3-0",3,0,"1",1,3,3,"H"
1975-04-19,1974,"Olympique Lyon","Red Star FC","2-1",2,1,"1",1,3,1,"H"
1975-04-19,1974,"Stade Reims","FC Metz","1-2",1,2,"1",1,3,-1,"D"
1975-04-19,1974,"RC Strasbourg","Stade Rennes","2-0",2,0,"1",1,2,2,"H"
1975-04-19,1974,"Lille OSC","OGC Nice","4-2",4,2,"1",1,6,2,"H"
1975-04-19,1974,"FC Sochaux","Angers SCO","0-1",0,1,"1",1,1,-1,"D"
1975-04-30,1974,"Paris Saint-Germain","AS Saint-Etienne","2-2",2,2,"1",1,4,0,"D"
1975-04-30,1974,"Olympique Marseille","FC Nantes","2-1",2,1,"1",1,3,1,"H"
1975-04-30,1974,"Olympique Lyon","RC Strasbourg","4-1",4,1,"1",1,5,3,"H"
1975-04-30,1974,"SC Bastia","Red Star FC","2-0",2,0,"1",1,2,2,"H"
1975-04-30,1974,"RC Lens","Nimes Olympique","3-0",3,0,"1",1,3,3,"H"
1975-04-30,1974,"Angers SCO","AS Monaco","2-1",2,1,"1",1,3,1,"H"
1975-04-30,1974,"OGC Nice","Stade Reims","0-0",0,0,"1",1,0,0,"D"
1975-04-30,1974,"Troyes AF","Girondins Bordeaux","1-0",1,0,"1",1,1,1,"H"
1975-04-30,1974,"FC Metz","Lille OSC","2-1",2,1,"1",1,3,1,"H"
1975-04-30,1974,"Stade Rennes","FC Sochaux","0-1",0,1,"1",1,1,-1,"D"
1975-05-03,1974,"AS Saint-Etienne","Olympique Marseille","4-1",4,1,"1",1,5,3,"H"
1975-05-03,1974,"FC Nantes","RC Lens","2-1",2,1,"1",1,3,1,"H"
1975-05-03,1974,"AS Monaco","Girondins Bordeaux","2-0",2,0,"1",1,2,2,"H"
1975-05-03,1974,"FC Sochaux","Olympique Lyon","3-1",3,1,"1",1,4,2,"H"
1975-05-03,1974,"Nimes Olympique","Troyes AF","2-2",2,2,"1",1,4,0,"D"
1975-05-03,1974,"RC Strasbourg","SC Bastia","3-2",3,2,"1",1,5,1,"H"
1975-05-03,1974,"Stade Reims","Angers SCO","1-1",1,1,"1",1,2,0,"D"
1975-05-03,1974,"Red Star FC","Paris Saint-Germain","1-1",1,1,"1",1,2,0,"D"
1975-05-03,1974,"FC Metz","OGC Nice","2-2",2,2,"1",1,4,0,"D"
1975-05-03,1974,"Lille OSC","Stade Rennes","1-0",1,0,"1",1,1,1,"H"
1975-05-16,1974,"FC Nantes","FC Metz","0-2",0,2,"1",1,2,-2,"D"
1975-05-16,1974,"Girondins Bordeaux","SC Bastia","1-0",1,0,"1",1,1,1,"H"
1975-05-16,1974,"AS Saint-Etienne","OGC Nice","2-0",2,0,"1",1,2,2,"H"
1975-05-21,1974,"AS Saint-Etienne","SC Bastia","3-2",3,2,"1",1,5,1,"H"
1975-05-30,1974,"RC Lens","AS Saint-Etienne","3-1",3,1,"1",1,4,2,"H"
1975-05-30,1974,"Olympique Marseille","Red Star FC","3-2",3,2,"1",1,5,1,"H"
1975-05-30,1974,"Olympique Lyon","Lille OSC","5-1",5,1,"1",1,6,4,"H"
1975-05-30,1974,"OGC Nice","FC Nantes","2-2",2,2,"1",1,4,0,"D"
1975-05-30,1974,"Girondins Bordeaux","Nimes Olympique","0-1",0,1,"1",1,1,-1,"D"
1975-05-30,1974,"SC Bastia","FC Sochaux","4-2",4,2,"1",1,6,2,"H"
1975-05-30,1974,"Troyes AF","AS Monaco","5-0",5,0,"1",1,5,5,"H"
1975-05-30,1974,"Stade Rennes","Stade Reims","2-2",2,2,"1",1,4,0,"D"
1975-05-30,1974,"Angers SCO","FC Metz","2-2",2,2,"1",1,4,0,"D"
1975-05-30,1974,"Paris Saint-Germain","RC Strasbourg","1-1",1,1,"1",1,2,0,"D"
1975-06-03,1974,"AS Saint-Etienne","Troyes AF","5-1",5,1,"1",1,6,4,"H"
1975-06-03,1974,"RC Strasbourg","Olympique Marseille","3-2",3,2,"1",1,5,1,"H"
1975-06-03,1974,"Stade Reims","Olympique Lyon","0-2",0,2,"1",1,2,-2,"D"
1975-06-03,1974,"FC Nantes","Girondins Bordeaux","3-0",3,0,"1",1,3,3,"H"
1975-06-03,1974,"Nimes Olympique","AS Monaco","3-0",3,0,"1",1,3,3,"H"
1975-06-03,1974,"Lille OSC","SC Bastia","0-0",0,0,"1",1,0,0,"D"
1975-06-03,1974,"Red Star FC","RC Lens","1-1",1,1,"1",1,2,0,"D"
1975-06-03,1974,"FC Metz","Stade Rennes","5-2",5,2,"1",1,7,3,"H"
1975-06-03,1974,"OGC Nice","Angers SCO","4-1",4,1,"1",1,5,3,"H"
1975-06-03,1974,"Paris Saint-Germain","FC Sochaux","0-1",0,1,"1",1,1,-1,"D"
1975-08-07,1975,"Lille OSC","AS Monaco","3-3",3,3,"1",1,6,0,"D"
1975-08-08,1975,"Nimes Olympique","FC Nantes","0-0",0,0,"1",1,0,0,"D"
1975-08-08,1975,"Girondins Bordeaux","RC Strasbourg","1-1",1,1,"1",1,2,0,"D"
1975-08-08,1975,"RC Lens","FC Metz","4-1",4,1,"1",1,5,3,"H"
1975-08-08,1975,"SC Bastia","Paris Saint-Germain","3-0",3,0,"1",1,3,3,"H"
1975-08-08,1975,"OGC Nice","FC Sochaux","3-0",3,0,"1",1,3,3,"H"
1975-08-08,1975,"Olympique Marseille","Association Sportive Avignonaise","3-1",3,1,"1",1,4,2,"H"
1975-08-08,1975,"Troyes AF","Olympique Lyon","3-4",3,4,"1",1,7,-1,"D"
1975-08-08,1975,"AS Saint-Etienne","Stade Reims","2-1",2,1,"1",1,3,1,"H"
1975-08-08,1975,"AS Nancy","US Valenciennes-Anzin","3-3",3,3,"1",1,6,0,"D"
1975-08-13,1975,"Association Sportive Avignonaise","OGC Nice","1-5",1,5,"1",1,6,-4,"D"
1975-08-13,1975,"RC Lens","Olympique Marseille","2-3",2,3,"1",1,5,-1,"D"
1975-08-13,1975,"SC Bastia","Lille OSC","1-1",1,1,"1",1,2,0,"D"
1975-08-13,1975,"Olympique Lyon","US Valenciennes-Anzin","1-1",1,1,"1",1,2,0,"D"
1975-08-13,1975,"FC Metz","AS Saint-Etienne","1-1",1,1,"1",1,2,0,"D"
1975-08-13,1975,"RC Strasbourg","Nimes Olympique","0-1",0,1,"1",1,1,-1,"D"
1975-08-13,1975,"FC Sochaux","AS Nancy","3-0",3,0,"1",1,3,3,"H"
1975-08-13,1975,"Stade Reims","Paris Saint-Germain","1-1",1,1,"1",1,2,0,"D"
1975-08-13,1975,"FC Nantes","Troyes AF","2-2",2,2,"1",1,4,0,"D"
1975-08-14,1975,"AS Monaco","Girondins Bordeaux","1-1",1,1,"1",1,2,0,"D"
1975-08-22,1975,"OGC Nice","AS Monaco","4-1",4,1,"1",1,5,3,"H"
1975-08-22,1975,"Olympique Marseille","FC Metz","2-1",2,1,"1",1,3,1,"H"
1975-08-22,1975,"AS Nancy","Olympique Lyon","1-4",1,4,"1",1,5,-3,"D"
1975-08-22,1975,"Nimes Olympique","SC Bastia","3-0",3,0,"1",1,3,3,"H"
1975-08-22,1975,"AS Saint-Etienne","RC Lens","2-0",2,0,"1",1,2,2,"H"
1975-08-22,1975,"Girondins Bordeaux","FC Sochaux","1-2",1,2,"1",1,3,-1,"D"
1975-08-22,1975,"Paris Saint-Germain","Association Sportive Avignonaise","6-2",6,2,"1",1,8,4,"H"
1975-08-22,1975,"Lille OSC","Stade Reims","2-2",2,2,"1",1,4,0,"D"
1975-08-22,1975,"US Valenciennes-Anzin","FC Nantes","1-1",1,1,"1",1,2,0,"D"
1975-08-22,1975,"Troyes AF","RC Strasbourg","1-1",1,1,"1",1,2,0,"D"
1975-08-27,1975,"AS Saint-Etienne","Girondins Bordeaux","5-2",5,2,"1",1,7,3,"H"
1975-08-27,1975,"FC Nantes","Olympique Lyon","2-3",2,3,"1",1,5,-1,"D"
1975-08-27,1975,"Stade Reims","Olympique Marseille","3-1",3,1,"1",1,4,2,"H"
1975-08-27,1975,"AS Monaco","Nimes Olympique","3-1",3,1,"1",1,4,2,"H"
1975-08-27,1975,"FC Sochaux","Troyes AF","2-2",2,2,"1",1,4,0,"D"
1975-08-27,1975,"RC Lens","Paris Saint-Germain","3-3",3,3,"1",1,6,0,"D"
1975-08-27,1975,"RC Strasbourg","US Valenciennes-Anzin","1-0",1,0,"1",1,1,1,"H"
1975-08-27,1975,"FC Metz","Lille OSC","5-2",5,2,"1",1,7,3,"H"
1975-08-27,1975,"Association Sportive Avignonaise","AS Nancy","2-3",2,3,"1",1,5,-1,"D"
1975-09-09,1975,"Olympique Lyon","RC Strasbourg","2-1",2,1,"1",1,3,1,"H"
1975-09-09,1975,"OGC Nice","Stade Reims","2-1",2,1,"1",1,3,1,"H"
1975-09-09,1975,"Olympique Marseille","AS Saint-Etienne","4-2",4,2,"1",1,6,2,"H"
1975-09-09,1975,"Nimes Olympique","FC Sochaux","0-2",0,2,"1",1,2,-2,"D"
1975-09-09,1975,"Paris Saint-Germain","FC Metz","3-1",3,1,"1",1,4,2,"H"
1975-09-09,1975,"Troyes AF","AS Monaco","3-1",3,1,"1",1,4,2,"H"
1975-09-09,1975,"US Valenciennes-Anzin","SC Bastia","3-1",3,1,"1",1,4,2,"H"
1975-09-09,1975,"Lille OSC","RC Lens","4-2",4,2,"1",1,6,2,"H"
1975-09-09,1975,"AS Nancy","FC Nantes","1-1",1,1,"1",1,2,0,"D"
1975-09-09,1975,"Girondins Bordeaux","Association Sportive Avignonaise","2-1",2,1,"1",1,3,1,"H"
1975-09-12,1975,"FC Metz","OGC Nice","2-2",2,2,"1",1,4,0,"D"
1975-09-12,1975,"FC Sochaux","Olympique Lyon","1-0",1,0,"1",1,1,1,"H"
1975-09-12,1975,"AS Saint-Etienne","Paris Saint-Germain","1-1",1,1,"1",1,2,0,"D"
1975-09-12,1975,"Olympique Marseille","AS Nancy","1-3",1,3,"1",1,4,-2,"D"
1975-09-12,1975,"AS Monaco","US Valenciennes-Anzin","3-1",3,1,"1",1,4,2,"H"
1975-09-12,1975,"Stade Reims","Girondins Bordeaux","0-0",0,0,"1",1,0,0,"D"
1975-09-12,1975,"RC Strasbourg","FC Nantes","1-1",1,1,"1",1,2,0,"D"
1975-09-12,1975,"Association Sportive Avignonaise","Lille OSC","1-0",1,0,"1",1,1,1,"H"
1975-09-13,1975,"RC Lens","Nimes Olympique","1-1",1,1,"1",1,2,0,"D"
1975-09-13,1975,"SC Bastia","Troyes AF","3-1",3,1,"1",1,4,2,"H"
1975-09-19,1975,"US Valenciennes-Anzin","FC Sochaux","3-0",3,0,"1",1,3,3,"H"
1975-09-20,1975,"OGC Nice","RC Lens","5-0",5,0,"1",1,5,5,"H"
1975-09-20,1975,"Olympique Lyon","AS Monaco","4-1",4,1,"1",1,5,3,"H"
1975-09-20,1975,"Paris Saint-Germain","Olympique Marseille","2-3",2,3,"1",1,5,-1,"D"
1975-09-20,1975,"Lille OSC","AS Saint-Etienne","0-0",0,0,"1",1,0,0,"D"
1975-09-20,1975,"Nimes Olympique","Stade Reims","0-3",0,3,"1",1,3,-3,"D"
1975-09-20,1975,"FC Nantes","SC Bastia","1-0",1,0,"1",1,1,1,"H"
1975-09-20,1975,"Girondins Bordeaux","FC Metz","3-1",3,1,"1",1,4,2,"H"
1975-09-20,1975,"AS Nancy","RC Strasbourg","1-1",1,1,"1",1,2,0,"D"
1975-09-20,1975,"Troyes AF","Association Sportive Avignonaise","1-1",1,1,"1",1,2,0,"D"
1975-09-25,1975,"AS Saint-Etienne","OGC Nice","1-1",1,1,"1",1,2,0,"D"
1975-09-26,1975,"Olympique Marseille","Troyes AF","3-2",3,2,"1",1,5,1,"H"
1975-09-26,1975,"Stade Reims","Olympique Lyon","3-2",3,2,"1",1,5,1,"H"
1975-09-26,1975,"FC Sochaux","RC Strasbourg","1-1",1,1,"1",1,2,0,"D"
1975-09-26,1975,"Association Sportive Avignonaise","US Valenciennes-Anzin","1-2",1,2,"1",1,3,-1,"D"
1975-09-26,1975,"Paris Saint-Germain","Lille OSC","2-2",2,2,"1",1,4,0,"D"
1975-09-26,1975,"AS Monaco","FC Nantes","4-4",4,4,"1",1,8,0,"D"
1975-09-26,1975,"SC Bastia","AS Nancy","3-0",3,0,"1",1,3,3,"H"
1975-09-26,1975,"RC Lens","Girondins Bordeaux","3-2",3,2,"1",1,5,1,"H"
1975-09-26,1975,"FC Metz","Nimes Olympique","4-3",4,3,"1",1,7,1,"H"
1975-09-30,1975,"SC Bastia","OGC Nice","1-1",1,1,"1",1,2,0,"D"
1975-10-03,1975,"RC Strasbourg","AS Monaco","1-0",1,0,"1",1,1,1,"H"
1975-10-04,1975,"OGC Nice","Paris Saint-Germain","2-1",2,1,"1",1,3,1,"H"
1975-10-04,1975,"Olympique Lyon","Association Sportive Avignonaise","2-0",2,0,"1",1,2,2,"H"
1975-10-04,1975,"Lille OSC","Olympique Marseille","4-3",4,3,"1",1,7,1,"H"
1975-10-04,1975,"FC Nantes","FC Sochaux","2-2",2,2,"1",1,4,0,"D"
1975-10-04,1975,"US Valenciennes-Anzin","RC Lens","1-1",1,1,"1",1,2,0,"D"
1975-10-04,1975,"Nimes Olympique","AS Saint-Etienne","2-0",2,0,"1",1,2,2,"H"
1975-10-04,1975,"Troyes AF","Stade Reims","2-1",2,1,"1",1,3,1,"H"
1975-10-04,1975,"Girondins Bordeaux","SC Bastia","3-0",3,0,"1",1,3,3,"H"
1975-10-04,1975,"AS Nancy","FC Metz","0-0",0,0,"1",1,0,0,"D"
1975-10-16,1975,"RC Lens","Troyes AF","1-1",1,1,"1",1,2,0,"D"
1975-10-17,1975,"Olympique Marseille","OGC Nice","2-1",2,1,"1",1,3,1,"H"
1975-10-17,1975,"Lille OSC","Olympique Lyon","2-1",2,1,"1",1,3,1,"H"
1975-10-17,1975,"AS Monaco","FC Sochaux","0-0",0,0,"1",1,0,0,"D"
1975-10-17,1975,"AS Saint-Etienne","FC Nantes","2-2",2,2,"1",1,4,0,"D"
1975-10-17,1975,"Stade Reims","AS Nancy","1-1",1,1,"1",1,2,0,"D"
1975-10-17,1975,"Paris Saint-Germain","Girondins Bordeaux","2-2",2,2,"1",1,4,0,"D"
1975-10-17,1975,"FC Metz","US Valenciennes-Anzin","3-0",3,0,"1",1,3,3,"H"
1975-10-17,1975,"SC Bastia","RC Strasbourg","2-1",2,1,"1",1,3,1,"H"
1975-10-17,1975,"Association Sportive Avignonaise","Nimes Olympique","1-0",1,0,"1",1,1,1,"H"
1975-10-25,1975,"OGC Nice","Lille OSC","2-2",2,2,"1",1,4,0,"D"
1975-10-25,1975,"Olympique Lyon","AS Saint-Etienne","0-0",0,0,"1",1,0,0,"D"
1975-10-25,1975,"Girondins Bordeaux","Olympique Marseille","3-1",3,1,"1",1,4,2,"H"
1975-10-25,1975,"FC Sochaux","SC Bastia","2-2",2,2,"1",1,4,0,"D"
1975-10-25,1975,"FC Nantes","Association Sportive Avignonaise","4-0",4,0,"1",1,4,4,"H"
1975-10-25,1975,"US Valenciennes-Anzin","Stade Reims","2-1",2,1,"1",1,3,1,"H"
1975-10-25,1975,"Troyes AF","FC Metz","0-1",0,1,"1",1,1,-1,"D"
1975-10-25,1975,"AS Nancy","AS Monaco","3-0",3,0,"1",1,3,3,"H"
1975-10-25,1975,"RC Strasbourg","RC Lens","1-1",1,1,"1",1,2,0,"D"
1975-10-25,1975,"Nimes Olympique","Paris Saint-Germain","2-1",2,1,"1",1,3,1,"H"
1975-10-31,1975,"OGC Nice","Girondins Bordeaux","2-0",2,0,"1",1,2,2,"H"
1975-10-31,1975,"RC Lens","Olympique Lyon","3-1",3,1,"1",1,4,2,"H"
1975-10-31,1975,"AS Saint-Etienne","US Valenciennes-Anzin","2-0",2,0,"1",1,2,2,"H"
1975-10-31,1975,"Olympique Marseille","Nimes Olympique","0-1",0,1,"1",1,1,-1,"D"
1975-10-31,1975,"FC Metz","FC Nantes","3-0",3,0,"1",1,3,3,"H"
1975-10-31,1975,"SC Bastia","AS Monaco","3-0",3,0,"1",1,3,3,"H"
1975-10-31,1975,"Association Sportive Avignonaise","FC Sochaux","3-1",3,1,"1",1,4,2,"H"
1975-10-31,1975,"Stade Reims","RC Strasbourg","6-0",6,0,"1",1,6,6,"H"
1975-10-31,1975,"Paris Saint-Germain","Troyes AF","1-0",1,0,"1",1,1,1,"H"
1975-11-03,1975,"Lille OSC","AS Nancy","1-2",1,2,"1",1,3,-1,"D"
1975-11-08,1975,"Nimes Olympique","OGC Nice","2-1",2,1,"1",1,3,1,"H"
1975-11-08,1975,"Troyes AF","AS Saint-Etienne","0-1",0,1,"1",1,1,-1,"D"
1975-11-08,1975,"Olympique Lyon","SC Bastia","2-2",2,2,"1",1,4,0,"D"
1975-11-08,1975,"RC Strasbourg","FC Metz","1-2",1,2,"1",1,3,-1,"D"
1975-11-08,1975,"FC Sochaux","RC Lens","3-2",3,2,"1",1,5,1,"H"
1975-11-08,1975,"FC Nantes","Stade Reims","4-1",4,1,"1",1,5,3,"H"
1975-11-08,1975,"Girondins Bordeaux","Lille OSC","2-1",2,1,"1",1,3,1,"H"
1975-11-08,1975,"US Valenciennes-Anzin","Olympique Marseille","1-0",1,0,"1",1,1,1,"H"
1975-11-08,1975,"AS Nancy","Paris Saint-Germain","2-4",2,4,"1",1,6,-2,"D"
1975-11-08,1975,"AS Monaco","Association Sportive Avignonaise","1-0",1,0,"1",1,1,1,"H"
1975-11-18,1975,"Lille OSC","Nimes Olympique","2-1",2,1,"1",1,3,1,"H"
1975-11-19,1975,"OGC Nice","AS Nancy","2-1",2,1,"1",1,3,1,"H"
1975-11-19,1975,"AS Saint-Etienne","RC Strasbourg","2-1",2,1,"1",1,3,1,"H"
1975-11-19,1975,"FC Metz","FC Sochaux","3-1",3,1,"1",1,4,2,"H"
1975-11-19,1975,"Olympique Marseille","Olympique Lyon","2-0",2,0,"1",1,2,2,"H"
1975-11-19,1975,"Paris Saint-Germain","US Valenciennes-Anzin","2-0",2,0,"1",1,2,2,"H"
1975-11-19,1975,"Association Sportive Avignonaise","SC Bastia","1-1",1,1,"1",1,2,0,"D"
1975-11-19,1975,"Girondins Bordeaux","Troyes AF","2-2",2,2,"1",1,4,0,"D"
1975-11-19,1975,"RC Lens","FC Nantes","3-2",3,2,"1",1,5,1,"H"
1975-11-19,1975,"Stade Reims","AS Monaco","2-2",2,2,"1",1,4,0,"D"
1975-11-22,1975,"Troyes AF","OGC Nice","2-2",2,2,"1",1,4,0,"D"
1975-11-22,1975,"AS Nancy","AS Saint-Etienne","0-0",0,0,"1",1,0,0,"D"
1975-11-22,1975,"FC Nantes","Olympique Marseille","0-1",0,1,"1",1,1,-1,"D"
1975-11-22,1975,"Olympique Lyon","Paris Saint-Germain","2-0",2,0,"1",1,2,2,"H"
1975-11-22,1975,"AS Monaco","FC Metz","2-0",2,0,"1",1,2,2,"H"
1975-11-22,1975,"Nimes Olympique","Girondins Bordeaux","1-2",1,2,"1",1,3,-1,"D"
1975-11-22,1975,"SC Bastia","RC Lens","0-0",0,0,"1",1,0,0,"D"
1975-11-22,1975,"RC Strasbourg","Association Sportive Avignonaise","4-0",4,0,"1",1,4,4,"H"
1975-11-23,1975,"FC Sochaux","Stade Reims","1-0",1,0,"1",1,1,1,"H"
1975-11-23,1975,"US Valenciennes-Anzin","Lille OSC","0-1",0,1,"1",1,1,-1,"D"
1975-11-26,1975,"OGC Nice","US Valenciennes-Anzin","1-0",1,0,"1",1,1,1,"H"
1975-11-26,1975,"AS Saint-Etienne","FC Sochaux","2-0",2,0,"1",1,2,2,"H"
1975-11-26,1975,"Olympique Marseille","RC Strasbourg","1-0",1,0,"1",1,1,1,"H"
1975-11-26,1975,"FC Metz","SC Bastia","4-1",4,1,"1",1,5,3,"H"
1975-11-26,1975,"Lille OSC","Troyes AF","3-0",3,0,"1",1,3,3,"H"
1975-11-26,1975,"Girondins Bordeaux","AS Nancy","0-0",0,0,"1",1,0,0,"D"
1975-11-26,1975,"Paris Saint-Germain","FC Nantes","2-1",2,1,"1",1,3,1,"H"
1975-11-26,1975,"Nimes Olympique","Olympique Lyon","2-0",2,0,"1",1,2,2,"H"
1975-11-26,1975,"RC Lens","AS Monaco","3-0",3,0,"1",1,3,3,"H"
1975-11-26,1975,"Stade Reims","Association Sportive Avignonaise","4-1",4,1,"1",1,5,3,"H"
1975-11-29,1975,"Olympique Lyon","OGC Nice","1-0",1,0,"1",1,1,1,"H"
1975-11-29,1975,"SC Bastia","Stade Reims","2-0",2,0,"1",1,2,2,"H"
1975-11-29,1975,"FC Nantes","Lille OSC","4-0",4,0,"1",1,4,4,"H"
1975-11-29,1975,"Troyes AF","Nimes Olympique","1-1",1,1,"1",1,2,0,"D"
1975-11-29,1975,"AS Nancy","RC Lens","3-0",3,0,"1",1,3,3,"H"
1975-11-30,1975,"AS Monaco","AS Saint-Etienne","0-3",0,3,"1",1,3,-3,"D"
1975-11-30,1975,"Association Sportive Avignonaise","FC Metz","0-1",0,1,"1",1,1,-1,"D"
1975-11-30,1975,"FC Sochaux","Olympique Marseille","3-0",3,0,"1",1,3,3,"H"
1975-11-30,1975,"US Valenciennes-Anzin","Girondins Bordeaux","1-1",1,1,"1",1,2,0,"D"
1975-11-30,1975,"RC Strasbourg","Paris Saint-Germain","1-0",1,0,"1",1,1,1,"H"
1975-12-05,1975,"Lille OSC","RC Strasbourg","3-0",3,0,"1",1,3,3,"H"
1975-12-06,1975,"FC Metz","Stade Reims","2-4",2,4,"1",1,6,-2,"D"
1975-12-06,1975,"Girondins Bordeaux","Olympique Lyon","3-1",3,1,"1",1,4,2,"H"
1975-12-06,1975,"RC Lens","Association Sportive Avignonaise","3-1",3,1,"1",1,4,2,"H"
1975-12-06,1975,"Troyes AF","AS Nancy","3-0",3,0,"1",1,3,3,"H"
1975-12-07,1975,"AS Saint-Etienne","SC Bastia","4-2",4,2,"1",1,6,2,"H"
1975-12-07,1975,"OGC Nice","FC Nantes","2-2",2,2,"1",1,4,0,"D"
1975-12-07,1975,"Olympique Marseille","AS Monaco","1-0",1,0,"1",1,1,1,"H"
1975-12-07,1975,"Paris Saint-Germain","FC Sochaux","2-3",2,3,"1",1,5,-1,"D"
1975-12-07,1975,"Nimes Olympique","US Valenciennes-Anzin","1-0",1,0,"1",1,1,1,"H"
1975-12-13,1975,"Association Sportive Avignonaise","AS Saint-Etienne","1-3",1,3,"1",1,4,-2,"D"
1975-12-13,1975,"RC Strasbourg","OGC Nice","2-2",2,2,"1",1,4,0,"D"
1975-12-13,1975,"Olympique Lyon","FC Metz","2-3",2,3,"1",1,5,-1,"D"
1975-12-13,1975,"Stade Reims","RC Lens","4-0",4,0,"1",1,4,4,"H"
1975-12-13,1975,"US Valenciennes-Anzin","Troyes AF","3-0",3,0,"1",1,3,3,"H"
1975-12-14,1975,"SC Bastia","Olympique Marseille","2-3",2,3,"1",1,5,-1,"D"
1975-12-14,1975,"FC Sochaux","Lille OSC","4-1",4,1,"1",1,5,3,"H"
1975-12-14,1975,"FC Nantes","Girondins Bordeaux","5-1",5,1,"1",1,6,4,"H"
1975-12-14,1975,"AS Nancy","Nimes Olympique","1-1",1,1,"1",1,2,0,"D"
1975-12-14,1975,"AS Monaco","Paris Saint-Germain","3-0",3,0,"1",1,3,3,"H"
1975-12-20,1975,"Girondins Bordeaux","AS Monaco","3-1",3,1,"1",1,4,2,"H"
1975-12-20,1975,"Nimes Olympique","RC Strasbourg","2-1",2,1,"1",1,3,1,"H"
1975-12-20,1975,"Lille OSC","SC Bastia","2-0",2,0,"1",1,2,2,"H"
1975-12-20,1975,"Troyes AF","FC Nantes","0-0",0,0,"1",1,0,0,"D"
1975-12-20,1975,"US Valenciennes-Anzin","Olympique Lyon","0-0",0,0,"1",1,0,0,"D"
1975-12-21,1975,"AS Saint-Etienne","FC Metz","1-0",1,0,"1",1,1,1,"H"
1975-12-21,1975,"OGC Nice","Association Sportive Avignonaise","2-0",2,0,"1",1,2,2,"H"
1975-12-21,1975,"Olympique Marseille","RC Lens","3-2",3,2,"1",1,5,1,"H"
1975-12-21,1975,"AS Nancy","FC Sochaux","5-1",5,1,"1",1,6,4,"H"
1975-12-21,1975,"Paris Saint-Germain","Stade Reims","2-3",2,3,"1",1,5,-1,"D"
1976-01-17,1975,"RC Lens","AS Saint-Etienne","1-1",1,1,"1",1,2,0,"D"
1976-01-17,1975,"FC Metz","Olympique Marseille","1-0",1,0,"1",1,1,1,"H"
1976-01-17,1975,"FC Sochaux","Girondins Bordeaux","2-0",2,0,"1",1,2,2,"H"
1976-01-17,1975,"FC Nantes","US Valenciennes-Anzin","2-0",2,0,"1",1,2,2,"H"
1976-01-18,1975,"AS Monaco","OGC Nice","4-1",4,1,"1",1,5,3,"H"
1976-01-18,1975,"SC Bastia","Nimes Olympique","1-1",1,1,"1",1,2,0,"D"
1976-01-18,1975,"Olympique Lyon","AS Nancy","1-0",1,0,"1",1,1,1,"H"
1976-01-18,1975,"Association Sportive Avignonaise","Paris Saint-Germain","1-1",1,1,"1",1,2,0,"D"
1976-01-18,1975,"RC Strasbourg","Troyes AF","2-1",2,1,"1",1,3,1,"H"
1976-01-24,1975,"Lille OSC","FC Metz","1-1",1,1,"1",1,2,0,"D"
1976-01-24,1975,"Troyes AF","FC Sochaux","3-0",3,0,"1",1,3,3,"H"
1976-01-24,1975,"US Valenciennes-Anzin","RC Strasbourg","2-0",2,0,"1",1,2,2,"H"
1976-01-25,1975,"Girondins Bordeaux","AS Saint-Etienne","1-1",1,1,"1",1,2,0,"D"
1976-01-25,1975,"OGC Nice","SC Bastia","1-1",1,1,"1",1,2,0,"D"
1976-01-25,1975,"Olympique Marseille","Stade Reims","1-0",1,0,"1",1,1,1,"H"
1976-01-25,1975,"Nimes Olympique","AS Monaco","3-2",3,2,"1",1,5,1,"H"
1976-01-25,1975,"Olympique Lyon","FC Nantes","3-3",3,3,"1",1,6,0,"D"
1976-01-25,1975,"AS Nancy","Association Sportive Avignonaise","6-0",6,0,"1",1,6,6,"H"
1976-01-25,1975,"Paris Saint-Germain","RC Lens","4-2",4,2,"1",1,6,2,"H"
1976-01-28,1975,"Stade Reims","Lille OSC","2-0",2,0,"1",1,2,2,"H"
1976-02-06,1975,"RC Strasbourg","Olympique Lyon","5-0",5,0,"1",1,5,5,"H"
1976-02-07,1975,"FC Sochaux","Nimes Olympique","2-1",2,1,"1",1,3,1,"H"
1976-02-07,1975,"FC Metz","Paris Saint-Germain","1-2",1,2,"1",1,3,-1,"D"
1976-02-07,1975,"FC Nantes","AS Nancy","3-0",3,0,"1",1,3,3,"H"
1976-02-07,1975,"RC Lens","Lille OSC","2-0",2,0,"1",1,2,2,"H"
1976-02-08,1975,"AS Saint-Etienne","Olympique Marseille","1-0",1,0,"1",1,1,1,"H"
1976-02-08,1975,"Stade Reims","OGC Nice","1-0",1,0,"1",1,1,1,"H"
1976-02-08,1975,"Association Sportive Avignonaise","Girondins Bordeaux","3-4",3,4,"1",1,7,-1,"D"
1976-02-08,1975,"SC Bastia","US Valenciennes-Anzin","1-1",1,1,"1",1,2,0,"D"
1976-02-08,1975,"AS Monaco","Troyes AF","1-1",1,1,"1",1,2,0,"D"
1976-02-14,1975,"FC Nantes","RC Strasbourg","2-1",2,1,"1",1,3,1,"H"
1976-02-14,1975,"US Valenciennes-Anzin","AS Monaco","5-1",5,1,"1",1,6,4,"H"
1976-02-14,1975,"Troyes AF","SC Bastia","0-2",0,2,"1",1,2,-2,"D"
1976-02-15,1975,"Paris Saint-Germain","AS Saint-Etienne","2-1",2,1,"1",1,3,1,"H"
1976-02-15,1975,"OGC Nice","FC Metz","4-2",4,2,"1",1,6,2,"H"
1976-02-15,1975,"Olympique Lyon","FC Sochaux","1-2",1,2,"1",1,3,-1,"D"
1976-02-15,1975,"AS Nancy","Olympique Marseille","4-2",4,2,"1",1,6,2,"H"
1976-02-15,1975,"Girondins Bordeaux","Stade Reims","2-3",2,3,"1",1,5,-1,"D"
1976-02-15,1975,"Nimes Olympique","RC Lens","2-2",2,2,"1",1,4,0,"D"
1976-02-15,1975,"Lille OSC","Association Sportive Avignonaise","4-0",4,0,"1",1,4,4,"H"
1976-02-21,1975,"FC Sochaux","US Valenciennes-Anzin","3-0",3,0,"1",1,3,3,"H"
1976-02-21,1975,"RC Lens","OGC Nice","2-1",2,1,"1",1,3,1,"H"
1976-02-21,1975,"Stade Reims","Nimes Olympique","2-0",2,0,"1",1,2,2,"H"
1976-02-21,1975,"SC Bastia","FC Nantes","0-1",0,1,"1",1,1,-1,"D"
1976-02-21,1975,"FC Metz","Girondins Bordeaux","2-1",2,1,"1",1,3,1,"H"
1976-02-21,1975,"RC Strasbourg","AS Nancy","1-5",1,5,"1",1,6,-4,"D"
1976-02-21,1975,"Association Sportive Avignonaise","Troyes AF","0-1",0,1,"1",1,1,-1,"D"
1976-02-22,1975,"AS Saint-Etienne","Lille OSC","3-1",3,1,"1",1,4,2,"H"
1976-02-22,1975,"Olympique Marseille","Paris Saint-Germain","2-1",2,1,"1",1,3,1,"H"
1976-02-22,1975,"AS Monaco","Olympique Lyon","1-0",1,0,"1",1,1,1,"H"
1976-03-11,1975,"OGC Nice","AS Saint-Etienne","1-1",1,1,"1",1,2,0,"D"
1976-03-12,1975,"RC Strasbourg","FC Sochaux","0-0",0,0,"1",1,0,0,"D"
1976-03-12,1975,"FC Nantes","AS Monaco","3-1",3,1,"1",1,4,2,"H"
1976-03-12,1975,"Olympique Lyon","Stade Reims","1-2",1,2,"1",1,3,-1,"D"
1976-03-12,1975,"Troyes AF","Olympique Marseille","2-2",2,2,"1",1,4,0,"D"
1976-03-12,1975,"Nimes Olympique","FC Metz","3-2",3,2,"1",1,5,1,"H"
1976-03-12,1975,"Lille OSC","Paris Saint-Germain","2-1",2,1,"1",1,3,1,"H"
1976-03-12,1975,"Girondins Bordeaux","RC Lens","2-2",2,2,"1",1,4,0,"D"
1976-03-12,1975,"AS Nancy","SC Bastia","0-1",0,1,"1",1,1,-1,"D"
1976-03-12,1975,"US Valenciennes-Anzin","Association Sportive Avignonaise","2-0",2,0,"1",1,2,2,"H"
1976-03-16,1975,"Olympique Marseille","Lille OSC","2-0",2,0,"1",1,2,2,"H"
1976-03-16,1975,"FC Sochaux","FC Nantes","1-1",1,1,"1",1,2,0,"D"
1976-03-16,1975,"Stade Reims","Troyes AF","1-1",1,1,"1",1,2,0,"D"
1976-03-16,1975,"Paris Saint-Germain","OGC Nice","0-0",0,0,"1",1,0,0,"D"
1976-03-16,1975,"FC Metz","AS Nancy","4-1",4,1,"1",1,5,3,"H"
1976-03-16,1975,"RC Lens","US Valenciennes-Anzin","0-1",0,1,"1",1,1,-1,"D"
1976-03-16,1975,"Association Sportive Avignonaise","Olympique Lyon","2-1",2,1,"1",1,3,1,"H"
1976-03-20,1975,"FC Nantes","AS Saint-Etienne","3-0",3,0,"1",1,3,3,"H"
1976-03-20,1975,"FC Sochaux","AS Monaco","4-0",4,0,"1",1,4,4,"H"
1976-03-20,1975,"OGC Nice","Olympique Marseille","2-1",2,1,"1",1,3,1,"H"
1976-03-20,1975,"AS Nancy","Stade Reims","3-1",3,1,"1",1,4,2,"H"
1976-03-20,1975,"US Valenciennes-Anzin","FC Metz","3-0",3,0,"1",1,3,3,"H"
1976-03-20,1975,"Nimes Olympique","Association Sportive Avignonaise","1-0",1,0,"1",1,1,1,"H"
1976-03-20,1975,"Girondins Bordeaux","Paris Saint-Germain","2-1",2,1,"1",1,3,1,"H"
1976-03-20,1975,"RC Strasbourg","SC Bastia","1-3",1,3,"1",1,4,-2,"D"
1976-03-20,1975,"Olympique Lyon","Lille OSC","3-0",3,0,"1",1,3,3,"H"
1976-03-20,1975,"Troyes AF","RC Lens","1-1",1,1,"1",1,2,0,"D"
1976-03-30,1975,"Association Sportive Avignonaise","FC Nantes","0-2",0,2,"1",1,2,-2,"D"
1976-03-30,1975,"Lille OSC","OGC Nice","0-3",0,3,"1",1,3,-3,"D"
1976-03-30,1975,"SC Bastia","FC Sochaux","1-1",1,1,"1",1,2,0,"D"
1976-03-30,1975,"Olympique Marseille","Girondins Bordeaux","1-0",1,0,"1",1,1,1,"H"
1976-03-30,1975,"Stade Reims","US Valenciennes-Anzin","5-1",5,1,"1",1,6,4,"H"
1976-03-30,1975,"FC Metz","Troyes AF","0-1",0,1,"1",1,1,-1,"D"
1976-03-30,1975,"Paris Saint-Germain","Nimes Olympique","2-0",2,0,"1",1,2,2,"H"
1976-03-30,1975,"AS Monaco","AS Nancy","1-0",1,0,"1",1,1,1,"H"
1976-03-30,1975,"RC Lens","RC Strasbourg","1-1",1,1,"1",1,2,0,"D"
1976-04-02,1975,"FC Nantes","FC Metz","2-0",2,0,"1",1,2,2,"H"
1976-04-02,1975,"FC Sochaux","Association Sportive Avignonaise","1-1",1,1,"1",1,2,0,"D"
1976-04-02,1975,"Nimes Olympique","Olympique Marseille","0-1",0,1,"1",1,1,-1,"D"
1976-04-02,1975,"Girondins Bordeaux","OGC Nice","1-0",1,0,"1",1,1,1,"H"
1976-04-02,1975,"RC Strasbourg","Stade Reims","1-1",1,1,"1",1,2,0,"D"
1976-04-02,1975,"AS Nancy","Lille OSC","5-0",5,0,"1",1,5,5,"H"
1976-04-02,1975,"Troyes AF","Paris Saint-Germain","1-1",1,1,"1",1,2,0,"D"
1976-04-02,1975,"AS Monaco","SC Bastia","2-0",2,0,"1",1,2,2,"H"
1976-04-02,1975,"Olympique Lyon","RC Lens","4-1",4,1,"1",1,5,3,"H"
1976-04-07,1975,"AS Saint-Etienne","Troyes AF","3-0",3,0,"1",1,3,3,"H"
1976-04-09,1975,"AS Monaco","RC Strasbourg","1-2",1,2,"1",1,3,-1,"D"
1976-04-15,1975,"Olympique Marseille","US Valenciennes-Anzin","3-0",3,0,"1",1,3,3,"H"
1976-04-15,1975,"Stade Reims","FC Nantes","1-0",1,0,"1",1,1,1,"H"
1976-04-15,1975,"OGC Nice","Nimes Olympique","4-0",4,0,"1",1,4,4,"H"
1976-04-15,1975,"RC Lens","FC Sochaux","1-1",1,1,"1",1,2,0,"D"
1976-04-15,1975,"Paris Saint-Germain","AS Nancy","1-4",1,4,"1",1,5,-3,"D"
1976-04-15,1975,"FC Metz","RC Strasbourg","5-0",5,0,"1",1,5,5,"H"
1976-04-15,1975,"SC Bastia","Olympique Lyon","4-1",4,1,"1",1,5,3,"H"
1976-04-15,1975,"Association Sportive Avignonaise","AS Monaco","1-1",1,1,"1",1,2,0,"D"
1976-04-16,1975,"Lille OSC","Girondins Bordeaux","3-2",3,2,"1",1,5,1,"H"
1976-04-30,1975,"RC Strasbourg","AS Saint-Etienne","0-2",0,2,"1",1,2,-2,"D"
1976-04-30,1975,"FC Sochaux","FC Metz","3-2",3,2,"1",1,5,1,"H"
1976-04-30,1975,"Olympique Lyon","Olympique Marseille","2-1",2,1,"1",1,3,1,"H"
1976-04-30,1975,"AS Nancy","OGC Nice","2-0",2,0,"1",1,2,2,"H"
1976-04-30,1975,"AS Monaco","Stade Reims","1-0",1,0,"1",1,1,1,"H"
1976-04-30,1975,"SC Bastia","Association Sportive Avignonaise","2-0",2,0,"1",1,2,2,"H"
1976-04-30,1975,"Nimes Olympique","Lille OSC","5-1",5,1,"1",1,6,4,"H"
1976-04-30,1975,"Troyes AF","Girondins Bordeaux","2-0",2,0,"1",1,2,2,"H"
1976-04-30,1975,"US Valenciennes-Anzin","Paris Saint-Germain","2-2",2,2,"1",1,4,0,"D"
1976-05-01,1975,"FC Nantes","RC Lens","1-1",1,1,"1",1,2,0,"D"
1976-05-04,1975,"AS Saint-Etienne","Nimes Olympique","5-2",5,2,"1",1,7,3,"H"
1976-05-11,1975,"Olympique Marseille","FC Nantes","1-2",1,2,"1",1,3,-1,"D"
1976-05-11,1975,"Stade Reims","FC Sochaux","1-1",1,1,"1",1,2,0,"D"
1976-05-11,1975,"OGC Nice","Troyes AF","5-2",5,2,"1",1,7,3,"H"
1976-05-11,1975,"FC Metz","AS Monaco","4-1",4,1,"1",1,5,3,"H"
1976-05-11,1975,"RC Lens","SC Bastia","1-1",1,1,"1",1,2,0,"D"
1976-05-11,1975,"Girondins Bordeaux","Nimes Olympique","1-0",1,0,"1",1,1,1,"H"
1976-05-11,1975,"Paris Saint-Germain","Olympique Lyon","2-0",2,0,"1",1,2,2,"H"
1976-05-11,1975,"Lille OSC","US Valenciennes-Anzin","5-1",5,1,"1",1,6,4,"H"
1976-05-11,1975,"Association Sportive Avignonaise","RC Strasbourg","1-0",1,0,"1",1,1,1,"H"
1976-05-15,1975,"US Valenciennes-Anzin","OGC Nice","0-0",0,0,"1",1,0,0,"D"
1976-05-15,1975,"FC Nantes","Paris Saint-Germain","1-2",1,2,"1",1,3,-1,"D"
1976-05-15,1975,"RC Strasbourg","Olympique Marseille","2-0",2,0,"1",1,2,2,"H"
1976-05-15,1975,"Association Sportive Avignonaise","Stade Reims","1-0",1,0,"1",1,1,1,"H"
1976-05-15,1975,"AS Nancy","Girondins Bordeaux","3-2",3,2,"1",1,5,1,"H"
1976-05-15,1975,"SC Bastia","FC Metz","3-2",3,2,"1",1,5,1,"H"
1976-05-15,1975,"Olympique Lyon","Nimes Olympique","1-1",1,1,"1",1,2,0,"D"
1976-05-15,1975,"AS Monaco","RC Lens","1-1",1,1,"1",1,2,0,"D"
1976-05-15,1975,"Troyes AF","Lille OSC","1-0",1,0,"1",1,1,1,"H"
1976-05-16,1975,"FC Sochaux","AS Saint-Etienne","1-1",1,1,"1",1,2,0,"D"
1976-05-25,1975,"AS Saint-Etienne","AS Monaco","2-2",2,2,"1",1,4,0,"D"
1976-05-25,1975,"Olympique Marseille","FC Sochaux","0-3",0,3,"1",1,3,-3,"D"
1976-05-25,1975,"OGC Nice","Olympique Lyon","1-0",1,0,"1",1,1,1,"H"
1976-05-25,1975,"Lille OSC","FC Nantes","1-0",1,0,"1",1,1,1,"H"
1976-05-25,1975,"Stade Reims","SC Bastia","1-2",1,2,"1",1,3,-1,"D"
1976-05-25,1975,"RC Lens","AS Nancy","4-2",4,2,"1",1,6,2,"H"
1976-05-25,1975,"FC Metz","Association Sportive Avignonaise","1-0",1,0,"1",1,1,1,"H"
1976-05-25,1975,"Paris Saint-Germain","RC Strasbourg","0-0",0,0,"1",1,0,0,"D"
1976-05-25,1975,"Nimes Olympique","Troyes AF","1-1",1,1,"1",1,2,0,"D"
1976-05-25,1975,"Girondins Bordeaux","US Valenciennes-Anzin","0-1",0,1,"1",1,1,-1,"D"
1976-05-28,1975,"US Valenciennes-Anzin","AS Saint-Etienne","1-1",1,1,"1",1,2,0,"D"
1976-05-29,1975,"SC Bastia","Girondins Bordeaux","2-1",2,1,"1",1,3,1,"H"
1976-06-01,1975,"AS Saint-Etienne","Olympique Lyon","1-1",1,1,"1",1,2,0,"D"
1976-06-04,1975,"SC Bastia","AS Saint-Etienne","2-2",2,2,"1",1,4,0,"D"
1976-06-04,1975,"FC Nantes","OGC Nice","1-1",1,1,"1",1,2,0,"D"
1976-06-04,1975,"FC Sochaux","Paris Saint-Germain","1-4",1,4,"1",1,5,-3,"D"
1976-06-04,1975,"Stade Reims","FC Metz","3-2",3,2,"1",1,5,1,"H"
1976-06-04,1975,"AS Monaco","Olympique Marseille","2-1",2,1,"1",1,3,1,"H"
1976-06-04,1975,"AS Nancy","Troyes AF","0-0",0,0,"1",1,0,0,"D"
1976-06-04,1975,"US Valenciennes-Anzin","Nimes Olympique","0-3",0,3,"1",1,3,-3,"D"
1976-06-04,1975,"Olympique Lyon","Girondins Bordeaux","1-2",1,2,"1",1,3,-1,"D"
1976-06-04,1975,"Association Sportive Avignonaise","RC Lens","0-0",0,0,"1",1,0,0,"D"
1976-06-04,1975,"RC Strasbourg","Lille OSC","3-0",3,0,"1",1,3,3,"H"
1976-06-08,1975,"AS Saint-Etienne","AS Nancy","3-0",3,0,"1",1,3,3,"H"
1976-06-16,1975,"AS Saint-Etienne","Association Sportive Avignonaise","4-0",4,0,"1",1,4,4,"H"
1976-06-16,1975,"OGC Nice","RC Strasbourg","1-0",1,0,"1",1,1,1,"H"
1976-06-16,1975,"Lille OSC","FC Sochaux","1-1",1,1,"1",1,2,0,"D"
1976-06-16,1975,"Girondins Bordeaux","FC Nantes","2-1",2,1,"1",1,3,1,"H"
1976-06-16,1975,"Olympique Marseille","SC Bastia","4-3",4,3,"1",1,7,1,"H"
1976-06-16,1975,"RC Lens","Stade Reims","1-0",1,0,"1",1,1,1,"H"
1976-06-16,1975,"Nimes Olympique","AS Nancy","2-2",2,2,"1",1,4,0,"D"
1976-06-16,1975,"FC Metz","Olympique Lyon","3-1",3,1,"1",1,4,2,"H"
1976-06-16,1975,"Paris Saint-Germain","AS Monaco","1-2",1,2,"1",1,3,-1,"D"
1976-06-16,1975,"Troyes AF","US Valenciennes-Anzin","4-0",4,0,"1",1,4,4,"H"
1976-06-19,1975,"Stade Reims","AS Saint-Etienne","3-2",3,2,"1",1,5,1,"H"
1976-06-19,1975,"FC Sochaux","OGC Nice","0-0",0,0,"1",1,0,0,"D"
1976-06-19,1975,"FC Nantes","Nimes Olympique","1-0",1,0,"1",1,1,1,"H"
1976-06-19,1975,"Paris Saint-Germain","SC Bastia","1-1",1,1,"1",1,2,0,"D"
1976-06-19,1975,"Association Sportive Avignonaise","Olympique Marseille","2-1",2,1,"1",1,3,1,"H"
1976-06-19,1975,"FC Metz","RC Lens","2-1",2,1,"1",1,3,1,"H"
1976-06-19,1975,"RC Strasbourg","Girondins Bordeaux","0-2",0,2,"1",1,2,-2,"D"
1976-06-19,1975,"US Valenciennes-Anzin","AS Nancy","2-0",2,0,"1",1,2,2,"H"
1976-06-19,1975,"AS Monaco","Lille OSC","3-4",3,4,"1",1,7,-1,"D"
1976-06-19,1975,"Olympique Lyon","Troyes AF","2-0",2,0,"1",1,2,2,"H"
1976-08-06,1976,"US Valenciennes-Anzin","AS Saint-Etienne","1-1",1,1,"1",1,2,0,"D"
1976-08-06,1976,"Paris Saint-Germain","Olympique Lyon","2-4",2,4,"1",1,6,-2,"D"
1976-08-06,1976,"Angers SCO","AS Nancy","3-1",3,1,"1",1,4,2,"H"
1976-08-06,1976,"SC Bastia","Stade Laval","3-1",3,1,"1",1,4,2,"H"
1976-08-06,1976,"FC Sochaux","OGC Nice","1-2",1,2,"1",1,3,-1,"D"
1976-08-06,1976,"FC Metz","FC Nantes","1-2",1,2,"1",1,3,-1,"D"
1976-08-06,1976,"Lille OSC","Stade Reims","2-1",2,1,"1",1,3,1,"H"
1976-08-06,1976,"Stade Rennes","Nimes Olympique","0-1",0,1,"1",1,1,-1,"D"
1976-08-06,1976,"Troyes AF","Girondins Bordeaux","0-1",0,1,"1",1,1,-1,"D"
1976-08-06,1976,"Olympique Marseille","RC Lens","2-2",2,2,"1",1,4,0,"D"
1976-08-13,1976,"FC Nantes","Olympique Marseille","3-0",3,0,"1",1,3,3,"H"
1976-08-13,1976,"Nimes Olympique","Angers SCO","3-1",3,1,"1",1,4,2,"H"
1976-08-13,1976,"OGC Nice","Paris Saint-Germain","1-0",1,0,"1",1,1,1,"H"
1976-08-13,1976,"Girondins Bordeaux","Lille OSC","2-1",2,1,"1",1,3,1,"H"
1976-08-13,1976,"AS Nancy","Olympique Lyon","0-0",0,0,"1",1,0,0,"D"
1976-08-13,1976,"RC Lens","SC Bastia","4-3",4,3,"1",1,7,1,"H"
1976-08-13,1976,"Stade Reims","Stade Rennes","3-0",3,0,"1",1,3,3,"H"
1976-08-13,1976,"Stade Laval","FC Sochaux","0-2",0,2,"1",1,2,-2,"D"
1976-08-13,1976,"US Valenciennes-Anzin","Troyes AF","1-2",1,2,"1",1,3,-1,"D"
1976-08-13,1976,"AS Saint-Etienne","FC Metz","0-0",0,0,"1",1,0,0,"D"
1976-08-18,1976,"Lille OSC","OGC Nice","0-2",0,2,"1",1,2,-2,"D"
1976-08-18,1976,"Olympique Lyon","Nimes Olympique","4-0",4,0,"1",1,4,4,"H"
1976-08-18,1976,"SC Bastia","FC Nantes","3-0",3,0,"1",1,3,3,"H"
1976-08-18,1976,"Angers SCO","Stade Reims","1-2",1,2,"1",1,3,-1,"D"
1976-08-18,1976,"FC Sochaux","Girondins Bordeaux","1-0",1,0,"1",1,1,1,"H"
1976-08-18,1976,"Troyes AF","Stade Laval","2-1",2,1,"1",1,3,1,"H"
1976-08-18,1976,"Stade Rennes","RC Lens","2-1",2,1,"1",1,3,1,"H"
1976-08-18,1976,"Olympique Marseille","AS Saint-Etienne","1-0",1,0,"1",1,1,1,"H"
1976-08-18,1976,"Paris Saint-Germain","AS Nancy","2-0",2,0,"1",1,2,2,"H"
1976-08-18,1976,"FC Metz","US Valenciennes-Anzin","2-2",2,2,"1",1,4,0,"D"
1976-08-27,1976,"OGC Nice","Angers SCO","4-1",4,1,"1",1,5,3,"H"
1976-08-27,1976,"Stade Reims","Olympique Lyon","1-1",1,1,"1",1,2,0,"D"
1976-08-27,1976,"FC Nantes","Troyes AF","2-1",2,1,"1",1,3,1,"H"
1976-08-27,1976,"Girondins Bordeaux","Stade Rennes","2-1",2,1,"1",1,3,1,"H"
1976-08-27,1976,"SC Bastia","AS Saint-Etienne","1-1",1,1,"1",1,2,0,"D"
1976-08-27,1976,"RC Lens","FC Sochaux","2-1",2,1,"1",1,3,1,"H"
1976-08-27,1976,"Nimes Olympique","AS Nancy","2-2",2,2,"1",1,4,0,"D"
1976-08-27,1976,"US Valenciennes-Anzin","Olympique Marseille","3-1",3,1,"1",1,4,2,"H"
1976-08-27,1976,"FC Metz","Lille OSC","3-1",3,1,"1",1,4,2,"H"
1976-08-27,1976,"Stade Laval","Paris Saint-Germain","2-1",2,1,"1",1,3,1,"H"
1976-09-07,1976,"Stade Rennes","OGC Nice","0-0",0,0,"1",1,0,0,"D"
1976-09-07,1976,"FC Sochaux","FC Nantes","2-6",2,6,"1",1,8,-4,"D"
1976-09-07,1976,"SC Bastia","US Valenciennes-Anzin","4-0",4,0,"1",1,4,4,"H"
1976-09-07,1976,"Olympique Lyon","RC Lens","3-3",3,3,"1",1,6,0,"D"
1976-09-07,1976,"Nimes Olympique","Paris Saint-Germain","3-0",3,0,"1",1,3,3,"H"
1976-09-07,1976,"Angers SCO","Girondins Bordeaux","0-0",0,0,"1",1,0,0,"D"
1976-09-07,1976,"AS Nancy","Stade Reims","4-2",4,2,"1",1,6,2,"H"
1976-09-07,1976,"Troyes AF","AS Saint-Etienne","0-0",0,0,"1",1,0,0,"D"
1976-09-07,1976,"Olympique Marseille","FC Metz","3-1",3,1,"1",1,4,2,"H"
1976-09-07,1976,"Lille OSC","Stade Laval","3-3",3,3,"1",1,6,0,"D"
1976-09-10,1976,"OGC Nice","AS Nancy","2-0",2,0,"1",1,2,2,"H"
1976-09-10,1976,"FC Nantes","Angers SCO","3-0",3,0,"1",1,3,3,"H"
1976-09-10,1976,"Girondins Bordeaux","Olympique Lyon","1-2",1,2,"1",1,3,-1,"D"
1976-09-10,1976,"Paris Saint-Germain","SC Bastia","2-2",2,2,"1",1,4,0,"D"
1976-09-10,1976,"RC Lens","Lille OSC","4-2",4,2,"1",1,6,2,"H"
1976-09-10,1976,"Stade Reims","Nimes Olympique","2-0",2,0,"1",1,2,2,"H"
1976-09-10,1976,"AS Saint-Etienne","FC Sochaux","2-0",2,0,"1",1,2,2,"H"
1976-09-10,1976,"FC Metz","Troyes AF","2-1",2,1,"1",1,3,1,"H"
1976-09-10,1976,"US Valenciennes-Anzin","Stade Rennes","2-0",2,0,"1",1,2,2,"H"
1976-09-10,1976,"Stade Laval","Olympique Marseille","2-1",2,1,"1",1,3,1,"H"
1976-09-18,1976,"Olympique Lyon","OGC Nice","4-1",4,1,"1",1,5,3,"H"
1976-09-18,1976,"SC Bastia","FC Metz","2-0",2,0,"1",1,2,2,"H"
1976-09-18,1976,"Stade Rennes","FC Nantes","2-1",2,1,"1",1,3,1,"H"
1976-09-18,1976,"Nimes Olympique","RC Lens","0-2",0,2,"1",1,2,-2,"D"
1976-09-18,1976,"Paris Saint-Germain","Stade Reims","2-1",2,1,"1",1,3,1,"H"
1976-09-18,1976,"AS Nancy","Girondins Bordeaux","7-3",7,3,"1",1,10,4,"H"
1976-09-18,1976,"Lille OSC","AS Saint-Etienne","1-0",1,0,"1",1,1,1,"H"
1976-09-18,1976,"Troyes AF","Olympique Marseille","0-0",0,0,"1",1,0,0,"D"
1976-09-18,1976,"FC Sochaux","US Valenciennes-Anzin","2-1",2,1,"1",1,3,1,"H"
1976-09-18,1976,"Angers SCO","Stade Laval","1-1",1,1,"1",1,2,0,"D"
1976-09-24,1976,"FC Nantes","AS Nancy","3-1",3,1,"1",1,4,2,"H"
1976-09-24,1976,"Stade Laval","Olympique Lyon","3-0",3,0,"1",1,3,3,"H"
1976-09-24,1976,"RC Lens","Paris Saint-Germain","3-3",3,3,"1",1,6,0,"D"
1976-09-24,1976,"OGC Nice","Stade Reims","2-3",2,3,"1",1,5,-1,"D"
1976-09-24,1976,"Olympique Marseille","SC Bastia","4-1",4,1,"1",1,5,3,"H"
1976-09-24,1976,"AS Saint-Etienne","Stade Rennes","4-0",4,0,"1",1,4,4,"H"
1976-09-24,1976,"FC Metz","FC Sochaux","2-0",2,0,"1",1,2,2,"H"
1976-09-24,1976,"US Valenciennes-Anzin","Lille OSC","1-0",1,0,"1",1,1,1,"H"
1976-09-24,1976,"Girondins Bordeaux","Nimes Olympique","0-0",0,0,"1",1,0,0,"D"
1976-09-24,1976,"Troyes AF","Angers SCO","1-1",1,1,"1",1,2,0,"D"
1976-10-02,1976,"Lille OSC","FC Nantes","1-3",1,3,"1",1,4,-2,"D"
1976-10-02,1976,"Olympique Lyon","US Valenciennes-Anzin","2-0",2,0,"1",1,2,2,"H"
1976-10-02,1976,"SC Bastia","Troyes AF","3-0",3,0,"1",1,3,3,"H"
1976-10-02,1976,"Angers SCO","RC Lens","3-2",3,2,"1",1,5,1,"H"
1976-10-02,1976,"Stade Reims","Girondins Bordeaux","2-1",2,1,"1",1,3,1,"H"
1976-10-02,1976,"Stade Rennes","Stade Laval","1-3",1,3,"1",1,4,-2,"D"
1976-10-02,1976,"FC Sochaux","Olympique Marseille","1-2",1,2,"1",1,3,-1,"D"
1976-10-02,1976,"Paris Saint-Germain","AS Saint-Etienne","2-0",2,0,"1",1,2,2,"H"
1976-10-02,1976,"AS Nancy","FC Metz","4-1",4,1,"1",1,5,3,"H"
1976-10-15,1976,"FC Nantes","Paris Saint-Germain","3-3",3,3,"1",1,6,0,"D"
1976-10-15,1976,"SC Bastia","AS Nancy","3-2",3,2,"1",1,5,1,"H"
1976-10-15,1976,"AS Saint-Etienne","Olympique Lyon","1-1",1,1,"1",1,2,0,"D"
1976-10-15,1976,"RC Lens","Stade Reims","2-2",2,2,"1",1,4,0,"D"
1976-10-15,1976,"Olympique Marseille","Lille OSC","3-2",3,2,"1",1,5,1,"H"
1976-10-15,1976,"Girondins Bordeaux","OGC Nice","3-1",3,1,"1",1,4,2,"H"
1976-10-15,1976,"Stade Laval","Nimes Olympique","0-1",0,1,"1",1,1,-1,"D"
1976-10-15,1976,"FC Metz","Stade Rennes","1-0",1,0,"1",1,1,1,"H"
1976-10-15,1976,"Troyes AF","FC Sochaux","1-0",1,0,"1",1,1,1,"H"
1976-10-15,1976,"US Valenciennes-Anzin","Angers SCO","0-2",0,2,"1",1,2,-2,"D"
1976-10-19,1976,"Nimes Olympique","OGC Nice","3-2",3,2,"1",1,5,1,"H"
1976-10-23,1976,"Olympique Lyon","FC Nantes","2-0",2,0,"1",1,2,2,"H"
1976-10-23,1976,"FC Sochaux","SC Bastia","2-0",2,0,"1",1,2,2,"H"
1976-10-23,1976,"OGC Nice","RC Lens","1-0",1,0,"1",1,1,1,"H"
1976-10-23,1976,"Nimes Olympique","US Valenciennes-Anzin","2-2",2,2,"1",1,4,0,"D"
1976-10-23,1976,"Stade Reims","FC Metz","0-2",0,2,"1",1,2,-2,"D"
1976-10-23,1976,"Stade Rennes","Olympique Marseille","2-1",2,1,"1",1,3,1,"H"
1976-10-23,1976,"Paris Saint-Germain","Girondins Bordeaux","2-1",2,1,"1",1,3,1,"H"
1976-10-23,1976,"Angers SCO","AS Saint-Etienne","4-2",4,2,"1",1,6,2,"H"
1976-10-23,1976,"AS Nancy","Stade Laval","4-1",4,1,"1",1,5,3,"H"
1976-10-23,1976,"Lille OSC","Troyes AF","3-1",3,1,"1",1,4,2,"H"
1976-10-29,1976,"SC Bastia","Angers SCO","5-1",5,1,"1",1,6,4,"H"
1976-10-29,1976,"FC Nantes","Stade Reims","1-1",1,1,"1",1,2,0,"D"
1976-10-29,1976,"FC Metz","Olympique Lyon","2-0",2,0,"1",1,2,2,"H"
1976-10-29,1976,"RC Lens","Girondins Bordeaux","3-3",3,3,"1",1,6,0,"D"
1976-10-29,1976,"Stade Laval","OGC Nice","1-0",1,0,"1",1,1,1,"H"
1976-10-29,1976,"US Valenciennes-Anzin","AS Nancy","1-1",1,1,"1",1,2,0,"D"
1976-10-29,1976,"Troyes AF","Stade Rennes","2-1",2,1,"1",1,3,1,"H"
1976-10-29,1976,"FC Sochaux","Lille OSC","4-2",4,2,"1",1,6,2,"H"
1976-11-06,1976,"Lille OSC","SC Bastia","0-3",0,3,"1",1,3,-3,"D"
1976-11-06,1976,"Olympique Lyon","Olympique Marseille","2-1",2,1,"1",1,3,1,"H"
1976-11-06,1976,"Nimes Olympique","FC Nantes","0-0",0,0,"1",1,0,0,"D"
1976-11-06,1976,"Angers SCO","FC Metz","0-2",0,2,"1",1,2,-2,"D"
1976-11-06,1976,"OGC Nice","US Valenciennes-Anzin","2-1",2,1,"1",1,3,1,"H"
1976-11-06,1976,"AS Nancy","RC Lens","1-1",1,1,"1",1,2,0,"D"
1976-11-06,1976,"Stade Reims","AS Saint-Etienne","2-2",2,2,"1",1,4,0,"D"
1976-11-06,1976,"Girondins Bordeaux","Stade Laval","0-1",0,1,"1",1,1,-1,"D"
1976-11-06,1976,"Paris Saint-Germain","Troyes AF","2-1",2,1,"1",1,3,1,"H"
1976-11-06,1976,"Stade Rennes","FC Sochaux","2-2",2,2,"1",1,4,0,"D"
1976-11-10,1976,"SC Bastia","Stade Rennes","3-1",3,1,"1",1,4,2,"H"
1976-11-10,1976,"Troyes AF","Olympique Lyon","0-3",0,3,"1",1,3,-3,"D"
1976-11-10,1976,"FC Nantes","Girondins Bordeaux","2-0",2,0,"1",1,2,2,"H"
1976-11-10,1976,"FC Metz","Nimes Olympique","2-0",2,0,"1",1,2,2,"H"
1976-11-10,1976,"Stade Laval","RC Lens","1-3",1,3,"1",1,4,-2,"D"
1976-11-10,1976,"AS Saint-Etienne","OGC Nice","2-0",2,0,"1",1,2,2,"H"
1976-11-10,1976,"US Valenciennes-Anzin","Stade Reims","5-0",5,0,"1",1,5,5,"H"
1976-11-10,1976,"Lille OSC","Angers SCO","0-1",0,1,"1",1,1,-1,"D"
1976-11-20,1976,"Olympique Lyon","SC Bastia","1-1",1,1,"1",1,2,0,"D"
1976-11-20,1976,"OGC Nice","FC Nantes","1-2",1,2,"1",1,3,-1,"D"
1976-11-20,1976,"RC Lens","US Valenciennes-Anzin","1-0",1,0,"1",1,1,1,"H"
1976-11-20,1976,"Paris Saint-Germain","FC Metz","3-1",3,1,"1",1,4,2,"H"
1976-11-20,1976,"Stade Reims","Stade Laval","1-0",1,0,"1",1,1,1,"H"
1976-11-20,1976,"AS Nancy","Troyes AF","2-0",2,0,"1",1,2,2,"H"
1976-11-20,1976,"Nimes Olympique","Olympique Marseille","2-3",2,3,"1",1,5,-1,"D"
1976-11-20,1976,"Angers SCO","FC Sochaux","1-1",1,1,"1",1,2,0,"D"
1976-11-20,1976,"Girondins Bordeaux","AS Saint-Etienne","2-0",2,0,"1",1,2,2,"H"
1976-11-20,1976,"Stade Rennes","Lille OSC","3-1",3,1,"1",1,4,2,"H"
1976-11-24,1976,"Olympique Marseille","Paris Saint-Germain","2-1",2,1,"1",1,3,1,"H"
1976-11-27,1976,"SC Bastia","Stade Reims","3-2",3,2,"1",1,5,1,"H"
1976-11-27,1976,"FC Nantes","Stade Laval","4-0",4,0,"1",1,4,4,"H"
1976-11-27,1976,"FC Sochaux","Olympique Lyon","2-1",2,1,"1",1,3,1,"H"
1976-11-27,1976,"FC Metz","OGC Nice","2-2",2,2,"1",1,4,0,"D"
1976-11-27,1976,"AS Saint-Etienne","RC Lens","3-0",3,0,"1",1,3,3,"H"
1976-11-27,1976,"Stade Rennes","AS Nancy","0-3",0,3,"1",1,3,-3,"D"
1976-11-27,1976,"Lille OSC","Paris Saint-Germain","2-0",2,0,"1",1,2,2,"H"
1976-11-27,1976,"US Valenciennes-Anzin","Girondins Bordeaux","3-2",3,2,"1",1,5,1,"H"
1976-11-27,1976,"Troyes AF","Nimes Olympique","3-1",3,1,"1",1,4,2,"H"
1976-11-28,1976,"Olympique Marseille","Angers SCO","2-1",2,1,"1",1,3,1,"H"
1976-12-04,1976,"RC Lens","FC Nantes","1-1",1,1,"1",1,2,0,"D"
1976-12-04,1976,"Olympique Lyon","Lille OSC","1-0",1,0,"1",1,1,1,"H"
1976-12-04,1976,"AS Nancy","FC Sochaux","3-0",3,0,"1",1,3,3,"H"
1976-12-04,1976,"Stade Reims","Olympique Marseille","1-0",1,0,"1",1,1,1,"H"
1976-12-04,1976,"Paris Saint-Germain","US Valenciennes-Anzin","1-2",1,2,"1",1,3,-1,"D"
1976-12-04,1976,"Stade Laval","AS Saint-Etienne","3-1",3,1,"1",1,4,2,"H"
1976-12-04,1976,"Angers SCO","Stade Rennes","1-0",1,0,"1",1,1,1,"H"
1976-12-05,1976,"Nimes Olympique","SC Bastia","3-1",3,1,"1",1,4,2,"H"
1976-12-05,1976,"Girondins Bordeaux","FC Metz","3-3",3,3,"1",1,6,0,"D"
1976-12-05,1976,"OGC Nice","Troyes AF","2-0",2,0,"1",1,2,2,"H"
1976-12-08,1976,"AS Saint-Etienne","Nimes Olympique","2-0",2,0,"1",1,2,2,"H"
1976-12-11,1976,"SC Bastia","Girondins Bordeaux","4-1",4,1,"1",1,5,3,"H"
1976-12-11,1976,"Stade Rennes","Olympique Lyon","2-2",2,2,"1",1,4,0,"D"
1976-12-11,1976,"FC Metz","RC Lens","0-1",0,1,"1",1,1,-1,"D"
1976-12-11,1976,"Lille OSC","AS Nancy","1-1",1,1,"1",1,2,0,"D"
1976-12-11,1976,"US Valenciennes-Anzin","Stade Laval","1-2",1,2,"1",1,3,-1,"D"
1976-12-11,1976,"Troyes AF","Stade Reims","4-1",4,1,"1",1,5,3,"H"
1976-12-11,1976,"Angers SCO","Paris Saint-Germain","0-2",0,2,"1",1,2,-2,"D"
1976-12-11,1976,"FC Sochaux","Nimes Olympique","2-1",2,1,"1",1,3,1,"H"
1976-12-12,1976,"Olympique Marseille","OGC Nice","0-1",0,1,"1",1,1,-1,"D"
1976-12-12,1976,"AS Saint-Etienne","FC Nantes","2-0",2,0,"1",1,2,2,"H"
1976-12-15,1976,"Olympique Marseille","AS Nancy","2-4",2,4,"1",1,6,-2,"D"
1976-12-15,1976,"FC Sochaux","Paris Saint-Germain","1-1",1,1,"1",1,2,0,"D"
1976-12-18,1976,"FC Nantes","US Valenciennes-Anzin","3-1",3,1,"1",1,4,2,"H"
1976-12-18,1976,"OGC Nice","SC Bastia","5-0",5,0,"1",1,5,5,"H"
1976-12-18,1976,"Olympique Lyon","Angers SCO","1-1",1,1,"1",1,2,0,"D"
1976-12-18,1976,"RC Lens","Troyes AF","3-1",3,1,"1",1,4,2,"H"
1976-12-18,1976,"Stade Laval","FC Metz","1-1",1,1,"1",1,2,0,"D"
1976-12-19,1976,"AS Nancy","AS Saint-Etienne","2-0",2,0,"1",1,2,2,"H"
1976-12-19,1976,"Paris Saint-Germain","Stade Rennes","3-1",3,1,"1",1,4,2,"H"
1976-12-19,1976,"Stade Reims","FC Sochaux","1-1",1,1,"1",1,2,0,"D"
1976-12-19,1976,"Nimes Olympique","Lille OSC","1-0",1,0,"1",1,1,1,"H"
1976-12-19,1976,"Girondins Bordeaux","Olympique Marseille","5-0",5,0,"1",1,5,5,"H"
1977-01-08,1976,"SC Bastia","RC Lens","3-2",3,2,"1",1,5,1,"H"
1977-01-08,1976,"FC Metz","AS Saint-Etienne","0-0",0,0,"1",1,0,0,"D"
1977-01-08,1976,"FC Sochaux","Stade Laval","1-1",1,1,"1",1,2,0,"D"
1977-01-08,1976,"Stade Rennes","Stade Reims","2-2",2,2,"1",1,4,0,"D"
1977-01-08,1976,"Lille OSC","Girondins Bordeaux","2-2",2,2,"1",1,4,0,"D"
1977-01-09,1976,"Olympique Marseille","FC Nantes","1-1",1,1,"1",1,2,0,"D"
1977-01-09,1976,"Olympique Lyon","AS Nancy","2-1",2,1,"1",1,3,1,"H"
1977-01-09,1976,"Paris Saint-Germain","OGC Nice","3-0",3,0,"1",1,3,3,"H"
1977-01-09,1976,"Angers SCO","Nimes Olympique","0-0",0,0,"1",1,0,0,"D"
1977-01-09,1976,"Troyes AF","US Valenciennes-Anzin","2-1",2,1,"1",1,3,1,"H"
1977-01-15,1976,"FC Nantes","SC Bastia","3-1",3,1,"1",1,4,2,"H"
1977-01-15,1976,"RC Lens","Stade Rennes","3-1",3,1,"1",1,4,2,"H"
1977-01-15,1976,"US Valenciennes-Anzin","FC Metz","1-1",1,1,"1",1,2,0,"D"
1977-01-15,1976,"Stade Laval","Troyes AF","1-1",1,1,"1",1,2,0,"D"
1977-01-16,1976,"Nimes Olympique","Olympique Lyon","1-1",1,1,"1",1,2,0,"D"
1977-01-16,1976,"OGC Nice","Lille OSC","2-0",2,0,"1",1,2,2,"H"
1977-01-16,1976,"AS Nancy","Paris Saint-Germain","1-2",1,2,"1",1,3,-1,"D"
1977-01-16,1976,"Stade Reims","Angers SCO","2-1",2,1,"1",1,3,1,"H"
1977-01-16,1976,"Girondins Bordeaux","FC Sochaux","2-1",2,1,"1",1,3,1,"H"
1977-01-16,1976,"AS Saint-Etienne","Olympique Marseille","4-0",4,0,"1",1,4,4,"H"
1977-01-22,1976,"Troyes AF","FC Nantes","2-3",2,3,"1",1,5,-1,"D"
1977-01-22,1976,"FC Sochaux","RC Lens","1-5",1,5,"1",1,6,-4,"D"
1977-01-22,1976,"Angers SCO","OGC Nice","5-0",5,0,"1",1,5,5,"H"
1977-01-22,1976,"Lille OSC","FC Metz","2-0",2,0,"1",1,2,2,"H"
1977-01-23,1976,"Olympique Lyon","Stade Reims","2-1",2,1,"1",1,3,1,"H"
1977-01-23,1976,"AS Saint-Etienne","SC Bastia","2-1",2,1,"1",1,3,1,"H"
1977-01-23,1976,"Paris Saint-Germain","Stade Laval","5-0",5,0,"1",1,5,5,"H"
1977-01-23,1976,"AS Nancy","Nimes Olympique","3-1",3,1,"1",1,4,2,"H"
1977-01-23,1976,"Stade Rennes","Girondins Bordeaux","0-2",0,2,"1",1,2,-2,"D"
1977-01-23,1976,"Olympique Marseille","US Valenciennes-Anzin","1-1",1,1,"1",1,2,0,"D"
1977-01-29,1976,"FC Nantes","FC Sochaux","2-1",2,1,"1",1,3,1,"H"
1977-01-29,1976,"RC Lens","Olympique Lyon","2-0",2,0,"1",1,2,2,"H"
1977-01-29,1976,"US Valenciennes-Anzin","SC Bastia","1-2",1,2,"1",1,3,-1,"D"
1977-01-29,1976,"FC Metz","Olympique Marseille","3-0",3,0,"1",1,3,3,"H"
1977-01-29,1976,"Stade Laval","Lille OSC","1-0",1,0,"1",1,1,1,"H"
1977-01-30,1976,"Paris Saint-Germain","Nimes Olympique","0-0",0,0,"1",1,0,0,"D"
1977-01-30,1976,"Stade Reims","AS Nancy","3-3",3,3,"1",1,6,0,"D"
1977-01-30,1976,"OGC Nice","Stade Rennes","4-0",4,0,"1",1,4,4,"H"
1977-01-30,1976,"AS Saint-Etienne","Troyes AF","4-0",4,0,"1",1,4,4,"H"
1977-01-30,1976,"Girondins Bordeaux","Angers SCO","4-1",4,1,"1",1,5,3,"H"
1977-02-05,1976,"Angers SCO","FC Nantes","2-2",2,2,"1",1,4,0,"D"
1977-02-05,1976,"SC Bastia","Paris Saint-Germain","5-2",5,2,"1",1,7,3,"H"
1977-02-05,1976,"Lille OSC","RC Lens","0-1",0,1,"1",1,1,-1,"D"
1977-02-06,1976,"Olympique Lyon","Girondins Bordeaux","1-0",1,0,"1",1,1,1,"H"
1977-02-06,1976,"AS Nancy","OGC Nice","1-4",1,4,"1",1,5,-3,"D"
1977-02-06,1976,"FC Sochaux","AS Saint-Etienne","4-0",4,0,"1",1,4,4,"H"
1977-02-06,1976,"Troyes AF","FC Metz","3-2",3,2,"1",1,5,1,"H"
1977-02-06,1976,"Nimes Olympique","Stade Reims","1-1",1,1,"1",1,2,0,"D"
1977-02-06,1976,"Olympique Marseille","Stade Laval","2-1",2,1,"1",1,3,1,"H"
1977-02-06,1976,"Stade Rennes","US Valenciennes-Anzin","0-2",0,2,"1",1,2,-2,"D"
1977-02-18,1976,"FC Nantes","Stade Rennes","3-1",3,1,"1",1,4,2,"H"
1977-02-18,1976,"OGC Nice","Olympique Lyon","1-2",1,2,"1",1,3,-1,"D"
1977-02-18,1976,"RC Lens","Nimes Olympique","3-0",3,0,"1",1,3,3,"H"
1977-02-18,1976,"FC Metz","SC Bastia","1-1",1,1,"1",1,2,0,"D"
1977-02-18,1976,"Stade Reims","Paris Saint-Germain","2-3",2,3,"1",1,5,-1,"D"
1977-02-18,1976,"Girondins Bordeaux","AS Nancy","2-0",2,0,"1",1,2,2,"H"
1977-02-18,1976,"Stade Laval","Angers SCO","2-0",2,0,"1",1,2,2,"H"
1977-02-18,1976,"Olympique Marseille","Troyes AF","2-0",2,0,"1",1,2,2,"H"
1977-02-18,1976,"US Valenciennes-Anzin","FC Sochaux","0-0",0,0,"1",1,0,0,"D"
1977-02-19,1976,"AS Saint-Etienne","Lille OSC","2-0",2,0,"1",1,2,2,"H"
1977-02-25,1976,"SC Bastia","Olympique Marseille","4-0",4,0,"1",1,4,4,"H"
1977-02-26,1976,"AS Nancy","FC Nantes","3-0",3,0,"1",1,3,3,"H"
1977-02-26,1976,"Stade Reims","OGC Nice","0-1",0,1,"1",1,1,-1,"D"
1977-02-26,1976,"Stade Rennes","AS Saint-Etienne","0-1",0,1,"1",1,1,-1,"D"
1977-02-26,1976,"Lille OSC","US Valenciennes-Anzin","1-1",1,1,"1",1,2,0,"D"
1977-02-26,1976,"Angers SCO","Troyes AF","1-2",1,2,"1",1,3,-1,"D"
1977-02-27,1976,"Olympique Lyon","Stade Laval","2-0",2,0,"1",1,2,2,"H"
1977-02-27,1976,"Paris Saint-Germain","RC Lens","3-1",3,1,"1",1,4,2,"H"
1977-02-27,1976,"FC Sochaux","FC Metz","1-0",1,0,"1",1,1,1,"H"
1977-02-27,1976,"Nimes Olympique","Girondins Bordeaux","3-2",3,2,"1",1,5,1,"H"
1977-03-05,1976,"FC Nantes","Lille OSC","3-1",3,1,"1",1,4,2,"H"
1977-03-05,1976,"US Valenciennes-Anzin","Olympique Lyon","3-2",3,2,"1",1,5,1,"H"
1977-03-05,1976,"RC Lens","Angers SCO","2-0",2,0,"1",1,2,2,"H"
1977-03-05,1976,"Troyes AF","SC Bastia","1-0",1,0,"1",1,1,1,"H"
1977-03-05,1976,"OGC Nice","Nimes Olympique","1-0",1,0,"1",1,1,1,"H"
1977-03-05,1976,"AS Saint-Etienne","Paris Saint-Germain","1-0",1,0,"1",1,1,1,"H"
1977-03-05,1976,"FC Metz","AS Nancy","3-0",3,0,"1",1,3,3,"H"
1977-03-05,1976,"Girondins Bordeaux","Stade Reims","3-1",3,1,"1",1,4,2,"H"
1977-03-05,1976,"Stade Laval","Stade Rennes","0-0",0,0,"1",1,0,0,"D"
1977-03-05,1976,"Olympique Marseille","FC Sochaux","1-1",1,1,"1",1,2,0,"D"
1977-03-23,1976,"Paris Saint-Germain","FC Nantes","0-1",0,1,"1",1,1,-1,"D"
1977-03-23,1976,"Olympique Lyon","AS Saint-Etienne","0-2",0,2,"1",1,2,-2,"D"
1977-03-23,1976,"Stade Reims","RC Lens","2-0",2,0,"1",1,2,2,"H"
1977-03-23,1976,"AS Nancy","SC Bastia","4-1",4,1,"1",1,5,3,"H"
1977-03-23,1976,"OGC Nice","Girondins Bordeaux","2-1",2,1,"1",1,3,1,"H"
1977-03-23,1976,"Stade Rennes","FC Metz","2-3",2,3,"1",1,5,-1,"D"
1977-03-23,1976,"FC Sochaux","Troyes AF","2-0",2,0,"1",1,2,2,"H"
1977-03-23,1976,"Nimes Olympique","Stade Laval","4-2",4,2,"1",1,6,2,"H"
1977-03-23,1976,"Angers SCO","US Valenciennes-Anzin","0-0",0,0,"1",1,0,0,"D"
1977-03-23,1976,"Lille OSC","Olympique Marseille","2-0",2,0,"1",1,2,2,"H"
1977-04-02,1976,"FC Nantes","Olympique Lyon","3-0",3,0,"1",1,3,3,"H"
1977-04-02,1976,"SC Bastia","FC Sochaux","2-0",2,0,"1",1,2,2,"H"
1977-04-02,1976,"AS Saint-Etienne","Angers SCO","1-1",1,1,"1",1,2,0,"D"
1977-04-02,1976,"FC Metz","Stade Reims","2-0",2,0,"1",1,2,2,"H"
1977-04-02,1976,"Stade Laval","AS Nancy","1-1",1,1,"1",1,2,0,"D"
1977-04-02,1976,"Girondins Bordeaux","Paris Saint-Germain","5-2",5,2,"1",1,7,3,"H"
1977-04-02,1976,"US Valenciennes-Anzin","Nimes Olympique","2-0",2,0,"1",1,2,2,"H"
1977-04-02,1976,"Olympique Marseille","Stade Rennes","3-2",3,2,"1",1,5,1,"H"
1977-04-02,1976,"Troyes AF","Lille OSC","1-0",1,0,"1",1,1,1,"H"
1977-04-16,1976,"Stade Reims","FC Nantes","0-2",0,2,"1",1,2,-2,"D"
1977-04-16,1976,"Angers SCO","SC Bastia","0-3",0,3,"1",1,3,-3,"D"
1977-04-16,1976,"Olympique Lyon","FC Metz","1-0",1,0,"1",1,1,1,"H"
1977-04-16,1976,"OGC Nice","Stade Laval","2-1",2,1,"1",1,3,1,"H"
1977-04-16,1976,"Nimes Olympique","AS Saint-Etienne","1-1",1,1,"1",1,2,0,"D"
1977-04-16,1976,"Girondins Bordeaux","RC Lens","5-2",5,2,"1",1,7,3,"H"
1977-04-16,1976,"AS Nancy","US Valenciennes-Anzin","3-0",3,0,"1",1,3,3,"H"
1977-04-16,1976,"Paris Saint-Germain","Olympique Marseille","1-1",1,1,"1",1,2,0,"D"
1977-04-16,1976,"Lille OSC","FC Sochaux","1-1",1,1,"1",1,2,0,"D"
1977-04-16,1976,"Stade Rennes","Troyes AF","2-2",2,2,"1",1,4,0,"D"
1977-04-22,1976,"RC Lens","OGC Nice","1-1",1,1,"1",1,2,0,"D"
1977-04-28,1976,"FC Nantes","Nimes Olympique","1-0",1,0,"1",1,1,1,"H"
1977-04-28,1976,"SC Bastia","Lille OSC","1-1",1,1,"1",1,2,0,"D"
1977-04-28,1976,"US Valenciennes-Anzin","OGC Nice","1-1",1,1,"1",1,2,0,"D"
1977-04-28,1976,"Olympique Marseille","Olympique Lyon","3-1",3,1,"1",1,4,2,"H"
1977-04-28,1976,"RC Lens","AS Nancy","1-1",1,1,"1",1,2,0,"D"
1977-04-28,1976,"AS Saint-Etienne","Stade Reims","0-0",0,0,"1",1,0,0,"D"
1977-04-28,1976,"FC Metz","Angers SCO","4-2",4,2,"1",1,6,2,"H"
1977-04-28,1976,"Stade Laval","Girondins Bordeaux","0-0",0,0,"1",1,0,0,"D"
1977-04-28,1976,"Troyes AF","Paris Saint-Germain","2-1",2,1,"1",1,3,1,"H"
1977-04-28,1976,"FC Sochaux","Stade Rennes","2-1",2,1,"1",1,3,1,"H"
1977-05-03,1976,"Girondins Bordeaux","FC Nantes","1-2",1,2,"1",1,3,-1,"D"
1977-05-03,1976,"Stade Rennes","SC Bastia","1-1",1,1,"1",1,2,0,"D"
1977-05-03,1976,"OGC Nice","AS Saint-Etienne","2-0",2,0,"1",1,2,2,"H"
1977-05-03,1976,"RC Lens","Stade Laval","2-1",2,1,"1",1,3,1,"H"
1977-05-03,1976,"AS Nancy","Olympique Marseille","2-0",2,0,"1",1,2,2,"H"
1977-05-03,1976,"Paris Saint-Germain","FC Sochaux","1-0",1,0,"1",1,1,1,"H"
1977-05-03,1976,"Stade Reims","US Valenciennes-Anzin","3-0",3,0,"1",1,3,3,"H"
1977-05-03,1976,"Angers SCO","Lille OSC","3-0",3,0,"1",1,3,3,"H"
1977-05-07,1976,"FC Nantes","OGC Nice","6-1",6,1,"1",1,7,5,"H"
1977-05-07,1976,"SC Bastia","Olympique Lyon","3-0",3,0,"1",1,3,3,"H"
1977-05-07,1976,"US Valenciennes-Anzin","RC Lens","0-1",0,1,"1",1,1,-1,"D"
1977-05-07,1976,"Troyes AF","AS Nancy","0-1",0,1,"1",1,1,-1,"D"
1977-05-07,1976,"AS Saint-Etienne","Girondins Bordeaux","2-0",2,0,"1",1,2,2,"H"
1977-05-07,1976,"FC Metz","Paris Saint-Germain","3-1",3,1,"1",1,4,2,"H"
1977-05-07,1976,"Olympique Marseille","Nimes Olympique","1-0",1,0,"1",1,1,1,"H"
1977-05-07,1976,"FC Sochaux","Angers SCO","1-1",1,1,"1",1,2,0,"D"
1977-05-07,1976,"Stade Laval","Stade Reims","0-0",0,0,"1",1,0,0,"D"
1977-05-07,1976,"Lille OSC","Stade Rennes","2-2",2,2,"1",1,4,0,"D"
1977-05-13,1976,"Olympique Lyon","Troyes AF","0-0",0,0,"1",1,0,0,"D"
1977-05-21,1976,"Stade Laval","FC Nantes","1-2",1,2,"1",1,3,-1,"D"
1977-05-21,1976,"Stade Reims","SC Bastia","1-1",1,1,"1",1,2,0,"D"
1977-05-21,1976,"RC Lens","AS Saint-Etienne","1-1",1,1,"1",1,2,0,"D"
1977-05-21,1976,"Olympique Lyon","FC Sochaux","3-0",3,0,"1",1,3,3,"H"
1977-05-21,1976,"AS Nancy","Stade Rennes","3-2",3,2,"1",1,5,1,"H"
1977-05-21,1976,"OGC Nice","FC Metz","2-4",2,4,"1",1,6,-2,"D"
1977-05-21,1976,"Paris Saint-Germain","Lille OSC","2-1",2,1,"1",1,3,1,"H"
1977-05-21,1976,"Angers SCO","Olympique Marseille","1-2",1,2,"1",1,3,-1,"D"
1977-05-21,1976,"Girondins Bordeaux","US Valenciennes-Anzin","0-0",0,0,"1",1,0,0,"D"
1977-05-21,1976,"Nimes Olympique","Troyes AF","2-0",2,0,"1",1,2,2,"H"
1977-05-24,1976,"Nimes Olympique","FC Metz","1-1",1,1,"1",1,2,0,"D"
1977-05-27,1976,"FC Nantes","RC Lens","1-1",1,1,"1",1,2,0,"D"
1977-05-27,1976,"FC Sochaux","AS Nancy","0-3",0,3,"1",1,3,-3,"D"
1977-05-27,1976,"AS Saint-Etienne","Stade Laval","3-1",3,1,"1",1,4,2,"H"
1977-05-27,1976,"FC Metz","Girondins Bordeaux","4-2",4,2,"1",1,6,2,"H"
1977-05-27,1976,"Troyes AF","OGC Nice","2-2",2,2,"1",1,4,0,"D"
1977-05-27,1976,"Lille OSC","Olympique Lyon","3-0",3,0,"1",1,3,3,"H"
1977-05-27,1976,"US Valenciennes-Anzin","Paris Saint-Germain","0-3",0,3,"1",1,3,-3,"D"
1977-05-27,1976,"Olympique Marseille","Stade Reims","0-1",0,1,"1",1,1,-1,"D"
1977-05-27,1976,"Stade Rennes","Angers SCO","4-2",4,2,"1",1,6,2,"H"
1977-05-28,1976,"SC Bastia","Nimes Olympique","5-0",5,0,"1",1,5,5,"H"
1977-06-01,1976,"FC Nantes","AS Saint-Etienne","3-0",3,0,"1",1,3,3,"H"
1977-06-01,1976,"Girondins Bordeaux","SC Bastia","1-0",1,0,"1",1,1,1,"H"
1977-06-01,1976,"RC Lens","FC Metz","4-1",4,1,"1",1,5,3,"H"
1977-06-01,1976,"AS Nancy","Lille OSC","3-0",3,0,"1",1,3,3,"H"
1977-06-01,1976,"OGC Nice","Olympique Marseille","2-2",2,2,"1",1,4,0,"D"
1977-06-01,1976,"Olympique Lyon","Stade Rennes","1-2",1,2,"1",1,3,-1,"D"
1977-06-01,1976,"Paris Saint-Germain","Angers SCO","2-0",2,0,"1",1,2,2,"H"
1977-06-01,1976,"Stade Reims","Troyes AF","1-3",1,3,"1",1,4,-2,"D"
1977-06-01,1976,"Nimes Olympique","FC Sochaux","0-1",0,1,"1",1,1,-1,"D"
1977-06-01,1976,"Stade Laval","US Valenciennes-Anzin","1-1",1,1,"1",1,2,0,"D"
1977-06-04,1976,"US Valenciennes-Anzin","FC Nantes","0-0",0,0,"1",1,0,0,"D"
1977-06-04,1976,"SC Bastia","OGC Nice","2-0",2,0,"1",1,2,2,"H"
1977-06-04,1976,"Troyes AF","RC Lens","0-2",0,2,"1",1,2,-2,"D"
1977-06-04,1976,"AS Saint-Etienne","AS Nancy","3-2",3,2,"1",1,5,1,"H"
1977-06-04,1976,"FC Metz","Stade Laval","5-3",5,3,"1",1,8,2,"H"
1977-06-04,1976,"Angers SCO","Olympique Lyon","0-1",0,1,"1",1,1,-1,"D"
1977-06-04,1976,"Stade Rennes","Paris Saint-Germain","1-1",1,1,"1",1,2,0,"D"
1977-06-04,1976,"Olympique Marseille","Girondins Bordeaux","1-1",1,1,"1",1,2,0,"D"
1977-06-04,1976,"FC Sochaux","Stade Reims","2-2",2,2,"1",1,4,0,"D"
1977-06-04,1976,"Lille OSC","Nimes Olympique","1-2",1,2,"1",1,3,-1,"D"
1977-06-08,1976,"FC Nantes","FC Metz","3-2",3,2,"1",1,5,1,"H"
1977-06-08,1976,"RC Lens","Olympique Marseille","1-0",1,0,"1",1,1,1,"H"
1977-06-08,1976,"Stade Laval","SC Bastia","3-1",3,1,"1",1,4,2,"H"
1977-06-08,1976,"AS Nancy","Angers SCO","1-1",1,1,"1",1,2,0,"D"
1977-06-08,1976,"AS Saint-Etienne","US Valenciennes-Anzin","5-0",5,0,"1",1,5,5,"H"
1977-06-08,1976,"Olympique Lyon","Paris Saint-Germain","1-1",1,1,"1",1,2,0,"D"
1977-06-08,1976,"OGC Nice","FC Sochaux","1-0",1,0,"1",1,1,1,"H"
1977-06-08,1976,"Girondins Bordeaux","Troyes AF","3-0",3,0,"1",1,3,3,"H"
1977-06-08,1976,"Stade Reims","Lille OSC","3-1",3,1,"1",1,4,2,"H"
1977-06-08,1976,"Nimes Olympique","Stade Rennes","6-2",6,2,"1",1,8,4,"H"
1977-08-03,1977,"US Valenciennes-Anzin","Troyes AF","6-1",6,1,"1",1,7,5,"H"
1977-08-03,1977,"RC Strasbourg","Stade Laval","6-2",6,2,"1",1,8,4,"H"
1977-08-03,1977,"Olympique Marseille","FC Sochaux","4-0",4,0,"1",1,4,4,"H"
1977-08-03,1977,"FC Rouen","FC Metz","5-2",5,2,"1",1,7,3,"H"
1977-08-03,1977,"AS Nancy","Paris Saint-Germain","4-1",4,1,"1",1,5,3,"H"
1977-08-03,1977,"Olympique Lyon","Nimes Olympique","3-1",3,1,"1",1,4,2,"H"
1977-08-03,1977,"SC Bastia","AS Monaco","0-2",0,2,"1",1,2,-2,"D"
1977-08-03,1977,"OGC Nice","FC Nantes","1-0",1,0,"1",1,1,1,"H"
1977-08-03,1977,"Girondins Bordeaux","AS Saint-Etienne","2-2",2,2,"1",1,4,0,"D"
1977-08-03,1977,"Stade Reims","RC Lens","0-0",0,0,"1",1,0,0,"D"
1977-08-09,1977,"Troyes AF","Olympique Lyon","0-2",0,2,"1",1,2,-2,"D"
1977-08-09,1977,"AS Monaco","AS Nancy","2-0",2,0,"1",1,2,2,"H"
1977-08-09,1977,"FC Sochaux","OGC Nice","1-2",1,2,"1",1,3,-1,"D"
1977-08-09,1977,"RC Lens","RC Strasbourg","2-2",2,2,"1",1,4,0,"D"
1977-08-09,1977,"SC Bastia","Girondins Bordeaux","1-2",1,2,"1",1,3,-1,"D"
1977-08-09,1977,"AS Saint-Etienne","Olympique Marseille","2-1",2,1,"1",1,3,1,"H"
1977-08-09,1977,"Stade Laval","US Valenciennes-Anzin","3-1",3,1,"1",1,4,2,"H"
1977-08-09,1977,"Nimes Olympique","FC Rouen","3-2",3,2,"1",1,5,1,"H"
1977-08-09,1977,"Paris Saint-Germain","Stade Reims","2-2",2,2,"1",1,4,0,"D"
1977-08-09,1977,"FC Metz","FC Nantes","2-2",2,2,"1",1,4,0,"D"
1977-08-16,1977,"Girondins Bordeaux","AS Monaco","0-4",0,4,"1",1,4,-4,"D"
1977-08-16,1977,"Olympique Lyon","RC Lens","2-0",2,0,"1",1,2,2,"H"
1977-08-16,1977,"OGC Nice","FC Metz","1-1",1,1,"1",1,2,0,"D"
1977-08-16,1977,"RC Strasbourg","Paris Saint-Germain","1-1",1,1,"1",1,2,0,"D"
1977-08-16,1977,"AS Nancy","SC Bastia","3-0",3,0,"1",1,3,3,"H"
1977-08-16,1977,"FC Rouen","Troyes AF","2-1",2,1,"1",1,3,1,"H"
1977-08-16,1977,"Stade Reims","AS Saint-Etienne","0-0",0,0,"1",1,0,0,"D"
1977-08-16,1977,"Olympique Marseille","Stade Laval","0-1",0,1,"1",1,1,-1,"D"
1977-08-16,1977,"FC Nantes","Nimes Olympique","3-1",3,1,"1",1,4,2,"H"
1977-08-16,1977,"US Valenciennes-Anzin","FC Sochaux","1-2",1,2,"1",1,3,-1,"D"
1977-08-19,1977,"AS Monaco","RC Strasbourg","3-2",3,2,"1",1,5,1,"H"
1977-08-19,1977,"AS Saint-Etienne","OGC Nice","1-2",1,2,"1",1,3,-1,"D"
1977-08-19,1977,"Stade Laval","Olympique Lyon","1-0",1,0,"1",1,1,1,"H"
1977-08-19,1977,"AS Nancy","US Valenciennes-Anzin","2-2",2,2,"1",1,4,0,"D"
1977-08-19,1977,"Paris Saint-Germain","Girondins Bordeaux","1-2",1,2,"1",1,3,-1,"D"
1977-08-19,1977,"FC Sochaux","FC Rouen","3-0",3,0,"1",1,3,3,"H"
1977-08-19,1977,"Nimes Olympique","FC Metz","2-0",2,0,"1",1,2,2,"H"
1977-08-19,1977,"RC Lens","Olympique Marseille","3-2",3,2,"1",1,5,1,"H"
1977-08-19,1977,"Troyes AF","FC Nantes","1-0",1,0,"1",1,1,1,"H"
1977-08-19,1977,"SC Bastia","Stade Reims","3-0",3,0,"1",1,3,3,"H"
1977-08-30,1977,"Stade Reims","AS Monaco","0-2",0,2,"1",1,2,-2,"D"
1977-08-30,1977,"OGC Nice","Nimes Olympique","3-1",3,1,"1",1,4,2,"H"
1977-08-30,1977,"FC Rouen","Stade Laval","1-1",1,1,"1",1,2,0,"D"
1977-08-30,1977,"Girondins Bordeaux","AS Nancy","2-0",2,0,"1",1,2,2,"H"
1977-08-30,1977,"Olympique Lyon","FC Sochaux","0-2",0,2,"1",1,2,-2,"D"
1977-08-30,1977,"RC Strasbourg","SC Bastia","1-1",1,1,"1",1,2,0,"D"
1977-08-30,1977,"FC Nantes","RC Lens","2-0",2,0,"1",1,2,2,"H"
1977-08-30,1977,"US Valenciennes-Anzin","AS Saint-Etienne","1-1",1,1,"1",1,2,0,"D"
1977-08-30,1977,"Olympique Marseille","Paris Saint-Germain","2-1",2,1,"1",1,3,1,"H"
1977-08-30,1977,"FC Metz","Troyes AF","0-0",0,0,"1",1,0,0,"D"
1977-09-02,1977,"Girondins Bordeaux","OGC Nice","3-5",3,5,"1",1,8,-2,"D"
1977-09-02,1977,"AS Monaco","Olympique Marseille","2-3",2,3,"1",1,5,-1,"D"
1977-09-02,1977,"FC Sochaux","FC Metz","4-0",4,0,"1",1,4,4,"H"
1977-09-02,1977,"Stade Laval","FC Nantes","1-1",1,1,"1",1,2,0,"D"
1977-09-02,1977,"AS Nancy","Stade Reims","4-1",4,1,"1",1,5,3,"H"
1977-09-02,1977,"AS Saint-Etienne","RC Strasbourg","4-3",4,3,"1",1,7,1,"H"
1977-09-02,1977,"SC Bastia","Olympique Lyon","2-1",2,1,"1",1,3,1,"H"
1977-09-02,1977,"RC Lens","FC Rouen","5-1",5,1,"1",1,6,4,"H"
1977-09-02,1977,"Troyes AF","Nimes Olympique","2-2",2,2,"1",1,4,0,"D"
1977-09-02,1977,"Paris Saint-Germain","US Valenciennes-Anzin","2-0",2,0,"1",1,2,2,"H"
1977-09-09,1977,"OGC Nice","Troyes AF","4-1",4,1,"1",1,5,3,"H"
1977-09-09,1977,"US Valenciennes-Anzin","AS Monaco","1-1",1,1,"1",1,2,0,"D"
1977-09-09,1977,"Olympique Marseille","SC Bastia","2-0",2,0,"1",1,2,2,"H"
1977-09-09,1977,"FC Nantes","FC Sochaux","2-0",2,0,"1",1,2,2,"H"
1977-09-09,1977,"Olympique Lyon","AS Saint-Etienne","2-2",2,2,"1",1,4,0,"D"
1977-09-09,1977,"FC Metz","Stade Laval","1-0",1,0,"1",1,1,1,"H"
1977-09-09,1977,"RC Strasbourg","AS Nancy","2-0",2,0,"1",1,2,2,"H"
1977-09-09,1977,"Nimes Olympique","RC Lens","2-1",2,1,"1",1,3,1,"H"
1977-09-09,1977,"Stade Reims","Girondins Bordeaux","1-0",1,0,"1",1,1,1,"H"
1977-09-09,1977,"FC Rouen","Paris Saint-Germain","1-3",1,3,"1",1,4,-2,"D"
1977-09-17,1977,"AS Monaco","Olympique Lyon","3-1",3,1,"1",1,4,2,"H"
1977-09-17,1977,"RC Lens","OGC Nice","3-1",3,1,"1",1,4,2,"H"
1977-09-17,1977,"FC Sochaux","Troyes AF","5-2",5,2,"1",1,7,3,"H"
1977-09-17,1977,"AS Saint-Etienne","FC Nantes","2-1",2,1,"1",1,3,1,"H"
1977-09-17,1977,"Stade Laval","Nimes Olympique","2-1",2,1,"1",1,3,1,"H"
1977-09-17,1977,"AS Nancy","Olympique Marseille","1-1",1,1,"1",1,2,0,"D"
1977-09-17,1977,"Girondins Bordeaux","FC Rouen","4-0",4,0,"1",1,4,4,"H"
1977-09-17,1977,"Stade Reims","RC Strasbourg","0-0",0,0,"1",1,0,0,"D"
1977-09-17,1977,"Paris Saint-Germain","FC Metz","2-0",2,0,"1",1,2,2,"H"
1977-09-17,1977,"SC Bastia","US Valenciennes-Anzin","3-0",3,0,"1",1,3,3,"H"
1977-09-23,1977,"OGC Nice","AS Monaco","1-1",1,1,"1",1,2,0,"D"
1977-09-23,1977,"FC Rouen","AS Saint-Etienne","1-2",1,2,"1",1,3,-1,"D"
1977-09-23,1977,"Nimes Olympique","FC Sochaux","1-1",1,1,"1",1,2,0,"D"
1977-09-23,1977,"Olympique Marseille","Stade Reims","2-1",2,1,"1",1,3,1,"H"
1977-09-23,1977,"Troyes AF","Stade Laval","0-0",0,0,"1",1,0,0,"D"
1977-09-23,1977,"RC Strasbourg","Girondins Bordeaux","3-0",3,0,"1",1,3,3,"H"
1977-09-23,1977,"FC Nantes","SC Bastia","2-0",2,0,"1",1,2,2,"H"
1977-09-23,1977,"Olympique Lyon","Paris Saint-Germain","2-3",2,3,"1",1,5,-1,"D"
1977-09-23,1977,"US Valenciennes-Anzin","RC Lens","3-3",3,3,"1",1,6,0,"D"
1977-09-23,1977,"FC Metz","AS Nancy","3-0",3,0,"1",1,3,3,"H"
1977-09-30,1977,"AS Saint-Etienne","Nimes Olympique","2-1",2,1,"1",1,3,1,"H"
1977-09-30,1977,"RC Strasbourg","FC Metz","5-1",5,1,"1",1,6,4,"H"
1977-10-01,1977,"Paris Saint-Germain","OGC Nice","0-3",0,3,"1",1,3,-3,"D"
1977-10-01,1977,"AS Monaco","FC Nantes","1-1",1,1,"1",1,2,0,"D"
1977-10-01,1977,"Girondins Bordeaux","Olympique Marseille","1-2",1,2,"1",1,3,-1,"D"
1977-10-01,1977,"Stade Laval","FC Sochaux","3-1",3,1,"1",1,4,2,"H"
1977-10-01,1977,"RC Lens","Troyes AF","3-2",3,2,"1",1,5,1,"H"
1977-10-01,1977,"AS Nancy","Olympique Lyon","3-1",3,1,"1",1,4,2,"H"
1977-10-01,1977,"SC Bastia","FC Rouen","3-2",3,2,"1",1,5,1,"H"
1977-10-01,1977,"Stade Reims","US Valenciennes-Anzin","3-0",3,0,"1",1,3,3,"H"
1977-10-11,1977,"OGC Nice","Stade Laval","4-2",4,2,"1",1,6,2,"H"
1977-10-11,1977,"FC Rouen","AS Monaco","3-4",3,4,"1",1,7,-1,"D"
1977-10-11,1977,"FC Metz","AS Saint-Etienne","0-2",0,2,"1",1,2,-2,"D"
1977-10-11,1977,"Olympique Marseille","RC Strasbourg","1-0",1,0,"1",1,1,1,"H"
1977-10-11,1977,"FC Sochaux","RC Lens","7-2",7,2,"1",1,9,5,"H"
1977-10-11,1977,"FC Nantes","Paris Saint-Germain","3-1",3,1,"1",1,4,2,"H"
1977-10-11,1977,"US Valenciennes-Anzin","Girondins Bordeaux","0-1",0,1,"1",1,1,-1,"D"
1977-10-11,1977,"Nimes Olympique","AS Nancy","1-0",1,0,"1",1,1,1,"H"
1977-10-11,1977,"Olympique Lyon","Stade Reims","0-1",0,1,"1",1,1,-1,"D"
1977-10-11,1977,"Troyes AF","SC Bastia","1-0",1,0,"1",1,1,1,"H"
1977-10-14,1977,"AS Monaco","Nimes Olympique","2-1",2,1,"1",1,3,1,"H"
1977-10-14,1977,"RC Strasbourg","OGC Nice","2-1",2,1,"1",1,3,1,"H"
1977-10-14,1977,"AS Saint-Etienne","FC Sochaux","3-1",3,1,"1",1,4,2,"H"
1977-10-14,1977,"Olympique Marseille","US Valenciennes-Anzin","3-0",3,0,"1",1,3,3,"H"
1977-10-14,1977,"AS Nancy","FC Nantes","3-0",3,0,"1",1,3,3,"H"
1977-10-14,1977,"RC Lens","Stade Laval","1-1",1,1,"1",1,2,0,"D"
1977-10-14,1977,"Paris Saint-Germain","Troyes AF","8-2",8,2,"1",1,10,6,"H"
1977-10-14,1977,"Stade Reims","FC Rouen","3-1",3,1,"1",1,4,2,"H"
1977-10-14,1977,"SC Bastia","FC Metz","2-0",2,0,"1",1,2,2,"H"
1977-10-14,1977,"Girondins Bordeaux","Olympique Lyon","1-4",1,4,"1",1,5,-3,"D"
1977-10-22,1977,"OGC Nice","Stade Reims","4-2",4,2,"1",1,6,2,"H"
1977-10-22,1977,"Troyes AF","AS Monaco","3-0",3,0,"1",1,3,3,"H"
1977-10-22,1977,"Stade Laval","AS Saint-Etienne","1-0",1,0,"1",1,1,1,"H"
1977-10-22,1977,"Olympique Lyon","Olympique Marseille","4-2",4,2,"1",1,6,2,"H"
1977-10-22,1977,"US Valenciennes-Anzin","RC Strasbourg","0-0",0,0,"1",1,0,0,"D"
1977-10-22,1977,"FC Nantes","Girondins Bordeaux","4-1",4,1,"1",1,5,3,"H"
1977-10-22,1977,"FC Sochaux","SC Bastia","2-0",2,0,"1",1,2,2,"H"
1977-10-22,1977,"FC Metz","RC Lens","2-1",2,1,"1",1,3,1,"H"
1977-10-22,1977,"FC Rouen","AS Nancy","3-2",3,2,"1",1,5,1,"H"
1977-10-28,1977,"AS Monaco","FC Sochaux","2-1",2,1,"1",1,3,1,"H"
1977-10-28,1977,"Olympique Marseille","OGC Nice","2-0",2,0,"1",1,2,2,"H"
1977-10-28,1977,"AS Saint-Etienne","RC Lens","0-1",0,1,"1",1,1,-1,"D"
1977-10-28,1977,"Stade Reims","FC Nantes","1-3",1,3,"1",1,4,-2,"D"
1977-10-28,1977,"Paris Saint-Germain","Stade Laval","2-2",2,2,"1",1,4,0,"D"
1977-10-28,1977,"RC Strasbourg","Olympique Lyon","2-2",2,2,"1",1,4,0,"D"
1977-10-28,1977,"SC Bastia","Nimes Olympique","2-1",2,1,"1",1,3,1,"H"
1977-10-28,1977,"Girondins Bordeaux","FC Metz","1-0",1,0,"1",1,1,1,"H"
1977-10-28,1977,"AS Nancy","Troyes AF","1-0",1,0,"1",1,1,1,"H"
1977-10-28,1977,"US Valenciennes-Anzin","FC Rouen","3-0",3,0,"1",1,3,3,"H"
1977-11-04,1977,"Nimes Olympique","Paris Saint-Germain","2-1",2,1,"1",1,3,1,"H"
1977-11-09,1977,"AS Monaco","RC Lens","3-0",3,0,"1",1,3,3,"H"
1977-11-09,1977,"US Valenciennes-Anzin","OGC Nice","2-4",2,4,"1",1,6,-2,"D"
1977-11-09,1977,"Olympique Marseille","FC Nantes","2-2",2,2,"1",1,4,0,"D"
1977-11-09,1977,"RC Strasbourg","FC Rouen","2-0",2,0,"1",1,2,2,"H"
1977-11-09,1977,"Paris Saint-Germain","AS Saint-Etienne","4-1",4,1,"1",1,5,3,"H"
1977-11-09,1977,"AS Nancy","FC Sochaux","1-1",1,1,"1",1,2,0,"D"
1977-11-09,1977,"Olympique Lyon","FC Metz","4-1",4,1,"1",1,5,3,"H"
1977-11-09,1977,"Stade Reims","Nimes Olympique","2-1",2,1,"1",1,3,1,"H"
1977-11-09,1977,"Girondins Bordeaux","Troyes AF","1-1",1,1,"1",1,2,0,"D"
1977-11-12,1977,"SC Bastia","Stade Laval","1-0",1,0,"1",1,1,1,"H"
1977-11-19,1977,"OGC Nice","SC Bastia","3-1",3,1,"1",1,4,2,"H"
1977-11-19,1977,"AS Saint-Etienne","AS Monaco","1-0",1,0,"1",1,1,1,"H"
1977-11-19,1977,"FC Metz","Olympique Marseille","0-2",0,2,"1",1,2,-2,"D"
1977-11-19,1977,"FC Nantes","US Valenciennes-Anzin","4-1",4,1,"1",1,5,3,"H"
1977-11-19,1977,"Nimes Olympique","RC Strasbourg","0-1",0,1,"1",1,1,-1,"D"
1977-11-19,1977,"FC Sochaux","Girondins Bordeaux","0-0",0,0,"1",1,0,0,"D"
1977-11-19,1977,"Stade Laval","AS Nancy","1-2",1,2,"1",1,3,-1,"D"
1977-11-19,1977,"RC Lens","Paris Saint-Germain","3-1",3,1,"1",1,4,2,"H"
1977-11-19,1977,"FC Rouen","Olympique Lyon","3-2",3,2,"1",1,5,1,"H"
1977-11-19,1977,"Troyes AF","Stade Reims","3-0",3,0,"1",1,3,3,"H"
1977-11-22,1977,"FC Nantes","RC Strasbourg","1-1",1,1,"1",1,2,0,"D"
1977-11-22,1977,"FC Metz","Stade Reims","2-1",2,1,"1",1,3,1,"H"
1977-11-26,1977,"FC Rouen","OGC Nice","2-0",2,0,"1",1,2,2,"H"
1977-11-26,1977,"AS Monaco","Paris Saint-Germain","0-0",0,0,"1",1,0,0,"D"
1977-11-26,1977,"RC Strasbourg","Troyes AF","3-0",3,0,"1",1,3,3,"H"
1977-11-26,1977,"Olympique Marseille","Nimes Olympique","1-1",1,1,"1",1,2,0,"D"
1977-11-26,1977,"Olympique Lyon","FC Nantes","1-0",1,0,"1",1,1,1,"H"
1977-11-26,1977,"SC Bastia","AS Saint-Etienne","2-0",2,0,"1",1,2,2,"H"
1977-11-26,1977,"Stade Reims","FC Sochaux","1-1",1,1,"1",1,2,0,"D"
1977-11-26,1977,"Girondins Bordeaux","Stade Laval","1-1",1,1,"1",1,2,0,"D"
1977-11-26,1977,"AS Nancy","RC Lens","0-0",0,0,"1",1,0,0,"D"
1977-11-26,1977,"US Valenciennes-Anzin","FC Metz","2-1",2,1,"1",1,3,1,"H"
1977-11-30,1977,"OGC Nice","Olympique Lyon","3-1",3,1,"1",1,4,2,"H"
1977-11-30,1977,"Troyes AF","Olympique Marseille","0-1",0,1,"1",1,1,-1,"D"
1977-11-30,1977,"FC Metz","AS Monaco","2-1",2,1,"1",1,3,1,"H"
1977-11-30,1977,"FC Sochaux","RC Strasbourg","3-2",3,2,"1",1,5,1,"H"
1977-11-30,1977,"FC Nantes","FC Rouen","0-0",0,0,"1",1,0,0,"D"
1977-11-30,1977,"AS Saint-Etienne","AS Nancy","2-1",2,1,"1",1,3,1,"H"
1977-11-30,1977,"RC Lens","Girondins Bordeaux","2-0",2,0,"1",1,2,2,"H"
1977-11-30,1977,"Paris Saint-Germain","SC Bastia","3-3",3,3,"1",1,6,0,"D"
1977-11-30,1977,"Nimes Olympique","US Valenciennes-Anzin","1-2",1,2,"1",1,3,-1,"D"
1977-12-03,1977,"OGC Nice","FC Sochaux","4-2",4,2,"1",1,6,2,"H"
1977-12-03,1977,"RC Strasbourg","RC Lens","3-0",3,0,"1",1,3,3,"H"
1977-12-03,1977,"AS Nancy","AS Monaco","2-2",2,2,"1",1,4,0,"D"
1977-12-03,1977,"FC Nantes","FC Metz","2-0",2,0,"1",1,2,2,"H"
1977-12-03,1977,"US Valenciennes-Anzin","Stade Laval","2-3",2,3,"1",1,5,-1,"D"
1977-12-03,1977,"Stade Reims","Paris Saint-Germain","0-0",0,0,"1",1,0,0,"D"
1977-12-03,1977,"Girondins Bordeaux","SC Bastia","1-0",1,0,"1",1,1,1,"H"
1977-12-03,1977,"Olympique Lyon","Troyes AF","0-0",0,0,"1",1,0,0,"D"
1977-12-03,1977,"FC Rouen","Nimes Olympique","2-0",2,0,"1",1,2,2,"H"
1977-12-04,1977,"Olympique Marseille","AS Saint-Etienne","3-0",3,0,"1",1,3,3,"H"
1977-12-10,1977,"FC Metz","OGC Nice","2-0",2,0,"1",1,2,2,"H"
1977-12-10,1977,"Stade Laval","Olympique Marseille","2-1",2,1,"1",1,3,1,"H"
1977-12-10,1977,"AS Monaco","Girondins Bordeaux","3-2",3,2,"1",1,5,1,"H"
1977-12-10,1977,"AS Saint-Etienne","Stade Reims","2-0",2,0,"1",1,2,2,"H"
1977-12-10,1977,"FC Sochaux","US Valenciennes-Anzin","0-1",0,1,"1",1,1,-1,"D"
1977-12-10,1977,"SC Bastia","AS Nancy","1-0",1,0,"1",1,1,1,"H"
1977-12-10,1977,"RC Lens","Olympique Lyon","2-3",2,3,"1",1,5,-1,"D"
1977-12-10,1977,"Troyes AF","FC Rouen","3-1",3,1,"1",1,4,2,"H"
1977-12-11,1977,"Paris Saint-Germain","RC Strasbourg","2-2",2,2,"1",1,4,0,"D"
1977-12-11,1977,"Nimes Olympique","FC Nantes","0-0",0,0,"1",1,0,0,"D"
1977-12-13,1977,"FC Rouen","Olympique Marseille","0-2",0,2,"1",1,2,-2,"D"
1977-12-14,1977,"Stade Laval","AS Monaco","0-0",0,0,"1",1,0,0,"D"
1977-12-14,1977,"FC Sochaux","Paris Saint-Germain","2-1",2,1,"1",1,3,1,"H"
1977-12-14,1977,"Olympique Lyon","US Valenciennes-Anzin","1-2",1,2,"1",1,3,-1,"D"
1977-12-17,1977,"RC Strasbourg","AS Monaco","3-0",3,0,"1",1,3,3,"H"
1977-12-17,1977,"FC Nantes","Troyes AF","3-0",3,0,"1",1,3,3,"H"
1977-12-17,1977,"FC Rouen","FC Sochaux","1-2",1,2,"1",1,3,-1,"D"
1977-12-17,1977,"US Valenciennes-Anzin","AS Nancy","0-1",0,1,"1",1,1,-1,"D"
1977-12-18,1977,"Olympique Lyon","Stade Laval","5-0",5,0,"1",1,5,5,"H"
1977-12-18,1977,"Stade Reims","SC Bastia","1-3",1,3,"1",1,4,-2,"D"
1977-12-18,1977,"Girondins Bordeaux","Paris Saint-Germain","1-2",1,2,"1",1,3,-1,"D"
1977-12-18,1977,"Olympique Marseille","RC Lens","4-0",4,0,"1",1,4,4,"H"
1978-01-07,1977,"AS Monaco","Stade Reims","2-0",2,0,"1",1,2,2,"H"
1978-01-07,1977,"RC Lens","FC Nantes","0-1",0,1,"1",1,1,-1,"D"
1978-01-07,1977,"SC Bastia","RC Strasbourg","3-1",3,1,"1",1,4,2,"H"
1978-01-07,1977,"Stade Laval","FC Rouen","3-0",3,0,"1",1,3,3,"H"
1978-01-08,1977,"Paris Saint-Germain","Olympique Marseille","5-1",5,1,"1",1,6,4,"H"
1978-01-08,1977,"Nimes Olympique","OGC Nice","1-1",1,1,"1",1,2,0,"D"
1978-01-08,1977,"FC Sochaux","Olympique Lyon","1-0",1,0,"1",1,1,1,"H"
1978-01-08,1977,"AS Saint-Etienne","US Valenciennes-Anzin","2-1",2,1,"1",1,3,1,"H"
1978-01-08,1977,"AS Nancy","Girondins Bordeaux","4-1",4,1,"1",1,5,3,"H"
1978-01-08,1977,"Troyes AF","FC Metz","0-2",0,2,"1",1,2,-2,"D"
1978-01-14,1977,"FC Nantes","Stade Laval","3-1",3,1,"1",1,4,2,"H"
1978-01-14,1977,"FC Metz","FC Sochaux","1-1",1,1,"1",1,2,0,"D"
1978-01-14,1977,"US Valenciennes-Anzin","Paris Saint-Germain","2-1",2,1,"1",1,3,1,"H"
1978-01-14,1977,"FC Rouen","RC Lens","0-0",0,0,"1",1,0,0,"D"
1978-01-15,1977,"OGC Nice","Girondins Bordeaux","1-0",1,0,"1",1,1,1,"H"
1978-01-15,1977,"Olympique Marseille","AS Monaco","2-2",2,2,"1",1,4,0,"D"
1978-01-15,1977,"RC Strasbourg","AS Saint-Etienne","2-0",2,0,"1",1,2,2,"H"
1978-01-15,1977,"Olympique Lyon","SC Bastia","2-1",2,1,"1",1,3,1,"H"
1978-01-15,1977,"Stade Reims","AS Nancy","4-1",4,1,"1",1,5,3,"H"
1978-01-15,1977,"Nimes Olympique","Troyes AF","1-1",1,1,"1",1,2,0,"D"
1978-01-18,1977,"OGC Nice","AS Nancy","3-7",3,7,"1",1,10,-4,"D"
1978-01-18,1977,"RC Lens","SC Bastia","3-4",3,4,"1",1,7,-1,"D"
1978-01-18,1977,"Stade Laval","Stade Reims","2-0",2,0,"1",1,2,2,"H"
1978-01-18,1977,"FC Metz","Nimes Olympique","3-0",3,0,"1",1,3,3,"H"
1978-01-18,1977,"OGC Nice","AS Saint-Etienne","2-1",2,1,"1",1,3,1,"H"
1978-01-21,1977,"AS Monaco","US Valenciennes-Anzin","3-2",3,2,"1",1,5,1,"H"
1978-01-21,1977,"Troyes AF","OGC Nice","3-1",3,1,"1",1,4,2,"H"
1978-01-21,1977,"SC Bastia","Olympique Marseille","2-0",2,0,"1",1,2,2,"H"
1978-01-21,1977,"Stade Laval","FC Metz","3-0",3,0,"1",1,3,3,"H"
1978-01-21,1977,"RC Lens","Nimes Olympique","4-1",4,1,"1",1,5,3,"H"
1978-01-22,1977,"FC Sochaux","FC Nantes","1-1",1,1,"1",1,2,0,"D"
1978-01-22,1977,"AS Nancy","RC Strasbourg","3-1",3,1,"1",1,4,2,"H"
1978-01-22,1977,"AS Saint-Etienne","Olympique Lyon","1-0",1,0,"1",1,1,1,"H"
1978-01-22,1977,"Girondins Bordeaux","Stade Reims","2-0",2,0,"1",1,2,2,"H"
1978-01-24,1977,"Paris Saint-Germain","FC Rouen","3-1",3,1,"1",1,4,2,"H"
1978-02-03,1977,"OGC Nice","RC Lens","5-4",5,4,"1",1,9,1,"H"
1978-02-03,1977,"FC Nantes","AS Saint-Etienne","1-0",1,0,"1",1,1,1,"H"
1978-02-03,1977,"Olympique Lyon","AS Monaco","1-1",1,1,"1",1,2,0,"D"
1978-02-03,1977,"Olympique Marseille","AS Nancy","1-1",1,1,"1",1,2,0,"D"
1978-02-03,1977,"RC Strasbourg","Stade Reims","2-1",2,1,"1",1,3,1,"H"
1978-02-03,1977,"Nimes Olympique","Stade Laval","1-0",1,0,"1",1,1,1,"H"
1978-02-03,1977,"US Valenciennes-Anzin","SC Bastia","2-0",2,0,"1",1,2,2,"H"
1978-02-03,1977,"FC Rouen","Girondins Bordeaux","1-2",1,2,"1",1,3,-1,"D"
1978-02-04,1977,"Troyes AF","FC Sochaux","1-0",1,0,"1",1,1,1,"H"
1978-02-04,1977,"FC Metz","Paris Saint-Germain","2-1",2,1,"1",1,3,1,"H"
1978-02-11,1977,"AS Monaco","OGC Nice","2-0",2,0,"1",1,2,2,"H"
1978-02-11,1977,"SC Bastia","FC Nantes","0-0",0,0,"1",1,0,0,"D"
1978-02-11,1977,"Girondins Bordeaux","RC Strasbourg","3-0",3,0,"1",1,3,3,"H"
1978-02-11,1977,"Stade Laval","Troyes AF","2-1",2,1,"1",1,3,1,"H"
1978-02-11,1977,"FC Sochaux","Nimes Olympique","1-1",1,1,"1",1,2,0,"D"
1978-02-11,1977,"RC Lens","US Valenciennes-Anzin","0-2",0,2,"1",1,2,-2,"D"
1978-02-12,1977,"Stade Reims","Olympique Marseille","0-0",0,0,"1",1,0,0,"D"
1978-02-12,1977,"Paris Saint-Germain","Olympique Lyon","2-3",2,3,"1",1,5,-1,"D"
1978-02-15,1977,"Olympique Marseille","Girondins Bordeaux","4-0",4,0,"1",1,4,4,"H"
1978-02-15,1977,"OGC Nice","Paris Saint-Germain","2-3",2,3,"1",1,5,-1,"D"
1978-02-15,1977,"FC Metz","RC Strasbourg","0-0",0,0,"1",1,0,0,"D"
1978-02-15,1977,"FC Sochaux","Stade Laval","4-1",4,1,"1",1,5,3,"H"
1978-02-15,1977,"Nimes Olympique","AS Saint-Etienne","0-0",0,0,"1",1,0,0,"D"
1978-02-15,1977,"US Valenciennes-Anzin","Stade Reims","0-0",0,0,"1",1,0,0,"D"
1978-02-15,1977,"Troyes AF","RC Lens","0-0",0,0,"1",1,0,0,"D"
1978-02-22,1977,"AS Saint-Etienne","FC Rouen","2-1",2,1,"1",1,3,1,"H"
1978-02-25,1977,"AS Monaco","FC Rouen","6-1",6,1,"1",1,7,5,"H"
1978-02-25,1977,"RC Lens","FC Sochaux","1-3",1,3,"1",1,4,-2,"D"
1978-02-26,1977,"Stade Reims","Olympique Lyon","2-1",2,1,"1",1,3,1,"H"
1978-02-26,1977,"Girondins Bordeaux","US Valenciennes-Anzin","2-0",2,0,"1",1,2,2,"H"
1978-02-26,1977,"AS Saint-Etienne","FC Metz","2-0",2,0,"1",1,2,2,"H"
1978-02-26,1977,"AS Nancy","Nimes Olympique","2-2",2,2,"1",1,4,0,"D"
1978-03-04,1977,"Nimes Olympique","AS Monaco","3-4",3,4,"1",1,7,-1,"D"
1978-03-04,1977,"US Valenciennes-Anzin","Olympique Marseille","1-2",1,2,"1",1,3,-1,"D"
1978-03-04,1977,"FC Nantes","AS Nancy","2-0",2,0,"1",1,2,2,"H"
1978-03-04,1977,"OGC Nice","RC Strasbourg","0-1",0,1,"1",1,1,-1,"D"
1978-03-04,1977,"Stade Laval","RC Lens","3-0",3,0,"1",1,3,3,"H"
1978-03-04,1977,"FC Metz","SC Bastia","0-0",0,0,"1",1,0,0,"D"
1978-03-04,1977,"Olympique Lyon","Girondins Bordeaux","1-1",1,1,"1",1,2,0,"D"
1978-03-04,1977,"Troyes AF","Paris Saint-Germain","3-1",3,1,"1",1,4,2,"H"
1978-03-04,1977,"FC Rouen","Stade Reims","1-2",1,2,"1",1,3,-1,"D"
1978-03-05,1977,"FC Sochaux","AS Saint-Etienne","2-3",2,3,"1",1,5,-1,"D"
1978-03-10,1977,"RC Strasbourg","US Valenciennes-Anzin","1-1",1,1,"1",1,2,0,"D"
1978-03-11,1977,"AS Monaco","Troyes AF","1-1",1,1,"1",1,2,0,"D"
1978-03-11,1977,"Olympique Marseille","Olympique Lyon","4-0",4,0,"1",1,4,4,"H"
1978-03-11,1977,"Girondins Bordeaux","FC Nantes","1-0",1,0,"1",1,1,1,"H"
1978-03-11,1977,"AS Saint-Etienne","Stade Laval","1-0",1,0,"1",1,1,1,"H"
1978-03-11,1977,"Stade Reims","OGC Nice","0-0",0,0,"1",1,0,0,"D"
1978-03-11,1977,"SC Bastia","FC Sochaux","0-0",0,0,"1",1,0,0,"D"
1978-03-11,1977,"AS Nancy","FC Rouen","1-0",1,0,"1",1,1,1,"H"
1978-03-11,1977,"Paris Saint-Germain","Nimes Olympique","5-0",5,0,"1",1,5,5,"H"
1978-03-11,1977,"RC Lens","FC Metz","1-2",1,2,"1",1,3,-1,"D"
1978-03-14,1977,"Nimes Olympique","Girondins Bordeaux","3-1",3,1,"1",1,4,2,"H"
1978-03-14,1977,"FC Nantes","AS Monaco","1-0",1,0,"1",1,1,1,"H"
1978-03-14,1977,"Olympique Lyon","AS Nancy","1-3",1,3,"1",1,4,-2,"D"
1978-03-14,1977,"RC Strasbourg","Olympique Marseille","2-1",2,1,"1",1,3,1,"H"
1978-03-14,1977,"Stade Laval","OGC Nice","2-0",2,0,"1",1,2,2,"H"
1978-03-25,1977,"OGC Nice","Olympique Marseille","1-1",1,1,"1",1,2,0,"D"
1978-03-25,1977,"FC Nantes","Stade Reims","3-1",3,1,"1",1,4,2,"H"
1978-03-25,1977,"FC Sochaux","AS Monaco","3-2",3,2,"1",1,5,1,"H"
1978-03-25,1977,"Olympique Lyon","RC Strasbourg","1-1",1,1,"1",1,2,0,"D"
1978-03-25,1977,"RC Lens","AS Saint-Etienne","2-0",2,0,"1",1,2,2,"H"
1978-03-25,1977,"Troyes AF","AS Nancy","2-3",2,3,"1",1,5,-1,"D"
1978-03-25,1977,"Stade Laval","Paris Saint-Germain","1-2",1,2,"1",1,3,-1,"D"
1978-03-25,1977,"Nimes Olympique","SC Bastia","2-0",2,0,"1",1,2,2,"H"
1978-03-25,1977,"FC Metz","Girondins Bordeaux","5-0",5,0,"1",1,5,5,"H"
1978-03-25,1977,"FC Rouen","US Valenciennes-Anzin","1-1",1,1,"1",1,2,0,"D"
1978-03-28,1977,"Paris Saint-Germain","FC Nantes","0-1",0,1,"1",1,1,-1,"D"
1978-04-02,1977,"SC Bastia","Troyes AF","6-0",6,0,"1",1,6,6,"H"
1978-04-04,1977,"RC Strasbourg","FC Nantes","1-0",1,0,"1",1,1,1,"H"
1978-04-04,1977,"AS Nancy","OGC Nice","1-1",1,1,"1",1,2,0,"D"
1978-04-05,1977,"Olympique Marseille","FC Rouen","4-1",4,1,"1",1,5,3,"H"
1978-04-05,1977,"AS Monaco","Stade Laval","4-0",4,0,"1",1,4,4,"H"
1978-04-05,1977,"AS Saint-Etienne","Troyes AF","1-0",1,0,"1",1,1,1,"H"
1978-04-05,1977,"Paris Saint-Germain","FC Sochaux","3-1",3,1,"1",1,4,2,"H"
1978-04-05,1977,"SC Bastia","RC Lens","3-1",3,1,"1",1,4,2,"H"
1978-04-05,1977,"Girondins Bordeaux","Nimes Olympique","4-4",4,4,"1",1,8,0,"D"
1978-04-05,1977,"Stade Reims","FC Metz","0-0",0,0,"1",1,0,0,"D"
1978-04-05,1977,"US Valenciennes-Anzin","Olympique Lyon","1-0",1,0,"1",1,1,1,"H"
1978-04-08,1977,"RC Lens","AS Monaco","2-3",2,3,"1",1,5,-1,"D"
1978-04-08,1977,"FC Nantes","Olympique Marseille","1-0",1,0,"1",1,1,1,"H"
1978-04-08,1977,"FC Rouen","RC Strasbourg","0-3",0,3,"1",1,3,-3,"D"
1978-04-08,1977,"AS Saint-Etienne","Paris Saint-Germain","1-1",1,1,"1",1,2,0,"D"
1978-04-08,1977,"FC Sochaux","AS Nancy","2-0",2,0,"1",1,2,2,"H"
1978-04-08,1977,"OGC Nice","US Valenciennes-Anzin","0-2",0,2,"1",1,2,-2,"D"
1978-04-08,1977,"Stade Laval","SC Bastia","0-1",0,1,"1",1,1,-1,"D"
1978-04-08,1977,"FC Metz","Olympique Lyon","1-0",1,0,"1",1,1,1,"H"
1978-04-08,1977,"Troyes AF","Girondins Bordeaux","1-1",1,1,"1",1,2,0,"D"
1978-04-09,1977,"Nimes Olympique","Stade Reims","1-0",1,0,"1",1,1,1,"H"
1978-04-11,1977,"AS Nancy","FC Metz","0-0",0,0,"1",1,0,0,"D"
1978-04-15,1977,"Troyes AF","AS Saint-Etienne","1-0",1,0,"1",1,1,1,"H"
1978-04-20,1977,"Olympique Lyon","FC Rouen","4-0",4,0,"1",1,4,4,"H"
1978-04-21,1977,"AS Monaco","AS Saint-Etienne","3-1",3,1,"1",1,4,2,"H"
1978-04-21,1977,"US Valenciennes-Anzin","FC Nantes","0-2",0,2,"1",1,2,-2,"D"
1978-04-21,1977,"Olympique Marseille","FC Metz","4-0",4,0,"1",1,4,4,"H"
1978-04-21,1977,"RC Strasbourg","Nimes Olympique","3-0",3,0,"1",1,3,3,"H"
1978-04-21,1977,"Girondins Bordeaux","FC Sochaux","1-1",1,1,"1",1,2,0,"D"
1978-04-21,1977,"AS Nancy","Stade Laval","3-0",3,0,"1",1,3,3,"H"
1978-04-21,1977,"SC Bastia","OGC Nice","4-1",4,1,"1",1,5,3,"H"
1978-04-21,1977,"Paris Saint-Germain","RC Lens","2-1",2,1,"1",1,3,1,"H"
1978-04-21,1977,"Stade Reims","Troyes AF","5-1",5,1,"1",1,6,4,"H"
1978-04-25,1977,"FC Nantes","Olympique Lyon","2-0",2,0,"1",1,2,2,"H"
1978-04-25,1977,"Paris Saint-Germain","AS Monaco","1-2",1,2,"1",1,3,-1,"D"
1978-04-25,1977,"Troyes AF","RC Strasbourg","0-2",0,2,"1",1,2,-2,"D"
1978-04-25,1977,"Nimes Olympique","Olympique Marseille","2-1",2,1,"1",1,3,1,"H"
1978-04-25,1977,"OGC Nice","FC Rouen","6-1",6,1,"1",1,7,5,"H"
1978-04-25,1977,"FC Sochaux","Stade Reims","2-3",2,3,"1",1,5,-1,"D"
1978-04-25,1977,"RC Lens","AS Nancy","1-0",1,0,"1",1,1,1,"H"
1978-04-25,1977,"Stade Laval","Girondins Bordeaux","2-1",2,1,"1",1,3,1,"H"
1978-04-25,1977,"FC Metz","US Valenciennes-Anzin","1-1",1,1,"1",1,2,0,"D"
1978-04-28,1977,"AS Monaco","FC Metz","4-0",4,0,"1",1,4,4,"H"
1978-04-28,1977,"FC Rouen","FC Nantes","0-0",0,0,"1",1,0,0,"D"
1978-04-28,1977,"RC Strasbourg","FC Sochaux","1-1",1,1,"1",1,2,0,"D"
1978-04-28,1977,"Olympique Marseille","Troyes AF","0-1",0,1,"1",1,1,-1,"D"
1978-04-28,1977,"AS Nancy","AS Saint-Etienne","2-1",2,1,"1",1,3,1,"H"
1978-04-28,1977,"Olympique Lyon","OGC Nice","1-1",1,1,"1",1,2,0,"D"
1978-04-28,1977,"Stade Reims","Stade Laval","3-1",3,1,"1",1,4,2,"H"
1978-04-28,1977,"US Valenciennes-Anzin","Nimes Olympique","1-1",1,1,"1",1,2,0,"D"
1978-04-28,1977,"Girondins Bordeaux","RC Lens","0-1",0,1,"1",1,1,-1,"D"
1978-05-01,1977,"AS Saint-Etienne","SC Bastia","0-4",0,4,"1",1,4,-4,"D"
1978-05-02,1977,"AS Monaco","SC Bastia","2-1",2,1,"1",1,3,1,"H"
1978-05-02,1977,"FC Nantes","OGC Nice","6-1",6,1,"1",1,7,5,"H"
1978-05-02,1977,"Stade Laval","RC Strasbourg","2-3",2,3,"1",1,5,-1,"D"
1978-05-02,1977,"FC Sochaux","Olympique Marseille","1-2",1,2,"1",1,3,-1,"D"
1978-05-02,1977,"Paris Saint-Germain","AS Nancy","1-2",1,2,"1",1,3,-1,"D"
1978-05-02,1977,"AS Saint-Etienne","Girondins Bordeaux","5-0",5,0,"1",1,5,5,"H"
1978-05-02,1977,"FC Metz","FC Rouen","4-1",4,1,"1",1,5,3,"H"
1978-05-02,1977,"Nimes Olympique","Olympique Lyon","3-0",3,0,"1",1,3,3,"H"
1978-05-02,1977,"Troyes AF","US Valenciennes-Anzin","2-1",2,1,"1",1,3,1,"H"
1978-05-02,1977,"RC Lens","Stade Reims","3-1",3,1,"1",1,4,2,"H"
1978-05-04,1977,"SC Bastia","Paris Saint-Germain","5-3",5,3,"1",1,8,2,"H"
1978-05-12,1977,"FC Rouen","SC Bastia","0-0",0,0,"1",1,0,0,"D"
1978-07-19,1978,"OGC Nice","Angers SCO","3-1",3,1,"1",1,4,2,"H"
1978-07-19,1978,"Stade Reims","Paris Saint-Germain","2-0",2,0,"1",1,2,2,"H"
1978-07-19,1978,"Lille OSC","AS Nancy","4-3",4,3,"1",1,7,1,"H"
1978-07-19,1978,"FC Nantes","Stade Laval","2-1",2,1,"1",1,3,1,"H"
1978-07-19,1978,"FC Metz","Olympique Marseille","2-1",2,1,"1",1,3,1,"H"
1978-07-19,1978,"AS Saint-Etienne","SC Bastia","2-1",2,1,"1",1,3,1,"H"
1978-07-19,1978,"RC Strasbourg","Olympique Lyon","1-0",1,0,"1",1,1,1,"H"
1978-07-19,1978,"Nimes Olympique","AS Monaco","1-0",1,0,"1",1,1,1,"H"
1978-07-19,1978,"Girondins Bordeaux","FC Sochaux","1-1",1,1,"1",1,2,0,"D"
1978-07-19,1978,"Paris FC","US Valenciennes-Anzin","0-2",0,2,"1",1,2,-2,"D"
1978-07-25,1978,"Olympique Lyon","Stade Reims","1-1",1,1,"1",1,2,0,"D"
1978-07-25,1978,"US Valenciennes-Anzin","Lille OSC","4-2",4,2,"1",1,6,2,"H"
1978-07-25,1978,"Paris Saint-Germain","FC Metz","0-2",0,2,"1",1,2,-2,"D"
1978-07-25,1978,"Stade Laval","RC Strasbourg","2-2",2,2,"1",1,4,0,"D"
1978-07-25,1978,"FC Sochaux","OGC Nice","2-1",2,1,"1",1,3,1,"H"
1978-07-25,1978,"SC Bastia","Paris FC","5-1",5,1,"1",1,6,4,"H"
1978-07-25,1978,"AS Nancy","Nimes Olympique","3-0",3,0,"1",1,3,3,"H"
1978-07-25,1978,"Olympique Marseille","AS Saint-Etienne","2-0",2,0,"1",1,2,2,"H"
1978-07-25,1978,"AS Monaco","FC Nantes","2-1",2,1,"1",1,3,1,"H"
1978-07-25,1978,"Angers SCO","Girondins Bordeaux","0-0",0,0,"1",1,0,0,"D"
1978-07-28,1978,"FC Metz","US Valenciennes-Anzin","1-0",1,0,"1",1,1,1,"H"
1978-07-28,1978,"RC Strasbourg","FC Nantes","2-1",2,1,"1",1,3,1,"H"
1978-07-28,1978,"OGC Nice","Olympique Marseille","4-2",4,2,"1",1,6,2,"H"
1978-07-28,1978,"Stade Reims","Stade Laval","1-1",1,1,"1",1,2,0,"D"
1978-07-28,1978,"Girondins Bordeaux","SC Bastia","2-0",2,0,"1",1,2,2,"H"
1978-07-28,1978,"Lille OSC","AS Monaco","4-2",4,2,"1",1,6,2,"H"
1978-07-28,1978,"AS Saint-Etienne","FC Sochaux","3-1",3,1,"1",1,4,2,"H"
1978-07-28,1978,"Angers SCO","AS Nancy","2-1",2,1,"1",1,3,1,"H"
1978-07-28,1978,"Paris FC","Olympique Lyon","0-0",0,0,"1",1,0,0,"D"
1978-07-28,1978,"Nimes Olympique","Paris Saint-Germain","1-2",1,2,"1",1,3,-1,"D"
1978-08-02,1978,"Stade Laval","FC Metz","0-1",0,1,"1",1,1,-1,"D"
1978-08-02,1978,"AS Monaco","RC Strasbourg","0-2",0,2,"1",1,2,-2,"D"
1978-08-02,1978,"FC Sochaux","Angers SCO","4-0",4,0,"1",1,4,4,"H"
1978-08-02,1978,"US Valenciennes-Anzin","AS Saint-Etienne","0-0",0,0,"1",1,0,0,"D"
1978-08-02,1978,"Olympique Marseille","Girondins Bordeaux","0-0",0,0,"1",1,0,0,"D"
1978-08-02,1978,"Paris Saint-Germain","Lille OSC","0-0",0,0,"1",1,0,0,"D"
1978-08-02,1978,"AS Nancy","Paris FC","5-1",5,1,"1",1,6,4,"H"
1978-08-02,1978,"SC Bastia","OGC Nice","5-2",5,2,"1",1,7,3,"H"
1978-08-02,1978,"FC Nantes","Stade Reims","2-0",2,0,"1",1,2,2,"H"
1978-08-02,1978,"Olympique Lyon","Nimes Olympique","3-1",3,1,"1",1,4,2,"H"
1978-08-08,1978,"Stade Reims","RC Strasbourg","1-1",1,1,"1",1,2,0,"D"
1978-08-08,1978,"FC Metz","Olympique Lyon","1-2",1,2,"1",1,3,-1,"D"
1978-08-08,1978,"OGC Nice","US Valenciennes-Anzin","3-4",3,4,"1",1,7,-1,"D"
1978-08-08,1978,"Girondins Bordeaux","Paris Saint-Germain","2-0",2,0,"1",1,2,2,"H"
1978-08-08,1978,"Lille OSC","Stade Laval","5-3",5,3,"1",1,8,2,"H"
1978-08-08,1978,"AS Saint-Etienne","AS Nancy","3-2",3,2,"1",1,5,1,"H"
1978-08-08,1978,"Angers SCO","SC Bastia","0-2",0,2,"1",1,2,-2,"D"
1978-08-08,1978,"FC Sochaux","AS Monaco","1-2",1,2,"1",1,3,-1,"D"
1978-08-08,1978,"Nimes Olympique","FC Nantes","4-2",4,2,"1",1,6,2,"H"
1978-08-08,1978,"Paris FC","Olympique Marseille","2-1",2,1,"1",1,3,1,"H"
1978-08-18,1978,"RC Strasbourg","FC Metz","3-0",3,0,"1",1,3,3,"H"
1978-08-18,1978,"US Valenciennes-Anzin","Girondins Bordeaux","0-1",0,1,"1",1,1,-1,"D"
1978-08-18,1978,"SC Bastia","FC Sochaux","3-0",3,0,"1",1,3,3,"H"
1978-08-18,1978,"Olympique Lyon","AS Saint-Etienne","2-0",2,0,"1",1,2,2,"H"
1978-08-18,1978,"FC Nantes","Lille OSC","0-0",0,0,"1",1,0,0,"D"
1978-08-18,1978,"AS Nancy","OGC Nice","3-1",3,1,"1",1,4,2,"H"
1978-08-18,1978,"AS Monaco","Stade Reims","3-0",3,0,"1",1,3,3,"H"
1978-08-18,1978,"Stade Laval","Nimes Olympique","2-2",2,2,"1",1,4,0,"D"
1978-08-18,1978,"Olympique Marseille","Angers SCO","0-3",0,3,"1",1,3,-3,"D"
1978-08-18,1978,"Paris Saint-Germain","Paris FC","2-2",2,2,"1",1,4,0,"D"
1978-08-22,1978,"Lille OSC","RC Strasbourg","1-2",1,2,"1",1,3,-1,"D"
1978-08-22,1978,"Girondins Bordeaux","AS Nancy","0-0",0,0,"1",1,0,0,"D"
1978-08-22,1978,"AS Saint-Etienne","FC Nantes","3-1",3,1,"1",1,4,2,"H"
1978-08-22,1978,"FC Metz","AS Monaco","1-1",1,1,"1",1,2,0,"D"
1978-08-22,1978,"SC Bastia","Olympique Marseille","1-3",1,3,"1",1,4,-2,"D"
1978-08-22,1978,"FC Sochaux","Olympique Lyon","5-1",5,1,"1",1,6,4,"H"
1978-08-22,1978,"Angers SCO","US Valenciennes-Anzin","1-0",1,0,"1",1,1,1,"H"
1978-08-22,1978,"Nimes Olympique","Stade Reims","4-0",4,0,"1",1,4,4,"H"
1978-08-22,1978,"OGC Nice","Paris Saint-Germain","1-3",1,3,"1",1,4,-2,"D"
1978-08-22,1978,"Paris FC","Stade Laval","2-2",2,2,"1",1,4,0,"D"
1978-08-25,1978,"RC Strasbourg","Nimes Olympique","0-0",0,0,"1",1,0,0,"D"
1978-08-25,1978,"Olympique Lyon","OGC Nice","4-0",4,0,"1",1,4,4,"H"
1978-08-25,1978,"Stade Laval","Girondins Bordeaux","3-1",3,1,"1",1,4,2,"H"
1978-08-25,1978,"Paris Saint-Germain","AS Saint-Etienne","1-1",1,1,"1",1,2,0,"D"
1978-08-25,1978,"AS Nancy","FC Metz","1-1",1,1,"1",1,2,0,"D"
1978-08-25,1978,"US Valenciennes-Anzin","SC Bastia","3-0",3,0,"1",1,3,3,"H"
1978-08-25,1978,"Stade Reims","Lille OSC","0-0",0,0,"1",1,0,0,"D"
1978-08-25,1978,"AS Monaco","Paris FC","2-1",2,1,"1",1,3,1,"H"
1978-08-25,1978,"Olympique Marseille","FC Sochaux","2-2",2,2,"1",1,4,0,"D"
1978-08-25,1978,"FC Nantes","Angers SCO","5-0",5,0,"1",1,5,5,"H"
1978-09-03,1978,"Lille OSC","Nimes Olympique","1-1",1,1,"1",1,2,0,"D"
1978-09-03,1978,"Angers SCO","Paris Saint-Germain","2-2",2,2,"1",1,4,0,"D"
1978-09-05,1978,"Paris FC","RC Strasbourg","0-1",0,1,"1",1,1,-1,"D"
1978-09-05,1978,"Girondins Bordeaux","Olympique Lyon","4-1",4,1,"1",1,5,3,"H"
1978-09-05,1978,"AS Saint-Etienne","AS Monaco","4-1",4,1,"1",1,5,3,"H"
1978-09-05,1978,"FC Metz","Stade Reims","4-1",4,1,"1",1,5,3,"H"
1978-09-05,1978,"SC Bastia","AS Nancy","5-1",5,1,"1",1,6,4,"H"
1978-09-05,1978,"FC Sochaux","US Valenciennes-Anzin","3-0",3,0,"1",1,3,3,"H"
1978-09-05,1978,"Olympique Marseille","FC Nantes","1-1",1,1,"1",1,2,0,"D"
1978-09-05,1978,"OGC Nice","Stade Laval","2-1",2,1,"1",1,3,1,"H"
1978-09-08,1978,"RC Strasbourg","Angers SCO","6-0",6,0,"1",1,6,6,"H"
1978-09-08,1978,"Stade Reims","Girondins Bordeaux","0-0",0,0,"1",1,0,0,"D"
1978-09-08,1978,"AS Nancy","FC Sochaux","1-2",1,2,"1",1,3,-1,"D"
1978-09-08,1978,"Olympique Lyon","Lille OSC","4-0",4,0,"1",1,4,4,"H"
1978-09-08,1978,"Stade Laval","AS Saint-Etienne","2-1",2,1,"1",1,3,1,"H"
1978-09-08,1978,"Nimes Olympique","FC Metz","2-0",2,0,"1",1,2,2,"H"
1978-09-08,1978,"AS Monaco","OGC Nice","6-1",6,1,"1",1,7,5,"H"
1978-09-08,1978,"Paris Saint-Germain","SC Bastia","4-0",4,0,"1",1,4,4,"H"
1978-09-08,1978,"FC Nantes","Paris FC","2-0",2,0,"1",1,2,2,"H"
1978-09-08,1978,"US Valenciennes-Anzin","Olympique Marseille","0-2",0,2,"1",1,2,-2,"D"
1978-09-19,1978,"OGC Nice","RC Strasbourg","0-0",0,0,"1",1,0,0,"D"
1978-09-19,1978,"FC Sochaux","Paris Saint-Germain","2-1",2,1,"1",1,3,1,"H"
1978-09-19,1978,"AS Saint-Etienne","Stade Reims","2-0",2,0,"1",1,2,2,"H"
1978-09-19,1978,"Girondins Bordeaux","FC Nantes","1-1",1,1,"1",1,2,0,"D"
1978-09-19,1978,"Olympique Marseille","AS Monaco","1-2",1,2,"1",1,3,-1,"D"
1978-09-19,1978,"FC Metz","Lille OSC","4-4",4,4,"1",1,8,0,"D"
1978-09-19,1978,"SC Bastia","Olympique Lyon","1-0",1,0,"1",1,1,1,"H"
1978-09-19,1978,"Paris FC","Nimes Olympique","1-0",1,0,"1",1,1,1,"H"
1978-09-19,1978,"US Valenciennes-Anzin","AS Nancy","1-0",1,0,"1",1,1,1,"H"
1978-09-19,1978,"Angers SCO","Stade Laval","1-1",1,1,"1",1,2,0,"D"
1978-09-22,1978,"RC Strasbourg","AS Saint-Etienne","2-1",2,1,"1",1,3,1,"H"
1978-09-22,1978,"AS Monaco","SC Bastia","6-0",6,0,"1",1,6,6,"H"
1978-09-22,1978,"Stade Laval","FC Sochaux","1-1",1,1,"1",1,2,0,"D"
1978-09-22,1978,"Olympique Lyon","Angers SCO","3-0",3,0,"1",1,3,3,"H"
1978-09-22,1978,"Nimes Olympique","Girondins Bordeaux","4-2",4,2,"1",1,6,2,"H"
1978-09-22,1978,"FC Nantes","FC Metz","1-0",1,0,"1",1,1,1,"H"
1978-09-22,1978,"Lille OSC","Paris FC","4-2",4,2,"1",1,6,2,"H"
1978-09-22,1978,"Paris Saint-Germain","US Valenciennes-Anzin","2-0",2,0,"1",1,2,2,"H"
1978-09-22,1978,"AS Nancy","Olympique Marseille","5-0",5,0,"1",1,5,5,"H"
1978-09-22,1978,"Stade Reims","OGC Nice","2-2",2,2,"1",1,4,0,"D"
1978-09-30,1978,"Girondins Bordeaux","RC Strasbourg","1-1",1,1,"1",1,2,0,"D"
1978-09-30,1978,"FC Sochaux","FC Nantes","3-1",3,1,"1",1,4,2,"H"
1978-09-30,1978,"US Valenciennes-Anzin","AS Monaco","0-0",0,0,"1",1,0,0,"D"
1978-09-30,1978,"AS Saint-Etienne","Lille OSC","5-1",5,1,"1",1,6,4,"H"
1978-09-30,1978,"AS Nancy","Olympique Lyon","1-1",1,1,"1",1,2,0,"D"
1978-09-30,1978,"OGC Nice","Nimes Olympique","1-2",1,2,"1",1,3,-1,"D"
1978-09-30,1978,"Paris FC","FC Metz","1-2",1,2,"1",1,3,-1,"D"
1978-09-30,1978,"SC Bastia","Stade Laval","2-2",2,2,"1",1,4,0,"D"
1978-09-30,1978,"Olympique Marseille","Paris Saint-Germain","4-1",4,1,"1",1,5,3,"H"
1978-09-30,1978,"Angers SCO","Stade Reims","3-0",3,0,"1",1,3,3,"H"
1978-10-11,1978,"AS Monaco","Angers SCO","3-0",3,0,"1",1,3,3,"H"
1978-10-11,1978,"Olympique Lyon","US Valenciennes-Anzin","3-0",3,0,"1",1,3,3,"H"
1978-10-11,1978,"Nimes Olympique","AS Saint-Etienne","2-2",2,2,"1",1,4,0,"D"
1978-10-11,1978,"FC Metz","Girondins Bordeaux","1-0",1,0,"1",1,1,1,"H"
1978-10-11,1978,"FC Nantes","SC Bastia","1-0",1,0,"1",1,1,1,"H"
1978-10-11,1978,"Lille OSC","OGC Nice","4-0",4,0,"1",1,4,4,"H"
1978-10-11,1978,"Paris Saint-Germain","AS Nancy","2-1",2,1,"1",1,3,1,"H"
1978-10-11,1978,"Stade Laval","Olympique Marseille","2-1",2,1,"1",1,3,1,"H"
1978-10-11,1978,"Stade Reims","Paris FC","0-2",0,2,"1",1,2,-2,"D"
1978-10-14,1978,"SC Bastia","RC Strasbourg","1-1",1,1,"1",1,2,0,"D"
1978-10-14,1978,"AS Nancy","AS Monaco","1-2",1,2,"1",1,3,-1,"D"
1978-10-14,1978,"AS Saint-Etienne","Paris FC","6-0",6,0,"1",1,6,6,"H"
1978-10-14,1978,"FC Sochaux","Stade Reims","2-1",2,1,"1",1,3,1,"H"
1978-10-14,1978,"Olympique Marseille","Olympique Lyon","2-2",2,2,"1",1,4,0,"D"
1978-10-14,1978,"OGC Nice","FC Metz","5-0",5,0,"1",1,5,5,"H"
1978-10-14,1978,"Angers SCO","Nimes Olympique","2-1",2,1,"1",1,3,1,"H"
1978-10-14,1978,"Paris Saint-Germain","FC Nantes","1-1",1,1,"1",1,2,0,"D"
1978-10-14,1978,"Girondins Bordeaux","Lille OSC","1-1",1,1,"1",1,2,0,"D"
1978-10-14,1978,"US Valenciennes-Anzin","Stade Laval","1-1",1,1,"1",1,2,0,"D"
1978-10-20,1978,"FC Metz","AS Saint-Etienne","0-1",0,1,"1",1,1,-1,"D"
1978-10-21,1978,"RC Strasbourg","Olympique Marseille","4-1",4,1,"1",1,5,3,"H"
1978-10-21,1978,"AS Monaco","Girondins Bordeaux","2-2",2,2,"1",1,4,0,"D"
1978-10-21,1978,"Olympique Lyon","Paris Saint-Germain","4-2",4,2,"1",1,6,2,"H"
1978-10-21,1978,"Nimes Olympique","FC Sochaux","2-1",2,1,"1",1,3,1,"H"
1978-10-21,1978,"FC Nantes","US Valenciennes-Anzin","4-0",4,0,"1",1,4,4,"H"
1978-10-21,1978,"Lille OSC","Angers SCO","0-0",0,0,"1",1,0,0,"D"
1978-10-21,1978,"Stade Reims","SC Bastia","1-1",1,1,"1",1,2,0,"D"
1978-10-21,1978,"Stade Laval","AS Nancy","1-4",1,4,"1",1,5,-3,"D"
1978-10-21,1978,"Paris FC","OGC Nice","3-0",3,0,"1",1,3,3,"H"
1978-10-27,1978,"US Valenciennes-Anzin","RC Strasbourg","2-2",2,2,"1",1,4,0,"D"
1978-10-27,1978,"OGC Nice","AS Saint-Etienne","1-1",1,1,"1",1,2,0,"D"
1978-10-27,1978,"Olympique Lyon","AS Monaco","0-0",0,0,"1",1,0,0,"D"
1978-10-27,1978,"FC Sochaux","Lille OSC","1-1",1,1,"1",1,2,0,"D"
1978-10-27,1978,"AS Nancy","FC Nantes","3-2",3,2,"1",1,5,1,"H"
1978-10-27,1978,"SC Bastia","Nimes Olympique","1-0",1,0,"1",1,1,1,"H"
1978-10-27,1978,"Girondins Bordeaux","Paris FC","1-2",1,2,"1",1,3,-1,"D"
1978-10-27,1978,"Angers SCO","FC Metz","3-1",3,1,"1",1,4,2,"H"
1978-10-27,1978,"Paris Saint-Germain","Stade Laval","1-2",1,2,"1",1,3,-1,"D"
1978-10-28,1978,"Olympique Marseille","Stade Reims","0-0",0,0,"1",1,0,0,"D"
1978-11-04,1978,"RC Strasbourg","AS Nancy","3-0",3,0,"1",1,3,3,"H"
1978-11-04,1978,"AS Monaco","Paris Saint-Germain","2-1",2,1,"1",1,3,1,"H"
1978-11-04,1978,"AS Saint-Etienne","Girondins Bordeaux","1-3",1,3,"1",1,4,-2,"D"
1978-11-04,1978,"Stade Laval","Olympique Lyon","3-1",3,1,"1",1,4,2,"H"
1978-11-04,1978,"FC Metz","FC Sochaux","0-0",0,0,"1",1,0,0,"D"
1978-11-04,1978,"FC Nantes","OGC Nice","5-0",5,0,"1",1,5,5,"H"
1978-11-04,1978,"Lille OSC","SC Bastia","2-2",2,2,"1",1,4,0,"D"
1978-11-04,1978,"Nimes Olympique","Olympique Marseille","1-2",1,2,"1",1,3,-1,"D"
1978-11-04,1978,"Paris FC","Angers SCO","3-0",3,0,"1",1,3,3,"H"
1978-11-04,1978,"Stade Reims","US Valenciennes-Anzin","2-1",2,1,"1",1,3,1,"H"
1978-11-14,1978,"Paris Saint-Germain","RC Strasbourg","2-1",2,1,"1",1,3,1,"H"
1978-11-14,1978,"Stade Laval","AS Monaco","0-3",0,3,"1",1,3,-3,"D"
1978-11-14,1978,"Angers SCO","AS Saint-Etienne","1-3",1,3,"1",1,4,-2,"D"
1978-11-14,1978,"FC Sochaux","Paris FC","1-0",1,0,"1",1,1,1,"H"
1978-11-14,1978,"Olympique Lyon","FC Nantes","0-3",0,3,"1",1,3,-3,"D"
1978-11-14,1978,"Girondins Bordeaux","OGC Nice","2-0",2,0,"1",1,2,2,"H"
1978-11-14,1978,"Olympique Marseille","Lille OSC","1-1",1,1,"1",1,2,0,"D"
1978-11-14,1978,"SC Bastia","FC Metz","1-3",1,3,"1",1,4,-2,"D"
1978-11-14,1978,"US Valenciennes-Anzin","Nimes Olympique","2-0",2,0,"1",1,2,2,"H"
1978-11-14,1978,"AS Nancy","Stade Reims","4-0",4,0,"1",1,4,4,"H"
1978-11-17,1978,"RC Strasbourg","Stade Laval","1-1",1,1,"1",1,2,0,"D"
1978-11-17,1978,"AS Saint-Etienne","Olympique Marseille","1-0",1,0,"1",1,1,1,"H"
1978-11-17,1978,"FC Nantes","AS Monaco","3-0",3,0,"1",1,3,3,"H"
1978-11-17,1978,"OGC Nice","FC Sochaux","2-1",2,1,"1",1,3,1,"H"
1978-11-17,1978,"Stade Reims","Olympique Lyon","1-2",1,2,"1",1,3,-1,"D"
1978-11-17,1978,"Girondins Bordeaux","Angers SCO","2-0",2,0,"1",1,2,2,"H"
1978-11-17,1978,"Lille OSC","US Valenciennes-Anzin","2-1",2,1,"1",1,3,1,"H"
1978-11-17,1978,"FC Metz","Paris Saint-Germain","2-1",2,1,"1",1,3,1,"H"
1978-11-17,1978,"Paris FC","SC Bastia","1-1",1,1,"1",1,2,0,"D"
1978-11-18,1978,"Nimes Olympique","AS Nancy","3-0",3,0,"1",1,3,3,"H"
1978-11-25,1978,"FC Nantes","RC Strasbourg","3-0",3,0,"1",1,3,3,"H"
1978-11-25,1978,"AS Monaco","Lille OSC","2-1",2,1,"1",1,3,1,"H"
1978-11-25,1978,"SC Bastia","Girondins Bordeaux","1-1",1,1,"1",1,2,0,"D"
1978-11-25,1978,"US Valenciennes-Anzin","FC Metz","2-2",2,2,"1",1,4,0,"D"
1978-11-25,1978,"Stade Laval","Stade Reims","1-0",1,0,"1",1,1,1,"H"
1978-11-25,1978,"Paris Saint-Germain","Nimes Olympique","3-2",3,2,"1",1,5,1,"H"
1978-11-26,1978,"FC Sochaux","AS Saint-Etienne","0-0",0,0,"1",1,0,0,"D"
1978-11-26,1978,"Olympique Lyon","Paris FC","2-1",2,1,"1",1,3,1,"H"
1978-11-26,1978,"AS Nancy","Angers SCO","2-2",2,2,"1",1,4,0,"D"
1978-11-26,1978,"Olympique Marseille","OGC Nice","0-0",0,0,"1",1,0,0,"D"
1978-12-01,1978,"RC Strasbourg","AS Monaco","2-1",2,1,"1",1,3,1,"H"
1978-12-02,1978,"Girondins Bordeaux","Olympique Marseille","2-1",2,1,"1",1,3,1,"H"
1978-12-02,1978,"FC Metz","Stade Laval","5-1",5,1,"1",1,6,4,"H"
1978-12-02,1978,"Angers SCO","FC Sochaux","3-2",3,2,"1",1,5,1,"H"
1978-12-02,1978,"Lille OSC","Paris Saint-Germain","3-1",3,1,"1",1,4,2,"H"
1978-12-02,1978,"OGC Nice","SC Bastia","2-2",2,2,"1",1,4,0,"D"
1978-12-03,1978,"AS Saint-Etienne","US Valenciennes-Anzin","5-0",5,0,"1",1,5,5,"H"
1978-12-03,1978,"Stade Reims","FC Nantes","1-4",1,4,"1",1,5,-3,"D"
1978-12-03,1978,"Nimes Olympique","Olympique Lyon","2-2",2,2,"1",1,4,0,"D"
1978-12-03,1978,"Paris FC","AS Nancy","1-1",1,1,"1",1,2,0,"D"
1978-12-09,1978,"FC Nantes","Nimes Olympique","4-0",4,0,"1",1,4,4,"H"
1978-12-09,1978,"Stade Laval","Lille OSC","3-3",3,3,"1",1,6,0,"D"
1978-12-09,1978,"SC Bastia","Angers SCO","1-0",1,0,"1",1,1,1,"H"
1978-12-09,1978,"US Valenciennes-Anzin","OGC Nice","0-3",0,3,"1",1,3,-3,"D"
1978-12-10,1978,"RC Strasbourg","Stade Reims","2-2",2,2,"1",1,4,0,"D"
1978-12-10,1978,"AS Nancy","AS Saint-Etienne","1-1",1,1,"1",1,2,0,"D"
1978-12-10,1978,"AS Monaco","FC Sochaux","1-1",1,1,"1",1,2,0,"D"
1978-12-10,1978,"Paris Saint-Germain","Girondins Bordeaux","2-5",2,5,"1",1,7,-3,"D"
1978-12-10,1978,"Olympique Lyon","FC Metz","3-1",3,1,"1",1,4,2,"H"
1978-12-10,1978,"Olympique Marseille","Paris FC","1-1",1,1,"1",1,2,0,"D"
1978-12-16,1978,"FC Metz","RC Strasbourg","1-2",1,2,"1",1,3,-1,"D"
1978-12-16,1978,"Lille OSC","FC Nantes","1-3",1,3,"1",1,4,-2,"D"
1978-12-16,1978,"Stade Reims","AS Monaco","0-2",0,2,"1",1,2,-2,"D"
1978-12-16,1978,"Girondins Bordeaux","US Valenciennes-Anzin","1-0",1,0,"1",1,1,1,"H"
1978-12-16,1978,"Nimes Olympique","Stade Laval","4-0",4,0,"1",1,4,4,"H"
1978-12-16,1978,"OGC Nice","AS Nancy","2-2",2,2,"1",1,4,0,"D"
1978-12-16,1978,"Angers SCO","Olympique Marseille","1-1",1,1,"1",1,2,0,"D"
1978-12-17,1978,"AS Saint-Etienne","Olympique Lyon","3-0",3,0,"1",1,3,3,"H"
1978-12-17,1978,"FC Sochaux","SC Bastia","5-0",5,0,"1",1,5,5,"H"
1978-12-17,1978,"Paris FC","Paris Saint-Germain","1-1",1,1,"1",1,2,0,"D"
1979-01-27,1978,"RC Strasbourg","Lille OSC","3-0",3,0,"1",1,3,3,"H"
1979-01-27,1978,"FC Nantes","AS Saint-Etienne","3-1",3,1,"1",1,4,2,"H"
1979-01-27,1978,"Stade Reims","Nimes Olympique","0-0",0,0,"1",1,0,0,"D"
1979-01-27,1978,"Stade Laval","Paris FC","5-1",5,1,"1",1,6,4,"H"
1979-01-27,1978,"US Valenciennes-Anzin","Angers SCO","1-1",1,1,"1",1,2,0,"D"
1979-01-28,1978,"AS Monaco","FC Metz","4-1",4,1,"1",1,5,3,"H"
1979-01-28,1978,"Olympique Marseille","SC Bastia","1-0",1,0,"1",1,1,1,"H"
1979-01-28,1978,"Paris Saint-Germain","OGC Nice","1-1",1,1,"1",1,2,0,"D"
1979-02-03,1978,"Angers SCO","FC Nantes","1-1",1,1,"1",1,2,0,"D"
1979-02-03,1978,"Girondins Bordeaux","Stade Laval","1-1",1,1,"1",1,2,0,"D"
1979-02-03,1978,"Lille OSC","Stade Reims","4-0",4,0,"1",1,4,4,"H"
1979-02-03,1978,"SC Bastia","US Valenciennes-Anzin","2-0",2,0,"1",1,2,2,"H"
1979-02-04,1978,"Nimes Olympique","RC Strasbourg","0-0",0,0,"1",1,0,0,"D"
1979-02-04,1978,"Paris FC","AS Monaco","1-7",1,7,"1",1,8,-6,"D"
1979-02-04,1978,"AS Saint-Etienne","Paris Saint-Germain","4-1",4,1,"1",1,5,3,"H"
1979-02-04,1978,"FC Sochaux","Olympique Marseille","2-2",2,2,"1",1,4,0,"D"
1979-02-04,1978,"OGC Nice","Olympique Lyon","4-0",4,0,"1",1,4,4,"H"
1979-02-14,1978,"RC Strasbourg","FC Sochaux","2-1",2,1,"1",1,3,1,"H"
1979-02-17,1978,"FC Nantes","Olympique Marseille","2-2",2,2,"1",1,4,0,"D"
1979-02-17,1978,"AS Monaco","AS Saint-Etienne","0-1",0,1,"1",1,1,-1,"D"
1979-02-17,1978,"Stade Laval","OGC Nice","1-2",1,2,"1",1,3,-1,"D"
1979-02-18,1978,"RC Strasbourg","Paris FC","3-0",3,0,"1",1,3,3,"H"
1979-02-18,1978,"Olympique Lyon","Girondins Bordeaux","0-1",0,1,"1",1,1,-1,"D"
1979-02-18,1978,"Nimes Olympique","Lille OSC","3-2",3,2,"1",1,5,1,"H"
1979-02-18,1978,"Stade Reims","FC Metz","1-2",1,2,"1",1,3,-1,"D"
1979-02-18,1978,"Paris Saint-Germain","Angers SCO","1-1",1,1,"1",1,2,0,"D"
1979-03-02,1978,"Angers SCO","RC Strasbourg","1-2",1,2,"1",1,3,-1,"D"
1979-03-02,1978,"Paris FC","FC Nantes","1-2",1,2,"1",1,3,-1,"D"
1979-03-02,1978,"AS Saint-Etienne","Stade Laval","3-0",3,0,"1",1,3,3,"H"
1979-03-02,1978,"OGC Nice","AS Monaco","1-2",1,2,"1",1,3,-1,"D"
1979-03-02,1978,"Girondins Bordeaux","Stade Reims","0-0",0,0,"1",1,0,0,"D"
1979-03-02,1978,"Lille OSC","Olympique Lyon","1-1",1,1,"1",1,2,0,"D"
1979-03-02,1978,"FC Metz","Nimes Olympique","2-0",2,0,"1",1,2,2,"H"
1979-03-02,1978,"FC Sochaux","AS Nancy","1-2",1,2,"1",1,3,-1,"D"
1979-03-02,1978,"SC Bastia","Paris Saint-Germain","1-2",1,2,"1",1,3,-1,"D"
1979-03-02,1978,"Olympique Marseille","US Valenciennes-Anzin","1-0",1,0,"1",1,1,1,"H"
1979-03-06,1978,"AS Nancy","Girondins Bordeaux","4-1",4,1,"1",1,5,3,"H"
1979-03-06,1978,"Olympique Lyon","FC Sochaux","1-0",1,0,"1",1,1,1,"H"
1979-03-16,1978,"RC Strasbourg","OGC Nice","1-0",1,0,"1",1,1,1,"H"
1979-03-16,1978,"FC Nantes","Girondins Bordeaux","1-0",1,0,"1",1,1,1,"H"
1979-03-16,1978,"Stade Reims","AS Saint-Etienne","0-1",0,1,"1",1,1,-1,"D"
1979-03-16,1978,"AS Monaco","Olympique Marseille","1-2",1,2,"1",1,3,-1,"D"
1979-03-16,1978,"Olympique Lyon","SC Bastia","1-1",1,1,"1",1,2,0,"D"
1979-03-16,1978,"Lille OSC","FC Metz","1-1",1,1,"1",1,2,0,"D"
1979-03-16,1978,"Nimes Olympique","Paris FC","2-0",2,0,"1",1,2,2,"H"
1979-03-16,1978,"AS Nancy","US Valenciennes-Anzin","4-0",4,0,"1",1,4,4,"H"
1979-03-16,1978,"Stade Laval","Angers SCO","1-2",1,2,"1",1,3,-1,"D"
1979-03-16,1978,"Paris Saint-Germain","FC Sochaux","3-1",3,1,"1",1,4,2,"H"
1979-03-28,1978,"AS Saint-Etienne","RC Strasbourg","2-0",2,0,"1",1,2,2,"H"
1979-03-28,1978,"FC Metz","FC Nantes","1-3",1,3,"1",1,4,-2,"D"
1979-03-28,1978,"SC Bastia","AS Monaco","4-1",4,1,"1",1,5,3,"H"
1979-03-28,1978,"Girondins Bordeaux","Nimes Olympique","0-0",0,0,"1",1,0,0,"D"
1979-03-28,1978,"Angers SCO","Olympique Lyon","1-1",1,1,"1",1,2,0,"D"
1979-03-28,1978,"FC Sochaux","Stade Laval","2-1",2,1,"1",1,3,1,"H"
1979-03-28,1978,"Paris FC","Lille OSC","1-1",1,1,"1",1,2,0,"D"
1979-03-28,1978,"Olympique Marseille","AS Nancy","3-2",3,2,"1",1,5,1,"H"
1979-03-28,1978,"US Valenciennes-Anzin","Paris Saint-Germain","1-0",1,0,"1",1,1,1,"H"
1979-03-28,1978,"OGC Nice","Stade Reims","2-0",2,0,"1",1,2,2,"H"
1979-04-07,1978,"RC Strasbourg","Girondins Bordeaux","1-1",1,1,"1",1,2,0,"D"
1979-04-07,1978,"FC Nantes","FC Sochaux","4-0",4,0,"1",1,4,4,"H"
1979-04-07,1978,"Lille OSC","AS Saint-Etienne","3-0",3,0,"1",1,3,3,"H"
1979-04-07,1978,"AS Monaco","US Valenciennes-Anzin","2-2",2,2,"1",1,4,0,"D"
1979-04-07,1978,"Olympique Lyon","AS Nancy","2-1",2,1,"1",1,3,1,"H"
1979-04-07,1978,"Nimes Olympique","OGC Nice","4-1",4,1,"1",1,5,3,"H"
1979-04-07,1978,"FC Metz","Paris FC","5-1",5,1,"1",1,6,4,"H"
1979-04-07,1978,"Stade Laval","SC Bastia","0-1",0,1,"1",1,1,-1,"D"
1979-04-07,1978,"Paris Saint-Germain","Olympique Marseille","4-3",4,3,"1",1,7,1,"H"
1979-04-07,1978,"Stade Reims","Angers SCO","3-1",3,1,"1",1,4,2,"H"
1979-04-12,1978,"US Valenciennes-Anzin","FC Sochaux","0-1",0,1,"1",1,1,-1,"D"
1979-04-20,1978,"FC Sochaux","RC Strasbourg","1-2",1,2,"1",1,3,-1,"D"
1979-04-20,1978,"SC Bastia","FC Nantes","1-0",1,0,"1",1,1,1,"H"
1979-04-20,1978,"AS Saint-Etienne","Nimes Olympique","2-0",2,0,"1",1,2,2,"H"
1979-04-20,1978,"Angers SCO","AS Monaco","2-2",2,2,"1",1,4,0,"D"
1979-04-20,1978,"Girondins Bordeaux","FC Metz","1-2",1,2,"1",1,3,-1,"D"
1979-04-20,1978,"US Valenciennes-Anzin","Olympique Lyon","3-1",3,1,"1",1,4,2,"H"
1979-04-20,1978,"OGC Nice","Lille OSC","1-1",1,1,"1",1,2,0,"D"
1979-04-20,1978,"Olympique Marseille","Stade Laval","0-0",0,0,"1",1,0,0,"D"
1979-04-20,1978,"AS Nancy","Paris Saint-Germain","2-1",2,1,"1",1,3,1,"H"
1979-04-20,1978,"Paris FC","Stade Reims","2-1",2,1,"1",1,3,1,"H"
1979-04-24,1978,"FC Metz","AS Nancy","3-1",3,1,"1",1,4,2,"H"
1979-04-27,1978,"RC Strasbourg","SC Bastia","2-0",2,0,"1",1,2,2,"H"
1979-04-27,1978,"FC Nantes","Paris Saint-Germain","1-0",1,0,"1",1,1,1,"H"
1979-04-27,1978,"Paris FC","AS Saint-Etienne","0-1",0,1,"1",1,1,-1,"D"
1979-04-27,1978,"AS Monaco","AS Nancy","1-3",1,3,"1",1,4,-2,"D"
1979-04-27,1978,"FC Metz","OGC Nice","2-0",2,0,"1",1,2,2,"H"
1979-04-27,1978,"Lille OSC","Girondins Bordeaux","1-1",1,1,"1",1,2,0,"D"
1979-04-27,1978,"Olympique Lyon","Olympique Marseille","1-1",1,1,"1",1,2,0,"D"
1979-04-27,1978,"Nimes Olympique","Angers SCO","3-0",3,0,"1",1,3,3,"H"
1979-04-27,1978,"Stade Laval","US Valenciennes-Anzin","1-1",1,1,"1",1,2,0,"D"
1979-04-28,1978,"Stade Reims","FC Sochaux","0-2",0,2,"1",1,2,-2,"D"
1979-05-05,1978,"Olympique Marseille","RC Strasbourg","1-0",1,0,"1",1,1,1,"H"
1979-05-05,1978,"AS Saint-Etienne","FC Metz","1-0",1,0,"1",1,1,1,"H"
1979-05-05,1978,"US Valenciennes-Anzin","FC Nantes","1-1",1,1,"1",1,2,0,"D"
1979-05-05,1978,"Girondins Bordeaux","AS Monaco","0-2",0,2,"1",1,2,-2,"D"
1979-05-05,1978,"Paris Saint-Germain","Olympique Lyon","2-1",2,1,"1",1,3,1,"H"
1979-05-05,1978,"FC Sochaux","Nimes Olympique","2-2",2,2,"1",1,4,0,"D"
1979-05-05,1978,"Angers SCO","Lille OSC","1-1",1,1,"1",1,2,0,"D"
1979-05-05,1978,"SC Bastia","Stade Reims","3-2",3,2,"1",1,5,1,"H"
1979-05-05,1978,"AS Nancy","Stade Laval","2-3",2,3,"1",1,5,-1,"D"
1979-05-05,1978,"OGC Nice","Paris FC","5-0",5,0,"1",1,5,5,"H"
1979-05-15,1978,"AS Nancy","SC Bastia","5-1",5,1,"1",1,6,4,"H"
1979-05-18,1978,"RC Strasbourg","US Valenciennes-Anzin","5-0",5,0,"1",1,5,5,"H"
1979-05-18,1978,"AS Saint-Etienne","OGC Nice","5-1",5,1,"1",1,6,4,"H"
1979-05-18,1978,"FC Nantes","AS Nancy","3-0",3,0,"1",1,3,3,"H"
1979-05-18,1978,"AS Monaco","Olympique Lyon","0-1",0,1,"1",1,1,-1,"D"
1979-05-18,1978,"FC Metz","Angers SCO","1-0",1,0,"1",1,1,1,"H"
1979-05-18,1978,"Nimes Olympique","SC Bastia","3-2",3,2,"1",1,5,1,"H"
1979-05-18,1978,"Lille OSC","FC Sochaux","4-2",4,2,"1",1,6,2,"H"
1979-05-18,1978,"Paris FC","Girondins Bordeaux","3-1",3,1,"1",1,4,2,"H"
1979-05-18,1978,"Stade Reims","Olympique Marseille","0-1",0,1,"1",1,1,-1,"D"
1979-05-18,1978,"Stade Laval","Paris Saint-Germain","2-3",2,3,"1",1,5,-1,"D"
1979-05-25,1978,"AS Nancy","RC Strasbourg","0-0",0,0,"1",1,0,0,"D"
1979-05-25,1978,"OGC Nice","FC Nantes","1-1",1,1,"1",1,2,0,"D"
1979-05-25,1978,"Girondins Bordeaux","AS Saint-Etienne","2-1",2,1,"1",1,3,1,"H"
1979-05-25,1978,"Paris Saint-Germain","AS Monaco","3-0",3,0,"1",1,3,3,"H"
1979-05-25,1978,"Olympique Lyon","Stade Laval","1-0",1,0,"1",1,1,1,"H"
1979-05-25,1978,"FC Sochaux","FC Metz","4-0",4,0,"1",1,4,4,"H"
1979-05-25,1978,"SC Bastia","Lille OSC","0-0",0,0,"1",1,0,0,"D"
1979-05-25,1978,"Olympique Marseille","Nimes Olympique","2-0",2,0,"1",1,2,2,"H"
1979-05-25,1978,"Angers SCO","Paris FC","0-0",0,0,"1",1,0,0,"D"
1979-05-25,1978,"US Valenciennes-Anzin","Stade Reims","3-0",3,0,"1",1,3,3,"H"
1979-05-29,1978,"RC Strasbourg","Paris Saint-Germain","3-0",3,0,"1",1,3,3,"H"
1979-05-29,1978,"FC Nantes","Olympique Lyon","5-1",5,1,"1",1,6,4,"H"
1979-05-29,1978,"AS Saint-Etienne","Angers SCO","4-0",4,0,"1",1,4,4,"H"
1979-05-29,1978,"AS Monaco","Stade Laval","2-2",2,2,"1",1,4,0,"D"
1979-05-29,1978,"FC Metz","SC Bastia","3-1",3,1,"1",1,4,2,"H"
1979-05-29,1978,"Lille OSC","Olympique Marseille","2-0",2,0,"1",1,2,2,"H"
1979-05-29,1978,"Nimes Olympique","US Valenciennes-Anzin","5-0",5,0,"1",1,5,5,"H"
1979-05-29,1978,"OGC Nice","Girondins Bordeaux","2-1",2,1,"1",1,3,1,"H"
1979-05-29,1978,"Paris FC","FC Sochaux","3-1",3,1,"1",1,4,2,"H"
1979-05-29,1978,"Stade Reims","AS Nancy","1-3",1,3,"1",1,4,-2,"D"
1979-06-01,1978,"Olympique Lyon","RC Strasbourg","0-3",0,3,"1",1,3,-3,"D"
1979-06-01,1978,"Stade Laval","FC Nantes","0-5",0,5,"1",1,5,-5,"D"
1979-06-01,1978,"SC Bastia","AS Saint-Etienne","0-2",0,2,"1",1,2,-2,"D"
1979-06-01,1978,"AS Monaco","Nimes Olympique","1-0",1,0,"1",1,1,1,"H"
1979-06-01,1978,"Olympique Marseille","FC Metz","2-3",2,3,"1",1,5,-1,"D"
1979-06-01,1978,"AS Nancy","Lille OSC","3-1",3,1,"1",1,4,2,"H"
1979-06-01,1978,"FC Sochaux","Girondins Bordeaux","2-0",2,0,"1",1,2,2,"H"
1979-06-01,1978,"Paris Saint-Germain","Stade Reims","3-2",3,2,"1",1,5,1,"H"
1979-06-01,1978,"Angers SCO","OGC Nice","1-1",1,1,"1",1,2,0,"D"
1979-06-01,1978,"US Valenciennes-Anzin","Paris FC","1-1",1,1,"1",1,2,0,"D"
1979-07-26,1979,"Olympique Marseille","Stade Brest","3-0",3,0,"1",1,3,3,"H"
1979-07-26,1979,"Girondins Bordeaux","RC Strasbourg","1-3",1,3,"1",1,4,-2,"D"
1979-07-26,1979,"Stade Laval","FC Nantes","0-2",0,2,"1",1,2,-2,"D"
1979-07-26,1979,"Lille OSC","AS Nancy","2-0",2,0,"1",1,2,2,"H"
1979-07-26,1979,"FC Sochaux","AS Monaco","1-2",1,2,"1",1,3,-1,"D"
1979-07-26,1979,"FC Metz","RC Lens","2-1",2,1,"1",1,3,1,"H"
1979-07-26,1979,"OGC Nice","Nimes Olympique","1-2",1,2,"1",1,3,-1,"D"
1979-07-26,1979,"US Valenciennes-Anzin","Angers SCO","2-1",2,1,"1",1,3,1,"H"
1979-07-26,1979,"SC Bastia","AS Saint-Etienne","0-1",0,1,"1",1,1,-1,"D"
1979-07-26,1979,"Olympique Lyon","Paris Saint-Germain","1-1",1,1,"1",1,2,0,"D"
1979-08-03,1979,"RC Lens","FC Nantes","1-3",1,3,"1",1,4,-2,"D"
1979-08-03,1979,"RC Strasbourg","FC Metz","3-2",3,2,"1",1,5,1,"H"
1979-08-03,1979,"Nimes Olympique","SC Bastia","2-0",2,0,"1",1,2,2,"H"
1979-08-03,1979,"AS Monaco","Stade Laval","2-1",2,1,"1",1,3,1,"H"
1979-08-03,1979,"US Valenciennes-Anzin","OGC Nice","1-0",1,0,"1",1,1,1,"H"
1979-08-03,1979,"AS Saint-Etienne","Lille OSC","0-0",0,0,"1",1,0,0,"D"
1979-08-03,1979,"Paris Saint-Germain","Olympique Marseille","2-1",2,1,"1",1,3,1,"H"
1979-08-03,1979,"Angers SCO","Girondins Bordeaux","3-0",3,0,"1",1,3,3,"H"
1979-08-03,1979,"Stade Brest","FC Sochaux","1-2",1,2,"1",1,3,-1,"D"
1979-08-03,1979,"AS Nancy","Olympique Lyon","1-0",1,0,"1",1,1,1,"H"
1979-08-10,1979,"Lille OSC","Nimes Olympique","4-0",4,0,"1",1,4,4,"H"
1979-08-10,1979,"FC Nantes","AS Monaco","0-0",0,0,"1",1,0,0,"D"
1979-08-10,1979,"Olympique Marseille","AS Saint-Etienne","3-5",3,5,"1",1,8,-2,"D"
1979-08-10,1979,"SC Bastia","RC Strasbourg","2-1",2,1,"1",1,3,1,"H"
1979-08-10,1979,"FC Metz","AS Nancy","2-1",2,1,"1",1,3,1,"H"
1979-08-10,1979,"FC Sochaux","Paris Saint-Germain","1-0",1,0,"1",1,1,1,"H"
1979-08-10,1979,"Girondins Bordeaux","US Valenciennes-Anzin","7-0",7,0,"1",1,7,7,"H"
1979-08-10,1979,"OGC Nice","Angers SCO","0-0",0,0,"1",1,0,0,"D"
1979-08-10,1979,"Stade Laval","Stade Brest","3-0",3,0,"1",1,3,3,"H"
1979-08-10,1979,"Olympique Lyon","RC Lens","1-1",1,1,"1",1,2,0,"D"
1979-08-17,1979,"AS Saint-Etienne","FC Metz","2-1",2,1,"1",1,3,1,"H"
1979-08-17,1979,"Stade Brest","AS Monaco","1-2",1,2,"1",1,3,-1,"D"
1979-08-17,1979,"US Valenciennes-Anzin","Lille OSC","0-0",0,0,"1",1,0,0,"D"
1979-08-17,1979,"RC Strasbourg","FC Nantes","2-2",2,2,"1",1,4,0,"D"
1979-08-17,1979,"Nimes Olympique","Girondins Bordeaux","2-0",2,0,"1",1,2,2,"H"
1979-08-17,1979,"Angers SCO","SC Bastia","3-1",3,1,"1",1,4,2,"H"
1979-08-17,1979,"Paris Saint-Germain","Stade Laval","3-1",3,1,"1",1,4,2,"H"
1979-08-17,1979,"AS Nancy","Olympique Marseille","5-0",5,0,"1",1,5,5,"H"
1979-08-17,1979,"RC Lens","FC Sochaux","2-0",2,0,"1",1,2,2,"H"
1979-08-17,1979,"OGC Nice","Olympique Lyon","3-1",3,1,"1",1,4,2,"H"
1979-08-24,1979,"Stade Laval","AS Saint-Etienne","2-3",2,3,"1",1,5,-1,"D"
1979-08-24,1979,"FC Nantes","Stade Brest","3-0",3,0,"1",1,3,3,"H"
1979-08-24,1979,"AS Monaco","Paris Saint-Germain","2-2",2,2,"1",1,4,0,"D"
1979-08-24,1979,"Lille OSC","Angers SCO","0-0",0,0,"1",1,0,0,"D"
1979-08-24,1979,"Olympique Lyon","RC Strasbourg","0-2",0,2,"1",1,2,-2,"D"
1979-08-24,1979,"FC Metz","Nimes Olympique","0-0",0,0,"1",1,0,0,"D"
1979-08-24,1979,"FC Sochaux","AS Nancy","5-1",5,1,"1",1,6,4,"H"
1979-08-24,1979,"SC Bastia","US Valenciennes-Anzin","2-1",2,1,"1",1,3,1,"H"
1979-08-24,1979,"Girondins Bordeaux","OGC Nice","3-1",3,1,"1",1,4,2,"H"
1979-08-24,1979,"Olympique Marseille","RC Lens","3-1",3,1,"1",1,4,2,"H"
1979-08-28,1979,"AS Saint-Etienne","FC Sochaux","2-1",2,1,"1",1,3,1,"H"
1979-08-28,1979,"Girondins Bordeaux","FC Nantes","1-3",1,3,"1",1,4,-2,"D"
1979-08-28,1979,"RC Lens","AS Monaco","0-3",0,3,"1",1,3,-3,"D"
1979-08-28,1979,"RC Strasbourg","Lille OSC","3-2",3,2,"1",1,5,1,"H"
1979-08-28,1979,"Nimes Olympique","Olympique Lyon","3-2",3,2,"1",1,5,1,"H"
1979-08-28,1979,"Angers SCO","Olympique Marseille","3-1",3,1,"1",1,4,2,"H"
1979-08-28,1979,"Paris Saint-Germain","Stade Brest","0-0",0,0,"1",1,0,0,"D"
1979-08-28,1979,"AS Nancy","Stade Laval","2-1",2,1,"1",1,3,1,"H"
1979-08-28,1979,"US Valenciennes-Anzin","FC Metz","2-2",2,2,"1",1,4,0,"D"
1979-08-28,1979,"OGC Nice","SC Bastia","2-1",2,1,"1",1,3,1,"H"
1979-09-11,1979,"Stade Brest","AS Saint-Etienne","0-2",0,2,"1",1,2,-2,"D"
1979-09-11,1979,"FC Nantes","Paris Saint-Germain","4-2",4,2,"1",1,6,2,"H"
1979-09-11,1979,"AS Monaco","AS Nancy","3-0",3,0,"1",1,3,3,"H"
1979-09-11,1979,"Olympique Marseille","Nimes Olympique","0-1",0,1,"1",1,1,-1,"D"
1979-09-11,1979,"FC Metz","Angers SCO","0-1",0,1,"1",1,1,-1,"D"
1979-09-11,1979,"FC Sochaux","RC Strasbourg","1-1",1,1,"1",1,2,0,"D"
1979-09-11,1979,"Lille OSC","OGC Nice","4-3",4,3,"1",1,7,1,"H"
1979-09-11,1979,"SC Bastia","Girondins Bordeaux","2-1",2,1,"1",1,3,1,"H"
1979-09-11,1979,"Olympique Lyon","US Valenciennes-Anzin","3-1",3,1,"1",1,4,2,"H"
1979-09-11,1979,"Stade Laval","RC Lens","0-0",0,0,"1",1,0,0,"D"
1979-09-14,1979,"AS Saint-Etienne","FC Nantes","4-2",4,2,"1",1,6,2,"H"
1979-09-14,1979,"Nimes Olympique","AS Monaco","1-1",1,1,"1",1,2,0,"D"
1979-09-14,1979,"Angers SCO","Olympique Lyon","1-1",1,1,"1",1,2,0,"D"
1979-09-14,1979,"Girondins Bordeaux","Lille OSC","1-1",1,1,"1",1,2,0,"D"
1979-09-14,1979,"RC Strasbourg","Stade Laval","0-3",0,3,"1",1,3,-3,"D"
1979-09-14,1979,"SC Bastia","FC Sochaux","0-1",0,1,"1",1,1,-1,"D"
1979-09-14,1979,"AS Nancy","Stade Brest","5-1",5,1,"1",1,6,4,"H"
1979-09-14,1979,"RC Lens","Paris Saint-Germain","1-1",1,1,"1",1,2,0,"D"
1979-09-14,1979,"US Valenciennes-Anzin","Olympique Marseille","1-0",1,0,"1",1,1,1,"H"
1979-09-14,1979,"OGC Nice","FC Metz","4-2",4,2,"1",1,6,2,"H"
1979-09-22,1979,"Olympique Lyon","AS Saint-Etienne","0-0",0,0,"1",1,0,0,"D"
1979-09-22,1979,"AS Monaco","OGC Nice","2-1",2,1,"1",1,3,1,"H"
1979-09-22,1979,"FC Nantes","US Valenciennes-Anzin","0-0",0,0,"1",1,0,0,"D"
1979-09-22,1979,"Lille OSC","SC Bastia","2-0",2,0,"1",1,2,2,"H"
1979-09-22,1979,"Olympique Marseille","RC Strasbourg","1-3",1,3,"1",1,4,-2,"D"
1979-09-22,1979,"FC Sochaux","Nimes Olympique","2-1",2,1,"1",1,3,1,"H"
1979-09-22,1979,"Stade Laval","Angers SCO","3-2",3,2,"1",1,5,1,"H"
1979-09-22,1979,"Paris Saint-Germain","AS Nancy","1-2",1,2,"1",1,3,-1,"D"
1979-09-22,1979,"FC Metz","Girondins Bordeaux","1-1",1,1,"1",1,2,0,"D"
1979-09-22,1979,"Stade Brest","RC Lens","0-0",0,0,"1",1,0,0,"D"
1979-09-28,1979,"AS Saint-Etienne","Paris Saint-Germain","2-0",2,0,"1",1,2,2,"H"
1979-09-28,1979,"Lille OSC","AS Monaco","3-1",3,1,"1",1,4,2,"H"
1979-09-28,1979,"RC Strasbourg","Stade Brest","2-1",2,1,"1",1,3,1,"H"
1979-09-28,1979,"Nimes Olympique","FC Nantes","2-1",2,1,"1",1,3,1,"H"
1979-09-28,1979,"Angers SCO","FC Sochaux","1-3",1,3,"1",1,4,-2,"D"
1979-09-28,1979,"AS Nancy","RC Lens","1-1",1,1,"1",1,2,0,"D"
1979-09-28,1979,"US Valenciennes-Anzin","Stade Laval","1-1",1,1,"1",1,2,0,"D"
1979-09-28,1979,"SC Bastia","FC Metz","0-1",0,1,"1",1,1,-1,"D"
1979-09-28,1979,"Girondins Bordeaux","Olympique Lyon","3-0",3,0,"1",1,3,3,"H"
1979-09-28,1979,"OGC Nice","Olympique Marseille","0-3",0,3,"1",1,3,-3,"D"
1979-10-06,1979,"RC Lens","AS Saint-Etienne","4-3",4,3,"1",1,7,1,"H"
1979-10-06,1979,"AS Monaco","RC Strasbourg","4-1",4,1,"1",1,5,3,"H"
1979-10-06,1979,"FC Nantes","AS Nancy","2-0",2,0,"1",1,2,2,"H"
1979-10-06,1979,"FC Metz","Lille OSC","2-0",2,0,"1",1,2,2,"H"
1979-10-06,1979,"Stade Laval","Nimes Olympique","3-1",3,1,"1",1,4,2,"H"
1979-10-06,1979,"FC Sochaux","US Valenciennes-Anzin","0-1",0,1,"1",1,1,-1,"D"
1979-10-06,1979,"Stade Brest","Angers SCO","0-1",0,1,"1",1,1,-1,"D"
1979-10-06,1979,"Olympique Marseille","Girondins Bordeaux","1-1",1,1,"1",1,2,0,"D"
1979-10-06,1979,"Paris Saint-Germain","OGC Nice","2-2",2,2,"1",1,4,0,"D"
1979-10-06,1979,"Olympique Lyon","SC Bastia","1-1",1,1,"1",1,2,0,"D"
1979-10-13,1979,"Angers SCO","AS Monaco","1-4",1,4,"1",1,5,-3,"D"
1979-10-13,1979,"AS Saint-Etienne","AS Nancy","2-2",2,2,"1",1,4,0,"D"
1979-10-13,1979,"Lille OSC","FC Nantes","1-1",1,1,"1",1,2,0,"D"
1979-10-13,1979,"Nimes Olympique","Paris Saint-Germain","2-0",2,0,"1",1,2,2,"H"
1979-10-13,1979,"Girondins Bordeaux","FC Sochaux","2-3",2,3,"1",1,5,-1,"D"
1979-10-13,1979,"RC Strasbourg","RC Lens","0-1",0,1,"1",1,1,-1,"D"
1979-10-13,1979,"US Valenciennes-Anzin","Stade Brest","2-1",2,1,"1",1,3,1,"H"
1979-10-13,1979,"FC Metz","Olympique Lyon","5-2",5,2,"1",1,7,3,"H"
1979-10-13,1979,"SC Bastia","Olympique Marseille","2-0",2,0,"1",1,2,2,"H"
1979-10-19,1979,"AS Monaco","AS Saint-Etienne","2-1",2,1,"1",1,3,1,"H"
1979-10-19,1979,"FC Nantes","SC Bastia","1-0",1,0,"1",1,1,1,"H"
1979-10-19,1979,"FC Sochaux","OGC Nice","2-1",2,1,"1",1,3,1,"H"
1979-10-19,1979,"Stade Brest","Nimes Olympique","2-2",2,2,"1",1,4,0,"D"
1979-10-19,1979,"AS Nancy","RC Strasbourg","3-4",3,4,"1",1,7,-1,"D"
1979-10-19,1979,"Olympique Lyon","Lille OSC","4-2",4,2,"1",1,6,2,"H"
1979-10-19,1979,"Paris Saint-Germain","US Valenciennes-Anzin","3-0",3,0,"1",1,3,3,"H"
1979-10-19,1979,"Olympique Marseille","FC Metz","1-0",1,0,"1",1,1,1,"H"
1979-10-19,1979,"RC Lens","Angers SCO","2-0",2,0,"1",1,2,2,"H"
1979-10-19,1979,"Stade Laval","Girondins Bordeaux","1-0",1,0,"1",1,1,1,"H"
1979-10-30,1979,"Girondins Bordeaux","AS Monaco","3-1",3,1,"1",1,4,2,"H"
1979-10-30,1979,"FC Metz","FC Nantes","0-0",0,0,"1",1,0,0,"D"
1979-10-30,1979,"RC Strasbourg","AS Saint-Etienne","1-0",1,0,"1",1,1,1,"H"
1979-10-30,1979,"Nimes Olympique","AS Nancy","4-2",4,2,"1",1,6,2,"H"
1979-10-30,1979,"Olympique Lyon","FC Sochaux","3-1",3,1,"1",1,4,2,"H"
1979-10-30,1979,"Lille OSC","Olympique Marseille","1-1",1,1,"1",1,2,0,"D"
1979-10-30,1979,"US Valenciennes-Anzin","RC Lens","3-1",3,1,"1",1,4,2,"H"
1979-10-30,1979,"Angers SCO","Paris Saint-Germain","1-2",1,2,"1",1,3,-1,"D"
1979-10-30,1979,"SC Bastia","Stade Laval","2-1",2,1,"1",1,3,1,"H"
1979-10-30,1979,"OGC Nice","Stade Brest","3-0",3,0,"1",1,3,3,"H"
1979-11-02,1979,"AS Monaco","SC Bastia","1-0",1,0,"1",1,1,1,"H"
1979-11-02,1979,"FC Nantes","OGC Nice","5-0",5,0,"1",1,5,5,"H"
1979-11-02,1979,"AS Saint-Etienne","Angers SCO","3-3",3,3,"1",1,6,0,"D"
1979-11-02,1979,"RC Lens","Nimes Olympique","1-0",1,0,"1",1,1,1,"H"
1979-11-02,1979,"Paris Saint-Germain","RC Strasbourg","1-0",1,0,"1",1,1,1,"H"
1979-11-02,1979,"Stade Laval","Lille OSC","2-0",2,0,"1",1,2,2,"H"
1979-11-02,1979,"AS Nancy","US Valenciennes-Anzin","1-0",1,0,"1",1,1,1,"H"
1979-11-02,1979,"Stade Brest","Girondins Bordeaux","0-1",0,1,"1",1,1,-1,"D"
1979-11-02,1979,"Olympique Marseille","Olympique Lyon","3-1",3,1,"1",1,4,2,"H"
1979-11-03,1979,"FC Sochaux","FC Metz","4-0",4,0,"1",1,4,4,"H"
1979-11-09,1979,"FC Metz","Stade Laval","1-4",1,4,"1",1,5,-3,"D"
1979-11-10,1979,"Olympique Marseille","AS Monaco","0-3",0,3,"1",1,3,-3,"D"
1979-11-10,1979,"Olympique Lyon","FC Nantes","1-2",1,2,"1",1,3,-1,"D"
1979-11-10,1979,"US Valenciennes-Anzin","AS Saint-Etienne","0-0",0,0,"1",1,0,0,"D"
1979-11-10,1979,"Lille OSC","FC Sochaux","1-1",1,1,"1",1,2,0,"D"
1979-11-10,1979,"Nimes Olympique","RC Strasbourg","0-0",0,0,"1",1,0,0,"D"
1979-11-10,1979,"Girondins Bordeaux","Paris Saint-Germain","0-1",0,1,"1",1,1,-1,"D"
1979-11-10,1979,"Angers SCO","AS Nancy","1-0",1,0,"1",1,1,1,"H"
1979-11-10,1979,"OGC Nice","RC Lens","1-0",1,0,"1",1,1,1,"H"
1979-11-10,1979,"SC Bastia","Stade Brest","1-0",1,0,"1",1,1,1,"H"
1979-11-21,1979,"AS Monaco","FC Metz","3-0",3,0,"1",1,3,3,"H"
1979-11-21,1979,"FC Nantes","Angers SCO","3-1",3,1,"1",1,4,2,"H"
1979-11-21,1979,"AS Saint-Etienne","Nimes Olympique","3-1",3,1,"1",1,4,2,"H"
1979-11-21,1979,"FC Sochaux","Olympique Marseille","3-0",3,0,"1",1,3,3,"H"
1979-11-21,1979,"RC Strasbourg","US Valenciennes-Anzin","2-1",2,1,"1",1,3,1,"H"
1979-11-21,1979,"Stade Brest","Lille OSC","1-1",1,1,"1",1,2,0,"D"
1979-11-21,1979,"Paris Saint-Germain","SC Bastia","1-1",1,1,"1",1,2,0,"D"
1979-11-21,1979,"RC Lens","Girondins Bordeaux","2-1",2,1,"1",1,3,1,"H"
1979-11-21,1979,"Stade Laval","Olympique Lyon","1-2",1,2,"1",1,3,-1,"D"
1979-11-21,1979,"AS Nancy","OGC Nice","1-2",1,2,"1",1,3,-1,"D"
1979-11-24,1979,"Olympique Lyon","AS Monaco","0-1",0,1,"1",1,1,-1,"D"
1979-11-24,1979,"OGC Nice","AS Saint-Etienne","2-4",2,4,"1",1,6,-2,"D"
1979-11-24,1979,"Angers SCO","RC Strasbourg","1-0",1,0,"1",1,1,1,"H"
1979-11-24,1979,"Lille OSC","Paris Saint-Germain","4-2",4,2,"1",1,6,2,"H"
1979-11-24,1979,"US Valenciennes-Anzin","Nimes Olympique","4-1",4,1,"1",1,5,3,"H"
1979-11-24,1979,"SC Bastia","RC Lens","1-2",1,2,"1",1,3,-1,"D"
1979-11-24,1979,"FC Metz","Stade Brest","0-0",0,0,"1",1,0,0,"D"
1979-11-25,1979,"FC Sochaux","FC Nantes","1-0",1,0,"1",1,1,1,"H"
1979-11-25,1979,"Olympique Marseille","Stade Laval","0-2",0,2,"1",1,2,-2,"D"
1979-12-01,1979,"AS Monaco","US Valenciennes-Anzin","0-1",0,1,"1",1,1,-1,"D"
1979-12-01,1979,"FC Nantes","Olympique Marseille","4-1",4,1,"1",1,5,3,"H"
1979-12-01,1979,"Stade Laval","FC Sochaux","3-3",3,3,"1",1,6,0,"D"
1979-12-01,1979,"RC Strasbourg","OGC Nice","2-3",2,3,"1",1,5,-1,"D"
1979-12-01,1979,"RC Lens","Lille OSC","5-3",5,3,"1",1,8,2,"H"
1979-12-01,1979,"Nimes Olympique","Angers SCO","1-1",1,1,"1",1,2,0,"D"
1979-12-01,1979,"Stade Brest","Olympique Lyon","5-1",5,1,"1",1,6,4,"H"
1979-12-02,1979,"AS Saint-Etienne","Girondins Bordeaux","3-3",3,3,"1",1,6,0,"D"
1979-12-02,1979,"Paris Saint-Germain","FC Metz","2-0",2,0,"1",1,2,2,"H"
1979-12-02,1979,"AS Nancy","SC Bastia","3-1",3,1,"1",1,4,2,"H"
1979-12-07,1979,"Lille OSC","AS Saint-Etienne","0-2",0,2,"1",1,2,-2,"D"
1979-12-07,1979,"Olympique Lyon","AS Nancy","2-1",2,1,"1",1,3,1,"H"
1979-12-08,1979,"Stade Laval","AS Monaco","0-2",0,2,"1",1,2,-2,"D"
1979-12-08,1979,"FC Nantes","RC Lens","3-0",3,0,"1",1,3,3,"H"
1979-12-08,1979,"Olympique Marseille","Paris Saint-Germain","0-2",0,2,"1",1,2,-2,"D"
1979-12-08,1979,"FC Metz","RC Strasbourg","0-0",0,0,"1",1,0,0,"D"
1979-12-08,1979,"SC Bastia","Nimes Olympique","2-0",2,0,"1",1,2,2,"H"
1979-12-08,1979,"OGC Nice","US Valenciennes-Anzin","2-0",2,0,"1",1,2,2,"H"
1979-12-09,1979,"FC Sochaux","Stade Brest","7-0",7,0,"1",1,7,7,"H"
1979-12-09,1979,"Girondins Bordeaux","Angers SCO","2-1",2,1,"1",1,3,1,"H"
1979-12-11,1979,"OGC Nice","Stade Laval","0-1",0,1,"1",1,1,-1,"D"
1979-12-12,1979,"Girondins Bordeaux","AS Nancy","4-1",4,1,"1",1,5,3,"H"
1979-12-14,1979,"RC Strasbourg","SC Bastia","1-0",1,0,"1",1,1,1,"H"
1979-12-15,1979,"AS Monaco","FC Nantes","2-1",2,1,"1",1,3,1,"H"
1979-12-15,1979,"Nimes Olympique","Lille OSC","3-2",3,2,"1",1,5,1,"H"
1979-12-15,1979,"Stade Brest","Stade Laval","2-2",2,2,"1",1,4,0,"D"
1979-12-15,1979,"RC Lens","Olympique Lyon","1-1",1,1,"1",1,2,0,"D"
1979-12-15,1979,"US Valenciennes-Anzin","Girondins Bordeaux","0-3",0,3,"1",1,3,-3,"D"
1979-12-15,1979,"Angers SCO","OGC Nice","2-3",2,3,"1",1,5,-1,"D"
1979-12-16,1979,"AS Saint-Etienne","Olympique Marseille","3-1",3,1,"1",1,4,2,"H"
1979-12-16,1979,"Paris Saint-Germain","FC Sochaux","3-1",3,1,"1",1,4,2,"H"
1979-12-16,1979,"AS Nancy","FC Metz","0-1",0,1,"1",1,1,-1,"D"
1980-01-19,1979,"AS Monaco","Stade Brest","4-0",4,0,"1",1,4,4,"H"
1980-01-19,1979,"FC Metz","AS Saint-Etienne","1-2",1,2,"1",1,3,-1,"D"
1980-01-19,1979,"FC Nantes","RC Strasbourg","2-1",2,1,"1",1,3,1,"H"
1980-01-19,1979,"Stade Laval","Paris Saint-Germain","3-1",3,1,"1",1,4,2,"H"
1980-01-19,1979,"Lille OSC","US Valenciennes-Anzin","0-1",0,1,"1",1,1,-1,"D"
1980-01-19,1979,"SC Bastia","Angers SCO","1-1",1,1,"1",1,2,0,"D"
1980-01-20,1979,"FC Sochaux","RC Lens","3-0",3,0,"1",1,3,3,"H"
1980-01-20,1979,"Girondins Bordeaux","Nimes Olympique","2-1",2,1,"1",1,3,1,"H"
1980-01-20,1979,"Olympique Lyon","OGC Nice","2-2",2,2,"1",1,4,0,"D"
1980-01-20,1979,"Olympique Marseille","AS Nancy","2-2",2,2,"1",1,4,0,"D"
1980-01-26,1979,"Stade Brest","FC Nantes","0-1",0,1,"1",1,1,-1,"D"
1980-01-26,1979,"AS Nancy","FC Sochaux","1-2",1,2,"1",1,3,-1,"D"
1980-01-26,1979,"RC Strasbourg","Olympique Lyon","3-1",3,1,"1",1,4,2,"H"
1980-01-26,1979,"US Valenciennes-Anzin","SC Bastia","5-0",5,0,"1",1,5,5,"H"
1980-01-26,1979,"RC Lens","Olympique Marseille","4-1",4,1,"1",1,5,3,"H"
1980-01-26,1979,"Angers SCO","Lille OSC","2-0",2,0,"1",1,2,2,"H"
1980-01-27,1979,"Paris Saint-Germain","AS Monaco","2-1",2,1,"1",1,3,1,"H"
1980-01-27,1979,"AS Saint-Etienne","Stade Laval","3-1",3,1,"1",1,4,2,"H"
1980-01-27,1979,"Nimes Olympique","FC Metz","2-1",2,1,"1",1,3,1,"H"
1980-01-27,1979,"OGC Nice","Girondins Bordeaux","0-0",0,0,"1",1,0,0,"D"
1980-02-02,1979,"AS Monaco","RC Lens","2-0",2,0,"1",1,2,2,"H"
1980-02-02,1979,"FC Nantes","Girondins Bordeaux","4-1",4,1,"1",1,5,3,"H"
1980-02-02,1979,"Stade Brest","Paris Saint-Germain","0-4",0,4,"1",1,4,-4,"D"
1980-02-02,1979,"Lille OSC","RC Strasbourg","2-0",2,0,"1",1,2,2,"H"
1980-02-02,1979,"FC Metz","US Valenciennes-Anzin","1-0",1,0,"1",1,1,1,"H"
1980-02-02,1979,"Stade Laval","AS Nancy","0-1",0,1,"1",1,1,-1,"D"
1980-02-02,1979,"SC Bastia","OGC Nice","3-0",3,0,"1",1,3,3,"H"
1980-02-03,1979,"FC Sochaux","AS Saint-Etienne","4-1",4,1,"1",1,5,3,"H"
1980-02-03,1979,"Olympique Lyon","Nimes Olympique","2-1",2,1,"1",1,3,1,"H"
1980-02-03,1979,"Olympique Marseille","Angers SCO","3-1",3,1,"1",1,4,2,"H"
1980-02-15,1979,"OGC Nice","Lille OSC","0-0",0,0,"1",1,0,0,"D"
1980-02-16,1979,"RC Strasbourg","FC Sochaux","0-1",0,1,"1",1,1,-1,"D"
1980-02-16,1979,"RC Lens","Stade Laval","1-0",1,0,"1",1,1,1,"H"
1980-02-16,1979,"US Valenciennes-Anzin","Olympique Lyon","1-1",1,1,"1",1,2,0,"D"
1980-02-16,1979,"Girondins Bordeaux","SC Bastia","2-1",2,1,"1",1,3,1,"H"
1980-02-16,1979,"Angers SCO","FC Metz","2-0",2,0,"1",1,2,2,"H"
1980-02-17,1979,"AS Nancy","AS Monaco","2-1",2,1,"1",1,3,1,"H"
1980-02-17,1979,"AS Saint-Etienne","Stade Brest","2-1",2,1,"1",1,3,1,"H"
1980-02-17,1979,"Paris Saint-Germain","FC Nantes","1-0",1,0,"1",1,1,1,"H"
1980-02-17,1979,"Nimes Olympique","Olympique Marseille","0-0",0,0,"1",1,0,0,"D"
1980-02-23,1979,"AS Monaco","Nimes Olympique","0-0",0,0,"1",1,0,0,"D"
1980-02-23,1979,"FC Nantes","AS Saint-Etienne","2-0",2,0,"1",1,2,2,"H"
1980-02-23,1979,"Lille OSC","Girondins Bordeaux","0-1",0,1,"1",1,1,-1,"D"
1980-02-23,1979,"Stade Laval","RC Strasbourg","0-0",0,0,"1",1,0,0,"D"
1980-02-23,1979,"FC Metz","OGC Nice","2-0",2,0,"1",1,2,2,"H"
1980-02-23,1979,"Stade Brest","AS Nancy","3-3",3,3,"1",1,6,0,"D"
1980-02-24,1979,"FC Sochaux","SC Bastia","3-0",3,0,"1",1,3,3,"H"
1980-02-24,1979,"Paris Saint-Germain","RC Lens","3-0",3,0,"1",1,3,3,"H"
1980-02-24,1979,"Olympique Marseille","US Valenciennes-Anzin","3-6",3,6,"1",1,9,-3,"D"
1980-02-24,1979,"Olympique Lyon","Angers SCO","0-1",0,1,"1",1,1,-1,"D"
1980-02-29,1979,"US Valenciennes-Anzin","FC Nantes","1-0",1,0,"1",1,1,1,"H"
1980-03-01,1979,"AS Saint-Etienne","Olympique Lyon","2-0",2,0,"1",1,2,2,"H"
1980-03-01,1979,"Nimes Olympique","FC Sochaux","2-0",2,0,"1",1,2,2,"H"
1980-03-01,1979,"AS Nancy","Paris Saint-Germain","3-2",3,2,"1",1,5,1,"H"
1980-03-01,1979,"Angers SCO","Stade Laval","3-1",3,1,"1",1,4,2,"H"
1980-03-01,1979,"RC Lens","Stade Brest","3-0",3,0,"1",1,3,3,"H"
1980-03-01,1979,"Girondins Bordeaux","FC Metz","1-3",1,3,"1",1,4,-2,"D"
1980-03-01,1979,"SC Bastia","Lille OSC","4-0",4,0,"1",1,4,4,"H"
1980-03-01,1979,"RC Strasbourg","Olympique Marseille","1-1",1,1,"1",1,2,0,"D"
1980-03-02,1979,"OGC Nice","AS Monaco","1-2",1,2,"1",1,3,-1,"D"
1980-03-12,1979,"AS Monaco","Lille OSC","0-1",0,1,"1",1,1,-1,"D"
1980-03-12,1979,"FC Sochaux","Angers SCO","4-0",4,0,"1",1,4,4,"H"
1980-03-12,1979,"FC Nantes","Nimes Olympique","4-1",4,1,"1",1,5,3,"H"
1980-03-12,1979,"Paris Saint-Germain","AS Saint-Etienne","2-2",2,2,"1",1,4,0,"D"
1980-03-12,1979,"Stade Brest","RC Strasbourg","2-5",2,5,"1",1,7,-3,"D"
1980-03-12,1979,"RC Lens","AS Nancy","4-0",4,0,"1",1,4,4,"H"
1980-03-12,1979,"Stade Laval","US Valenciennes-Anzin","3-0",3,0,"1",1,3,3,"H"
1980-03-12,1979,"Olympique Lyon","Girondins Bordeaux","1-1",1,1,"1",1,2,0,"D"
1980-03-12,1979,"FC Metz","SC Bastia","0-2",0,2,"1",1,2,-2,"D"
1980-03-12,1979,"Olympique Marseille","OGC Nice","3-1",3,1,"1",1,4,2,"H"
1980-03-22,1979,"AS Nancy","FC Nantes","0-2",0,2,"1",1,2,-2,"D"
1980-03-22,1979,"RC Strasbourg","AS Monaco","1-1",1,1,"1",1,2,0,"D"
1980-03-22,1979,"AS Saint-Etienne","RC Lens","3-1",3,1,"1",1,4,2,"H"
1980-03-22,1979,"US Valenciennes-Anzin","FC Sochaux","1-1",1,1,"1",1,2,0,"D"
1980-03-22,1979,"OGC Nice","Paris Saint-Germain","3-0",3,0,"1",1,3,3,"H"
1980-03-22,1979,"Nimes Olympique","Stade Laval","2-0",2,0,"1",1,2,2,"H"
1980-03-22,1979,"Girondins Bordeaux","Olympique Marseille","2-0",2,0,"1",1,2,2,"H"
1980-03-22,1979,"Angers SCO","Stade Brest","2-0",2,0,"1",1,2,2,"H"
1980-03-22,1979,"Lille OSC","FC Metz","3-0",3,0,"1",1,3,3,"H"
1980-03-22,1979,"SC Bastia","Olympique Lyon","2-0",2,0,"1",1,2,2,"H"
1980-03-29,1979,"FC Nantes","Lille OSC","1-0",1,0,"1",1,1,1,"H"
1980-03-29,1979,"AS Monaco","Angers SCO","3-0",3,0,"1",1,3,3,"H"
1980-03-29,1979,"FC Sochaux","Girondins Bordeaux","2-0",2,0,"1",1,2,2,"H"
1980-03-29,1979,"AS Nancy","AS Saint-Etienne","1-1",1,1,"1",1,2,0,"D"
1980-03-29,1979,"Paris Saint-Germain","Nimes Olympique","4-0",4,0,"1",1,4,4,"H"
1980-03-29,1979,"Stade Brest","US Valenciennes-Anzin","1-5",1,5,"1",1,6,-4,"D"
1980-03-29,1979,"RC Lens","RC Strasbourg","1-1",1,1,"1",1,2,0,"D"
1980-03-29,1979,"Stade Laval","OGC Nice","3-0",3,0,"1",1,3,3,"H"
1980-03-29,1979,"Olympique Marseille","SC Bastia","2-1",2,1,"1",1,3,1,"H"
1980-03-29,1979,"Olympique Lyon","FC Metz","1-0",1,0,"1",1,1,1,"H"
1980-04-02,1979,"OGC Nice","FC Sochaux","1-2",1,2,"1",1,3,-1,"D"
1980-04-02,1979,"AS Saint-Etienne","AS Monaco","2-1",2,1,"1",1,3,1,"H"
1980-04-02,1979,"SC Bastia","FC Nantes","1-0",1,0,"1",1,1,1,"H"
1980-04-02,1979,"US Valenciennes-Anzin","Paris Saint-Germain","1-1",1,1,"1",1,2,0,"D"
1980-04-02,1979,"Nimes Olympique","Stade Brest","2-0",2,0,"1",1,2,2,"H"
1980-04-02,1979,"Girondins Bordeaux","Stade Laval","4-1",4,1,"1",1,5,3,"H"
1980-04-02,1979,"Angers SCO","RC Lens","2-1",2,1,"1",1,3,1,"H"
1980-04-02,1979,"Lille OSC","Olympique Lyon","1-0",1,0,"1",1,1,1,"H"
1980-04-02,1979,"FC Metz","Olympique Marseille","3-2",3,2,"1",1,5,1,"H"
1980-04-03,1979,"RC Strasbourg","AS Nancy","1-0",1,0,"1",1,1,1,"H"
1980-04-08,1979,"FC Sochaux","Olympique Lyon","3-1",3,1,"1",1,4,2,"H"
1980-04-08,1979,"AS Saint-Etienne","RC Strasbourg","2-1",2,1,"1",1,3,1,"H"
1980-04-08,1979,"AS Monaco","Girondins Bordeaux","0-0",0,0,"1",1,0,0,"D"
1980-04-08,1979,"Paris Saint-Germain","Angers SCO","1-1",1,1,"1",1,2,0,"D"
1980-04-08,1979,"RC Lens","US Valenciennes-Anzin","1-1",1,1,"1",1,2,0,"D"
1980-04-08,1979,"AS Nancy","Nimes Olympique","1-0",1,0,"1",1,1,1,"H"
1980-04-08,1979,"Stade Laval","SC Bastia","3-0",3,0,"1",1,3,3,"H"
1980-04-08,1979,"Olympique Marseille","Lille OSC","2-0",2,0,"1",1,2,2,"H"
1980-04-08,1979,"Stade Brest","OGC Nice","1-0",1,0,"1",1,1,1,"H"
1980-04-18,1979,"Angers SCO","AS Saint-Etienne","0-2",0,2,"1",1,2,-2,"D"
1980-04-18,1979,"FC Metz","FC Sochaux","0-0",0,0,"1",1,0,0,"D"
1980-04-18,1979,"OGC Nice","FC Nantes","1-2",1,2,"1",1,3,-1,"D"
1980-04-18,1979,"SC Bastia","AS Monaco","2-0",2,0,"1",1,2,2,"H"
1980-04-18,1979,"RC Strasbourg","Paris Saint-Germain","2-1",2,1,"1",1,3,1,"H"
1980-04-18,1979,"Girondins Bordeaux","Stade Brest","4-1",4,1,"1",1,5,3,"H"
1980-04-18,1979,"US Valenciennes-Anzin","AS Nancy","0-1",0,1,"1",1,1,-1,"D"
1980-04-18,1979,"Nimes Olympique","RC Lens","3-1",3,1,"1",1,4,2,"H"
1980-04-18,1979,"Lille OSC","Stade Laval","2-0",2,0,"1",1,2,2,"H"
1980-04-18,1979,"Olympique Lyon","Olympique Marseille","1-0",1,0,"1",1,1,1,"H"
1980-04-25,1979,"AS Saint-Etienne","US Valenciennes-Anzin","0-1",0,1,"1",1,1,-1,"D"
1980-04-25,1979,"AS Monaco","Olympique Marseille","1-0",1,0,"1",1,1,1,"H"
1980-04-25,1979,"RC Strasbourg","Nimes Olympique","1-0",1,0,"1",1,1,1,"H"
1980-04-25,1979,"Paris Saint-Germain","Girondins Bordeaux","0-1",0,1,"1",1,1,-1,"D"
1980-04-25,1979,"Stade Laval","FC Metz","3-2",3,2,"1",1,5,1,"H"
1980-04-25,1979,"AS Nancy","Angers SCO","1-0",1,0,"1",1,1,1,"H"
1980-04-25,1979,"RC Lens","OGC Nice","0-1",0,1,"1",1,1,-1,"D"
1980-04-25,1979,"Stade Brest","SC Bastia","3-0",3,0,"1",1,3,3,"H"
1980-04-26,1979,"FC Sochaux","Lille OSC","3-0",3,0,"1",1,3,3,"H"
1980-04-26,1979,"FC Nantes","Olympique Lyon","3-0",3,0,"1",1,3,3,"H"
1980-04-29,1979,"FC Nantes","FC Metz","4-1",4,1,"1",1,5,3,"H"
1980-05-02,1979,"Angers SCO","FC Nantes","0-1",0,1,"1",1,1,-1,"D"
1980-05-02,1979,"Olympique Marseille","FC Sochaux","1-1",1,1,"1",1,2,0,"D"
1980-05-02,1979,"Nimes Olympique","AS Saint-Etienne","0-1",0,1,"1",1,1,-1,"D"
1980-05-02,1979,"FC Metz","AS Monaco","0-0",0,0,"1",1,0,0,"D"
1980-05-02,1979,"US Valenciennes-Anzin","RC Strasbourg","1-1",1,1,"1",1,2,0,"D"
1980-05-02,1979,"Girondins Bordeaux","RC Lens","1-1",1,1,"1",1,2,0,"D"
1980-05-02,1979,"SC Bastia","Paris Saint-Germain","1-0",1,0,"1",1,1,1,"H"
1980-05-02,1979,"Olympique Lyon","Stade Laval","2-0",2,0,"1",1,2,2,"H"
1980-05-02,1979,"Lille OSC","Stade Brest","1-0",1,0,"1",1,1,1,"H"
1980-05-02,1979,"OGC Nice","AS Nancy","1-1",1,1,"1",1,2,0,"D"
1980-05-06,1979,"FC Nantes","FC Sochaux","3-2",3,2,"1",1,5,1,"H"
1980-05-06,1979,"AS Saint-Etienne","OGC Nice","2-1",2,1,"1",1,3,1,"H"
1980-05-06,1979,"AS Monaco","Olympique Lyon","4-0",4,0,"1",1,4,4,"H"
1980-05-06,1979,"RC Strasbourg","Angers SCO","4-0",4,0,"1",1,4,4,"H"
1980-05-06,1979,"Nimes Olympique","US Valenciennes-Anzin","1-1",1,1,"1",1,2,0,"D"
1980-05-06,1979,"AS Nancy","Girondins Bordeaux","3-1",3,1,"1",1,4,2,"H"
1980-05-06,1979,"Paris Saint-Germain","Lille OSC","2-2",2,2,"1",1,4,0,"D"
1980-05-06,1979,"Stade Laval","Olympique Marseille","3-0",3,0,"1",1,3,3,"H"
1980-05-06,1979,"RC Lens","SC Bastia","2-0",2,0,"1",1,2,2,"H"
1980-05-06,1979,"Stade Brest","FC Metz","1-3",1,3,"1",1,4,-2,"D"
1980-05-17,1979,"Olympique Marseille","FC Nantes","0-1",0,1,"1",1,1,-1,"D"
1980-05-17,1979,"FC Sochaux","Stade Laval","2-0",2,0,"1",1,2,2,"H"
1980-05-17,1979,"Girondins Bordeaux","AS Saint-Etienne","5-1",5,1,"1",1,6,4,"H"
1980-05-17,1979,"US Valenciennes-Anzin","AS Monaco","0-0",0,0,"1",1,0,0,"D"
1980-05-17,1979,"OGC Nice","RC Strasbourg","6-1",6,1,"1",1,7,5,"H"
1980-05-17,1979,"FC Metz","Paris Saint-Germain","5-2",5,2,"1",1,7,3,"H"
1980-05-17,1979,"Angers SCO","Nimes Olympique","0-1",0,1,"1",1,1,-1,"D"
1980-05-17,1979,"Lille OSC","RC Lens","0-0",0,0,"1",1,0,0,"D"
1980-05-17,1979,"SC Bastia","AS Nancy","2-2",2,2,"1",1,4,0,"D"
1980-05-17,1979,"Olympique Lyon","Stade Brest","3-0",3,0,"1",1,3,3,"H"
1980-05-27,1979,"FC Nantes","Stade Laval","4-1",4,1,"1",1,5,3,"H"
1980-05-27,1979,"AS Monaco","FC Sochaux","0-1",0,1,"1",1,1,-1,"D"
1980-05-27,1979,"AS Saint-Etienne","SC Bastia","2-0",2,0,"1",1,2,2,"H"
1980-05-27,1979,"RC Strasbourg","Girondins Bordeaux","4-0",4,0,"1",1,4,4,"H"
1980-05-27,1979,"Paris Saint-Germain","Olympique Lyon","2-1",2,1,"1",1,3,1,"H"
1980-05-27,1979,"Angers SCO","US Valenciennes-Anzin","2-1",2,1,"1",1,3,1,"H"
1980-05-27,1979,"RC Lens","FC Metz","4-1",4,1,"1",1,5,3,"H"
1980-05-27,1979,"Nimes Olympique","OGC Nice","0-1",0,1,"1",1,1,-1,"D"
1980-05-27,1979,"AS Nancy","Lille OSC","1-0",1,0,"1",1,1,1,"H"
1980-05-27,1979,"Stade Brest","Olympique Marseille","7-2",7,2,"1",1,9,5,"H"
1980-07-24,1980,"Girondins Bordeaux","AS Saint-Etienne","3-0",3,0,"1",1,3,3,"H"
1980-07-24,1980,"Lille OSC","RC Strasbourg","3-0",3,0,"1",1,3,3,"H"
1980-07-24,1980,"SC Bastia","AJ Auxerre","2-0",2,0,"1",1,2,2,"H"
1980-07-24,1980,"AS Nancy","AS Monaco","2-3",2,3,"1",1,5,-1,"D"
1980-07-24,1980,"Nimes Olympique","FC Nantes","2-3",2,3,"1",1,5,-1,"D"
1980-07-24,1980,"Tours FC","Stade Laval","3-2",3,2,"1",1,5,1,"H"
1980-07-24,1980,"FC Sochaux","RC Lens","1-2",1,2,"1",1,3,-1,"D"
1980-07-24,1980,"Angers SCO","Paris Saint-Germain","1-1",1,1,"1",1,2,0,"D"
1980-07-24,1980,"Olympique Lyon","US Valenciennes-Anzin","1-1",1,1,"1",1,2,0,"D"
1980-07-24,1980,"OGC Nice","FC Metz","0-0",0,0,"1",1,0,0,"D"
1980-07-29,1980,"AS Monaco","Lille OSC","1-2",1,2,"1",1,3,-1,"D"
1980-07-29,1980,"FC Nantes","Girondins Bordeaux","1-0",1,0,"1",1,1,1,"H"
1980-07-29,1980,"US Valenciennes-Anzin","SC Bastia","1-1",1,1,"1",1,2,0,"D"
1980-07-29,1980,"FC Metz","Olympique Lyon","0-2",0,2,"1",1,2,-2,"D"
1980-07-29,1980,"RC Lens","Nimes Olympique","1-1",1,1,"1",1,2,0,"D"
1980-07-29,1980,"Paris Saint-Germain","RC Strasbourg","1-0",1,0,"1",1,1,1,"H"
1980-07-29,1980,"FC Sochaux","Tours FC","1-0",1,0,"1",1,1,1,"H"
1980-07-29,1980,"Stade Laval","AS Nancy","1-0",1,0,"1",1,1,1,"H"
1980-07-29,1980,"AJ Auxerre","Angers SCO","2-2",2,2,"1",1,4,0,"D"
1980-07-29,1980,"AS Saint-Etienne","OGC Nice","3-2",3,2,"1",1,5,1,"H"
1980-08-05,1980,"Lille OSC","Paris Saint-Germain","2-2",2,2,"1",1,4,0,"D"
1980-08-05,1980,"Olympique Lyon","AS Monaco","3-2",3,2,"1",1,5,1,"H"
1980-08-05,1980,"SC Bastia","AS Saint-Etienne","2-1",2,1,"1",1,3,1,"H"
1980-08-05,1980,"Girondins Bordeaux","Stade Laval","2-1",2,1,"1",1,3,1,"H"
1980-08-05,1980,"OGC Nice","FC Nantes","3-2",3,2,"1",1,5,1,"H"
1980-08-05,1980,"Tours FC","RC Lens","1-1",1,1,"1",1,2,0,"D"
1980-08-05,1980,"Angers SCO","US Valenciennes-Anzin","1-1",1,1,"1",1,2,0,"D"
1980-08-05,1980,"Nimes Olympique","FC Sochaux","0-0",0,0,"1",1,0,0,"D"
1980-08-05,1980,"AS Nancy","FC Metz","2-0",2,0,"1",1,2,2,"H"
1980-08-05,1980,"RC Strasbourg","AJ Auxerre","1-0",1,0,"1",1,1,1,"H"
1980-08-12,1980,"Nimes Olympique","Olympique Lyon","1-2",1,2,"1",1,3,-1,"D"
1980-08-12,1980,"RC Lens","OGC Nice","2-0",2,0,"1",1,2,2,"H"
1980-08-12,1980,"FC Nantes","Tours FC","4-3",4,3,"1",1,7,1,"H"
1980-08-12,1980,"AJ Auxerre","Paris Saint-Germain","0-1",0,1,"1",1,1,-1,"D"
1980-08-12,1980,"FC Sochaux","Girondins Bordeaux","0-0",0,0,"1",1,0,0,"D"
1980-08-12,1980,"Stade Laval","Lille OSC","4-2",4,2,"1",1,6,2,"H"
1980-08-12,1980,"FC Metz","SC Bastia","1-0",1,0,"1",1,1,1,"H"
1980-08-12,1980,"AS Monaco","Angers SCO","2-0",2,0,"1",1,2,2,"H"
1980-08-12,1980,"AS Saint-Etienne","AS Nancy","4-1",4,1,"1",1,5,3,"H"
1980-08-12,1980,"US Valenciennes-Anzin","RC Strasbourg","1-2",1,2,"1",1,3,-1,"D"
1980-08-19,1980,"Olympique Lyon","Stade Laval","1-0",1,0,"1",1,1,1,"H"
1980-08-19,1980,"Paris Saint-Germain","US Valenciennes-Anzin","3-2",3,2,"1",1,5,1,"H"
1980-08-19,1980,"Girondins Bordeaux","RC Lens","5-1",5,1,"1",1,6,4,"H"
1980-08-19,1980,"RC Strasbourg","AS Saint-Etienne","0-2",0,2,"1",1,2,-2,"D"
1980-08-19,1980,"SC Bastia","AS Monaco","1-1",1,1,"1",1,2,0,"D"
1980-08-19,1980,"AS Nancy","FC Nantes","1-0",1,0,"1",1,1,1,"H"
1980-08-19,1980,"Lille OSC","AJ Auxerre","2-3",2,3,"1",1,5,-1,"D"
1980-08-19,1980,"Tours FC","Nimes Olympique","4-3",4,3,"1",1,7,1,"H"
1980-08-19,1980,"OGC Nice","FC Sochaux","4-2",4,2,"1",1,6,2,"H"
1980-08-19,1980,"Angers SCO","FC Metz","0-0",0,0,"1",1,0,0,"D"
1980-08-22,1980,"Nimes Olympique","Girondins Bordeaux","0-2",0,2,"1",1,2,-2,"D"
1980-08-22,1980,"FC Nantes","Olympique Lyon","2-1",2,1,"1",1,3,1,"H"
1980-08-22,1980,"AS Saint-Etienne","Angers SCO","5-0",5,0,"1",1,5,5,"H"
1980-08-22,1980,"AS Monaco","Paris Saint-Germain","4-0",4,0,"1",1,4,4,"H"
1980-08-22,1980,"Stade Laval","OGC Nice","0-1",0,1,"1",1,1,-1,"D"
1980-08-22,1980,"RC Lens","AS Nancy","0-0",0,0,"1",1,0,0,"D"
1980-08-22,1980,"Tours FC","Lille OSC","3-3",3,3,"1",1,6,0,"D"
1980-08-22,1980,"FC Sochaux","SC Bastia","1-0",1,0,"1",1,1,1,"H"
1980-08-22,1980,"FC Metz","RC Strasbourg","4-1",4,1,"1",1,5,3,"H"
1980-08-22,1980,"US Valenciennes-Anzin","AJ Auxerre","2-0",2,0,"1",1,2,2,"H"
1980-08-26,1980,"AJ Auxerre","AS Saint-Etienne","0-2",0,2,"1",1,2,-2,"D"
1980-08-26,1980,"Girondins Bordeaux","Tours FC","1-1",1,1,"1",1,2,0,"D"
1980-08-26,1980,"Olympique Lyon","RC Lens","4-1",4,1,"1",1,5,3,"H"
1980-08-26,1980,"SC Bastia","FC Nantes","1-2",1,2,"1",1,3,-1,"D"
1980-08-26,1980,"Paris Saint-Germain","FC Metz","1-1",1,1,"1",1,2,0,"D"
1980-08-26,1980,"RC Strasbourg","AS Monaco","0-0",0,0,"1",1,0,0,"D"
1980-08-26,1980,"OGC Nice","Nimes Olympique","0-0",0,0,"1",1,0,0,"D"
1980-08-26,1980,"Lille OSC","US Valenciennes-Anzin","1-2",1,2,"1",1,3,-1,"D"
1980-08-26,1980,"AS Nancy","FC Sochaux","2-2",2,2,"1",1,4,0,"D"
1980-08-26,1980,"Angers SCO","Stade Laval","2-0",2,0,"1",1,2,2,"H"
1980-08-29,1980,"AS Saint-Etienne","Lille OSC","3-1",3,1,"1",1,4,2,"H"
1980-08-29,1980,"Girondins Bordeaux","Angers SCO","1-0",1,0,"1",1,1,1,"H"
1980-08-29,1980,"FC Sochaux","Olympique Lyon","2-2",2,2,"1",1,4,0,"D"
1980-08-29,1980,"FC Nantes","Paris Saint-Germain","1-1",1,1,"1",1,2,0,"D"
1980-08-29,1980,"AS Monaco","US Valenciennes-Anzin","5-1",5,1,"1",1,6,4,"H"
1980-08-29,1980,"Tours FC","OGC Nice","1-0",1,0,"1",1,1,1,"H"
1980-08-29,1980,"RC Lens","SC Bastia","5-0",5,0,"1",1,5,5,"H"
1980-08-29,1980,"FC Metz","AJ Auxerre","2-2",2,2,"1",1,4,0,"D"
1980-08-29,1980,"Nimes Olympique","AS Nancy","1-2",1,2,"1",1,3,-1,"D"
1980-08-29,1980,"Stade Laval","RC Strasbourg","3-1",3,1,"1",1,4,2,"H"
1980-09-09,1980,"Olympique Lyon","AS Saint-Etienne","1-1",1,1,"1",1,2,0,"D"
1980-09-09,1980,"OGC Nice","Girondins Bordeaux","1-1",1,1,"1",1,2,0,"D"
1980-09-09,1980,"Angers SCO","FC Nantes","0-3",0,3,"1",1,3,-3,"D"
1980-09-09,1980,"Paris Saint-Germain","Nimes Olympique","3-2",3,2,"1",1,5,1,"H"
1980-09-09,1980,"AJ Auxerre","AS Monaco","0-0",0,0,"1",1,0,0,"D"
1980-09-09,1980,"AS Nancy","Tours FC","1-3",1,3,"1",1,4,-2,"D"
1980-09-09,1980,"Lille OSC","RC Lens","2-1",2,1,"1",1,3,1,"H"
1980-09-09,1980,"US Valenciennes-Anzin","FC Metz","3-0",3,0,"1",1,3,3,"H"
1980-09-09,1980,"RC Strasbourg","FC Sochaux","2-0",2,0,"1",1,2,2,"H"
1980-09-09,1980,"SC Bastia","Stade Laval","2-2",2,2,"1",1,4,0,"D"
1980-09-12,1980,"AS Saint-Etienne","US Valenciennes-Anzin","4-0",4,0,"1",1,4,4,"H"
1980-09-12,1980,"Girondins Bordeaux","AS Nancy","2-0",2,0,"1",1,2,2,"H"
1980-09-12,1980,"FC Nantes","Lille OSC","4-1",4,1,"1",1,5,3,"H"
1980-09-12,1980,"Tours FC","Olympique Lyon","1-1",1,1,"1",1,2,0,"D"
1980-09-12,1980,"OGC Nice","Paris Saint-Germain","1-1",1,1,"1",1,2,0,"D"
1980-09-12,1980,"FC Metz","AS Monaco","1-1",1,1,"1",1,2,0,"D"
1980-09-12,1980,"FC Sochaux","Angers SCO","2-0",2,0,"1",1,2,2,"H"
1980-09-12,1980,"RC Lens","RC Strasbourg","1-2",1,2,"1",1,3,-1,"D"
1980-09-12,1980,"Stade Laval","AJ Auxerre","0-0",0,0,"1",1,0,0,"D"
1980-09-12,1980,"Nimes Olympique","SC Bastia","3-2",3,2,"1",1,5,1,"H"
1980-09-23,1980,"AS Monaco","AS Saint-Etienne","1-2",1,2,"1",1,3,-1,"D"
1980-09-23,1980,"RC Strasbourg","FC Nantes","1-2",1,2,"1",1,3,-1,"D"
1980-09-23,1980,"Olympique Lyon","Girondins Bordeaux","1-0",1,0,"1",1,1,1,"H"
1980-09-23,1980,"Paris Saint-Germain","Stade Laval","3-2",3,2,"1",1,5,1,"H"
1980-09-23,1980,"US Valenciennes-Anzin","Nimes Olympique","1-1",1,1,"1",1,2,0,"D"
1980-09-23,1980,"AS Nancy","OGC Nice","3-2",3,2,"1",1,5,1,"H"
1980-09-23,1980,"Lille OSC","FC Metz","0-1",0,1,"1",1,1,-1,"D"
1980-09-23,1980,"AJ Auxerre","FC Sochaux","1-1",1,1,"1",1,2,0,"D"
1980-09-23,1980,"Angers SCO","RC Lens","1-2",1,2,"1",1,3,-1,"D"
1980-09-23,1980,"SC Bastia","Tours FC","0-1",0,1,"1",1,1,-1,"D"
1980-09-26,1980,"AS Saint-Etienne","FC Metz","3-0",3,0,"1",1,3,3,"H"
1980-09-26,1980,"FC Nantes","US Valenciennes-Anzin","3-0",3,0,"1",1,3,3,"H"
1980-09-26,1980,"Girondins Bordeaux","SC Bastia","0-0",0,0,"1",1,0,0,"D"
1980-09-26,1980,"AS Nancy","Olympique Lyon","3-1",3,1,"1",1,4,2,"H"
1980-09-26,1980,"Tours FC","Angers SCO","2-2",2,2,"1",1,4,0,"D"
1980-09-26,1980,"FC Sochaux","Paris Saint-Germain","4-0",4,0,"1",1,4,4,"H"
1980-09-26,1980,"Stade Laval","AS Monaco","3-3",3,3,"1",1,6,0,"D"
1980-09-26,1980,"RC Lens","AJ Auxerre","1-1",1,1,"1",1,2,0,"D"
1980-09-26,1980,"OGC Nice","Lille OSC","1-2",1,2,"1",1,3,-1,"D"
1980-09-26,1980,"Nimes Olympique","RC Strasbourg","4-2",4,2,"1",1,6,2,"H"
1980-10-03,1980,"FC Metz","Stade Laval","3-2",3,2,"1",1,5,1,"H"
1980-10-04,1980,"Paris Saint-Germain","AS Saint-Etienne","1-1",1,1,"1",1,2,0,"D"
1980-10-04,1980,"AJ Auxerre","FC Nantes","0-0",0,0,"1",1,0,0,"D"
1980-10-04,1980,"Olympique Lyon","OGC Nice","5-1",5,1,"1",1,6,4,"H"
1980-10-04,1980,"Lille OSC","Girondins Bordeaux","2-2",2,2,"1",1,4,0,"D"
1980-10-04,1980,"AS Monaco","FC Sochaux","2-1",2,1,"1",1,3,1,"H"
1980-10-04,1980,"RC Strasbourg","Tours FC","4-1",4,1,"1",1,5,3,"H"
1980-10-04,1980,"US Valenciennes-Anzin","RC Lens","1-0",1,0,"1",1,1,1,"H"
1980-10-04,1980,"Angers SCO","Nimes Olympique","1-2",1,2,"1",1,3,-1,"D"
1980-10-04,1980,"SC Bastia","AS Nancy","2-1",2,1,"1",1,3,1,"H"
1980-10-14,1980,"FC Nantes","FC Metz","1-0",1,0,"1",1,1,1,"H"
1980-10-14,1980,"Stade Laval","AS Saint-Etienne","0-0",0,0,"1",1,0,0,"D"
1980-10-14,1980,"Olympique Lyon","Angers SCO","5-1",5,1,"1",1,6,4,"H"
1980-10-14,1980,"Girondins Bordeaux","RC Strasbourg","2-1",2,1,"1",1,3,1,"H"
1980-10-14,1980,"Tours FC","Paris Saint-Germain","0-2",0,2,"1",1,2,-2,"D"
1980-10-14,1980,"RC Lens","AS Monaco","0-0",0,0,"1",1,0,0,"D"
1980-10-14,1980,"FC Sochaux","US Valenciennes-Anzin","3-3",3,3,"1",1,6,0,"D"
1980-10-14,1980,"AS Nancy","Lille OSC","2-0",2,0,"1",1,2,2,"H"
1980-10-14,1980,"OGC Nice","SC Bastia","2-1",2,1,"1",1,3,1,"H"
1980-10-14,1980,"Nimes Olympique","AJ Auxerre","0-0",0,0,"1",1,0,0,"D"
1980-10-17,1980,"AS Saint-Etienne","FC Sochaux","3-0",3,0,"1",1,3,3,"H"
1980-10-17,1980,"AS Monaco","FC Nantes","2-1",2,1,"1",1,3,1,"H"
1980-10-17,1980,"SC Bastia","Olympique Lyon","2-0",2,0,"1",1,2,2,"H"
1980-10-17,1980,"Paris Saint-Germain","Girondins Bordeaux","4-0",4,0,"1",1,4,4,"H"
1980-10-17,1980,"FC Metz","RC Lens","0-2",0,2,"1",1,2,-2,"D"
1980-10-17,1980,"AJ Auxerre","Tours FC","3-2",3,2,"1",1,5,1,"H"
1980-10-17,1980,"US Valenciennes-Anzin","Stade Laval","4-2",4,2,"1",1,6,2,"H"
1980-10-17,1980,"Angers SCO","AS Nancy","2-0",2,0,"1",1,2,2,"H"
1980-10-17,1980,"RC Strasbourg","OGC Nice","2-1",2,1,"1",1,3,1,"H"
1980-10-17,1980,"Lille OSC","Nimes Olympique","0-0",0,0,"1",1,0,0,"D"
1980-10-31,1980,"RC Lens","AS Saint-Etienne","1-1",1,1,"1",1,2,0,"D"
1980-10-31,1980,"FC Nantes","Stade Laval","4-1",4,1,"1",1,5,3,"H"
1980-10-31,1980,"Olympique Lyon","Lille OSC","2-2",2,2,"1",1,4,0,"D"
1980-10-31,1980,"Girondins Bordeaux","AJ Auxerre","2-0",2,0,"1",1,2,2,"H"
1980-10-31,1980,"Nimes Olympique","AS Monaco","1-3",1,3,"1",1,4,-2,"D"
1980-10-31,1980,"SC Bastia","Paris Saint-Germain","2-0",2,0,"1",1,2,2,"H"
1980-10-31,1980,"Tours FC","US Valenciennes-Anzin","2-3",2,3,"1",1,5,-1,"D"
1980-10-31,1980,"FC Sochaux","FC Metz","3-0",3,0,"1",1,3,3,"H"
1980-10-31,1980,"AS Nancy","RC Strasbourg","2-0",2,0,"1",1,2,2,"H"
1980-10-31,1980,"OGC Nice","Angers SCO","2-2",2,2,"1",1,4,0,"D"
1980-11-07,1980,"FC Metz","Nimes Olympique","2-1",2,1,"1",1,3,1,"H"
1980-11-07,1980,"Paris Saint-Germain","AS Nancy","2-1",2,1,"1",1,3,1,"H"
1980-11-07,1980,"RC Strasbourg","Olympique Lyon","2-1",2,1,"1",1,3,1,"H"
1980-11-08,1980,"AS Saint-Etienne","FC Nantes","0-0",0,0,"1",1,0,0,"D"
1980-11-08,1980,"US Valenciennes-Anzin","Girondins Bordeaux","2-2",2,2,"1",1,4,0,"D"
1980-11-08,1980,"AS Monaco","Tours FC","1-1",1,1,"1",1,2,0,"D"
1980-11-08,1980,"Lille OSC","FC Sochaux","2-1",2,1,"1",1,3,1,"H"
1980-11-08,1980,"Stade Laval","RC Lens","3-0",3,0,"1",1,3,3,"H"
1980-11-08,1980,"Angers SCO","SC Bastia","1-0",1,0,"1",1,1,1,"H"
1980-11-08,1980,"AJ Auxerre","OGC Nice","3-1",3,1,"1",1,4,2,"H"
1980-11-12,1980,"Nimes Olympique","AS Saint-Etienne","0-1",0,1,"1",1,1,-1,"D"
1980-11-12,1980,"RC Lens","FC Nantes","0-0",0,0,"1",1,0,0,"D"
1980-11-12,1980,"Girondins Bordeaux","AS Monaco","1-0",1,0,"1",1,1,1,"H"
1980-11-12,1980,"FC Sochaux","Stade Laval","2-1",2,1,"1",1,3,1,"H"
1980-11-12,1980,"AS Nancy","AJ Auxerre","3-0",3,0,"1",1,3,3,"H"
1980-11-12,1980,"OGC Nice","US Valenciennes-Anzin","4-0",4,0,"1",1,4,4,"H"
1980-11-12,1980,"Tours FC","FC Metz","1-1",1,1,"1",1,2,0,"D"
1980-11-12,1980,"SC Bastia","RC Strasbourg","2-0",2,0,"1",1,2,2,"H"
1980-11-12,1980,"Angers SCO","Lille OSC","3-2",3,2,"1",1,5,1,"H"
1980-11-22,1980,"Lille OSC","SC Bastia","3-1",3,1,"1",1,4,2,"H"
1980-11-23,1980,"FC Nantes","FC Sochaux","2-1",2,1,"1",1,3,1,"H"
1980-11-23,1980,"AS Saint-Etienne","Tours FC","1-2",1,2,"1",1,3,-1,"D"
1980-11-23,1980,"FC Metz","Girondins Bordeaux","1-1",1,1,"1",1,2,0,"D"
1980-11-23,1980,"Paris Saint-Germain","RC Lens","3-0",3,0,"1",1,3,3,"H"
1980-11-23,1980,"AS Monaco","OGC Nice","1-0",1,0,"1",1,1,1,"H"
1980-11-23,1980,"AJ Auxerre","Olympique Lyon","2-2",2,2,"1",1,4,0,"D"
1980-11-23,1980,"US Valenciennes-Anzin","AS Nancy","3-0",3,0,"1",1,3,3,"H"
1980-11-23,1980,"RC Strasbourg","Angers SCO","2-0",2,0,"1",1,2,2,"H"
1980-11-23,1980,"Stade Laval","Nimes Olympique","4-0",4,0,"1",1,4,4,"H"
1980-11-28,1980,"RC Strasbourg","Paris Saint-Germain","1-0",1,0,"1",1,1,1,"H"
1980-11-28,1980,"Tours FC","FC Sochaux","0-1",0,1,"1",1,1,-1,"D"
1980-11-28,1980,"AS Nancy","Stade Laval","3-0",3,0,"1",1,3,3,"H"
1980-11-29,1980,"Girondins Bordeaux","FC Nantes","0-0",0,0,"1",1,0,0,"D"
1980-11-29,1980,"OGC Nice","AS Saint-Etienne","0-1",0,1,"1",1,1,-1,"D"
1980-11-29,1980,"Olympique Lyon","FC Metz","0-0",0,0,"1",1,0,0,"D"
1980-11-29,1980,"Lille OSC","AS Monaco","2-1",2,1,"1",1,3,1,"H"
1980-11-29,1980,"Nimes Olympique","RC Lens","1-1",1,1,"1",1,2,0,"D"
1980-11-29,1980,"Angers SCO","AJ Auxerre","4-1",4,1,"1",1,5,3,"H"
1980-11-30,1980,"SC Bastia","US Valenciennes-Anzin","1-1",1,1,"1",1,2,0,"D"
1980-12-05,1980,"AS Saint-Etienne","SC Bastia","3-0",3,0,"1",1,3,3,"H"
1980-12-06,1980,"FC Nantes","OGC Nice","4-1",4,1,"1",1,5,3,"H"
1980-12-06,1980,"Stade Laval","Girondins Bordeaux","2-4",2,4,"1",1,6,-2,"D"
1980-12-06,1980,"Paris Saint-Germain","Lille OSC","4-1",4,1,"1",1,5,3,"H"
1980-12-06,1980,"FC Sochaux","Nimes Olympique","2-1",2,1,"1",1,3,1,"H"
1980-12-06,1980,"FC Metz","AS Nancy","2-0",2,0,"1",1,2,2,"H"
1980-12-06,1980,"US Valenciennes-Anzin","Angers SCO","0-0",0,0,"1",1,0,0,"D"
1980-12-06,1980,"RC Lens","Tours FC","3-0",3,0,"1",1,3,3,"H"
1980-12-06,1980,"AJ Auxerre","RC Strasbourg","1-1",1,1,"1",1,2,0,"D"
1980-12-06,1980,"AS Monaco","Olympique Lyon","2-1",2,1,"1",1,3,1,"H"
1980-12-13,1980,"AS Nancy","AS Saint-Etienne","0-0",0,0,"1",1,0,0,"D"
1980-12-13,1980,"Tours FC","FC Nantes","2-3",2,3,"1",1,5,-1,"D"
1980-12-13,1980,"Angers SCO","AS Monaco","1-1",1,1,"1",1,2,0,"D"
1980-12-13,1980,"OGC Nice","RC Lens","1-1",1,1,"1",1,2,0,"D"
1980-12-13,1980,"SC Bastia","FC Metz","1-0",1,0,"1",1,1,1,"H"
1980-12-13,1980,"Lille OSC","Stade Laval","1-1",1,1,"1",1,2,0,"D"
1980-12-14,1980,"Girondins Bordeaux","FC Sochaux","0-0",0,0,"1",1,0,0,"D"
1980-12-14,1980,"Paris Saint-Germain","AJ Auxerre","2-3",2,3,"1",1,5,-1,"D"
1980-12-14,1980,"Olympique Lyon","Nimes Olympique","4-2",4,2,"1",1,6,2,"H"
1980-12-14,1980,"RC Strasbourg","US Valenciennes-Anzin","3-0",3,0,"1",1,3,3,"H"
1980-12-20,1980,"FC Nantes","AS Nancy","3-0",3,0,"1",1,3,3,"H"
1980-12-20,1980,"RC Lens","Girondins Bordeaux","0-1",0,1,"1",1,1,-1,"D"
1980-12-20,1980,"AS Monaco","SC Bastia","3-0",3,0,"1",1,3,3,"H"
1980-12-20,1980,"Stade Laval","Olympique Lyon","0-0",0,0,"1",1,0,0,"D"
1980-12-20,1980,"FC Metz","Angers SCO","1-0",1,0,"1",1,1,1,"H"
1980-12-20,1980,"AJ Auxerre","Lille OSC","2-2",2,2,"1",1,4,0,"D"
1980-12-20,1980,"Nimes Olympique","Tours FC","2-1",2,1,"1",1,3,1,"H"
1980-12-21,1980,"AS Saint-Etienne","RC Strasbourg","3-0",3,0,"1",1,3,3,"H"
1980-12-21,1980,"FC Sochaux","OGC Nice","1-1",1,1,"1",1,2,0,"D"
1980-12-21,1980,"US Valenciennes-Anzin","Paris Saint-Germain","2-0",2,0,"1",1,2,2,"H"
1981-01-24,1980,"Girondins Bordeaux","Nimes Olympique","1-1",1,1,"1",1,2,0,"D"
1981-01-24,1980,"Paris Saint-Germain","AS Monaco","0-0",0,0,"1",1,0,0,"D"
1981-01-24,1980,"AS Nancy","RC Lens","1-2",1,2,"1",1,3,-1,"D"
1981-01-24,1980,"OGC Nice","Stade Laval","2-1",2,1,"1",1,3,1,"H"
1981-01-24,1980,"SC Bastia","FC Sochaux","1-1",1,1,"1",1,2,0,"D"
1981-01-24,1980,"AJ Auxerre","US Valenciennes-Anzin","1-1",1,1,"1",1,2,0,"D"
1981-01-24,1980,"Lille OSC","Tours FC","1-1",1,1,"1",1,2,0,"D"
1981-01-24,1980,"RC Strasbourg","FC Metz","3-3",3,3,"1",1,6,0,"D"
1981-01-25,1980,"Olympique Lyon","FC Nantes","0-0",0,0,"1",1,0,0,"D"
1981-01-25,1980,"Angers SCO","AS Saint-Etienne","1-1",1,1,"1",1,2,0,"D"
1981-01-30,1980,"US Valenciennes-Anzin","Lille OSC","0-3",0,3,"1",1,3,-3,"D"
1981-01-31,1980,"FC Nantes","SC Bastia","2-1",2,1,"1",1,3,1,"H"
1981-01-31,1980,"Tours FC","Girondins Bordeaux","0-1",0,1,"1",1,1,-1,"D"
1981-01-31,1980,"AS Monaco","RC Strasbourg","3-1",3,1,"1",1,4,2,"H"
1981-01-31,1980,"RC Lens","Olympique Lyon","2-2",2,2,"1",1,4,0,"D"
1981-01-31,1980,"FC Metz","Paris Saint-Germain","0-0",0,0,"1",1,0,0,"D"
1981-01-31,1980,"Stade Laval","Angers SCO","2-0",2,0,"1",1,2,2,"H"
1981-02-01,1980,"AS Saint-Etienne","AJ Auxerre","2-0",2,0,"1",1,2,2,"H"
1981-02-01,1980,"FC Sochaux","AS Nancy","1-1",1,1,"1",1,2,0,"D"
1981-02-01,1980,"Nimes Olympique","OGC Nice","1-3",1,3,"1",1,4,-2,"D"
1981-02-04,1980,"Olympique Lyon","Paris Saint-Germain","2-0",2,0,"1",1,2,2,"H"
1981-02-06,1980,"Lille OSC","AS Saint-Etienne","1-3",1,3,"1",1,4,-2,"D"
1981-02-06,1980,"SC Bastia","RC Lens","3-1",3,1,"1",1,4,2,"H"
1981-02-07,1980,"Angers SCO","Girondins Bordeaux","0-3",0,3,"1",1,3,-3,"D"
1981-02-07,1980,"RC Strasbourg","Stade Laval","0-0",0,0,"1",1,0,0,"D"
1981-02-07,1980,"AJ Auxerre","FC Metz","4-2",4,2,"1",1,6,2,"H"
1981-02-08,1980,"Paris Saint-Germain","FC Nantes","0-2",0,2,"1",1,2,-2,"D"
1981-02-08,1980,"US Valenciennes-Anzin","AS Monaco","0-1",0,1,"1",1,1,-1,"D"
1981-02-08,1980,"Olympique Lyon","FC Sochaux","5-1",5,1,"1",1,6,4,"H"
1981-02-08,1980,"AS Nancy","Nimes Olympique","2-0",2,0,"1",1,2,2,"H"
1981-02-08,1980,"OGC Nice","Tours FC","2-2",2,2,"1",1,4,0,"D"
1981-02-21,1980,"FC Nantes","Angers SCO","3-1",3,1,"1",1,4,2,"H"
1981-02-21,1980,"AS Monaco","AJ Auxerre","2-1",2,1,"1",1,3,1,"H"
1981-02-21,1980,"FC Metz","US Valenciennes-Anzin","4-2",4,2,"1",1,6,2,"H"
1981-02-21,1980,"RC Lens","Lille OSC","0-0",0,0,"1",1,0,0,"D"
1981-02-21,1980,"Tours FC","AS Nancy","1-0",1,0,"1",1,1,1,"H"
1981-02-21,1980,"Stade Laval","SC Bastia","3-0",3,0,"1",1,3,3,"H"
1981-02-22,1980,"AS Saint-Etienne","Olympique Lyon","3-2",3,2,"1",1,5,1,"H"
1981-02-22,1980,"Girondins Bordeaux","OGC Nice","3-0",3,0,"1",1,3,3,"H"
1981-02-22,1980,"Nimes Olympique","Paris Saint-Germain","2-1",2,1,"1",1,3,1,"H"
1981-02-22,1980,"FC Sochaux","RC Strasbourg","1-1",1,1,"1",1,2,0,"D"
1981-02-27,1980,"Lille OSC","FC Nantes","0-3",0,3,"1",1,3,-3,"D"
1981-02-27,1980,"RC Strasbourg","RC Lens","1-0",1,0,"1",1,1,1,"H"
1981-02-27,1980,"SC Bastia","Nimes Olympique","3-2",3,2,"1",1,5,1,"H"
1981-02-28,1980,"US Valenciennes-Anzin","AS Saint-Etienne","0-1",0,1,"1",1,1,-1,"D"
1981-02-28,1980,"AS Monaco","FC Metz","2-1",2,1,"1",1,3,1,"H"
1981-02-28,1980,"Paris Saint-Germain","OGC Nice","3-1",3,1,"1",1,4,2,"H"
1981-02-28,1980,"Angers SCO","FC Sochaux","1-2",1,2,"1",1,3,-1,"D"
1981-02-28,1980,"AJ Auxerre","Stade Laval","1-0",1,0,"1",1,1,1,"H"
1981-03-01,1980,"AS Nancy","Girondins Bordeaux","2-0",2,0,"1",1,2,2,"H"
1981-03-01,1980,"Olympique Lyon","Tours FC","2-3",2,3,"1",1,5,-1,"D"
1981-03-14,1980,"AS Saint-Etienne","AS Monaco","5-1",5,1,"1",1,6,4,"H"
1981-03-14,1980,"FC Nantes","RC Strasbourg","1-1",1,1,"1",1,2,0,"D"
1981-03-14,1980,"Girondins Bordeaux","Olympique Lyon","3-2",3,2,"1",1,5,1,"H"
1981-03-14,1980,"Stade Laval","Paris Saint-Germain","0-0",0,0,"1",1,0,0,"D"
1981-03-14,1980,"FC Sochaux","AJ Auxerre","1-1",1,1,"1",1,2,0,"D"
1981-03-14,1980,"FC Metz","Lille OSC","3-0",3,0,"1",1,3,3,"H"
1981-03-14,1980,"OGC Nice","AS Nancy","2-2",2,2,"1",1,4,0,"D"
1981-03-14,1980,"RC Lens","Angers SCO","1-0",1,0,"1",1,1,1,"H"
1981-03-14,1980,"Tours FC","SC Bastia","2-2",2,2,"1",1,4,0,"D"
1981-03-14,1980,"Nimes Olympique","US Valenciennes-Anzin","1-1",1,1,"1",1,2,0,"D"
1981-03-28,1980,"FC Metz","AS Saint-Etienne","0-0",0,0,"1",1,0,0,"D"
1981-03-28,1980,"US Valenciennes-Anzin","FC Nantes","3-3",3,3,"1",1,6,0,"D"
1981-03-28,1980,"SC Bastia","Girondins Bordeaux","3-2",3,2,"1",1,5,1,"H"
1981-03-28,1980,"AS Monaco","Stade Laval","3-0",3,0,"1",1,3,3,"H"
1981-03-28,1980,"Olympique Lyon","AS Nancy","4-2",4,2,"1",1,6,2,"H"
1981-03-28,1980,"Paris Saint-Germain","FC Sochaux","3-2",3,2,"1",1,5,1,"H"
1981-03-28,1980,"RC Strasbourg","Nimes Olympique","1-0",1,0,"1",1,1,1,"H"
1981-03-28,1980,"AJ Auxerre","RC Lens","1-1",1,1,"1",1,2,0,"D"
1981-03-28,1980,"Angers SCO","Tours FC","2-2",2,2,"1",1,4,0,"D"
1981-03-28,1980,"Lille OSC","OGC Nice","3-1",3,1,"1",1,4,2,"H"
1981-04-07,1980,"AS Saint-Etienne","Paris Saint-Germain","0-2",0,2,"1",1,2,-2,"D"
1981-04-07,1980,"FC Nantes","AJ Auxerre","0-1",0,1,"1",1,1,-1,"D"
1981-04-07,1980,"Girondins Bordeaux","Lille OSC","2-0",2,0,"1",1,2,2,"H"
1981-04-07,1980,"OGC Nice","Olympique Lyon","3-2",3,2,"1",1,5,1,"H"
1981-04-07,1980,"Tours FC","RC Strasbourg","1-1",1,1,"1",1,2,0,"D"
1981-04-07,1980,"Stade Laval","FC Metz","1-1",1,1,"1",1,2,0,"D"
1981-04-07,1980,"AS Nancy","SC Bastia","3-0",3,0,"1",1,3,3,"H"
1981-04-07,1980,"RC Lens","US Valenciennes-Anzin","1-2",1,2,"1",1,3,-1,"D"
1981-04-07,1980,"Nimes Olympique","Angers SCO","0-0",0,0,"1",1,0,0,"D"
1981-04-15,1980,"AS Saint-Etienne","Stade Laval","1-0",1,0,"1",1,1,1,"H"
1981-04-15,1980,"FC Metz","FC Nantes","2-2",2,2,"1",1,4,0,"D"
1981-04-15,1980,"AS Monaco","RC Lens","1-0",1,0,"1",1,1,1,"H"
1981-04-15,1980,"Paris Saint-Germain","Tours FC","4-1",4,1,"1",1,5,3,"H"
1981-04-15,1980,"Angers SCO","Olympique Lyon","1-3",1,3,"1",1,4,-2,"D"
1981-04-15,1980,"US Valenciennes-Anzin","FC Sochaux","2-1",2,1,"1",1,3,1,"H"
1981-04-15,1980,"Lille OSC","AS Nancy","0-0",0,0,"1",1,0,0,"D"
1981-04-15,1980,"AJ Auxerre","Nimes Olympique","4-2",4,2,"1",1,6,2,"H"
1981-04-15,1980,"SC Bastia","OGC Nice","3-0",3,0,"1",1,3,3,"H"
1981-04-15,1980,"RC Strasbourg","Girondins Bordeaux","1-1",1,1,"1",1,2,0,"D"
1981-04-21,1980,"FC Nantes","AS Monaco","5-0",5,0,"1",1,5,5,"H"
1981-04-21,1980,"Girondins Bordeaux","Paris Saint-Germain","1-3",1,3,"1",1,4,-2,"D"
1981-04-21,1980,"Olympique Lyon","SC Bastia","2-1",2,1,"1",1,3,1,"H"
1981-04-21,1980,"OGC Nice","RC Strasbourg","0-0",0,0,"1",1,0,0,"D"
1981-04-21,1980,"AS Nancy","Angers SCO","2-0",2,0,"1",1,2,2,"H"
1981-04-21,1980,"Tours FC","AJ Auxerre","1-4",1,4,"1",1,5,-3,"D"
1981-04-21,1980,"RC Lens","FC Metz","2-2",2,2,"1",1,4,0,"D"
1981-04-21,1980,"Stade Laval","US Valenciennes-Anzin","2-1",2,1,"1",1,3,1,"H"
1981-04-21,1980,"Nimes Olympique","Lille OSC","2-1",2,1,"1",1,3,1,"H"
1981-05-02,1980,"FC Sochaux","AS Monaco","1-1",1,1,"1",1,2,0,"D"
1981-05-05,1980,"AS Saint-Etienne","RC Lens","0-0",0,0,"1",1,0,0,"D"
1981-05-05,1980,"Stade Laval","FC Nantes","2-0",2,0,"1",1,2,2,"H"
1981-05-05,1980,"AJ Auxerre","Girondins Bordeaux","1-2",1,2,"1",1,3,-1,"D"
1981-05-05,1980,"AS Monaco","Nimes Olympique","2-1",2,1,"1",1,3,1,"H"
1981-05-05,1980,"Paris Saint-Germain","SC Bastia","3-1",3,1,"1",1,4,2,"H"
1981-05-05,1980,"Lille OSC","Olympique Lyon","1-1",1,1,"1",1,2,0,"D"
1981-05-05,1980,"RC Strasbourg","AS Nancy","2-0",2,0,"1",1,2,2,"H"
1981-05-05,1980,"FC Metz","FC Sochaux","4-2",4,2,"1",1,6,2,"H"
1981-05-05,1980,"US Valenciennes-Anzin","Tours FC","1-1",1,1,"1",1,2,0,"D"
1981-05-05,1980,"Angers SCO","OGC Nice","1-1",1,1,"1",1,2,0,"D"
1981-05-12,1980,"FC Nantes","AS Saint-Etienne","1-1",1,1,"1",1,2,0,"D"
1981-05-12,1980,"Girondins Bordeaux","US Valenciennes-Anzin","4-0",4,0,"1",1,4,4,"H"
1981-05-12,1980,"Tours FC","AS Monaco","0-1",0,1,"1",1,1,-1,"D"
1981-05-12,1980,"AS Nancy","Paris Saint-Germain","2-2",2,2,"1",1,4,0,"D"
1981-05-12,1980,"Olympique Lyon","RC Strasbourg","0-0",0,0,"1",1,0,0,"D"
1981-05-12,1980,"Nimes Olympique","FC Metz","3-3",3,3,"1",1,6,0,"D"
1981-05-12,1980,"FC Sochaux","Lille OSC","3-0",3,0,"1",1,3,3,"H"
1981-05-12,1980,"OGC Nice","AJ Auxerre","0-0",0,0,"1",1,0,0,"D"
1981-05-12,1980,"RC Lens","Stade Laval","3-0",3,0,"1",1,3,3,"H"
1981-05-12,1980,"SC Bastia","Angers SCO","3-0",3,0,"1",1,3,3,"H"
1981-05-22,1980,"FC Nantes","RC Lens","2-0",2,0,"1",1,2,2,"H"
1981-05-22,1980,"AS Saint-Etienne","Nimes Olympique","0-0",0,0,"1",1,0,0,"D"
1981-05-22,1980,"AS Monaco","Girondins Bordeaux","0-0",0,0,"1",1,0,0,"D"
1981-05-22,1980,"Paris Saint-Germain","Olympique Lyon","1-1",1,1,"1",1,2,0,"D"
1981-05-22,1980,"RC Strasbourg","SC Bastia","1-1",1,1,"1",1,2,0,"D"
1981-05-22,1980,"AJ Auxerre","AS Nancy","0-2",0,2,"1",1,2,-2,"D"
1981-05-22,1980,"FC Metz","Tours FC","2-3",2,3,"1",1,5,-1,"D"
1981-05-22,1980,"Stade Laval","FC Sochaux","0-0",0,0,"1",1,0,0,"D"
1981-05-22,1980,"US Valenciennes-Anzin","OGC Nice","1-0",1,0,"1",1,1,1,"H"
1981-05-22,1980,"Lille OSC","Angers SCO","4-0",4,0,"1",1,4,4,"H"
1981-05-26,1980,"FC Sochaux","AS Saint-Etienne","1-2",1,2,"1",1,3,-1,"D"
1981-05-29,1980,"Tours FC","AS Saint-Etienne","1-3",1,3,"1",1,4,-2,"D"
1981-05-29,1980,"FC Sochaux","FC Nantes","2-4",2,4,"1",1,6,-2,"D"
1981-05-29,1980,"Girondins Bordeaux","FC Metz","1-1",1,1,"1",1,2,0,"D"
1981-05-29,1980,"OGC Nice","AS Monaco","2-1",2,1,"1",1,3,1,"H"
1981-05-29,1980,"RC Lens","Paris Saint-Germain","2-3",2,3,"1",1,5,-1,"D"
1981-05-29,1980,"Olympique Lyon","AJ Auxerre","1-3",1,3,"1",1,4,-2,"D"
1981-05-29,1980,"Angers SCO","RC Strasbourg","0-0",0,0,"1",1,0,0,"D"
1981-05-29,1980,"AS Nancy","US Valenciennes-Anzin","7-1",7,1,"1",1,8,6,"H"
1981-05-29,1980,"SC Bastia","Lille OSC","5-1",5,1,"1",1,6,4,"H"
1981-05-29,1980,"Nimes Olympique","Stade Laval","2-2",2,2,"1",1,4,0,"D"
1981-06-02,1980,"AS Saint-Etienne","Girondins Bordeaux","2-1",2,1,"1",1,3,1,"H"
1981-06-02,1980,"FC Nantes","Nimes Olympique","1-1",1,1,"1",1,2,0,"D"
1981-06-02,1980,"AS Monaco","AS Nancy","1-0",1,0,"1",1,1,1,"H"
1981-06-02,1980,"Paris Saint-Germain","Angers SCO","2-2",2,2,"1",1,4,0,"D"
1981-06-02,1980,"US Valenciennes-Anzin","Olympique Lyon","2-1",2,1,"1",1,3,1,"H"
1981-06-02,1980,"RC Strasbourg","Lille OSC","3-2",3,2,"1",1,5,1,"H"
1981-06-02,1980,"FC Metz","OGC Nice","0-1",0,1,"1",1,1,-1,"D"
1981-06-02,1980,"AJ Auxerre","SC Bastia","0-0",0,0,"1",1,0,0,"D"
1981-06-02,1980,"RC Lens","FC Sochaux","5-1",5,1,"1",1,6,4,"H"
1981-06-02,1980,"Stade Laval","Tours FC","2-0",2,0,"1",1,2,2,"H"
1981-07-24,1981,"Olympique Lyon","AS Nancy","2-0",2,0,"1",1,2,2,"H"
1981-07-24,1981,"Girondins Bordeaux","FC Nantes","3-2",3,2,"1",1,5,1,"H"
1981-07-24,1981,"Tours FC","Paris Saint-Germain","1-2",1,2,"1",1,3,-1,"D"
1981-07-24,1981,"OGC Nice","US Valenciennes-Anzin","1-2",1,2,"1",1,3,-1,"D"
1981-07-24,1981,"RC Strasbourg","AS Monaco","0-1",0,1,"1",1,1,-1,"D"
1981-07-24,1981,"SC Bastia","RC Lens","1-0",1,0,"1",1,1,1,"H"
1981-07-24,1981,"Stade Laval","FC Sochaux","1-1",1,1,"1",1,2,0,"D"
1981-07-24,1981,"Lille OSC","Stade Brest","1-1",1,1,"1",1,2,0,"D"
1981-07-24,1981,"FC Metz","AS Saint-Etienne","0-0",0,0,"1",1,0,0,"D"
1981-07-24,1981,"Montpellier La Paillade SC","AJ Auxerre","0-0",0,0,"1",1,0,0,"D"
1981-07-28,1981,"US Valenciennes-Anzin","Olympique Lyon","0-1",0,1,"1",1,1,-1,"D"
1981-07-28,1981,"Paris Saint-Germain","Stade Laval","2-1",2,1,"1",1,3,1,"H"
1981-07-28,1981,"AS Saint-Etienne","AS Monaco","2-0",2,0,"1",1,2,2,"H"
1981-07-28,1981,"OGC Nice","Girondins Bordeaux","2-2",2,2,"1",1,4,0,"D"
1981-07-28,1981,"FC Sochaux","FC Metz","2-1",2,1,"1",1,3,1,"H"
1981-07-28,1981,"AJ Auxerre","Lille OSC","1-2",1,2,"1",1,3,-1,"D"
1981-07-28,1981,"Stade Brest","Tours FC","2-1",2,1,"1",1,3,1,"H"
1981-07-28,1981,"FC Nantes","SC Bastia","1-0",1,0,"1",1,1,1,"H"
1981-07-28,1981,"AS Nancy","Montpellier La Paillade SC","3-2",3,2,"1",1,5,1,"H"
1981-07-28,1981,"RC Lens","RC Strasbourg","0-1",0,1,"1",1,1,-1,"D"
1981-08-04,1981,"Olympique Lyon","OGC Nice","1-0",1,0,"1",1,1,1,"H"
1981-08-04,1981,"Girondins Bordeaux","US Valenciennes-Anzin","2-0",2,0,"1",1,2,2,"H"
1981-08-04,1981,"AS Monaco","FC Sochaux","2-3",2,3,"1",1,5,-1,"D"
1981-08-04,1981,"FC Metz","Paris Saint-Germain","1-1",1,1,"1",1,2,0,"D"
1981-08-04,1981,"SC Bastia","Stade Brest","3-1",3,1,"1",1,4,2,"H"
1981-08-04,1981,"RC Strasbourg","AS Saint-Etienne","2-0",2,0,"1",1,2,2,"H"
1981-08-04,1981,"Lille OSC","AS Nancy","1-2",1,2,"1",1,3,-1,"D"
1981-08-04,1981,"Stade Laval","AJ Auxerre","2-0",2,0,"1",1,2,2,"H"
1981-08-04,1981,"Montpellier La Paillade SC","FC Nantes","2-0",2,0,"1",1,2,2,"H"
1981-08-04,1981,"Tours FC","RC Lens","1-0",1,0,"1",1,1,1,"H"
1981-08-07,1981,"Olympique Lyon","Tours FC","2-1",2,1,"1",1,3,1,"H"
1981-08-07,1981,"FC Sochaux","AS Saint-Etienne","2-1",2,1,"1",1,3,1,"H"
1981-08-07,1981,"AS Nancy","Girondins Bordeaux","0-0",0,0,"1",1,0,0,"D"
1981-08-07,1981,"AJ Auxerre","SC Bastia","2-2",2,2,"1",1,4,0,"D"
1981-08-07,1981,"Paris Saint-Germain","AS Monaco","1-2",1,2,"1",1,3,-1,"D"
1981-08-07,1981,"US Valenciennes-Anzin","Lille OSC","4-0",4,0,"1",1,4,4,"H"
1981-08-07,1981,"Stade Brest","Stade Laval","2-2",2,2,"1",1,4,0,"D"
1981-08-07,1981,"FC Nantes","RC Strasbourg","2-0",2,0,"1",1,2,2,"H"
1981-08-07,1981,"OGC Nice","Montpellier La Paillade SC","1-0",1,0,"1",1,1,1,"H"
1981-08-07,1981,"RC Lens","FC Metz","2-0",2,0,"1",1,2,2,"H"
1981-08-11,1981,"RC Strasbourg","FC Sochaux","2-3",2,3,"1",1,5,-1,"D"
1981-08-11,1981,"Girondins Bordeaux","Olympique Lyon","3-0",3,0,"1",1,3,3,"H"
1981-08-11,1981,"AS Monaco","AJ Auxerre","7-1",7,1,"1",1,8,6,"H"
1981-08-11,1981,"SC Bastia","AS Nancy","3-3",3,3,"1",1,6,0,"D"
1981-08-11,1981,"Stade Laval","RC Lens","1-0",1,0,"1",1,1,1,"H"
1981-08-11,1981,"AS Saint-Etienne","Paris Saint-Germain","0-0",0,0,"1",1,0,0,"D"
1981-08-11,1981,"Montpellier La Paillade SC","US Valenciennes-Anzin","0-0",0,0,"1",1,0,0,"D"
1981-08-11,1981,"Lille OSC","OGC Nice","5-0",5,0,"1",1,5,5,"H"
1981-08-11,1981,"Tours FC","FC Nantes","1-1",1,1,"1",1,2,0,"D"
1981-08-11,1981,"FC Metz","Stade Brest","1-1",1,1,"1",1,2,0,"D"
1981-08-21,1981,"Olympique Lyon","Montpellier La Paillade SC","2-0",2,0,"1",1,2,2,"H"
1981-08-21,1981,"Girondins Bordeaux","RC Strasbourg","1-1",1,1,"1",1,2,0,"D"
1981-08-21,1981,"Paris Saint-Germain","FC Sochaux","1-0",1,0,"1",1,1,1,"H"
1981-08-21,1981,"US Valenciennes-Anzin","SC Bastia","1-2",1,2,"1",1,3,-1,"D"
1981-08-21,1981,"OGC Nice","Stade Laval","1-2",1,2,"1",1,3,-1,"D"
1981-08-21,1981,"AS Nancy","Tours FC","2-0",2,0,"1",1,2,2,"H"
1981-08-21,1981,"Stade Brest","AS Monaco","2-2",2,2,"1",1,4,0,"D"
1981-08-21,1981,"FC Nantes","Lille OSC","1-2",1,2,"1",1,3,-1,"D"
1981-08-21,1981,"RC Lens","AS Saint-Etienne","2-5",2,5,"1",1,7,-3,"D"
1981-08-21,1981,"AJ Auxerre","FC Metz","0-0",0,0,"1",1,0,0,"D"
1981-08-28,1981,"Montpellier La Paillade SC","Girondins Bordeaux","1-2",1,2,"1",1,3,-1,"D"
1981-08-28,1981,"Stade Laval","AS Nancy","2-1",2,1,"1",1,3,1,"H"
1981-08-28,1981,"FC Sochaux","Stade Brest","0-0",0,0,"1",1,0,0,"D"
1981-08-28,1981,"Lille OSC","Olympique Lyon","1-0",1,0,"1",1,1,1,"H"
1981-08-28,1981,"AS Monaco","RC Lens","4-1",4,1,"1",1,5,3,"H"
1981-08-28,1981,"SC Bastia","OGC Nice","1-1",1,1,"1",1,2,0,"D"
1981-08-28,1981,"RC Strasbourg","Paris Saint-Germain","2-0",2,0,"1",1,2,2,"H"
1981-08-28,1981,"FC Metz","FC Nantes","0-0",0,0,"1",1,0,0,"D"
1981-08-28,1981,"Tours FC","US Valenciennes-Anzin","2-1",2,1,"1",1,3,1,"H"
1981-09-01,1981,"Girondins Bordeaux","Lille OSC","1-1",1,1,"1",1,2,0,"D"
1981-09-01,1981,"Olympique Lyon","SC Bastia","4-1",4,1,"1",1,5,3,"H"
1981-09-01,1981,"AS Nancy","FC Sochaux","0-0",0,0,"1",1,0,0,"D"
1981-09-01,1981,"Stade Brest","AS Saint-Etienne","1-1",1,1,"1",1,2,0,"D"
1981-09-01,1981,"US Valenciennes-Anzin","Stade Laval","3-1",3,1,"1",1,4,2,"H"
1981-09-01,1981,"FC Nantes","AS Monaco","3-1",3,1,"1",1,4,2,"H"
1981-09-01,1981,"RC Lens","Paris Saint-Germain","1-1",1,1,"1",1,2,0,"D"
1981-09-01,1981,"AJ Auxerre","RC Strasbourg","3-0",3,0,"1",1,3,3,"H"
1981-09-01,1981,"OGC Nice","Tours FC","0-1",0,1,"1",1,1,-1,"D"
1981-09-01,1981,"Montpellier La Paillade SC","FC Metz","1-1",1,1,"1",1,2,0,"D"
1981-09-11,1981,"Lille OSC","Montpellier La Paillade SC","6-1",6,1,"1",1,7,5,"H"
1981-09-12,1981,"SC Bastia","Girondins Bordeaux","4-4",4,4,"1",1,8,0,"D"
1981-09-12,1981,"FC Sochaux","RC Lens","1-0",1,0,"1",1,1,1,"H"
1981-09-12,1981,"AS Saint-Etienne","Olympique Lyon","4-0",4,0,"1",1,4,4,"H"
1981-09-12,1981,"AS Monaco","OGC Nice","1-0",1,0,"1",1,1,1,"H"
1981-09-12,1981,"Stade Laval","FC Nantes","1-1",1,1,"1",1,2,0,"D"
1981-09-12,1981,"FC Metz","AS Nancy","1-2",1,2,"1",1,3,-1,"D"
1981-09-12,1981,"RC Strasbourg","US Valenciennes-Anzin","4-0",4,0,"1",1,4,4,"H"
1981-09-12,1981,"Paris Saint-Germain","Stade Brest","1-2",1,2,"1",1,3,-1,"D"
1981-09-12,1981,"Tours FC","AJ Auxerre","2-0",2,0,"1",1,2,2,"H"
1981-09-17,1981,"AS Saint-Etienne","AJ Auxerre","3-0",3,0,"1",1,3,3,"H"
1981-09-22,1981,"Girondins Bordeaux","Tours FC","2-1",2,1,"1",1,3,1,"H"
1981-09-22,1981,"FC Nantes","FC Sochaux","1-1",1,1,"1",1,2,0,"D"
1981-09-22,1981,"Lille OSC","AS Saint-Etienne","3-4",3,4,"1",1,7,-1,"D"
1981-09-22,1981,"US Valenciennes-Anzin","AS Monaco","0-0",0,0,"1",1,0,0,"D"
1981-09-22,1981,"Stade Brest","RC Lens","2-0",2,0,"1",1,2,2,"H"
1981-09-22,1981,"Montpellier La Paillade SC","SC Bastia","3-2",3,2,"1",1,5,1,"H"
1981-09-22,1981,"AJ Auxerre","Paris Saint-Germain","1-0",1,0,"1",1,1,1,"H"
1981-09-22,1981,"OGC Nice","FC Metz","3-1",3,1,"1",1,4,2,"H"
1981-09-25,1981,"FC Sochaux","OGC Nice","2-1",2,1,"1",1,3,1,"H"
1981-09-25,1981,"Stade Laval","Girondins Bordeaux","1-0",1,0,"1",1,1,1,"H"
1981-09-25,1981,"AS Monaco","AS Nancy","5-1",5,1,"1",1,6,4,"H"
1981-09-25,1981,"AS Saint-Etienne","FC Nantes","1-0",1,0,"1",1,1,1,"H"
1981-09-25,1981,"RC Strasbourg","Stade Brest","2-3",2,3,"1",1,5,-1,"D"
1981-09-25,1981,"SC Bastia","Lille OSC","3-2",3,2,"1",1,5,1,"H"
1981-09-25,1981,"Paris Saint-Germain","Olympique Lyon","2-0",2,0,"1",1,2,2,"H"
1981-09-25,1981,"Tours FC","Montpellier La Paillade SC","1-0",1,0,"1",1,1,1,"H"
1981-09-25,1981,"FC Metz","US Valenciennes-Anzin","1-1",1,1,"1",1,2,0,"D"
1981-09-25,1981,"RC Lens","AJ Auxerre","5-2",5,2,"1",1,7,3,"H"
1981-10-02,1981,"AS Nancy","Paris Saint-Germain","0-0",0,0,"1",1,0,0,"D"
1981-10-03,1981,"Girondins Bordeaux","FC Metz","2-1",2,1,"1",1,3,1,"H"
1981-10-03,1981,"Olympique Lyon","AS Monaco","0-2",0,2,"1",1,2,-2,"D"
1981-10-03,1981,"US Valenciennes-Anzin","FC Sochaux","3-0",3,0,"1",1,3,3,"H"
1981-10-03,1981,"AJ Auxerre","Stade Brest","1-1",1,1,"1",1,2,0,"D"
1981-10-03,1981,"Lille OSC","Tours FC","2-0",2,0,"1",1,2,2,"H"
1981-10-03,1981,"SC Bastia","RC Strasbourg","1-0",1,0,"1",1,1,1,"H"
1981-10-03,1981,"Montpellier La Paillade SC","Stade Laval","2-1",2,1,"1",1,3,1,"H"
1981-10-03,1981,"FC Nantes","RC Lens","4-0",4,0,"1",1,4,4,"H"
1981-10-06,1981,"AS Monaco","Girondins Bordeaux","0-1",0,1,"1",1,1,-1,"D"
1981-10-06,1981,"FC Sochaux","AJ Auxerre","5-0",5,0,"1",1,5,5,"H"
1981-10-06,1981,"AS Saint-Etienne","AS Nancy","2-1",2,1,"1",1,3,1,"H"
1981-10-06,1981,"Stade Laval","Lille OSC","2-0",2,0,"1",1,2,2,"H"
1981-10-06,1981,"Stade Brest","FC Nantes","1-2",1,2,"1",1,3,-1,"D"
1981-10-06,1981,"Paris Saint-Germain","US Valenciennes-Anzin","4-0",4,0,"1",1,4,4,"H"
1981-10-06,1981,"Tours FC","SC Bastia","4-0",4,0,"1",1,4,4,"H"
1981-10-06,1981,"FC Metz","Olympique Lyon","1-0",1,0,"1",1,1,1,"H"
1981-10-06,1981,"RC Strasbourg","Montpellier La Paillade SC","0-0",0,0,"1",1,0,0,"D"
1981-10-06,1981,"RC Lens","OGC Nice","1-0",1,0,"1",1,1,1,"H"
1981-10-16,1981,"SC Bastia","Stade Laval","2-2",2,2,"1",1,4,0,"D"
1981-10-17,1981,"Girondins Bordeaux","AS Saint-Etienne","1-1",1,1,"1",1,2,0,"D"
1981-10-17,1981,"Montpellier La Paillade SC","AS Monaco","1-2",1,2,"1",1,3,-1,"D"
1981-10-17,1981,"Olympique Lyon","FC Sochaux","1-0",1,0,"1",1,1,1,"H"
1981-10-17,1981,"FC Nantes","AJ Auxerre","2-0",2,0,"1",1,2,2,"H"
1981-10-17,1981,"Lille OSC","RC Strasbourg","1-1",1,1,"1",1,2,0,"D"
1981-10-17,1981,"OGC Nice","Paris Saint-Germain","2-2",2,2,"1",1,4,0,"D"
1981-10-17,1981,"AS Nancy","Stade Brest","5-0",5,0,"1",1,5,5,"H"
1981-10-17,1981,"Tours FC","FC Metz","2-2",2,2,"1",1,4,0,"D"
1981-10-17,1981,"US Valenciennes-Anzin","RC Lens","1-1",1,1,"1",1,2,0,"D"
1981-10-20,1981,"Olympique Lyon","Stade Laval","0-0",0,0,"1",1,0,0,"D"
1981-10-23,1981,"AS Nancy","RC Strasbourg","3-0",3,0,"1",1,3,3,"H"
1981-10-27,1981,"AS Monaco","Lille OSC","4-0",4,0,"1",1,4,4,"H"
1981-10-27,1981,"AS Saint-Etienne","Montpellier La Paillade SC","4-0",4,0,"1",1,4,4,"H"
1981-10-27,1981,"FC Sochaux","Girondins Bordeaux","2-1",2,1,"1",1,3,1,"H"
1981-10-27,1981,"Stade Laval","Tours FC","0-0",0,0,"1",1,0,0,"D"
1981-10-27,1981,"Paris Saint-Germain","FC Nantes","4-0",4,0,"1",1,4,4,"H"
1981-10-27,1981,"RC Lens","AS Nancy","2-2",2,2,"1",1,4,0,"D"
1981-10-27,1981,"Stade Brest","US Valenciennes-Anzin","3-0",3,0,"1",1,3,3,"H"
1981-10-27,1981,"RC Strasbourg","Olympique Lyon","2-0",2,0,"1",1,2,2,"H"
1981-10-27,1981,"FC Metz","SC Bastia","2-0",2,0,"1",1,2,2,"H"
1981-10-27,1981,"AJ Auxerre","OGC Nice","0-0",0,0,"1",1,0,0,"D"
1981-10-30,1981,"Girondins Bordeaux","Paris Saint-Germain","2-0",2,0,"1",1,2,2,"H"
1981-10-30,1981,"Montpellier La Paillade SC","FC Sochaux","1-3",1,3,"1",1,4,-2,"D"
1981-10-30,1981,"Stade Laval","AS Saint-Etienne","0-0",0,0,"1",1,0,0,"D"
1981-10-30,1981,"SC Bastia","AS Monaco","1-0",1,0,"1",1,1,1,"H"
1981-10-30,1981,"AS Nancy","FC Nantes","1-0",1,0,"1",1,1,1,"H"
1981-10-30,1981,"OGC Nice","Stade Brest","2-4",2,4,"1",1,6,-2,"D"
1981-10-30,1981,"Lille OSC","FC Metz","1-0",1,0,"1",1,1,1,"H"
1981-10-30,1981,"Tours FC","RC Strasbourg","2-1",2,1,"1",1,3,1,"H"
1981-10-30,1981,"Olympique Lyon","RC Lens","3-0",3,0,"1",1,3,3,"H"
1981-10-30,1981,"US Valenciennes-Anzin","AJ Auxerre","3-1",3,1,"1",1,4,2,"H"
1981-11-03,1981,"OGC Nice","AS Saint-Etienne","1-3",1,3,"1",1,4,-2,"D"
1981-11-06,1981,"FC Metz","Stade Laval","1-1",1,1,"1",1,2,0,"D"
1981-11-06,1981,"AJ Auxerre","AS Nancy","1-0",1,0,"1",1,1,1,"H"
1981-11-07,1981,"AS Saint-Etienne","SC Bastia","3-0",3,0,"1",1,3,3,"H"
1981-11-07,1981,"RC Lens","Girondins Bordeaux","1-2",1,2,"1",1,3,-1,"D"
1981-11-07,1981,"FC Sochaux","Lille OSC","1-1",1,1,"1",1,2,0,"D"
1981-11-07,1981,"AS Monaco","Tours FC","3-1",3,1,"1",1,4,2,"H"
1981-11-07,1981,"Stade Brest","Olympique Lyon","1-0",1,0,"1",1,1,1,"H"
1981-11-07,1981,"Paris Saint-Germain","Montpellier La Paillade SC","1-0",1,0,"1",1,1,1,"H"
1981-11-07,1981,"FC Nantes","US Valenciennes-Anzin","4-1",4,1,"1",1,5,3,"H"
1981-11-07,1981,"RC Strasbourg","OGC Nice","1-1",1,1,"1",1,2,0,"D"
1981-11-10,1981,"Tours FC","AS Saint-Etienne","3-4",3,4,"1",1,7,-1,"D"
1981-11-10,1981,"Girondins Bordeaux","Stade Brest","1-1",1,1,"1",1,2,0,"D"
1981-11-10,1981,"Stade Laval","AS Monaco","2-3",2,3,"1",1,5,-1,"D"
1981-11-10,1981,"SC Bastia","FC Sochaux","1-1",1,1,"1",1,2,0,"D"
1981-11-10,1981,"Lille OSC","Paris Saint-Germain","2-1",2,1,"1",1,3,1,"H"
1981-11-10,1981,"US Valenciennes-Anzin","AS Nancy","2-1",2,1,"1",1,3,1,"H"
1981-11-10,1981,"OGC Nice","FC Nantes","3-0",3,0,"1",1,3,3,"H"
1981-11-10,1981,"Olympique Lyon","AJ Auxerre","0-1",0,1,"1",1,1,-1,"D"
1981-11-10,1981,"FC Metz","RC Strasbourg","0-0",0,0,"1",1,0,0,"D"
1981-11-10,1981,"Montpellier La Paillade SC","RC Lens","1-1",1,1,"1",1,2,0,"D"
1981-11-21,1981,"AS Saint-Etienne","US Valenciennes-Anzin","5-1",5,1,"1",1,6,4,"H"
1981-11-21,1981,"AS Monaco","FC Metz","2-1",2,1,"1",1,3,1,"H"
1981-11-21,1981,"FC Sochaux","Tours FC","4-1",4,1,"1",1,5,3,"H"
1981-11-21,1981,"AJ Auxerre","Girondins Bordeaux","3-2",3,2,"1",1,5,1,"H"
1981-11-21,1981,"RC Strasbourg","Stade Laval","1-2",1,2,"1",1,3,-1,"D"
1981-11-21,1981,"Stade Brest","Montpellier La Paillade SC","0-1",0,1,"1",1,1,-1,"D"
1981-11-21,1981,"AS Nancy","OGC Nice","4-0",4,0,"1",1,4,4,"H"
1981-11-21,1981,"RC Lens","Lille OSC","1-0",1,0,"1",1,1,1,"H"
1981-11-21,1981,"FC Nantes","Olympique Lyon","0-0",0,0,"1",1,0,0,"D"
1981-11-24,1981,"Paris Saint-Germain","SC Bastia","3-1",3,1,"1",1,4,2,"H"
1981-11-28,1981,"AS Monaco","AS Saint-Etienne","1-0",1,0,"1",1,1,1,"H"
1981-11-28,1981,"Stade Laval","Paris Saint-Germain","0-3",0,3,"1",1,3,-3,"D"
1981-11-28,1981,"Tours FC","Stade Brest","5-0",5,0,"1",1,5,5,"H"
1981-11-28,1981,"Lille OSC","AJ Auxerre","1-1",1,1,"1",1,2,0,"D"
1981-11-28,1981,"SC Bastia","FC Nantes","1-0",1,0,"1",1,1,1,"H"
1981-11-28,1981,"RC Strasbourg","RC Lens","2-1",2,1,"1",1,3,1,"H"
1981-11-29,1981,"FC Metz","FC Sochaux","1-1",1,1,"1",1,2,0,"D"
1981-11-29,1981,"Girondins Bordeaux","OGC Nice","1-0",1,0,"1",1,1,1,"H"
1981-11-29,1981,"Montpellier La Paillade SC","AS Nancy","3-0",3,0,"1",1,3,3,"H"
1981-11-29,1981,"Olympique Lyon","US Valenciennes-Anzin","3-0",3,0,"1",1,3,3,"H"
1981-12-12,1981,"AJ Auxerre","Stade Laval","0-1",0,1,"1",1,1,-1,"D"
1981-12-12,1981,"Stade Brest","SC Bastia","2-0",2,0,"1",1,2,2,"H"
1981-12-12,1981,"FC Nantes","Montpellier La Paillade SC","7-0",7,0,"1",1,7,7,"H"
1981-12-12,1981,"OGC Nice","Olympique Lyon","0-0",0,0,"1",1,0,0,"D"
1981-12-12,1981,"RC Lens","Tours FC","4-2",4,2,"1",1,6,2,"H"
1981-12-13,1981,"AS Saint-Etienne","RC Strasbourg","2-0",2,0,"1",1,2,2,"H"
1981-12-13,1981,"FC Sochaux","AS Monaco","1-4",1,4,"1",1,5,-3,"D"
1981-12-13,1981,"US Valenciennes-Anzin","Girondins Bordeaux","0-1",0,1,"1",1,1,-1,"D"
1981-12-13,1981,"Paris Saint-Germain","FC Metz","2-0",2,0,"1",1,2,2,"H"
1981-12-13,1981,"AS Nancy","Lille OSC","1-1",1,1,"1",1,2,0,"D"
1981-12-19,1981,"AS Monaco","Paris Saint-Germain","0-0",0,0,"1",1,0,0,"D"
1981-12-19,1981,"Stade Laval","Stade Brest","1-0",1,0,"1",1,1,1,"H"
1981-12-19,1981,"Lille OSC","US Valenciennes-Anzin","2-0",2,0,"1",1,2,2,"H"
1981-12-19,1981,"Tours FC","Olympique Lyon","3-0",3,0,"1",1,3,3,"H"
1981-12-19,1981,"SC Bastia","AJ Auxerre","0-1",0,1,"1",1,1,-1,"D"
1981-12-20,1981,"AS Saint-Etienne","FC Sochaux","0-1",0,1,"1",1,1,-1,"D"
1981-12-20,1981,"Girondins Bordeaux","AS Nancy","1-1",1,1,"1",1,2,0,"D"
1981-12-20,1981,"Montpellier La Paillade SC","OGC Nice","2-1",2,1,"1",1,3,1,"H"
1982-01-16,1981,"Paris Saint-Germain","AS Saint-Etienne","0-0",0,0,"1",1,0,0,"D"
1982-01-16,1981,"AJ Auxerre","AS Monaco","2-0",2,0,"1",1,2,2,"H"
1982-01-16,1981,"RC Lens","Stade Laval","0-1",0,1,"1",1,1,-1,"D"
1982-01-16,1981,"Brest Armorique FC","FC Metz","2-0",2,0,"1",1,2,2,"H"
1982-01-16,1981,"OGC Nice","Lille OSC","2-0",2,0,"1",1,2,2,"H"
1982-01-16,1981,"FC Nantes","Tours FC","3-1",3,1,"1",1,4,2,"H"
1982-01-17,1981,"Olympique Lyon","Girondins Bordeaux","0-1",0,1,"1",1,1,-1,"D"
1982-01-23,1981,"AS Monaco","Brest Armorique FC","0-0",0,0,"1",1,0,0,"D"
1982-01-23,1981,"Stade Laval","OGC Nice","5-0",5,0,"1",1,5,5,"H"
1982-01-23,1981,"Lille OSC","FC Nantes","1-0",1,0,"1",1,1,1,"H"
1982-01-23,1981,"Tours FC","AS Nancy","1-1",1,1,"1",1,2,0,"D"
1982-01-23,1981,"SC Bastia","US Valenciennes-Anzin","1-0",1,0,"1",1,1,1,"H"
1982-01-24,1981,"AS Saint-Etienne","RC Lens","3-1",3,1,"1",1,4,2,"H"
1982-01-24,1981,"Montpellier La Paillade SC","Olympique Lyon","0-0",0,0,"1",1,0,0,"D"
1982-01-27,1981,"US Valenciennes-Anzin","Montpellier La Paillade SC","1-0",1,0,"1",1,1,1,"H"
1982-01-30,1981,"AJ Auxerre","AS Saint-Etienne","3-1",3,1,"1",1,4,2,"H"
1982-01-30,1981,"RC Lens","AS Monaco","0-0",0,0,"1",1,0,0,"D"
1982-01-30,1981,"Paris Saint-Germain","RC Strasbourg","2-1",2,1,"1",1,3,1,"H"
1982-01-30,1981,"Brest Armorique FC","FC Sochaux","2-1",2,1,"1",1,3,1,"H"
1982-01-30,1981,"FC Nantes","FC Metz","2-0",2,0,"1",1,2,2,"H"
1982-01-30,1981,"OGC Nice","SC Bastia","1-1",1,1,"1",1,2,0,"D"
1982-01-31,1981,"Girondins Bordeaux","Montpellier La Paillade SC","4-1",4,1,"1",1,5,3,"H"
1982-01-31,1981,"AS Nancy","Stade Laval","2-2",2,2,"1",1,4,0,"D"
1982-01-31,1981,"Olympique Lyon","Lille OSC","4-1",4,1,"1",1,5,3,"H"
1982-01-31,1981,"US Valenciennes-Anzin","Tours FC","1-1",1,1,"1",1,2,0,"D"
1982-02-03,1981,"RC Strasbourg","Girondins Bordeaux","1-0",1,0,"1",1,1,1,"H"
1982-02-06,1981,"Lille OSC","Girondins Bordeaux","0-1",0,1,"1",1,1,-1,"D"
1982-02-06,1981,"AS Monaco","FC Nantes","1-0",1,0,"1",1,1,1,"H"
1982-02-06,1981,"Stade Laval","US Valenciennes-Anzin","0-0",0,0,"1",1,0,0,"D"
1982-02-06,1981,"Paris Saint-Germain","RC Lens","2-1",2,1,"1",1,3,1,"H"
1982-02-06,1981,"FC Sochaux","AS Nancy","1-0",1,0,"1",1,1,1,"H"
1982-02-06,1981,"Tours FC","OGC Nice","2-1",2,1,"1",1,3,1,"H"
1982-02-06,1981,"SC Bastia","Olympique Lyon","1-0",1,0,"1",1,1,1,"H"
1982-02-07,1981,"AS Saint-Etienne","Brest Armorique FC","1-0",1,0,"1",1,1,1,"H"
1982-02-07,1981,"RC Strasbourg","AJ Auxerre","2-2",2,2,"1",1,4,0,"D"
1982-02-07,1981,"FC Metz","Montpellier La Paillade SC","4-0",4,0,"1",1,4,4,"H"
1982-02-10,1981,"FC Sochaux","RC Strasbourg","2-2",2,2,"1",1,4,0,"D"
1982-02-10,1981,"AS Nancy","SC Bastia","2-1",2,1,"1",1,3,1,"H"
1982-02-17,1981,"FC Metz","AJ Auxerre","1-0",1,0,"1",1,1,1,"H"
1982-02-17,1981,"FC Sochaux","Paris Saint-Germain","2-1",2,1,"1",1,3,1,"H"
1982-02-19,1981,"OGC Nice","AS Monaco","0-2",0,2,"1",1,2,-2,"D"
1982-02-19,1981,"Montpellier La Paillade SC","Lille OSC","2-1",2,1,"1",1,3,1,"H"
1982-02-20,1981,"Olympique Lyon","AS Saint-Etienne","0-1",0,1,"1",1,1,-1,"D"
1982-02-20,1981,"Girondins Bordeaux","SC Bastia","4-0",4,0,"1",1,4,4,"H"
1982-02-20,1981,"RC Lens","FC Sochaux","3-2",3,2,"1",1,5,1,"H"
1982-02-20,1981,"Brest Armorique FC","Paris Saint-Germain","0-3",0,3,"1",1,3,-3,"D"
1982-02-20,1981,"FC Nantes","Stade Laval","1-0",1,0,"1",1,1,1,"H"
1982-02-20,1981,"AS Nancy","FC Metz","2-2",2,2,"1",1,4,0,"D"
1982-02-20,1981,"AJ Auxerre","Tours FC","1-2",1,2,"1",1,3,-1,"D"
1982-02-20,1981,"US Valenciennes-Anzin","RC Strasbourg","0-0",0,0,"1",1,0,0,"D"
1982-02-24,1981,"FC Metz","RC Lens","0-0",0,0,"1",1,0,0,"D"
1982-02-27,1981,"Tours FC","Girondins Bordeaux","1-2",1,2,"1",1,3,-1,"D"
1982-02-27,1981,"AS Monaco","US Valenciennes-Anzin","3-1",3,1,"1",1,4,2,"H"
1982-02-27,1981,"Paris Saint-Germain","AJ Auxerre","2-1",2,1,"1",1,3,1,"H"
1982-02-27,1981,"Stade Laval","Olympique Lyon","3-1",3,1,"1",1,4,2,"H"
1982-02-27,1981,"RC Lens","Brest Armorique FC","4-0",4,0,"1",1,4,4,"H"
1982-02-27,1981,"SC Bastia","Montpellier La Paillade SC","1-0",1,0,"1",1,1,1,"H"
1982-02-28,1981,"AS Saint-Etienne","Lille OSC","1-1",1,1,"1",1,2,0,"D"
1982-02-28,1981,"FC Sochaux","FC Nantes","2-1",2,1,"1",1,3,1,"H"
1982-02-28,1981,"FC Metz","OGC Nice","1-0",1,0,"1",1,1,1,"H"
1982-03-03,1981,"AS Nancy","AS Monaco","0-3",0,3,"1",1,3,-3,"D"
1982-03-03,1981,"Girondins Bordeaux","Stade Laval","0-0",0,0,"1",1,0,0,"D"
1982-03-03,1981,"FC Nantes","AS Saint-Etienne","3-0",3,0,"1",1,3,3,"H"
1982-03-03,1981,"Olympique Lyon","Paris Saint-Germain","2-3",2,3,"1",1,5,-1,"D"
1982-03-03,1981,"OGC Nice","FC Sochaux","1-0",1,0,"1",1,1,1,"H"
1982-03-03,1981,"Montpellier La Paillade SC","Tours FC","1-3",1,3,"1",1,4,-2,"D"
1982-03-03,1981,"Lille OSC","SC Bastia","4-0",4,0,"1",1,4,4,"H"
1982-03-03,1981,"Brest Armorique FC","RC Strasbourg","1-2",1,2,"1",1,3,-1,"D"
1982-03-03,1981,"AJ Auxerre","RC Lens","1-1",1,1,"1",1,2,0,"D"
1982-03-03,1981,"US Valenciennes-Anzin","FC Metz","2-0",2,0,"1",1,2,2,"H"
1982-03-13,1981,"AS Monaco","Olympique Lyon","3-1",3,1,"1",1,4,2,"H"
1982-03-13,1981,"FC Metz","Girondins Bordeaux","1-1",1,1,"1",1,2,0,"D"
1982-03-13,1981,"AS Saint-Etienne","OGC Nice","2-0",2,0,"1",1,2,2,"H"
1982-03-13,1981,"FC Sochaux","US Valenciennes-Anzin","2-0",2,0,"1",1,2,2,"H"
1982-03-13,1981,"Paris Saint-Germain","AS Nancy","1-2",1,2,"1",1,3,-1,"D"
1982-03-13,1981,"Stade Laval","Montpellier La Paillade SC","2-1",2,1,"1",1,3,1,"H"
1982-03-13,1981,"Tours FC","Lille OSC","4-1",4,1,"1",1,5,3,"H"
1982-03-13,1981,"Brest Armorique FC","AJ Auxerre","2-2",2,2,"1",1,4,0,"D"
1982-03-13,1981,"RC Lens","FC Nantes","1-0",1,0,"1",1,1,1,"H"
1982-03-13,1981,"RC Strasbourg","SC Bastia","0-0",0,0,"1",1,0,0,"D"
1982-03-16,1981,"RC Strasbourg","FC Nantes","1-0",1,0,"1",1,1,1,"H"
1982-03-20,1981,"Girondins Bordeaux","AS Monaco","1-0",1,0,"1",1,1,1,"H"
1982-03-20,1981,"AS Nancy","AS Saint-Etienne","0-0",0,0,"1",1,0,0,"D"
1982-03-20,1981,"US Valenciennes-Anzin","Paris Saint-Germain","2-2",2,2,"1",1,4,0,"D"
1982-03-20,1981,"AJ Auxerre","FC Sochaux","3-0",3,0,"1",1,3,3,"H"
1982-03-20,1981,"Lille OSC","Stade Laval","1-0",1,0,"1",1,1,1,"H"
1982-03-20,1981,"FC Nantes","Brest Armorique FC","3-1",3,1,"1",1,4,2,"H"
1982-03-20,1981,"SC Bastia","Tours FC","2-1",2,1,"1",1,3,1,"H"
1982-03-20,1981,"Montpellier La Paillade SC","RC Strasbourg","0-0",0,0,"1",1,0,0,"D"
1982-03-20,1981,"Olympique Lyon","FC Metz","3-1",3,1,"1",1,4,2,"H"
1982-03-20,1981,"OGC Nice","RC Lens","3-1",3,1,"1",1,4,2,"H"
1982-03-27,1981,"AS Monaco","Montpellier La Paillade SC","1-0",1,0,"1",1,1,1,"H"
1982-03-27,1981,"AS Saint-Etienne","Girondins Bordeaux","5-0",5,0,"1",1,5,5,"H"
1982-03-27,1981,"FC Sochaux","Olympique Lyon","3-1",3,1,"1",1,4,2,"H"
1982-03-27,1981,"Paris Saint-Germain","OGC Nice","1-1",1,1,"1",1,2,0,"D"
1982-03-27,1981,"Stade Laval","SC Bastia","2-0",2,0,"1",1,2,2,"H"
1982-03-27,1981,"AJ Auxerre","FC Nantes","0-1",0,1,"1",1,1,-1,"D"
1982-03-27,1981,"Brest Armorique FC","AS Nancy","0-1",0,1,"1",1,1,-1,"D"
1982-03-27,1981,"FC Metz","Tours FC","4-2",4,2,"1",1,6,2,"H"
1982-03-27,1981,"RC Strasbourg","Lille OSC","3-0",3,0,"1",1,3,3,"H"
1982-03-27,1981,"RC Lens","US Valenciennes-Anzin","1-1",1,1,"1",1,2,0,"D"
1982-04-02,1981,"Lille OSC","AS Monaco","0-2",0,2,"1",1,2,-2,"D"
1982-04-02,1981,"Montpellier La Paillade SC","AS Saint-Etienne","0-1",0,1,"1",1,1,-1,"D"
1982-04-02,1981,"Girondins Bordeaux","FC Sochaux","3-1",3,1,"1",1,4,2,"H"
1982-04-02,1981,"FC Nantes","Paris Saint-Germain","4-0",4,0,"1",1,4,4,"H"
1982-04-02,1981,"Tours FC","Stade Laval","2-1",2,1,"1",1,3,1,"H"
1982-04-02,1981,"AS Nancy","RC Lens","0-0",0,0,"1",1,0,0,"D"
1982-04-02,1981,"Olympique Lyon","RC Strasbourg","1-1",1,1,"1",1,2,0,"D"
1982-04-02,1981,"SC Bastia","FC Metz","1-1",1,1,"1",1,2,0,"D"
1982-04-02,1981,"US Valenciennes-Anzin","Brest Armorique FC","5-2",5,2,"1",1,7,3,"H"
1982-04-02,1981,"OGC Nice","AJ Auxerre","4-0",4,0,"1",1,4,4,"H"
1982-04-09,1981,"AS Monaco","SC Bastia","4-1",4,1,"1",1,5,3,"H"
1982-04-09,1981,"Paris Saint-Germain","Girondins Bordeaux","0-2",0,2,"1",1,2,-2,"D"
1982-04-09,1981,"AS Saint-Etienne","Stade Laval","1-1",1,1,"1",1,2,0,"D"
1982-04-09,1981,"FC Sochaux","Montpellier La Paillade SC","1-0",1,0,"1",1,1,1,"H"
1982-04-09,1981,"FC Nantes","AS Nancy","5-1",5,1,"1",1,6,4,"H"
1982-04-09,1981,"RC Strasbourg","Tours FC","1-1",1,1,"1",1,2,0,"D"
1982-04-09,1981,"Brest Armorique FC","OGC Nice","1-0",1,0,"1",1,1,1,"H"
1982-04-09,1981,"FC Metz","Lille OSC","1-0",1,0,"1",1,1,1,"H"
1982-04-09,1981,"AJ Auxerre","US Valenciennes-Anzin","3-0",3,0,"1",1,3,3,"H"
1982-04-09,1981,"RC Lens","Olympique Lyon","2-1",2,1,"1",1,3,1,"H"
1982-04-13,1981,"Tours FC","AS Monaco","1-1",1,1,"1",1,2,0,"D"
1982-04-13,1981,"SC Bastia","AS Saint-Etienne","1-1",1,1,"1",1,2,0,"D"
1982-04-13,1981,"Girondins Bordeaux","RC Lens","0-1",0,1,"1",1,1,-1,"D"
1982-04-13,1981,"Lille OSC","FC Sochaux","0-0",0,0,"1",1,0,0,"D"
1982-04-13,1981,"Stade Laval","FC Metz","1-0",1,0,"1",1,1,1,"H"
1982-04-13,1981,"Montpellier La Paillade SC","Paris Saint-Germain","2-5",2,5,"1",1,7,-3,"D"
1982-04-13,1981,"US Valenciennes-Anzin","FC Nantes","1-2",1,2,"1",1,3,-1,"D"
1982-04-13,1981,"AS Nancy","AJ Auxerre","1-1",1,1,"1",1,2,0,"D"
1982-04-13,1981,"OGC Nice","RC Strasbourg","0-1",0,1,"1",1,1,-1,"D"
1982-04-13,1981,"Olympique Lyon","Brest Armorique FC","1-0",1,0,"1",1,1,1,"H"
1982-04-16,1981,"RC Strasbourg","AS Nancy","2-0",2,0,"1",1,2,2,"H"
1982-04-23,1981,"AS Monaco","Stade Laval","3-0",3,0,"1",1,3,3,"H"
1982-04-23,1981,"AS Saint-Etienne","Tours FC","1-0",1,0,"1",1,1,1,"H"
1982-04-23,1981,"Brest Armorique FC","Girondins Bordeaux","3-1",3,1,"1",1,4,2,"H"
1982-04-23,1981,"FC Sochaux","SC Bastia","3-0",3,0,"1",1,3,3,"H"
1982-04-23,1981,"FC Nantes","OGC Nice","2-0",2,0,"1",1,2,2,"H"
1982-04-23,1981,"Paris Saint-Germain","Lille OSC","0-1",0,1,"1",1,1,-1,"D"
1982-04-23,1981,"RC Strasbourg","FC Metz","0-1",0,1,"1",1,1,-1,"D"
1982-04-23,1981,"AS Nancy","US Valenciennes-Anzin","1-3",1,3,"1",1,4,-2,"D"
1982-04-23,1981,"RC Lens","Montpellier La Paillade SC","1-0",1,0,"1",1,1,1,"H"
1982-04-23,1981,"AJ Auxerre","Olympique Lyon","2-2",2,2,"1",1,4,0,"D"
1982-05-04,1981,"FC Metz","AS Monaco","0-0",0,0,"1",1,0,0,"D"
1982-05-04,1981,"US Valenciennes-Anzin","AS Saint-Etienne","0-2",0,2,"1",1,2,-2,"D"
1982-05-04,1981,"Girondins Bordeaux","AJ Auxerre","0-2",0,2,"1",1,2,-2,"D"
1982-05-04,1981,"Tours FC","FC Sochaux","1-2",1,2,"1",1,3,-1,"D"
1982-05-04,1981,"Stade Laval","RC Strasbourg","4-2",4,2,"1",1,6,2,"H"
1982-05-04,1981,"Olympique Lyon","FC Nantes","1-0",1,0,"1",1,1,1,"H"
1982-05-04,1981,"SC Bastia","Paris Saint-Germain","3-1",3,1,"1",1,4,2,"H"
1982-05-04,1981,"OGC Nice","AS Nancy","1-2",1,2,"1",1,3,-1,"D"
1982-05-04,1981,"Montpellier La Paillade SC","Brest Armorique FC","1-3",1,3,"1",1,4,-2,"D"
1982-05-04,1981,"Lille OSC","RC Lens","0-3",0,3,"1",1,3,-3,"D"
1982-05-07,1981,"AS Monaco","RC Strasbourg","1-0",1,0,"1",1,1,1,"H"
1982-05-07,1981,"AS Saint-Etienne","FC Metz","9-2",9,2,"1",1,11,7,"H"
1982-05-07,1981,"FC Sochaux","Stade Laval","3-1",3,1,"1",1,4,2,"H"
1982-05-07,1981,"FC Nantes","Girondins Bordeaux","6-0",6,0,"1",1,6,6,"H"
1982-05-07,1981,"Paris Saint-Germain","Tours FC","4-3",4,3,"1",1,7,1,"H"
1982-05-07,1981,"AS Nancy","Olympique Lyon","2-1",2,1,"1",1,3,1,"H"
1982-05-07,1981,"Brest Armorique FC","Lille OSC","1-0",1,0,"1",1,1,1,"H"
1982-05-07,1981,"RC Lens","SC Bastia","1-1",1,1,"1",1,2,0,"D"
1982-05-07,1981,"AJ Auxerre","Montpellier La Paillade SC","1-1",1,1,"1",1,2,0,"D"
1982-05-07,1981,"US Valenciennes-Anzin","OGC Nice","0-0",0,0,"1",1,0,0,"D"
1982-08-10,1982,"Brest Armorique FC","Tours FC","4-2",4,2,"1",1,6,2,"H"
1982-08-10,1982,"Stade Laval","FC Sochaux","3-1",3,1,"1",1,4,2,"H"
1982-08-10,1982,"Girondins Bordeaux","AS Monaco","3-1",3,1,"1",1,4,2,"H"
1982-08-10,1982,"Toulouse FC","RC Strasbourg","3-1",3,1,"1",1,4,2,"H"
1982-08-10,1982,"FC Metz","Lille OSC","2-0",2,0,"1",1,2,2,"H"
1982-08-10,1982,"RC Lens","AS Nancy","2-1",2,1,"1",1,3,1,"H"
1982-08-10,1982,"SC Bastia","AS Saint-Etienne","2-1",2,1,"1",1,3,1,"H"
1982-08-10,1982,"Paris Saint-Germain","FC Rouen","1-0",1,0,"1",1,1,1,"H"
1982-08-10,1982,"FC Mulhouse","FC Nantes","1-1",1,1,"1",1,2,0,"D"
1982-08-10,1982,"Olympique Lyon","AJ Auxerre","1-1",1,1,"1",1,2,0,"D"
1982-08-17,1982,"FC Sochaux","Toulouse FC","2-3",2,3,"1",1,5,-1,"D"
1982-08-17,1982,"AJ Auxerre","Stade Laval","0-1",0,1,"1",1,1,-1,"D"
1982-08-17,1982,"FC Nantes","SC Bastia","3-0",3,0,"1",1,3,3,"H"
1982-08-17,1982,"RC Lens","Girondins Bordeaux","2-2",2,2,"1",1,4,0,"D"
1982-08-17,1982,"AS Saint-Etienne","Brest Armorique FC","0-0",0,0,"1",1,0,0,"D"
1982-08-17,1982,"AS Monaco","Paris Saint-Germain","1-1",1,1,"1",1,2,0,"D"
1982-08-17,1982,"Tours FC","FC Metz","3-2",3,2,"1",1,5,1,"H"
1982-08-17,1982,"FC Rouen","Olympique Lyon","2-1",2,1,"1",1,3,1,"H"
1982-08-17,1982,"RC Strasbourg","Lille OSC","1-0",1,0,"1",1,1,1,"H"
1982-08-17,1982,"AS Nancy","FC Mulhouse","6-0",6,0,"1",1,6,6,"H"
1982-08-24,1982,"Toulouse FC","AJ Auxerre","2-1",2,1,"1",1,3,1,"H"
1982-08-24,1982,"Brest Armorique FC","FC Rouen","4-2",4,2,"1",1,6,2,"H"
1982-08-24,1982,"Girondins Bordeaux","FC Nantes","1-2",1,2,"1",1,3,-1,"D"
1982-08-24,1982,"FC Mulhouse","RC Lens","1-3",1,3,"1",1,4,-2,"D"
1982-08-24,1982,"Stade Laval","AS Saint-Etienne","0-0",0,0,"1",1,0,0,"D"
1982-08-24,1982,"Paris Saint-Germain","AS Nancy","2-3",2,3,"1",1,5,-1,"D"
1982-08-24,1982,"SC Bastia","AS Monaco","2-0",2,0,"1",1,2,2,"H"
1982-08-24,1982,"FC Metz","RC Strasbourg","1-1",1,1,"1",1,2,0,"D"
1982-08-24,1982,"Olympique Lyon","Tours FC","2-0",2,0,"1",1,2,2,"H"
1982-08-24,1982,"Lille OSC","FC Sochaux","1-0",1,0,"1",1,1,1,"H"
1982-08-27,1982,"FC Nantes","Brest Armorique FC","5-1",5,1,"1",1,6,4,"H"
1982-08-27,1982,"RC Lens","SC Bastia","2-1",2,1,"1",1,3,1,"H"
1982-08-27,1982,"AS Nancy","Girondins Bordeaux","2-1",2,1,"1",1,3,1,"H"
1982-08-27,1982,"Tours FC","Toulouse FC","2-0",2,0,"1",1,2,2,"H"
1982-08-27,1982,"AS Monaco","Stade Laval","4-1",4,1,"1",1,5,3,"H"
1982-08-27,1982,"FC Rouen","FC Metz","0-0",0,0,"1",1,0,0,"D"
1982-08-27,1982,"AS Saint-Etienne","Paris Saint-Germain","1-1",1,1,"1",1,2,0,"D"
1982-08-27,1982,"FC Sochaux","RC Strasbourg","2-2",2,2,"1",1,4,0,"D"
1982-08-27,1982,"AJ Auxerre","Lille OSC","3-0",3,0,"1",1,3,3,"H"
1982-08-28,1982,"FC Mulhouse","Olympique Lyon","1-1",1,1,"1",1,2,0,"D"
1982-09-03,1982,"Lille OSC","RC Lens","1-1",1,1,"1",1,2,0,"D"
1982-09-03,1982,"Toulouse FC","FC Rouen","2-1",2,1,"1",1,3,1,"H"
1982-09-03,1982,"Paris Saint-Germain","FC Nantes","2-1",2,1,"1",1,3,1,"H"
1982-09-03,1982,"Stade Laval","Tours FC","3-0",3,0,"1",1,3,3,"H"
1982-09-03,1982,"SC Bastia","AS Nancy","3-2",3,2,"1",1,5,1,"H"
1982-09-03,1982,"Olympique Lyon","AS Saint-Etienne","2-1",2,1,"1",1,3,1,"H"
1982-09-03,1982,"Brest Armorique FC","AS Monaco","1-1",1,1,"1",1,2,0,"D"
1982-09-03,1982,"RC Strasbourg","AJ Auxerre","0-2",0,2,"1",1,2,-2,"D"
1982-09-03,1982,"Girondins Bordeaux","FC Mulhouse","2-0",2,0,"1",1,2,2,"H"
1982-09-04,1982,"FC Metz","FC Sochaux","1-1",1,1,"1",1,2,0,"D"
1982-09-10,1982,"RC Lens","Paris Saint-Germain","4-0",4,0,"1",1,4,4,"H"
1982-09-10,1982,"FC Nantes","Olympique Lyon","1-0",1,0,"1",1,1,1,"H"
1982-09-10,1982,"AS Saint-Etienne","Toulouse FC","2-1",2,1,"1",1,3,1,"H"
1982-09-10,1982,"AS Nancy","Brest Armorique FC","1-1",1,1,"1",1,2,0,"D"
1982-09-10,1982,"Girondins Bordeaux","Stade Laval","4-1",4,1,"1",1,5,3,"H"
1982-09-10,1982,"AJ Auxerre","FC Sochaux","2-2",2,2,"1",1,4,0,"D"
1982-09-10,1982,"AS Monaco","FC Metz","2-1",2,1,"1",1,3,1,"H"
1982-09-10,1982,"Tours FC","RC Strasbourg","2-0",2,0,"1",1,2,2,"H"
1982-09-10,1982,"FC Mulhouse","SC Bastia","4-1",4,1,"1",1,5,3,"H"
1982-09-10,1982,"FC Rouen","Lille OSC","2-0",2,0,"1",1,2,2,"H"
1982-09-21,1982,"Stade Laval","FC Nantes","1-3",1,3,"1",1,4,-2,"D"
1982-09-21,1982,"Brest Armorique FC","RC Lens","2-1",2,1,"1",1,3,1,"H"
1982-09-21,1982,"Toulouse FC","AS Monaco","2-1",2,1,"1",1,3,1,"H"
1982-09-21,1982,"Olympique Lyon","AS Nancy","1-2",1,2,"1",1,3,-1,"D"
1982-09-21,1982,"SC Bastia","Girondins Bordeaux","1-2",1,2,"1",1,3,-1,"D"
1982-09-21,1982,"Paris Saint-Germain","FC Mulhouse","5-1",5,1,"1",1,6,4,"H"
1982-09-21,1982,"FC Metz","AJ Auxerre","1-1",1,1,"1",1,2,0,"D"
1982-09-21,1982,"Lille OSC","Tours FC","2-0",2,0,"1",1,2,2,"H"
1982-09-21,1982,"RC Strasbourg","FC Rouen","1-0",1,0,"1",1,1,1,"H"
1982-09-21,1982,"FC Sochaux","AS Saint-Etienne","3-0",3,0,"1",1,3,3,"H"
1982-09-24,1982,"FC Nantes","RC Strasbourg","3-0",3,0,"1",1,3,3,"H"
1982-09-24,1982,"RC Lens","Olympique Lyon","1-0",1,0,"1",1,1,1,"H"
1982-09-24,1982,"Girondins Bordeaux","Paris Saint-Germain","2-1",2,1,"1",1,3,1,"H"
1982-09-24,1982,"SC Bastia","Toulouse FC","1-1",1,1,"1",1,2,0,"D"
1982-09-24,1982,"AS Nancy","Stade Laval","1-1",1,1,"1",1,2,0,"D"
1982-09-24,1982,"FC Mulhouse","Brest Armorique FC","1-1",1,1,"1",1,2,0,"D"
1982-09-24,1982,"Tours FC","AJ Auxerre","3-2",3,2,"1",1,5,1,"H"
1982-09-24,1982,"AS Monaco","Lille OSC","0-0",0,0,"1",1,0,0,"D"
1982-09-24,1982,"AS Saint-Etienne","FC Metz","3-1",3,1,"1",1,4,2,"H"
1982-09-24,1982,"FC Rouen","FC Sochaux","1-1",1,1,"1",1,2,0,"D"
1982-10-02,1982,"Toulouse FC","FC Nantes","0-1",0,1,"1",1,1,-1,"D"
1982-10-02,1982,"Brest Armorique FC","Girondins Bordeaux","0-1",0,1,"1",1,1,-1,"D"
1982-10-02,1982,"Stade Laval","RC Lens","0-0",0,0,"1",1,0,0,"D"
1982-10-02,1982,"FC Metz","AS Nancy","2-3",2,3,"1",1,5,-1,"D"
1982-10-02,1982,"Paris Saint-Germain","SC Bastia","1-0",1,0,"1",1,1,1,"H"
1982-10-02,1982,"AJ Auxerre","FC Rouen","2-0",2,0,"1",1,2,2,"H"
1982-10-02,1982,"FC Sochaux","Tours FC","1-1",1,1,"1",1,2,0,"D"
1982-10-02,1982,"Olympique Lyon","AS Monaco","1-1",1,1,"1",1,2,0,"D"
1982-10-02,1982,"Lille OSC","AS Saint-Etienne","1-1",1,1,"1",1,2,0,"D"
1982-10-02,1982,"RC Strasbourg","FC Mulhouse","2-1",2,1,"1",1,3,1,"H"
1982-10-12,1982,"FC Nantes","FC Metz","2-3",2,3,"1",1,5,-1,"D"
1982-10-12,1982,"Girondins Bordeaux","Olympique Lyon","5-1",5,1,"1",1,6,4,"H"
1982-10-12,1982,"RC Lens","Toulouse FC","3-1",3,1,"1",1,4,2,"H"
1982-10-12,1982,"AS Nancy","Lille OSC","2-2",2,2,"1",1,4,0,"D"
1982-10-12,1982,"Paris Saint-Germain","FC Sochaux","1-0",1,0,"1",1,1,1,"H"
1982-10-12,1982,"SC Bastia","Brest Armorique FC","1-1",1,1,"1",1,2,0,"D"
1982-10-12,1982,"AS Monaco","RC Strasbourg","3-0",3,0,"1",1,3,3,"H"
1982-10-12,1982,"AS Saint-Etienne","AJ Auxerre","1-0",1,0,"1",1,1,1,"H"
1982-10-12,1982,"FC Mulhouse","Stade Laval","2-1",2,1,"1",1,3,1,"H"
1982-10-12,1982,"FC Rouen","Tours FC","4-2",4,2,"1",1,6,2,"H"
1982-10-15,1982,"Lille OSC","FC Nantes","0-2",0,2,"1",1,2,-2,"D"
1982-10-15,1982,"FC Metz","Girondins Bordeaux","2-1",2,1,"1",1,3,1,"H"
1982-10-15,1982,"RC Strasbourg","RC Lens","2-1",2,1,"1",1,3,1,"H"
1982-10-15,1982,"Toulouse FC","AS Nancy","2-1",2,1,"1",1,3,1,"H"
1982-10-15,1982,"Brest Armorique FC","Paris Saint-Germain","3-1",3,1,"1",1,4,2,"H"
1982-10-15,1982,"Tours FC","AS Saint-Etienne","0-2",0,2,"1",1,2,-2,"D"
1982-10-15,1982,"AJ Auxerre","FC Mulhouse","2-1",2,1,"1",1,3,1,"H"
1982-10-15,1982,"FC Sochaux","AS Monaco","1-1",1,1,"1",1,2,0,"D"
1982-10-15,1982,"Stade Laval","FC Rouen","3-1",3,1,"1",1,4,2,"H"
1982-10-15,1982,"Olympique Lyon","SC Bastia","3-1",3,1,"1",1,4,2,"H"
1982-10-26,1982,"FC Nantes","AJ Auxerre","1-0",1,0,"1",1,1,1,"H"
1982-10-26,1982,"Girondins Bordeaux","Toulouse FC","1-0",1,0,"1",1,1,1,"H"
1982-10-26,1982,"RC Lens","FC Metz","4-2",4,2,"1",1,6,2,"H"
1982-10-26,1982,"Brest Armorique FC","Olympique Lyon","2-1",2,1,"1",1,3,1,"H"
1982-10-26,1982,"AS Saint-Etienne","FC Rouen","1-0",1,0,"1",1,1,1,"H"
1982-10-26,1982,"Paris Saint-Germain","RC Strasbourg","4-3",4,3,"1",1,7,1,"H"
1982-10-26,1982,"AS Nancy","FC Sochaux","1-3",1,3,"1",1,4,-2,"D"
1982-10-26,1982,"AS Monaco","Tours FC","3-0",3,0,"1",1,3,3,"H"
1982-10-26,1982,"SC Bastia","Stade Laval","1-1",1,1,"1",1,2,0,"D"
1982-10-26,1982,"FC Mulhouse","Lille OSC","1-0",1,0,"1",1,1,1,"H"
1982-10-29,1982,"FC Sochaux","FC Nantes","1-1",1,1,"1",1,2,0,"D"
1982-10-29,1982,"Lille OSC","Girondins Bordeaux","2-1",2,1,"1",1,3,1,"H"
1982-10-29,1982,"Tours FC","RC Lens","5-1",5,1,"1",1,6,4,"H"
1982-10-29,1982,"Olympique Lyon","Paris Saint-Germain","1-3",1,3,"1",1,4,-2,"D"
1982-10-29,1982,"Stade Laval","Brest Armorique FC","1-1",1,1,"1",1,2,0,"D"
1982-10-29,1982,"AJ Auxerre","AS Nancy","2-3",2,3,"1",1,5,-1,"D"
1982-10-29,1982,"Toulouse FC","FC Mulhouse","2-1",2,1,"1",1,3,1,"H"
1982-10-29,1982,"FC Rouen","AS Monaco","1-1",1,1,"1",1,2,0,"D"
1982-10-29,1982,"RC Strasbourg","AS Saint-Etienne","2-0",2,0,"1",1,2,2,"H"
1982-10-29,1982,"FC Metz","SC Bastia","0-0",0,0,"1",1,0,0,"D"
1982-11-06,1982,"FC Nantes","FC Rouen","1-0",1,0,"1",1,1,1,"H"
1982-11-06,1982,"Girondins Bordeaux","RC Strasbourg","1-1",1,1,"1",1,2,0,"D"
1982-11-06,1982,"RC Lens","AJ Auxerre","0-0",0,0,"1",1,0,0,"D"
1982-11-06,1982,"Paris Saint-Germain","Stade Laval","0-0",0,0,"1",1,0,0,"D"
1982-11-06,1982,"Brest Armorique FC","FC Metz","1-1",1,1,"1",1,2,0,"D"
1982-11-06,1982,"AS Nancy","Tours FC","3-3",3,3,"1",1,6,0,"D"
1982-11-06,1982,"AS Monaco","AS Saint-Etienne","2-2",2,2,"1",1,4,0,"D"
1982-11-06,1982,"Olympique Lyon","Toulouse FC","4-1",4,1,"1",1,5,3,"H"
1982-11-06,1982,"FC Mulhouse","FC Sochaux","1-0",1,0,"1",1,1,1,"H"
1982-11-06,1982,"SC Bastia","Lille OSC","0-0",0,0,"1",1,0,0,"D"
1982-11-16,1982,"Tours FC","FC Nantes","0-4",0,4,"1",1,4,-4,"D"
1982-11-16,1982,"FC Sochaux","Girondins Bordeaux","0-2",0,2,"1",1,2,-2,"D"
1982-11-16,1982,"AS Saint-Etienne","RC Lens","0-1",0,1,"1",1,1,-1,"D"
1982-11-16,1982,"Toulouse FC","Brest Armorique FC","2-2",2,2,"1",1,4,0,"D"
1982-11-16,1982,"Lille OSC","Paris Saint-Germain","1-0",1,0,"1",1,1,1,"H"
1982-11-16,1982,"FC Rouen","AS Nancy","1-0",1,0,"1",1,1,1,"H"
1982-11-16,1982,"AJ Auxerre","AS Monaco","1-0",1,0,"1",1,1,1,"H"
1982-11-16,1982,"Stade Laval","Olympique Lyon","1-1",1,1,"1",1,2,0,"D"
1982-11-16,1982,"RC Strasbourg","SC Bastia","2-1",2,1,"1",1,3,1,"H"
1982-11-16,1982,"FC Metz","FC Mulhouse","3-0",3,0,"1",1,3,3,"H"
1982-11-20,1982,"FC Nantes","AS Monaco","0-0",0,0,"1",1,0,0,"D"
1982-11-20,1982,"Girondins Bordeaux","AJ Auxerre","3-0",3,0,"1",1,3,3,"H"
1982-11-20,1982,"RC Lens","FC Rouen","2-0",2,0,"1",1,2,2,"H"
1982-11-20,1982,"Brest Armorique FC","Lille OSC","0-1",0,1,"1",1,1,-1,"D"
1982-11-20,1982,"Stade Laval","RC Strasbourg","2-1",2,1,"1",1,3,1,"H"
1982-11-20,1982,"FC Mulhouse","Tours FC","1-0",1,0,"1",1,1,1,"H"
1982-11-20,1982,"SC Bastia","FC Sochaux","0-0",0,0,"1",1,0,0,"D"
1982-11-21,1982,"AS Nancy","AS Saint-Etienne","3-1",3,1,"1",1,4,2,"H"
1982-11-21,1982,"Olympique Lyon","FC Metz","3-3",3,3,"1",1,6,0,"D"
1982-11-23,1982,"Paris Saint-Germain","Toulouse FC","2-1",2,1,"1",1,3,1,"H"
1982-11-27,1982,"Tours FC","Girondins Bordeaux","1-2",1,2,"1",1,3,-1,"D"
1982-11-27,1982,"FC Sochaux","RC Lens","1-1",1,1,"1",1,2,0,"D"
1982-11-27,1982,"FC Metz","Paris Saint-Germain","1-2",1,2,"1",1,3,-1,"D"
1982-11-27,1982,"RC Strasbourg","Brest Armorique FC","0-0",0,0,"1",1,0,0,"D"
1982-11-27,1982,"Toulouse FC","Stade Laval","0-1",0,1,"1",1,1,-1,"D"
1982-11-27,1982,"AS Monaco","AS Nancy","1-0",1,0,"1",1,1,1,"H"
1982-11-27,1982,"Lille OSC","Olympique Lyon","1-0",1,0,"1",1,1,1,"H"
1982-11-27,1982,"AJ Auxerre","SC Bastia","1-1",1,1,"1",1,2,0,"D"
1982-11-27,1982,"FC Rouen","FC Mulhouse","4-2",4,2,"1",1,6,2,"H"
1982-12-04,1982,"AS Nancy","FC Nantes","2-2",2,2,"1",1,4,0,"D"
1982-12-04,1982,"Girondins Bordeaux","FC Rouen","3-2",3,2,"1",1,5,1,"H"
1982-12-04,1982,"RC Lens","AS Monaco","2-0",2,0,"1",1,2,2,"H"
1982-12-04,1982,"Paris Saint-Germain","AJ Auxerre","0-0",0,0,"1",1,0,0,"D"
1982-12-04,1982,"Stade Laval","Lille OSC","2-0",2,0,"1",1,2,2,"H"
1982-12-04,1982,"Brest Armorique FC","FC Sochaux","2-2",2,2,"1",1,4,0,"D"
1982-12-04,1982,"Toulouse FC","FC Metz","2-1",2,1,"1",1,3,1,"H"
1982-12-04,1982,"Olympique Lyon","RC Strasbourg","4-2",4,2,"1",1,6,2,"H"
1982-12-04,1982,"FC Mulhouse","AS Saint-Etienne","1-0",1,0,"1",1,1,1,"H"
1982-12-04,1982,"SC Bastia","Tours FC","4-1",4,1,"1",1,5,3,"H"
1982-12-11,1982,"FC Nantes","RC Lens","5-1",5,1,"1",1,6,4,"H"
1982-12-11,1982,"AS Saint-Etienne","Girondins Bordeaux","3-1",3,1,"1",1,4,2,"H"
1982-12-11,1982,"Tours FC","Paris Saint-Germain","3-1",3,1,"1",1,4,2,"H"
1982-12-11,1982,"FC Metz","Stade Laval","3-2",3,2,"1",1,5,1,"H"
1982-12-11,1982,"AS Monaco","FC Mulhouse","1-0",1,0,"1",1,1,1,"H"
1982-12-11,1982,"AJ Auxerre","Brest Armorique FC","4-2",4,2,"1",1,6,2,"H"
1982-12-11,1982,"RC Strasbourg","AS Nancy","2-0",2,0,"1",1,2,2,"H"
1982-12-11,1982,"Lille OSC","Toulouse FC","3-0",3,0,"1",1,3,3,"H"
1982-12-11,1982,"FC Sochaux","Olympique Lyon","1-1",1,1,"1",1,2,0,"D"
1982-12-11,1982,"FC Rouen","SC Bastia","2-1",2,1,"1",1,3,1,"H"
1982-12-15,1982,"AS Saint-Etienne","FC Nantes","0-1",0,1,"1",1,1,-1,"D"
1982-12-18,1982,"SC Bastia","FC Nantes","1-1",1,1,"1",1,2,0,"D"
1982-12-18,1982,"Girondins Bordeaux","RC Lens","3-0",3,0,"1",1,3,3,"H"
1982-12-18,1982,"Stade Laval","AJ Auxerre","1-0",1,0,"1",1,1,1,"H"
1982-12-18,1982,"Paris Saint-Germain","AS Monaco","0-1",0,1,"1",1,1,-1,"D"
1982-12-18,1982,"Brest Armorique FC","AS Saint-Etienne","4-2",4,2,"1",1,6,2,"H"
1982-12-18,1982,"Lille OSC","RC Strasbourg","1-0",1,0,"1",1,1,1,"H"
1982-12-18,1982,"FC Metz","Tours FC","5-1",5,1,"1",1,6,4,"H"
1982-12-18,1982,"FC Mulhouse","AS Nancy","3-1",3,1,"1",1,4,2,"H"
1982-12-18,1982,"Toulouse FC","FC Sochaux","2-6",2,6,"1",1,8,-4,"D"
1982-12-18,1982,"Olympique Lyon","FC Rouen","0-4",0,4,"1",1,4,-4,"D"
1983-01-15,1982,"FC Nantes","Girondins Bordeaux","4-0",4,0,"1",1,4,4,"H"
1983-01-15,1982,"RC Lens","FC Mulhouse","4-2",4,2,"1",1,6,2,"H"
1983-01-15,1982,"AS Monaco","SC Bastia","3-0",3,0,"1",1,3,3,"H"
1983-01-15,1982,"AS Saint-Etienne","Stade Laval","1-1",1,1,"1",1,2,0,"D"
1983-01-15,1982,"AS Nancy","Paris Saint-Germain","2-3",2,3,"1",1,5,-1,"D"
1983-01-15,1982,"FC Rouen","Brest Armorique FC","1-1",1,1,"1",1,2,0,"D"
1983-01-15,1982,"FC Sochaux","Lille OSC","2-0",2,0,"1",1,2,2,"H"
1983-01-15,1982,"AJ Auxerre","Toulouse FC","5-1",5,1,"1",1,6,4,"H"
1983-01-15,1982,"RC Strasbourg","FC Metz","2-1",2,1,"1",1,3,1,"H"
1983-01-15,1982,"Tours FC","Olympique Lyon","3-0",3,0,"1",1,3,3,"H"
1983-01-22,1982,"Brest Armorique FC","FC Nantes","1-1",1,1,"1",1,2,0,"D"
1983-01-22,1982,"Girondins Bordeaux","AS Nancy","3-2",3,2,"1",1,5,1,"H"
1983-01-22,1982,"SC Bastia","RC Lens","4-0",4,0,"1",1,4,4,"H"
1983-01-22,1982,"Paris Saint-Germain","AS Saint-Etienne","4-1",4,1,"1",1,5,3,"H"
1983-01-22,1982,"Stade Laval","AS Monaco","1-0",1,0,"1",1,1,1,"H"
1983-01-22,1982,"Lille OSC","AJ Auxerre","1-2",1,2,"1",1,3,-1,"D"
1983-01-23,1982,"FC Metz","FC Rouen","3-2",3,2,"1",1,5,1,"H"
1983-01-23,1982,"RC Strasbourg","FC Sochaux","1-1",1,1,"1",1,2,0,"D"
1983-01-23,1982,"Toulouse FC","Tours FC","1-1",1,1,"1",1,2,0,"D"
1983-01-23,1982,"Olympique Lyon","FC Mulhouse","7-3",7,3,"1",1,10,4,"H"
1983-01-29,1982,"FC Nantes","Paris Saint-Germain","2-0",2,0,"1",1,2,2,"H"
1983-01-29,1982,"RC Lens","Lille OSC","2-0",2,0,"1",1,2,2,"H"
1983-01-29,1982,"AS Monaco","Brest Armorique FC","5-0",5,0,"1",1,5,5,"H"
1983-01-29,1982,"Tours FC","Stade Laval","4-1",4,1,"1",1,5,3,"H"
1983-01-29,1982,"AJ Auxerre","RC Strasbourg","0-0",0,0,"1",1,0,0,"D"
1983-01-29,1982,"FC Rouen","Toulouse FC","3-0",3,0,"1",1,3,3,"H"
1983-01-30,1982,"FC Mulhouse","Girondins Bordeaux","4-4",4,4,"1",1,8,0,"D"
1983-01-30,1982,"FC Sochaux","FC Metz","4-3",4,3,"1",1,7,1,"H"
1983-01-30,1982,"AS Nancy","SC Bastia","2-2",2,2,"1",1,4,0,"D"
1983-01-30,1982,"AS Saint-Etienne","Olympique Lyon","1-0",1,0,"1",1,1,1,"H"
1983-02-05,1982,"Stade Laval","Girondins Bordeaux","2-0",2,0,"1",1,2,2,"H"
1983-02-05,1982,"Brest Armorique FC","AS Nancy","0-3",0,3,"1",1,3,-3,"D"
1983-02-05,1982,"Lille OSC","FC Rouen","5-0",5,0,"1",1,5,5,"H"
1983-02-05,1982,"SC Bastia","FC Mulhouse","2-0",2,0,"1",1,2,2,"H"
1983-02-05,1982,"Toulouse FC","AS Saint-Etienne","1-1",1,1,"1",1,2,0,"D"
1983-02-06,1982,"Olympique Lyon","FC Nantes","1-2",1,2,"1",1,3,-1,"D"
1983-02-06,1982,"FC Metz","AS Monaco","1-1",1,1,"1",1,2,0,"D"
1983-02-06,1982,"FC Sochaux","AJ Auxerre","2-0",2,0,"1",1,2,2,"H"
1983-02-06,1982,"RC Strasbourg","Tours FC","1-1",1,1,"1",1,2,0,"D"
1983-02-08,1982,"Paris Saint-Germain","RC Lens","4-3",4,3,"1",1,7,1,"H"
1983-02-19,1982,"FC Nantes","Stade Laval","0-0",0,0,"1",1,0,0,"D"
1983-02-19,1982,"Girondins Bordeaux","SC Bastia","0-0",0,0,"1",1,0,0,"D"
1983-02-19,1982,"RC Lens","Brest Armorique FC","2-3",2,3,"1",1,5,-1,"D"
1983-02-19,1982,"AS Monaco","Toulouse FC","0-0",0,0,"1",1,0,0,"D"
1983-02-19,1982,"AJ Auxerre","FC Metz","2-2",2,2,"1",1,4,0,"D"
1983-02-19,1982,"Tours FC","Lille OSC","5-0",5,0,"1",1,5,5,"H"
1983-02-19,1982,"FC Rouen","RC Strasbourg","2-1",2,1,"1",1,3,1,"H"
1983-02-20,1982,"FC Mulhouse","Paris Saint-Germain","1-1",1,1,"1",1,2,0,"D"
1983-02-20,1982,"AS Saint-Etienne","FC Sochaux","0-1",0,1,"1",1,1,-1,"D"
1983-02-20,1982,"AS Nancy","Olympique Lyon","5-2",5,2,"1",1,7,3,"H"
1983-02-25,1982,"Paris Saint-Germain","Girondins Bordeaux","2-0",2,0,"1",1,2,2,"H"
1983-02-25,1982,"Olympique Lyon","RC Lens","2-1",2,1,"1",1,3,1,"H"
1983-02-26,1982,"Stade Laval","AS Nancy","0-0",0,0,"1",1,0,0,"D"
1983-02-26,1982,"Lille OSC","AS Monaco","1-1",1,1,"1",1,2,0,"D"
1983-02-26,1982,"Brest Armorique FC","FC Mulhouse","4-0",4,0,"1",1,4,4,"H"
1983-02-26,1982,"AJ Auxerre","Tours FC","3-1",3,1,"1",1,4,2,"H"
1983-02-26,1982,"FC Metz","AS Saint-Etienne","1-1",1,1,"1",1,2,0,"D"
1983-02-26,1982,"Toulouse FC","SC Bastia","3-1",3,1,"1",1,4,2,"H"
1983-02-27,1982,"RC Strasbourg","FC Nantes","2-0",2,0,"1",1,2,2,"H"
1983-02-27,1982,"FC Sochaux","FC Rouen","2-2",2,2,"1",1,4,0,"D"
1983-03-09,1982,"FC Nantes","Toulouse FC","3-0",3,0,"1",1,3,3,"H"
1983-03-09,1982,"Girondins Bordeaux","Brest Armorique FC","0-0",0,0,"1",1,0,0,"D"
1983-03-09,1982,"SC Bastia","Paris Saint-Germain","1-1",1,1,"1",1,2,0,"D"
1983-03-09,1982,"AS Monaco","Olympique Lyon","3-0",3,0,"1",1,3,3,"H"
1983-03-09,1982,"RC Lens","Stade Laval","2-0",2,0,"1",1,2,2,"H"
1983-03-09,1982,"Tours FC","FC Sochaux","1-1",1,1,"1",1,2,0,"D"
1983-03-09,1982,"AS Nancy","FC Metz","4-0",4,0,"1",1,4,4,"H"
1983-03-09,1982,"FC Rouen","AJ Auxerre","1-1",1,1,"1",1,2,0,"D"
1983-03-09,1982,"FC Mulhouse","RC Strasbourg","2-0",2,0,"1",1,2,2,"H"
1983-03-09,1982,"AS Saint-Etienne","Lille OSC","1-0",1,0,"1",1,1,1,"H"
1983-03-19,1982,"FC Metz","FC Nantes","0-4",0,4,"1",1,4,-4,"D"
1983-03-19,1982,"Olympique Lyon","Girondins Bordeaux","3-5",3,5,"1",1,8,-2,"D"
1983-03-19,1982,"FC Sochaux","Paris Saint-Germain","1-2",1,2,"1",1,3,-1,"D"
1983-03-19,1982,"RC Strasbourg","AS Monaco","0-4",0,4,"1",1,4,-4,"D"
1983-03-19,1982,"Toulouse FC","RC Lens","1-0",1,0,"1",1,1,1,"H"
1983-03-19,1982,"Brest Armorique FC","SC Bastia","4-2",4,2,"1",1,6,2,"H"
1983-03-19,1982,"Stade Laval","FC Mulhouse","0-0",0,0,"1",1,0,0,"D"
1983-03-19,1982,"AJ Auxerre","AS Saint-Etienne","4-1",4,1,"1",1,5,3,"H"
1983-03-19,1982,"Lille OSC","AS Nancy","2-0",2,0,"1",1,2,2,"H"
1983-03-19,1982,"Tours FC","FC Rouen","3-1",3,1,"1",1,4,2,"H"
1983-03-29,1982,"FC Nantes","Lille OSC","1-0",1,0,"1",1,1,1,"H"
1983-03-29,1982,"Girondins Bordeaux","FC Metz","2-0",2,0,"1",1,2,2,"H"
1983-03-29,1982,"Paris Saint-Germain","Brest Armorique FC","2-0",2,0,"1",1,2,2,"H"
1983-03-29,1982,"AS Monaco","FC Sochaux","0-0",0,0,"1",1,0,0,"D"
1983-03-29,1982,"RC Lens","RC Strasbourg","2-1",2,1,"1",1,3,1,"H"
1983-03-29,1982,"FC Rouen","Stade Laval","2-2",2,2,"1",1,4,0,"D"
1983-03-29,1982,"FC Mulhouse","AJ Auxerre","3-2",3,2,"1",1,5,1,"H"
1983-03-29,1982,"AS Nancy","Toulouse FC","1-2",1,2,"1",1,3,-1,"D"
1983-03-29,1982,"AS Saint-Etienne","Tours FC","0-0",0,0,"1",1,0,0,"D"
1983-03-29,1982,"SC Bastia","Olympique Lyon","2-1",2,1,"1",1,3,1,"H"
1983-04-01,1982,"AJ Auxerre","FC Nantes","1-1",1,1,"1",1,2,0,"D"
1983-04-01,1982,"Toulouse FC","Girondins Bordeaux","0-1",0,1,"1",1,1,-1,"D"
1983-04-01,1982,"RC Strasbourg","Paris Saint-Germain","1-1",1,1,"1",1,2,0,"D"
1983-04-01,1982,"Tours FC","AS Monaco","2-2",2,2,"1",1,4,0,"D"
1983-04-01,1982,"Stade Laval","SC Bastia","1-0",1,0,"1",1,1,1,"H"
1983-04-01,1982,"FC Metz","RC Lens","2-1",2,1,"1",1,3,1,"H"
1983-04-01,1982,"Olympique Lyon","Brest Armorique FC","2-0",2,0,"1",1,2,2,"H"
1983-04-01,1982,"FC Sochaux","AS Nancy","0-1",0,1,"1",1,1,-1,"D"
1983-04-01,1982,"Lille OSC","FC Mulhouse","4-0",4,0,"1",1,4,4,"H"
1983-04-01,1982,"FC Rouen","AS Saint-Etienne","0-1",0,1,"1",1,1,-1,"D"
1983-04-08,1982,"FC Nantes","FC Sochaux","4-0",4,0,"1",1,4,4,"H"
1983-04-08,1982,"Girondins Bordeaux","Lille OSC","2-0",2,0,"1",1,2,2,"H"
1983-04-08,1982,"Paris Saint-Germain","Olympique Lyon","3-0",3,0,"1",1,3,3,"H"
1983-04-08,1982,"AS Monaco","FC Rouen","2-0",2,0,"1",1,2,2,"H"
1983-04-08,1982,"RC Lens","Tours FC","2-1",2,1,"1",1,3,1,"H"
1983-04-08,1982,"Brest Armorique FC","Stade Laval","3-0",3,0,"1",1,3,3,"H"
1983-04-08,1982,"AS Nancy","AJ Auxerre","3-1",3,1,"1",1,4,2,"H"
1983-04-08,1982,"FC Mulhouse","Toulouse FC","1-2",1,2,"1",1,3,-1,"D"
1983-04-08,1982,"SC Bastia","FC Metz","0-3",0,3,"1",1,3,-3,"D"
1983-04-08,1982,"AS Saint-Etienne","RC Strasbourg","0-0",0,0,"1",1,0,0,"D"
1983-04-19,1982,"FC Rouen","FC Nantes","1-0",1,0,"1",1,1,1,"H"
1983-04-19,1982,"RC Strasbourg","Girondins Bordeaux","0-0",0,0,"1",1,0,0,"D"
1983-04-19,1982,"Stade Laval","Paris Saint-Germain","1-0",1,0,"1",1,1,1,"H"
1983-04-19,1982,"AS Saint-Etienne","AS Monaco","2-0",2,0,"1",1,2,2,"H"
1983-04-19,1982,"AJ Auxerre","RC Lens","0-0",0,0,"1",1,0,0,"D"
1983-04-19,1982,"Tours FC","AS Nancy","1-2",1,2,"1",1,3,-1,"D"
1983-04-19,1982,"FC Metz","Brest Armorique FC","1-0",1,0,"1",1,1,1,"H"
1983-04-19,1982,"Toulouse FC","Olympique Lyon","4-1",4,1,"1",1,5,3,"H"
1983-04-19,1982,"FC Sochaux","FC Mulhouse","1-1",1,1,"1",1,2,0,"D"
1983-04-19,1982,"Lille OSC","SC Bastia","2-0",2,0,"1",1,2,2,"H"
1983-04-29,1982,"FC Nantes","Tours FC","2-1",2,1,"1",1,3,1,"H"
1983-04-29,1982,"Girondins Bordeaux","FC Sochaux","3-1",3,1,"1",1,4,2,"H"
1983-04-29,1982,"Paris Saint-Germain","Lille OSC","4-1",4,1,"1",1,5,3,"H"
1983-04-29,1982,"AS Monaco","AJ Auxerre","1-1",1,1,"1",1,2,0,"D"
1983-04-29,1982,"RC Lens","AS Saint-Etienne","4-2",4,2,"1",1,6,2,"H"
1983-04-29,1982,"Olympique Lyon","Stade Laval","2-0",2,0,"1",1,2,2,"H"
1983-04-29,1982,"AS Nancy","FC Rouen","2-0",2,0,"1",1,2,2,"H"
1983-04-29,1982,"Brest Armorique FC","Toulouse FC","2-2",2,2,"1",1,4,0,"D"
1983-04-29,1982,"FC Mulhouse","FC Metz","3-4",3,4,"1",1,7,-1,"D"
1983-04-29,1982,"SC Bastia","RC Strasbourg","1-1",1,1,"1",1,2,0,"D"
1983-05-06,1982,"AS Monaco","FC Nantes","2-2",2,2,"1",1,4,0,"D"
1983-05-06,1982,"AJ Auxerre","Girondins Bordeaux","2-2",2,2,"1",1,4,0,"D"
1983-05-06,1982,"Toulouse FC","Paris Saint-Germain","2-1",2,1,"1",1,3,1,"H"
1983-05-06,1982,"FC Rouen","RC Lens","1-1",1,1,"1",1,2,0,"D"
1983-05-06,1982,"RC Strasbourg","Stade Laval","1-2",1,2,"1",1,3,-1,"D"
1983-05-06,1982,"AS Saint-Etienne","AS Nancy","3-4",3,4,"1",1,7,-1,"D"
1983-05-06,1982,"FC Metz","Olympique Lyon","4-1",4,1,"1",1,5,3,"H"
1983-05-06,1982,"Lille OSC","Brest Armorique FC","4-0",4,0,"1",1,4,4,"H"
1983-05-06,1982,"FC Sochaux","SC Bastia","2-1",2,1,"1",1,3,1,"H"
1983-05-06,1982,"Tours FC","FC Mulhouse","1-0",1,0,"1",1,1,1,"H"
1983-05-13,1982,"FC Nantes","AS Saint-Etienne","4-2",4,2,"1",1,6,2,"H"
1983-05-13,1982,"Girondins Bordeaux","Tours FC","1-0",1,0,"1",1,1,1,"H"
1983-05-13,1982,"Paris Saint-Germain","FC Metz","3-1",3,1,"1",1,4,2,"H"
1983-05-13,1982,"RC Lens","FC Sochaux","3-0",3,0,"1",1,3,3,"H"
1983-05-13,1982,"Stade Laval","Toulouse FC","2-1",2,1,"1",1,3,1,"H"
1983-05-13,1982,"AS Nancy","AS Monaco","2-1",2,1,"1",1,3,1,"H"
1983-05-13,1982,"Brest Armorique FC","RC Strasbourg","1-0",1,0,"1",1,1,1,"H"
1983-05-13,1982,"SC Bastia","AJ Auxerre","1-0",1,0,"1",1,1,1,"H"
1983-05-13,1982,"Olympique Lyon","Lille OSC","3-1",3,1,"1",1,4,2,"H"
1983-05-13,1982,"FC Mulhouse","FC Rouen","0-0",0,0,"1",1,0,0,"D"
1983-05-20,1982,"FC Nantes","AS Nancy","3-1",3,1,"1",1,4,2,"H"
1983-05-20,1982,"FC Rouen","Girondins Bordeaux","2-1",2,1,"1",1,3,1,"H"
1983-05-20,1982,"AJ Auxerre","Paris Saint-Germain","3-2",3,2,"1",1,5,1,"H"
1983-05-20,1982,"AS Monaco","RC Lens","2-1",2,1,"1",1,3,1,"H"
1983-05-20,1982,"Lille OSC","Stade Laval","0-0",0,0,"1",1,0,0,"D"
1983-05-20,1982,"FC Metz","Toulouse FC","3-2",3,2,"1",1,5,1,"H"
1983-05-20,1982,"FC Sochaux","Brest Armorique FC","4-0",4,0,"1",1,4,4,"H"
1983-05-20,1982,"AS Saint-Etienne","FC Mulhouse","1-0",1,0,"1",1,1,1,"H"
1983-05-20,1982,"RC Strasbourg","Olympique Lyon","2-0",2,0,"1",1,2,2,"H"
1983-05-20,1982,"Tours FC","SC Bastia","0-1",0,1,"1",1,1,-1,"D"
1983-05-24,1982,"RC Lens","FC Nantes","2-2",2,2,"1",1,4,0,"D"
1983-05-24,1982,"Girondins Bordeaux","AS Saint-Etienne","1-1",1,1,"1",1,2,0,"D"
1983-05-24,1982,"Paris Saint-Germain","Tours FC","4-2",4,2,"1",1,6,2,"H"
1983-05-24,1982,"Stade Laval","FC Metz","2-1",2,1,"1",1,3,1,"H"
1983-05-24,1982,"Brest Armorique FC","AJ Auxerre","2-2",2,2,"1",1,4,0,"D"
1983-05-24,1982,"Toulouse FC","Lille OSC","3-0",3,0,"1",1,3,3,"H"
1983-05-24,1982,"Olympique Lyon","FC Sochaux","3-1",3,1,"1",1,4,2,"H"
1983-05-24,1982,"SC Bastia","FC Rouen","0-0",0,0,"1",1,0,0,"D"
1983-05-29,1982,"FC Mulhouse","AS Monaco","2-1",2,1,"1",1,3,1,"H"
1983-05-29,1982,"AS Nancy","RC Strasbourg","2-1",2,1,"1",1,3,1,"H"
1983-06-03,1982,"FC Nantes","FC Mulhouse","2-1",2,1,"1",1,3,1,"H"
1983-06-03,1982,"AS Monaco","Girondins Bordeaux","3-1",3,1,"1",1,4,2,"H"
1983-06-03,1982,"FC Rouen","Paris Saint-Germain","0-1",0,1,"1",1,1,-1,"D"
1983-06-03,1982,"AS Nancy","RC Lens","1-2",1,2,"1",1,3,-1,"D"
1983-06-03,1982,"FC Sochaux","Stade Laval","1-1",1,1,"1",1,2,0,"D"
1983-06-03,1982,"AJ Auxerre","Olympique Lyon","3-1",3,1,"1",1,4,2,"H"
1983-06-03,1982,"Lille OSC","FC Metz","1-1",1,1,"1",1,2,0,"D"
1983-06-03,1982,"Tours FC","Brest Armorique FC","2-0",2,0,"1",1,2,2,"H"
1983-06-03,1982,"RC Strasbourg","Toulouse FC","3-0",3,0,"1",1,3,3,"H"
1983-06-03,1982,"AS Saint-Etienne","SC Bastia","1-1",1,1,"1",1,2,0,"D"
1983-07-20,1983,"Girondins Bordeaux","Stade Rennes","4-1",4,1,"1",1,5,3,"H"
1983-07-20,1983,"FC Sochaux","Nimes Olympique","4-1",4,1,"1",1,5,3,"H"
1983-07-20,1983,"FC Rouen","AJ Auxerre","2-0",2,0,"1",1,2,2,"H"
1983-07-20,1983,"RC Lens","FC Metz","3-2",3,2,"1",1,5,1,"H"
1983-07-20,1983,"AS Nancy","Lille OSC","1-2",1,2,"1",1,3,-1,"D"
1983-07-20,1983,"Toulouse FC","Paris Saint-Germain","1-1",1,1,"1",1,2,0,"D"
1983-07-20,1983,"Stade Laval","AS Saint-Etienne","1-1",1,1,"1",1,2,0,"D"
1983-07-20,1983,"Sporting Toulon Var","Brest Armorique FC","0-0",0,0,"1",1,0,0,"D"
1983-07-20,1983,"RC Strasbourg","SC Bastia","0-0",0,0,"1",1,0,0,"D"
1983-07-20,1983,"FC Nantes","AS Monaco","0-0",0,0,"1",1,0,0,"D"
1983-07-27,1983,"FC Sochaux","Girondins Bordeaux","3-1",3,1,"1",1,4,2,"H"
1983-07-27,1983,"AS Saint-Etienne","RC Lens","0-4",0,4,"1",1,4,-4,"D"
1983-07-27,1983,"Stade Rennes","Toulouse FC","1-5",1,5,"1",1,6,-4,"D"
1983-07-27,1983,"Paris Saint-Germain","Sporting Toulon Var","5-1",5,1,"1",1,6,4,"H"
1983-07-27,1983,"AS Monaco","Stade Laval","3-0",3,0,"1",1,3,3,"H"
1983-07-27,1983,"SC Bastia","FC Rouen","0-0",0,0,"1",1,0,0,"D"
1983-07-27,1983,"Lille OSC","RC Strasbourg","1-1",1,1,"1",1,2,0,"D"
1983-07-27,1983,"FC Metz","Brest Armorique FC","1-0",1,0,"1",1,1,1,"H"
1983-07-27,1983,"AJ Auxerre","FC Nantes","1-0",1,0,"1",1,1,1,"H"
1983-07-27,1983,"Nimes Olympique","AS Nancy","1-1",1,1,"1",1,2,0,"D"
1983-08-03,1983,"RC Lens","AS Monaco","3-1",3,1,"1",1,4,2,"H"
1983-08-03,1983,"AS Nancy","FC Sochaux","0-0",0,0,"1",1,0,0,"D"
1983-08-03,1983,"FC Rouen","Lille OSC","3-1",3,1,"1",1,4,2,"H"
1983-08-03,1983,"Girondins Bordeaux","Nimes Olympique","4-0",4,0,"1",1,4,4,"H"
1983-08-03,1983,"Toulouse FC","AJ Auxerre","0-2",0,2,"1",1,2,-2,"D"
1983-08-03,1983,"FC Nantes","Paris Saint-Germain","3-1",3,1,"1",1,4,2,"H"
1983-08-03,1983,"Sporting Toulon Var","FC Metz","0-0",0,0,"1",1,0,0,"D"
1983-08-03,1983,"Brest Armorique FC","AS Saint-Etienne","3-2",3,2,"1",1,5,1,"H"
1983-08-03,1983,"RC Strasbourg","Stade Rennes","1-1",1,1,"1",1,2,0,"D"
1983-08-03,1983,"Stade Laval","SC Bastia","1-0",1,0,"1",1,1,1,"H"
1983-08-10,1983,"FC Sochaux","RC Strasbourg","0-0",0,0,"1",1,0,0,"D"
1983-08-10,1983,"Paris Saint-Germain","RC Lens","3-0",3,0,"1",1,3,3,"H"
1983-08-10,1983,"AJ Auxerre","Stade Laval","3-0",3,0,"1",1,3,3,"H"
1983-08-10,1983,"Lille OSC","Girondins Bordeaux","1-1",1,1,"1",1,2,0,"D"
1983-08-10,1983,"Nimes Olympique","FC Rouen","2-1",2,1,"1",1,3,1,"H"
1983-08-10,1983,"AS Monaco","Brest Armorique FC","2-0",2,0,"1",1,2,2,"H"
1983-08-10,1983,"AS Nancy","FC Nantes","0-1",0,1,"1",1,1,-1,"D"
1983-08-10,1983,"AS Saint-Etienne","FC Metz","2-2",2,2,"1",1,4,0,"D"
1983-08-10,1983,"SC Bastia","Toulouse FC","3-2",3,2,"1",1,5,1,"H"
1983-08-10,1983,"Stade Rennes","Sporting Toulon Var","1-2",1,2,"1",1,3,-1,"D"
1983-08-17,1983,"RC Lens","AJ Auxerre","1-3",1,3,"1",1,4,-2,"D"
1983-08-17,1983,"FC Metz","AS Monaco","0-4",0,4,"1",1,4,-4,"D"
1983-08-17,1983,"Girondins Bordeaux","AS Nancy","2-1",2,1,"1",1,3,1,"H"
1983-08-17,1983,"FC Rouen","FC Sochaux","1-0",1,0,"1",1,1,1,"H"
1983-08-17,1983,"FC Nantes","Stade Rennes","3-1",3,1,"1",1,4,2,"H"
1983-08-17,1983,"RC Strasbourg","Nimes Olympique","1-0",1,0,"1",1,1,1,"H"
1983-08-17,1983,"Stade Laval","Paris Saint-Germain","2-0",2,0,"1",1,2,2,"H"
1983-08-17,1983,"Toulouse FC","Lille OSC","2-1",2,1,"1",1,3,1,"H"
1983-08-17,1983,"Brest Armorique FC","SC Bastia","3-0",3,0,"1",1,3,3,"H"
1983-08-17,1983,"Sporting Toulon Var","AS Saint-Etienne","0-1",0,1,"1",1,1,-1,"D"
1983-08-20,1983,"AJ Auxerre","Brest Armorique FC","5-0",5,0,"1",1,5,5,"H"
1983-08-20,1983,"AS Monaco","AS Saint-Etienne","3-1",3,1,"1",1,4,2,"H"
1983-08-20,1983,"Girondins Bordeaux","Sporting Toulon Var","1-0",1,0,"1",1,1,1,"H"
1983-08-20,1983,"Paris Saint-Germain","FC Metz","2-0",2,0,"1",1,2,2,"H"
1983-08-20,1983,"Stade Rennes","FC Rouen","2-1",2,1,"1",1,3,1,"H"
1983-08-20,1983,"SC Bastia","RC Lens","2-2",2,2,"1",1,4,0,"D"
1983-08-20,1983,"Lille OSC","FC Nantes","2-0",2,0,"1",1,2,2,"H"
1983-08-20,1983,"FC Sochaux","Stade Laval","0-1",0,1,"1",1,1,-1,"D"
1983-08-20,1983,"AS Nancy","RC Strasbourg","3-2",3,2,"1",1,5,1,"H"
1983-08-20,1983,"Nimes Olympique","Toulouse FC","3-0",3,0,"1",1,3,3,"H"
1983-08-31,1983,"FC Metz","AJ Auxerre","1-2",1,2,"1",1,3,-1,"D"
1983-08-31,1983,"Sporting Toulon Var","AS Monaco","1-3",1,3,"1",1,4,-2,"D"
1983-08-31,1983,"RC Strasbourg","Girondins Bordeaux","2-2",2,2,"1",1,4,0,"D"
1983-08-31,1983,"FC Rouen","AS Nancy","7-1",7,1,"1",1,8,6,"H"
1983-08-31,1983,"FC Nantes","Nimes Olympique","4-0",4,0,"1",1,4,4,"H"
1983-08-31,1983,"Stade Laval","Lille OSC","3-1",3,1,"1",1,4,2,"H"
1983-08-31,1983,"Brest Armorique FC","Paris Saint-Germain","2-2",2,2,"1",1,4,0,"D"
1983-08-31,1983,"Toulouse FC","FC Sochaux","0-0",0,0,"1",1,0,0,"D"
1983-08-31,1983,"RC Lens","Stade Rennes","0-1",0,1,"1",1,1,-1,"D"
1983-08-31,1983,"AS Saint-Etienne","SC Bastia","0-2",0,2,"1",1,2,-2,"D"
1983-09-10,1983,"AJ Auxerre","AS Saint-Etienne","1-0",1,0,"1",1,1,1,"H"
1983-09-10,1983,"Paris Saint-Germain","AS Monaco","0-1",0,1,"1",1,1,-1,"D"
1983-09-10,1983,"Girondins Bordeaux","FC Rouen","3-1",3,1,"1",1,4,2,"H"
1983-09-10,1983,"FC Sochaux","FC Nantes","0-1",0,1,"1",1,1,-1,"D"
1983-09-10,1983,"RC Strasbourg","RC Lens","2-1",2,1,"1",1,3,1,"H"
1983-09-10,1983,"SC Bastia","Sporting Toulon Var","1-0",1,0,"1",1,1,1,"H"
1983-09-10,1983,"Lille OSC","FC Metz","2-0",2,0,"1",1,2,2,"H"
1983-09-10,1983,"Stade Rennes","Brest Armorique FC","1-1",1,1,"1",1,2,0,"D"
1983-09-10,1983,"AS Nancy","Toulouse FC","2-0",2,0,"1",1,2,2,"H"
1983-09-11,1983,"Nimes Olympique","Stade Laval","3-0",3,0,"1",1,3,3,"H"
1983-09-17,1983,"AS Monaco","AJ Auxerre","0-1",0,1,"1",1,1,-1,"D"
1983-09-17,1983,"Toulouse FC","Girondins Bordeaux","1-3",1,3,"1",1,4,-2,"D"
1983-09-17,1983,"FC Nantes","SC Bastia","1-0",1,0,"1",1,1,1,"H"
1983-09-17,1983,"Stade Laval","Stade Rennes","2-0",2,0,"1",1,2,2,"H"
1983-09-17,1983,"FC Rouen","RC Strasbourg","2-2",2,2,"1",1,4,0,"D"
1983-09-17,1983,"AS Saint-Etienne","Paris Saint-Germain","2-3",2,3,"1",1,5,-1,"D"
1983-09-17,1983,"RC Lens","Lille OSC","4-2",4,2,"1",1,6,2,"H"
1983-09-17,1983,"Brest Armorique FC","AS Nancy","1-1",1,1,"1",1,2,0,"D"
1983-09-17,1983,"FC Metz","FC Sochaux","3-1",3,1,"1",1,4,2,"H"
1983-09-17,1983,"Sporting Toulon Var","Nimes Olympique","3-1",3,1,"1",1,4,2,"H"
1983-09-21,1983,"AJ Auxerre","Paris Saint-Germain","1-2",1,2,"1",1,3,-1,"D"
1983-09-21,1983,"Girondins Bordeaux","FC Nantes","1-0",1,0,"1",1,1,1,"H"
1983-09-21,1983,"SC Bastia","AS Monaco","0-1",0,1,"1",1,1,-1,"D"
1983-09-21,1983,"FC Rouen","FC Metz","3-0",3,0,"1",1,3,3,"H"
1983-09-21,1983,"AS Nancy","Stade Laval","0-0",0,0,"1",1,0,0,"D"
1983-09-21,1983,"FC Sochaux","RC Lens","2-2",2,2,"1",1,4,0,"D"
1983-09-21,1983,"Lille OSC","Sporting Toulon Var","4-2",4,2,"1",1,6,2,"H"
1983-09-21,1983,"RC Strasbourg","Toulouse FC","1-3",1,3,"1",1,4,-2,"D"
1983-09-21,1983,"Nimes Olympique","Brest Armorique FC","2-2",2,2,"1",1,4,0,"D"
1983-09-21,1983,"Stade Rennes","AS Saint-Etienne","1-2",1,2,"1",1,3,-1,"D"
1983-09-24,1983,"Stade Laval","Girondins Bordeaux","0-1",0,1,"1",1,1,-1,"D"
1983-09-24,1983,"Sporting Toulon Var","AJ Auxerre","1-0",1,0,"1",1,1,1,"H"
1983-09-24,1983,"AS Monaco","AS Nancy","1-1",1,1,"1",1,2,0,"D"
1983-09-24,1983,"Paris Saint-Germain","SC Bastia","1-0",1,0,"1",1,1,1,"H"
1983-09-24,1983,"FC Nantes","RC Strasbourg","1-1",1,1,"1",1,2,0,"D"
1983-09-24,1983,"Toulouse FC","FC Rouen","2-0",2,0,"1",1,2,2,"H"
1983-09-24,1983,"RC Lens","Nimes Olympique","0-0",0,0,"1",1,0,0,"D"
1983-09-24,1983,"Brest Armorique FC","Lille OSC","1-1",1,1,"1",1,2,0,"D"
1983-09-24,1983,"AS Saint-Etienne","FC Sochaux","1-0",1,0,"1",1,1,1,"H"
1983-09-24,1983,"FC Metz","Stade Rennes","6-0",6,0,"1",1,6,6,"H"
1983-10-01,1983,"Girondins Bordeaux","RC Lens","3-2",3,2,"1",1,5,1,"H"
1983-10-01,1983,"Lille OSC","AS Monaco","1-1",1,1,"1",1,2,0,"D"
1983-10-01,1983,"SC Bastia","AJ Auxerre","1-0",1,0,"1",1,1,1,"H"
1983-10-01,1983,"Stade Rennes","Paris Saint-Germain","0-1",0,1,"1",1,1,-1,"D"
1983-10-01,1983,"Toulouse FC","FC Nantes","3-1",3,1,"1",1,4,2,"H"
1983-10-01,1983,"FC Rouen","Sporting Toulon Var","1-1",1,1,"1",1,2,0,"D"
1983-10-01,1983,"RC Strasbourg","Stade Laval","1-0",1,0,"1",1,1,1,"H"
1983-10-01,1983,"AS Nancy","FC Metz","2-1",2,1,"1",1,3,1,"H"
1983-10-01,1983,"FC Sochaux","Brest Armorique FC","2-0",2,0,"1",1,2,2,"H"
1983-10-01,1983,"Nimes Olympique","AS Saint-Etienne","1-1",1,1,"1",1,2,0,"D"
1983-10-08,1983,"Brest Armorique FC","Girondins Bordeaux","0-0",0,0,"1",1,0,0,"D"
1983-10-08,1983,"AS Monaco","Nimes Olympique","5-1",5,1,"1",1,6,4,"H"
1983-10-08,1983,"AJ Auxerre","Stade Rennes","1-0",1,0,"1",1,1,1,"H"
1983-10-08,1983,"Paris Saint-Germain","FC Sochaux","3-1",3,1,"1",1,4,2,"H"
1983-10-08,1983,"FC Nantes","FC Rouen","3-0",3,0,"1",1,3,3,"H"
1983-10-08,1983,"Sporting Toulon Var","RC Strasbourg","1-3",1,3,"1",1,4,-2,"D"
1983-10-08,1983,"Stade Laval","Toulouse FC","1-0",1,0,"1",1,1,1,"H"
1983-10-08,1983,"RC Lens","AS Nancy","3-1",3,1,"1",1,4,2,"H"
1983-10-08,1983,"AS Saint-Etienne","Lille OSC","2-0",2,0,"1",1,2,2,"H"
1983-10-08,1983,"FC Metz","SC Bastia","1-0",1,0,"1",1,1,1,"H"
1983-10-14,1983,"Nimes Olympique","Paris Saint-Germain","1-1",1,1,"1",1,2,0,"D"
1983-10-14,1983,"FC Nantes","RC Lens","0-0",0,0,"1",1,0,0,"D"
1983-10-14,1983,"FC Rouen","Stade Laval","2-0",2,0,"1",1,2,2,"H"
1983-10-15,1983,"Girondins Bordeaux","FC Metz","1-1",1,1,"1",1,2,0,"D"
1983-10-15,1983,"FC Sochaux","AS Monaco","1-1",1,1,"1",1,2,0,"D"
1983-10-15,1983,"Lille OSC","AJ Auxerre","1-2",1,2,"1",1,3,-1,"D"
1983-10-15,1983,"RC Strasbourg","Brest Armorique FC","1-0",1,0,"1",1,1,1,"H"
1983-10-15,1983,"AS Nancy","AS Saint-Etienne","2-0",2,0,"1",1,2,2,"H"
1983-10-15,1983,"Toulouse FC","Sporting Toulon Var","1-3",1,3,"1",1,4,-2,"D"
1983-10-15,1983,"Stade Rennes","SC Bastia","4-1",4,1,"1",1,5,3,"H"
1983-10-22,1983,"AS Saint-Etienne","Girondins Bordeaux","0-2",0,2,"1",1,2,-2,"D"
1983-10-22,1983,"AS Monaco","Stade Rennes","3-2",3,2,"1",1,5,1,"H"
1983-10-22,1983,"AJ Auxerre","Nimes Olympique","0-0",0,0,"1",1,0,0,"D"
1983-10-22,1983,"Paris Saint-Germain","Lille OSC","4-5",4,5,"1",1,9,-1,"D"
1983-10-22,1983,"Stade Laval","FC Nantes","0-1",0,1,"1",1,1,-1,"D"
1983-10-22,1983,"FC Metz","RC Strasbourg","0-1",0,1,"1",1,1,-1,"D"
1983-10-22,1983,"Brest Armorique FC","FC Rouen","1-0",1,0,"1",1,1,1,"H"
1983-10-22,1983,"RC Lens","Toulouse FC","0-1",0,1,"1",1,1,-1,"D"
1983-10-22,1983,"Sporting Toulon Var","AS Nancy","0-0",0,0,"1",1,0,0,"D"
1983-10-22,1983,"SC Bastia","FC Sochaux","0-2",0,2,"1",1,2,-2,"D"
1983-10-28,1983,"FC Rouen","RC Lens","0-2",0,2,"1",1,2,-2,"D"
1983-10-28,1983,"Stade Laval","FC Metz","1-0",1,0,"1",1,1,1,"H"
1983-10-28,1983,"AS Nancy","Paris Saint-Germain","1-2",1,2,"1",1,3,-1,"D"
1983-10-29,1983,"Girondins Bordeaux","AS Monaco","0-2",0,2,"1",1,2,-2,"D"
1983-10-29,1983,"FC Sochaux","AJ Auxerre","3-0",3,0,"1",1,3,3,"H"
1983-10-29,1983,"FC Nantes","Sporting Toulon Var","1-0",1,0,"1",1,1,1,"H"
1983-10-29,1983,"Lille OSC","Stade Rennes","2-0",2,0,"1",1,2,2,"H"
1983-10-29,1983,"Toulouse FC","Brest Armorique FC","1-0",1,0,"1",1,1,1,"H"
1983-10-29,1983,"Nimes Olympique","SC Bastia","0-0",0,0,"1",1,0,0,"D"
1983-11-01,1983,"RC Strasbourg","AS Saint-Etienne","2-0",2,0,"1",1,2,2,"H"
1983-11-05,1983,"AS Monaco","RC Strasbourg","1-0",1,0,"1",1,1,1,"H"
1983-11-05,1983,"Paris Saint-Germain","Girondins Bordeaux","2-1",2,1,"1",1,3,1,"H"
1983-11-05,1983,"AJ Auxerre","AS Nancy","4-0",4,0,"1",1,4,4,"H"
1983-11-05,1983,"Brest Armorique FC","FC Nantes","0-1",0,1,"1",1,1,-1,"D"
1983-11-05,1983,"RC Lens","Stade Laval","2-1",2,1,"1",1,3,1,"H"
1983-11-05,1983,"SC Bastia","Lille OSC","1-0",1,0,"1",1,1,1,"H"
1983-11-05,1983,"AS Saint-Etienne","FC Rouen","1-0",1,0,"1",1,1,1,"H"
1983-11-05,1983,"Sporting Toulon Var","FC Sochaux","1-0",1,0,"1",1,1,1,"H"
1983-11-05,1983,"Stade Rennes","Nimes Olympique","2-1",2,1,"1",1,3,1,"H"
1983-11-11,1983,"FC Metz","Toulouse FC","1-3",1,3,"1",1,4,-2,"D"
1983-11-15,1983,"RC Lens","Sporting Toulon Var","5-1",5,1,"1",1,6,4,"H"
1983-11-15,1983,"Stade Laval","Brest Armorique FC","2-1",2,1,"1",1,3,1,"H"
1983-11-16,1983,"FC Rouen","AS Monaco","1-0",1,0,"1",1,1,1,"H"
1983-11-16,1983,"Girondins Bordeaux","AJ Auxerre","4-1",4,1,"1",1,5,3,"H"
1983-11-16,1983,"FC Nantes","FC Metz","2-1",2,1,"1",1,3,1,"H"
1983-11-16,1983,"RC Strasbourg","Paris Saint-Germain","0-0",0,0,"1",1,0,0,"D"
1983-11-16,1983,"Toulouse FC","AS Saint-Etienne","2-1",2,1,"1",1,3,1,"H"
1983-11-16,1983,"FC Sochaux","Stade Rennes","1-0",1,0,"1",1,1,1,"H"
1983-11-16,1983,"Nimes Olympique","Lille OSC","2-2",2,2,"1",1,4,0,"D"
1983-11-16,1983,"AS Nancy","SC Bastia","1-3",1,3,"1",1,4,-2,"D"
1983-11-18,1983,"Brest Armorique FC","RC Lens","2-1",2,1,"1",1,3,1,"H"
1983-11-19,1983,"SC Bastia","Girondins Bordeaux","1-3",1,3,"1",1,4,-2,"D"
1983-11-19,1983,"AS Monaco","Toulouse FC","2-3",2,3,"1",1,5,-1,"D"
1983-11-19,1983,"AS Saint-Etienne","FC Nantes","0-0",0,0,"1",1,0,0,"D"
1983-11-19,1983,"AJ Auxerre","RC Strasbourg","3-0",3,0,"1",1,3,3,"H"
1983-11-19,1983,"Lille OSC","FC Sochaux","1-2",1,2,"1",1,3,-1,"D"
1983-11-19,1983,"Sporting Toulon Var","Stade Laval","2-2",2,2,"1",1,4,0,"D"
1983-11-19,1983,"FC Metz","Nimes Olympique","2-1",2,1,"1",1,3,1,"H"
1983-11-19,1983,"Stade Rennes","AS Nancy","2-1",2,1,"1",1,3,1,"H"
1983-11-22,1983,"Paris Saint-Germain","FC Rouen","2-0",2,0,"1",1,2,2,"H"
1983-11-26,1983,"Girondins Bordeaux","FC Sochaux","3-0",3,0,"1",1,3,3,"H"
1983-11-26,1983,"FC Nantes","AJ Auxerre","1-2",1,2,"1",1,3,-1,"D"
1983-11-26,1983,"Stade Laval","AS Monaco","2-0",2,0,"1",1,2,2,"H"
1983-11-26,1983,"Sporting Toulon Var","Paris Saint-Germain","1-0",1,0,"1",1,1,1,"H"
1983-11-26,1983,"Toulouse FC","Stade Rennes","3-1",3,1,"1",1,4,2,"H"
1983-11-26,1983,"RC Strasbourg","Lille OSC","1-1",1,1,"1",1,2,0,"D"
1983-11-26,1983,"RC Lens","AS Saint-Etienne","2-1",2,1,"1",1,3,1,"H"
1983-11-26,1983,"FC Rouen","SC Bastia","1-2",1,2,"1",1,3,-1,"D"
1983-11-26,1983,"Brest Armorique FC","FC Metz","0-2",0,2,"1",1,2,-2,"D"
1983-11-27,1983,"AS Nancy","Nimes Olympique","2-1",2,1,"1",1,3,1,"H"
1983-12-02,1983,"AS Monaco","RC Lens","3-1",3,1,"1",1,4,2,"H"
1983-12-03,1983,"Nimes Olympique","Girondins Bordeaux","1-2",1,2,"1",1,3,-1,"D"
1983-12-03,1983,"AJ Auxerre","Toulouse FC","1-1",1,1,"1",1,2,0,"D"
1983-12-03,1983,"Paris Saint-Germain","FC Nantes","0-0",0,0,"1",1,0,0,"D"
1983-12-03,1983,"Stade Rennes","RC Strasbourg","3-0",3,0,"1",1,3,3,"H"
1983-12-03,1983,"SC Bastia","Stade Laval","3-0",3,0,"1",1,3,3,"H"
1983-12-03,1983,"Lille OSC","FC Rouen","0-1",0,1,"1",1,1,-1,"D"
1983-12-03,1983,"FC Sochaux","AS Nancy","0-1",0,1,"1",1,1,-1,"D"
1983-12-03,1983,"FC Metz","Sporting Toulon Var","2-0",2,0,"1",1,2,2,"H"
1983-12-03,1983,"AS Saint-Etienne","Brest Armorique FC","1-0",1,0,"1",1,1,1,"H"
1983-12-10,1983,"Girondins Bordeaux","Lille OSC","5-2",5,2,"1",1,7,3,"H"
1983-12-10,1983,"Brest Armorique FC","AS Monaco","0-1",0,1,"1",1,1,-1,"D"
1983-12-10,1983,"RC Lens","Paris Saint-Germain","0-3",0,3,"1",1,3,-3,"D"
1983-12-10,1983,"FC Nantes","AS Nancy","2-1",2,1,"1",1,3,1,"H"
1983-12-10,1983,"Stade Laval","AJ Auxerre","1-0",1,0,"1",1,1,1,"H"
1983-12-10,1983,"Toulouse FC","SC Bastia","4-0",4,0,"1",1,4,4,"H"
1983-12-10,1983,"RC Strasbourg","FC Sochaux","0-0",0,0,"1",1,0,0,"D"
1983-12-10,1983,"FC Rouen","Nimes Olympique","3-0",3,0,"1",1,3,3,"H"
1983-12-10,1983,"FC Metz","AS Saint-Etienne","1-0",1,0,"1",1,1,1,"H"
1983-12-10,1983,"Sporting Toulon Var","Stade Rennes","0-1",0,1,"1",1,1,-1,"D"
1983-12-17,1983,"AS Monaco","FC Metz","2-2",2,2,"1",1,4,0,"D"
1983-12-17,1983,"Stade Rennes","FC Nantes","1-2",1,2,"1",1,3,-1,"D"
1983-12-17,1983,"AJ Auxerre","RC Lens","4-0",4,0,"1",1,4,4,"H"
1983-12-17,1983,"Paris Saint-Germain","Stade Laval","0-0",0,0,"1",1,0,0,"D"
1983-12-17,1983,"Lille OSC","Toulouse FC","0-0",0,0,"1",1,0,0,"D"
1983-12-17,1983,"Nimes Olympique","RC Strasbourg","0-3",0,3,"1",1,3,-3,"D"
1983-12-17,1983,"SC Bastia","Brest Armorique FC","2-1",2,1,"1",1,3,1,"H"
1983-12-18,1983,"AS Nancy","Girondins Bordeaux","0-2",0,2,"1",1,2,-2,"D"
1983-12-18,1983,"FC Sochaux","FC Rouen","1-1",1,1,"1",1,2,0,"D"
1983-12-18,1983,"AS Saint-Etienne","Sporting Toulon Var","1-0",1,0,"1",1,1,1,"H"
1984-01-14,1983,"Sporting Toulon Var","Girondins Bordeaux","1-0",1,0,"1",1,1,1,"H"
1984-01-14,1983,"FC Nantes","Lille OSC","2-1",2,1,"1",1,3,1,"H"
1984-01-14,1983,"FC Metz","Paris Saint-Germain","1-1",1,1,"1",1,2,0,"D"
1984-01-14,1983,"Brest Armorique FC","AJ Auxerre","2-0",2,0,"1",1,2,2,"H"
1984-01-14,1983,"Toulouse FC","Nimes Olympique","5-0",5,0,"1",1,5,5,"H"
1984-01-14,1983,"RC Strasbourg","AS Nancy","1-1",1,1,"1",1,2,0,"D"
1984-01-14,1983,"Stade Laval","FC Sochaux","1-1",1,1,"1",1,2,0,"D"
1984-01-14,1983,"FC Rouen","Stade Rennes","1-0",1,0,"1",1,1,1,"H"
1984-01-14,1983,"RC Lens","SC Bastia","1-0",1,0,"1",1,1,1,"H"
1984-01-15,1983,"AS Saint-Etienne","AS Monaco","0-1",0,1,"1",1,1,-1,"D"
1984-01-21,1983,"Girondins Bordeaux","RC Strasbourg","2-0",2,0,"1",1,2,2,"H"
1984-01-21,1983,"AS Monaco","Sporting Toulon Var","1-0",1,0,"1",1,1,1,"H"
1984-01-21,1983,"Nimes Olympique","FC Nantes","1-0",1,0,"1",1,1,1,"H"
1984-01-21,1983,"AJ Auxerre","FC Metz","6-1",6,1,"1",1,7,5,"H"
1984-01-21,1983,"Stade Rennes","RC Lens","1-1",1,1,"1",1,2,0,"D"
1984-01-21,1983,"Lille OSC","Stade Laval","1-0",1,0,"1",1,1,1,"H"
1984-01-21,1983,"AS Nancy","FC Rouen","2-0",2,0,"1",1,2,2,"H"
1984-01-21,1983,"SC Bastia","AS Saint-Etienne","2-1",2,1,"1",1,3,1,"H"
1984-01-24,1983,"Paris Saint-Germain","Brest Armorique FC","1-1",1,1,"1",1,2,0,"D"
1984-02-04,1983,"FC Rouen","Girondins Bordeaux","1-0",1,0,"1",1,1,1,"H"
1984-02-04,1983,"AS Monaco","Paris Saint-Germain","0-1",0,1,"1",1,1,-1,"D"
1984-02-04,1983,"FC Nantes","FC Sochaux","1-1",1,1,"1",1,2,0,"D"
1984-02-04,1983,"AS Saint-Etienne","AJ Auxerre","0-0",0,0,"1",1,0,0,"D"
1984-02-04,1983,"Toulouse FC","AS Nancy","1-0",1,0,"1",1,1,1,"H"
1984-02-04,1983,"RC Lens","RC Strasbourg","2-2",2,2,"1",1,4,0,"D"
1984-02-04,1983,"Stade Laval","Nimes Olympique","1-0",1,0,"1",1,1,1,"H"
1984-02-04,1983,"Sporting Toulon Var","SC Bastia","1-0",1,0,"1",1,1,1,"H"
1984-02-04,1983,"FC Metz","Lille OSC","1-0",1,0,"1",1,1,1,"H"
1984-02-04,1983,"Brest Armorique FC","Stade Rennes","1-1",1,1,"1",1,2,0,"D"
1984-02-11,1983,"Girondins Bordeaux","Toulouse FC","0-0",0,0,"1",1,0,0,"D"
1984-02-11,1983,"AJ Auxerre","AS Monaco","0-0",0,0,"1",1,0,0,"D"
1984-02-11,1983,"Paris Saint-Germain","AS Saint-Etienne","3-1",3,1,"1",1,4,2,"H"
1984-02-11,1983,"SC Bastia","FC Nantes","1-0",1,0,"1",1,1,1,"H"
1984-02-11,1983,"Stade Rennes","Stade Laval","1-1",1,1,"1",1,2,0,"D"
1984-02-11,1983,"Lille OSC","RC Lens","3-1",3,1,"1",1,4,2,"H"
1984-02-11,1983,"FC Sochaux","FC Metz","2-0",2,0,"1",1,2,2,"H"
1984-02-11,1983,"Nimes Olympique","Sporting Toulon Var","1-0",1,0,"1",1,1,1,"H"
1984-02-12,1983,"AS Nancy","Brest Armorique FC","1-1",1,1,"1",1,2,0,"D"
1984-02-25,1983,"FC Nantes","Girondins Bordeaux","0-1",0,1,"1",1,1,-1,"D"
1984-02-25,1983,"AS Monaco","SC Bastia","1-0",1,0,"1",1,1,1,"H"
1984-02-25,1983,"Paris Saint-Germain","AJ Auxerre","1-2",1,2,"1",1,3,-1,"D"
1984-02-25,1983,"Toulouse FC","RC Strasbourg","1-0",1,0,"1",1,1,1,"H"
1984-02-25,1983,"Stade Laval","AS Nancy","1-1",1,1,"1",1,2,0,"D"
1984-02-25,1983,"RC Lens","FC Sochaux","1-0",1,0,"1",1,1,1,"H"
1984-02-25,1983,"FC Metz","FC Rouen","1-1",1,1,"1",1,2,0,"D"
1984-02-25,1983,"Sporting Toulon Var","Lille OSC","0-3",0,3,"1",1,3,-3,"D"
1984-02-25,1983,"Brest Armorique FC","Nimes Olympique","2-0",2,0,"1",1,2,2,"H"
1984-02-25,1983,"AS Saint-Etienne","Stade Rennes","1-0",1,0,"1",1,1,1,"H"
1984-03-03,1983,"Girondins Bordeaux","Stade Laval","0-0",0,0,"1",1,0,0,"D"
1984-03-03,1983,"AS Nancy","AS Monaco","1-1",1,1,"1",1,2,0,"D"
1984-03-03,1983,"AJ Auxerre","Sporting Toulon Var","1-1",1,1,"1",1,2,0,"D"
1984-03-03,1983,"SC Bastia","Paris Saint-Germain","1-1",1,1,"1",1,2,0,"D"
1984-03-03,1983,"FC Rouen","Toulouse FC","3-1",3,1,"1",1,4,2,"H"
1984-03-03,1983,"Nimes Olympique","RC Lens","2-1",2,1,"1",1,3,1,"H"
1984-03-03,1983,"Lille OSC","Brest Armorique FC","2-1",2,1,"1",1,3,1,"H"
1984-03-03,1983,"Stade Rennes","FC Metz","1-2",1,2,"1",1,3,-1,"D"
1984-03-07,1983,"FC Sochaux","Toulouse FC","1-0",1,0,"1",1,1,1,"H"
1984-03-10,1983,"RC Lens","Girondins Bordeaux","3-1",3,1,"1",1,4,2,"H"
1984-03-10,1983,"AS Monaco","Lille OSC","1-1",1,1,"1",1,2,0,"D"
1984-03-10,1983,"Paris Saint-Germain","Stade Rennes","3-2",3,2,"1",1,5,1,"H"
1984-03-10,1983,"AJ Auxerre","SC Bastia","1-1",1,1,"1",1,2,0,"D"
1984-03-10,1983,"FC Nantes","Toulouse FC","3-1",3,1,"1",1,4,2,"H"
1984-03-10,1983,"Stade Laval","RC Strasbourg","1-1",1,1,"1",1,2,0,"D"
1984-03-10,1983,"Sporting Toulon Var","FC Rouen","1-0",1,0,"1",1,1,1,"H"
1984-03-10,1983,"Brest Armorique FC","FC Sochaux","0-0",0,0,"1",1,0,0,"D"
1984-03-10,1983,"FC Metz","AS Nancy","1-2",1,2,"1",1,3,-1,"D"
1984-03-10,1983,"AS Saint-Etienne","Nimes Olympique","3-1",3,1,"1",1,4,2,"H"
1984-03-14,1983,"Girondins Bordeaux","Brest Armorique FC","1-1",1,1,"1",1,2,0,"D"
1984-03-14,1983,"Nimes Olympique","AS Monaco","1-2",1,2,"1",1,3,-1,"D"
1984-03-14,1983,"Stade Rennes","AJ Auxerre","1-3",1,3,"1",1,4,-2,"D"
1984-03-14,1983,"FC Sochaux","Paris Saint-Germain","2-1",2,1,"1",1,3,1,"H"
1984-03-14,1983,"Toulouse FC","Stade Laval","0-0",0,0,"1",1,0,0,"D"
1984-03-14,1983,"FC Rouen","FC Nantes","2-0",2,0,"1",1,2,2,"H"
1984-03-14,1983,"RC Strasbourg","Sporting Toulon Var","2-0",2,0,"1",1,2,2,"H"
1984-03-14,1983,"AS Nancy","RC Lens","2-0",2,0,"1",1,2,2,"H"
1984-03-14,1983,"SC Bastia","FC Metz","1-0",1,0,"1",1,1,1,"H"
1984-03-14,1983,"Lille OSC","AS Saint-Etienne","1-1",1,1,"1",1,2,0,"D"
1984-03-24,1983,"FC Metz","Girondins Bordeaux","0-0",0,0,"1",1,0,0,"D"
1984-03-24,1983,"AS Monaco","FC Sochaux","1-1",1,1,"1",1,2,0,"D"
1984-03-24,1983,"AJ Auxerre","Lille OSC","2-0",2,0,"1",1,2,2,"H"
1984-03-24,1983,"Paris Saint-Germain","Nimes Olympique","0-0",0,0,"1",1,0,0,"D"
1984-03-24,1983,"RC Lens","FC Nantes","2-2",2,2,"1",1,4,0,"D"
1984-03-24,1983,"Sporting Toulon Var","Toulouse FC","3-2",3,2,"1",1,5,1,"H"
1984-03-24,1983,"Stade Laval","FC Rouen","0-0",0,0,"1",1,0,0,"D"
1984-03-24,1983,"Brest Armorique FC","RC Strasbourg","0-0",0,0,"1",1,0,0,"D"
1984-03-24,1983,"SC Bastia","Stade Rennes","2-1",2,1,"1",1,3,1,"H"
1984-03-24,1983,"AS Saint-Etienne","AS Nancy","1-0",1,0,"1",1,1,1,"H"
1984-03-27,1983,"RC Strasbourg","FC Rouen","0-0",0,0,"1",1,0,0,"D"
1984-03-27,1983,"FC Sochaux","AS Saint-Etienne","1-1",1,1,"1",1,2,0,"D"
1984-03-31,1983,"Girondins Bordeaux","AS Saint-Etienne","7-0",7,0,"1",1,7,7,"H"
1984-03-31,1983,"Stade Rennes","AS Monaco","1-2",1,2,"1",1,3,-1,"D"
1984-03-31,1983,"Nimes Olympique","AJ Auxerre","1-1",1,1,"1",1,2,0,"D"
1984-03-31,1983,"Lille OSC","Paris Saint-Germain","1-0",1,0,"1",1,1,1,"H"
1984-03-31,1983,"FC Nantes","Stade Laval","3-1",3,1,"1",1,4,2,"H"
1984-03-31,1983,"Toulouse FC","RC Lens","2-0",2,0,"1",1,2,2,"H"
1984-03-31,1983,"FC Sochaux","SC Bastia","2-0",2,0,"1",1,2,2,"H"
1984-03-31,1983,"RC Strasbourg","FC Metz","0-0",0,0,"1",1,0,0,"D"
1984-03-31,1983,"FC Rouen","Brest Armorique FC","0-1",0,1,"1",1,1,-1,"D"
1984-03-31,1983,"AS Nancy","Sporting Toulon Var","2-2",2,2,"1",1,4,0,"D"
1984-04-06,1983,"AS Saint-Etienne","RC Strasbourg","0-1",0,1,"1",1,1,-1,"D"
1984-04-07,1983,"AS Monaco","Girondins Bordeaux","2-1",2,1,"1",1,3,1,"H"
1984-04-07,1983,"AJ Auxerre","FC Sochaux","2-0",2,0,"1",1,2,2,"H"
1984-04-07,1983,"Paris Saint-Germain","AS Nancy","1-1",1,1,"1",1,2,0,"D"
1984-04-07,1983,"Brest Armorique FC","Toulouse FC","0-1",0,1,"1",1,1,-1,"D"
1984-04-07,1983,"Sporting Toulon Var","FC Nantes","1-1",1,1,"1",1,2,0,"D"
1984-04-07,1983,"Stade Rennes","Lille OSC","0-0",0,0,"1",1,0,0,"D"
1984-04-07,1983,"FC Metz","Stade Laval","0-0",0,0,"1",1,0,0,"D"
1984-04-07,1983,"RC Lens","FC Rouen","4-2",4,2,"1",1,6,2,"H"
1984-04-07,1983,"SC Bastia","Nimes Olympique","1-1",1,1,"1",1,2,0,"D"
1984-04-14,1983,"RC Strasbourg","AS Monaco","0-1",0,1,"1",1,1,-1,"D"
1984-04-14,1983,"Girondins Bordeaux","Paris Saint-Germain","2-1",2,1,"1",1,3,1,"H"
1984-04-14,1983,"AS Nancy","AJ Auxerre","0-1",0,1,"1",1,1,-1,"D"
1984-04-14,1983,"FC Nantes","Brest Armorique FC","4-0",4,0,"1",1,4,4,"H"
1984-04-14,1983,"Toulouse FC","FC Metz","3-1",3,1,"1",1,4,2,"H"
1984-04-14,1983,"FC Sochaux","Sporting Toulon Var","8-2",8,2,"1",1,10,6,"H"
1984-04-14,1983,"Stade Laval","RC Lens","3-0",3,0,"1",1,3,3,"H"
1984-04-14,1983,"FC Rouen","AS Saint-Etienne","1-1",1,1,"1",1,2,0,"D"
1984-04-14,1983,"Lille OSC","SC Bastia","0-0",0,0,"1",1,0,0,"D"
1984-04-14,1983,"Nimes Olympique","Stade Rennes","1-1",1,1,"1",1,2,0,"D"
1984-04-19,1983,"FC Metz","FC Nantes","2-1",2,1,"1",1,3,1,"H"
1984-04-21,1983,"AS Monaco","FC Rouen","1-0",1,0,"1",1,1,1,"H"
1984-04-21,1983,"AJ Auxerre","Girondins Bordeaux","1-4",1,4,"1",1,5,-3,"D"
1984-04-21,1983,"AS Saint-Etienne","Toulouse FC","0-1",0,1,"1",1,1,-1,"D"
1984-04-21,1983,"Stade Rennes","FC Sochaux","0-1",0,1,"1",1,1,-1,"D"
1984-04-21,1983,"Brest Armorique FC","Stade Laval","1-0",1,0,"1",1,1,1,"H"
1984-04-21,1983,"Lille OSC","Nimes Olympique","1-0",1,0,"1",1,1,1,"H"
1984-04-21,1983,"SC Bastia","AS Nancy","0-1",0,1,"1",1,1,-1,"D"
1984-04-21,1983,"Sporting Toulon Var","RC Lens","3-0",3,0,"1",1,3,3,"H"
1984-04-22,1983,"RC Strasbourg","FC Nantes","0-0",0,0,"1",1,0,0,"D"
1984-04-25,1983,"Paris Saint-Germain","RC Strasbourg","2-0",2,0,"1",1,2,2,"H"
1984-04-28,1983,"Girondins Bordeaux","SC Bastia","2-1",2,1,"1",1,3,1,"H"
1984-04-28,1983,"Toulouse FC","AS Monaco","1-1",1,1,"1",1,2,0,"D"
1984-04-28,1983,"RC Strasbourg","AJ Auxerre","2-1",2,1,"1",1,3,1,"H"
1984-04-28,1983,"FC Rouen","Paris Saint-Germain","0-1",0,1,"1",1,1,-1,"D"
1984-04-28,1983,"FC Nantes","AS Saint-Etienne","1-0",1,0,"1",1,1,1,"H"
1984-04-28,1983,"FC Sochaux","Lille OSC","1-0",1,0,"1",1,1,1,"H"
1984-04-28,1983,"Stade Laval","Sporting Toulon Var","0-2",0,2,"1",1,2,-2,"D"
1984-04-28,1983,"RC Lens","Brest Armorique FC","3-2",3,2,"1",1,5,1,"H"
1984-04-28,1983,"Nimes Olympique","FC Metz","3-7",3,7,"1",1,10,-4,"D"
1984-04-28,1983,"AS Nancy","Stade Rennes","1-3",1,3,"1",1,4,-2,"D"
1984-05-02,1983,"Stade Rennes","Girondins Bordeaux","0-2",0,2,"1",1,2,-2,"D"
1984-05-02,1983,"AS Monaco","FC Nantes","3-0",3,0,"1",1,3,3,"H"
1984-05-02,1983,"AJ Auxerre","FC Rouen","1-0",1,0,"1",1,1,1,"H"
1984-05-02,1983,"Paris Saint-Germain","Toulouse FC","1-0",1,0,"1",1,1,1,"H"
1984-05-02,1983,"Nimes Olympique","FC Sochaux","2-2",2,2,"1",1,4,0,"D"
1984-05-02,1983,"SC Bastia","RC Strasbourg","4-2",4,2,"1",1,6,2,"H"
1984-05-02,1983,"Lille OSC","AS Nancy","2-0",2,0,"1",1,2,2,"H"
1984-05-02,1983,"AS Saint-Etienne","Stade Laval","1-0",1,0,"1",1,1,1,"H"
1984-05-02,1983,"FC Metz","RC Lens","3-0",3,0,"1",1,3,3,"H"
1984-05-02,1983,"Brest Armorique FC","Sporting Toulon Var","5-2",5,2,"1",1,7,3,"H"
1984-08-17,1984,"Paris Saint-Germain","AS Nancy","2-4",2,4,"1",1,6,-2,"D"
1984-08-17,1984,"Olympique Marseille","FC Sochaux","3-1",3,1,"1",1,4,2,"H"
1984-08-17,1984,"FC Nantes","Sporting Toulon Var","3-1",3,1,"1",1,4,2,"H"
1984-08-17,1984,"AJ Auxerre","RC Strasbourg","2-0",2,0,"1",1,2,2,"H"
1984-08-17,1984,"FC Metz","Racing Club de France","2-0",2,0,"1",1,2,2,"H"
1984-08-17,1984,"Girondins Bordeaux","Toulouse FC","2-1",2,1,"1",1,3,1,"H"
1984-08-17,1984,"RC Lens","FC Rouen","1-0",1,0,"1",1,1,1,"H"
1984-08-17,1984,"SC Bastia","AS Monaco","1-0",1,0,"1",1,1,1,"H"
1984-08-17,1984,"Tours FC","Stade Laval","1-1",1,1,"1",1,2,0,"D"
1984-08-17,1984,"Brest Armorique FC","Lille OSC","0-0",0,0,"1",1,0,0,"D"
1984-08-21,1984,"FC Nantes","Olympique Marseille","3-0",3,0,"1",1,3,3,"H"
1984-08-21,1984,"AS Nancy","Girondins Bordeaux","0-1",0,1,"1",1,1,-1,"D"
1984-08-21,1984,"Lille OSC","Paris Saint-Germain","3-1",3,1,"1",1,4,2,"H"
1984-08-21,1984,"Stade Laval","AJ Auxerre","2-1",2,1,"1",1,3,1,"H"
1984-08-21,1984,"AS Monaco","Tours FC","4-0",4,0,"1",1,4,4,"H"
1984-08-21,1984,"Toulouse FC","SC Bastia","3-0",3,0,"1",1,3,3,"H"
1984-08-21,1984,"RC Strasbourg","FC Metz","4-1",4,1,"1",1,5,3,"H"
1984-08-21,1984,"Racing Club de France","RC Lens","2-1",2,1,"1",1,3,1,"H"
1984-08-21,1984,"Sporting Toulon Var","Brest Armorique FC","2-1",2,1,"1",1,3,1,"H"
1984-08-21,1984,"FC Rouen","FC Sochaux","1-1",1,1,"1",1,2,0,"D"
1984-08-24,1984,"Girondins Bordeaux","Lille OSC","2-0",2,0,"1",1,2,2,"H"
1984-08-24,1984,"FC Metz","Stade Laval","0-2",0,2,"1",1,2,-2,"D"
1984-08-24,1984,"Brest Armorique FC","FC Nantes","4-2",4,2,"1",1,6,2,"H"
1984-08-24,1984,"AJ Auxerre","AS Monaco","2-0",2,0,"1",1,2,2,"H"
1984-08-24,1984,"Olympique Marseille","FC Rouen","3-2",3,2,"1",1,5,1,"H"
1984-08-24,1984,"FC Sochaux","Racing Club de France","6-1",6,1,"1",1,7,5,"H"
1984-08-24,1984,"Tours FC","Toulouse FC","2-2",2,2,"1",1,4,0,"D"
1984-08-24,1984,"SC Bastia","AS Nancy","1-1",1,1,"1",1,2,0,"D"
1984-08-24,1984,"RC Lens","RC Strasbourg","0-0",0,0,"1",1,0,0,"D"
1984-08-24,1984,"Paris Saint-Germain","Sporting Toulon Var","0-0",0,0,"1",1,0,0,"D"
1984-08-28,1984,"Sporting Toulon Var","Girondins Bordeaux","1-2",1,2,"1",1,3,-1,"D"
1984-08-28,1984,"FC Nantes","Paris Saint-Germain","2-0",2,0,"1",1,2,2,"H"
1984-08-28,1984,"Toulouse FC","AJ Auxerre","1-3",1,3,"1",1,4,-2,"D"
1984-08-28,1984,"Brest Armorique FC","Olympique Marseille","3-0",3,0,"1",1,3,3,"H"
1984-08-28,1984,"RC Strasbourg","FC Sochaux","4-2",4,2,"1",1,6,2,"H"
1984-08-28,1984,"AS Nancy","Tours FC","1-0",1,0,"1",1,1,1,"H"
1984-08-28,1984,"Stade Laval","RC Lens","1-3",1,3,"1",1,4,-2,"D"
1984-08-28,1984,"Lille OSC","SC Bastia","1-2",1,2,"1",1,3,-1,"D"
1984-08-28,1984,"AS Monaco","FC Metz","7-0",7,0,"1",1,7,7,"H"
1984-08-28,1984,"Racing Club de France","FC Rouen","1-0",1,0,"1",1,1,1,"H"
1984-08-31,1984,"Girondins Bordeaux","FC Nantes","2-1",2,1,"1",1,3,1,"H"
1984-08-31,1984,"AJ Auxerre","AS Nancy","1-0",1,0,"1",1,1,1,"H"
1984-08-31,1984,"SC Bastia","Sporting Toulon Var","3-2",3,2,"1",1,5,1,"H"
1984-08-31,1984,"Paris Saint-Germain","Brest Armorique FC","1-1",1,1,"1",1,2,0,"D"
1984-08-31,1984,"RC Lens","AS Monaco","2-2",2,2,"1",1,4,0,"D"
1984-08-31,1984,"Olympique Marseille","Racing Club de France","0-2",0,2,"1",1,2,-2,"D"
1984-08-31,1984,"FC Sochaux","Stade Laval","2-0",2,0,"1",1,2,2,"H"
1984-08-31,1984,"FC Rouen","RC Strasbourg","1-0",1,0,"1",1,1,1,"H"
1984-08-31,1984,"Tours FC","Lille OSC","2-0",2,0,"1",1,2,2,"H"
1984-08-31,1984,"FC Metz","Toulouse FC","2-1",2,1,"1",1,3,1,"H"
1984-09-07,1984,"RC Strasbourg","Racing Club de France","3-0",3,0,"1",1,3,3,"H"
1984-09-07,1984,"AS Nancy","FC Metz","2-1",2,1,"1",1,3,1,"H"
1984-09-07,1984,"Sporting Toulon Var","Tours FC","2-0",2,0,"1",1,2,2,"H"
1984-09-08,1984,"Brest Armorique FC","Girondins Bordeaux","0-0",0,0,"1",1,0,0,"D"
1984-09-08,1984,"Lille OSC","AJ Auxerre","1-1",1,1,"1",1,2,0,"D"
1984-09-08,1984,"FC Nantes","SC Bastia","3-0",3,0,"1",1,3,3,"H"
1984-09-08,1984,"AS Monaco","FC Sochaux","2-0",2,0,"1",1,2,2,"H"
1984-09-08,1984,"Stade Laval","FC Rouen","2-0",2,0,"1",1,2,2,"H"
1984-09-08,1984,"Paris Saint-Germain","Olympique Marseille","2-1",2,1,"1",1,3,1,"H"
1984-09-11,1984,"Toulouse FC","RC Lens","1-0",1,0,"1",1,1,1,"H"
1984-09-11,1984,"Girondins Bordeaux","Paris Saint-Germain","3-1",3,1,"1",1,4,2,"H"
1984-09-11,1984,"AJ Auxerre","Sporting Toulon Var","1-1",1,1,"1",1,2,0,"D"
1984-09-11,1984,"SC Bastia","Brest Armorique FC","2-0",2,0,"1",1,2,2,"H"
1984-09-11,1984,"Racing Club de France","Stade Laval","2-0",2,0,"1",1,2,2,"H"
1984-09-11,1984,"FC Rouen","AS Monaco","2-1",2,1,"1",1,3,1,"H"
1984-09-11,1984,"Olympique Marseille","RC Strasbourg","2-1",2,1,"1",1,3,1,"H"
1984-09-11,1984,"FC Metz","Lille OSC","2-0",2,0,"1",1,2,2,"H"
1984-09-14,1984,"Tours FC","FC Nantes","0-1",0,1,"1",1,1,-1,"D"
1984-09-14,1984,"RC Lens","AS Nancy","3-0",3,0,"1",1,3,3,"H"
1984-09-14,1984,"FC Sochaux","Toulouse FC","0-1",0,1,"1",1,1,-1,"D"
1984-09-21,1984,"Stade Laval","RC Strasbourg","2-1",2,1,"1",1,3,1,"H"
1984-09-21,1984,"Brest Armorique FC","Tours FC","3-3",3,3,"1",1,6,0,"D"
1984-09-21,1984,"Lille OSC","RC Lens","2-0",2,0,"1",1,2,2,"H"
1984-09-21,1984,"Toulouse FC","FC Rouen","1-1",1,1,"1",1,2,0,"D"
1984-09-21,1984,"AS Nancy","FC Sochaux","2-2",2,2,"1",1,4,0,"D"
1984-09-22,1984,"Girondins Bordeaux","Olympique Marseille","4-1",4,1,"1",1,5,3,"H"
1984-09-22,1984,"FC Nantes","AJ Auxerre","2-1",2,1,"1",1,3,1,"H"
1984-09-22,1984,"AS Monaco","Racing Club de France","3-0",3,0,"1",1,3,3,"H"
1984-09-22,1984,"Paris Saint-Germain","SC Bastia","7-1",7,1,"1",1,8,6,"H"
1984-09-22,1984,"Sporting Toulon Var","FC Metz","0-2",0,2,"1",1,2,-2,"D"
1984-09-25,1984,"SC Bastia","Girondins Bordeaux","0-0",0,0,"1",1,0,0,"D"
1984-09-25,1984,"FC Metz","FC Nantes","1-1",1,1,"1",1,2,0,"D"
1984-09-25,1984,"AJ Auxerre","Brest Armorique FC","3-1",3,1,"1",1,4,2,"H"
1984-09-25,1984,"RC Strasbourg","AS Monaco","3-3",3,3,"1",1,6,0,"D"
1984-09-25,1984,"RC Lens","Sporting Toulon Var","3-0",3,0,"1",1,3,3,"H"
1984-09-25,1984,"FC Rouen","AS Nancy","0-1",0,1,"1",1,1,-1,"D"
1984-09-25,1984,"Olympique Marseille","Stade Laval","0-0",0,0,"1",1,0,0,"D"
1984-09-25,1984,"Racing Club de France","Toulouse FC","3-1",3,1,"1",1,4,2,"H"
1984-09-25,1984,"FC Sochaux","Lille OSC","1-0",1,0,"1",1,1,1,"H"
1984-09-25,1984,"Tours FC","Paris Saint-Germain","2-3",2,3,"1",1,5,-1,"D"
1984-09-28,1984,"Girondins Bordeaux","Tours FC","2-1",2,1,"1",1,3,1,"H"
1984-09-28,1984,"FC Nantes","RC Lens","2-0",2,0,"1",1,2,2,"H"
1984-09-28,1984,"Paris Saint-Germain","AJ Auxerre","0-0",0,0,"1",1,0,0,"D"
1984-09-28,1984,"AS Nancy","Racing Club de France","4-0",4,0,"1",1,4,4,"H"
1984-09-28,1984,"SC Bastia","Olympique Marseille","1-0",1,0,"1",1,1,1,"H"
1984-09-28,1984,"AS Monaco","Stade Laval","0-0",0,0,"1",1,0,0,"D"
1984-09-28,1984,"Brest Armorique FC","FC Metz","0-1",0,1,"1",1,1,-1,"D"
1984-09-28,1984,"Toulouse FC","RC Strasbourg","2-1",2,1,"1",1,3,1,"H"
1984-09-28,1984,"Sporting Toulon Var","FC Sochaux","1-0",1,0,"1",1,1,1,"H"
1984-09-28,1984,"Lille OSC","FC Rouen","0-0",0,0,"1",1,0,0,"D"
1984-10-05,1984,"FC Sochaux","FC Nantes","0-1",0,1,"1",1,1,-1,"D"
1984-10-05,1984,"RC Strasbourg","AS Nancy","2-1",2,1,"1",1,3,1,"H"
1984-10-05,1984,"Stade Laval","Toulouse FC","3-3",3,3,"1",1,6,0,"D"
1984-10-05,1984,"Tours FC","SC Bastia","2-0",2,0,"1",1,2,2,"H"
1984-10-05,1984,"RC Lens","Brest Armorique FC","1-1",1,1,"1",1,2,0,"D"
1984-10-05,1984,"Racing Club de France","Lille OSC","2-2",2,2,"1",1,4,0,"D"
1984-10-05,1984,"FC Rouen","Sporting Toulon Var","1-0",1,0,"1",1,1,1,"H"
1984-10-06,1984,"AJ Auxerre","Girondins Bordeaux","1-1",1,1,"1",1,2,0,"D"
1984-10-06,1984,"FC Metz","Paris Saint-Germain","2-1",2,1,"1",1,3,1,"H"
1984-10-06,1984,"Olympique Marseille","AS Monaco","3-0",3,0,"1",1,3,3,"H"
1984-10-16,1984,"Girondins Bordeaux","FC Metz","6-0",6,0,"1",1,6,6,"H"
1984-10-16,1984,"FC Nantes","FC Rouen","2-1",2,1,"1",1,3,1,"H"
1984-10-16,1984,"SC Bastia","AJ Auxerre","2-2",2,2,"1",1,4,0,"D"
1984-10-16,1984,"AS Nancy","Stade Laval","2-3",2,3,"1",1,5,-1,"D"
1984-10-16,1984,"Toulouse FC","AS Monaco","1-2",1,2,"1",1,3,-1,"D"
1984-10-16,1984,"Paris Saint-Germain","RC Lens","4-3",4,3,"1",1,7,1,"H"
1984-10-16,1984,"Brest Armorique FC","FC Sochaux","1-0",1,0,"1",1,1,1,"H"
1984-10-16,1984,"Sporting Toulon Var","Racing Club de France","1-0",1,0,"1",1,1,1,"H"
1984-10-16,1984,"Lille OSC","RC Strasbourg","3-0",3,0,"1",1,3,3,"H"
1984-10-16,1984,"Tours FC","Olympique Marseille","2-2",2,2,"1",1,4,0,"D"
1984-10-19,1984,"RC Lens","Girondins Bordeaux","2-1",2,1,"1",1,3,1,"H"
1984-10-19,1984,"AJ Auxerre","Tours FC","1-0",1,0,"1",1,1,1,"H"
1984-10-19,1984,"AS Monaco","AS Nancy","1-0",1,0,"1",1,1,1,"H"
1984-10-19,1984,"Stade Laval","Lille OSC","1-1",1,1,"1",1,2,0,"D"
1984-10-19,1984,"FC Metz","SC Bastia","1-0",1,0,"1",1,1,1,"H"
1984-10-19,1984,"FC Rouen","Brest Armorique FC","2-2",2,2,"1",1,4,0,"D"
1984-10-19,1984,"RC Strasbourg","Sporting Toulon Var","0-1",0,1,"1",1,1,-1,"D"
1984-10-19,1984,"Olympique Marseille","Toulouse FC","2-1",2,1,"1",1,3,1,"H"
1984-10-19,1984,"FC Sochaux","Paris Saint-Germain","4-1",4,1,"1",1,5,3,"H"
1984-10-20,1984,"Racing Club de France","FC Nantes","1-2",1,2,"1",1,3,-1,"D"
1984-10-26,1984,"FC Nantes","RC Strasbourg","2-2",2,2,"1",1,4,0,"D"
1984-10-26,1984,"AJ Auxerre","Olympique Marseille","4-2",4,2,"1",1,6,2,"H"
1984-10-26,1984,"Lille OSC","AS Monaco","1-1",1,1,"1",1,2,0,"D"
1984-10-26,1984,"Sporting Toulon Var","Stade Laval","1-1",1,1,"1",1,2,0,"D"
1984-10-26,1984,"SC Bastia","RC Lens","2-1",2,1,"1",1,3,1,"H"
1984-10-26,1984,"Brest Armorique FC","Racing Club de France","3-0",3,0,"1",1,3,3,"H"
1984-10-26,1984,"AS Nancy","Toulouse FC","1-1",1,1,"1",1,2,0,"D"
1984-10-27,1984,"Paris Saint-Germain","FC Rouen","3-2",3,2,"1",1,5,1,"H"
1984-10-27,1984,"Girondins Bordeaux","FC Sochaux","1-0",1,0,"1",1,1,1,"H"
1984-10-27,1984,"Tours FC","FC Metz","2-1",2,1,"1",1,3,1,"H"
1984-11-01,1984,"RC Strasbourg","Brest Armorique FC","1-1",1,1,"1",1,2,0,"D"
1984-11-02,1984,"FC Rouen","Girondins Bordeaux","0-0",0,0,"1",1,0,0,"D"
1984-11-02,1984,"Stade Laval","FC Nantes","0-1",0,1,"1",1,1,-1,"D"
1984-11-02,1984,"FC Metz","AJ Auxerre","2-1",2,1,"1",1,3,1,"H"
1984-11-02,1984,"AS Monaco","Sporting Toulon Var","0-2",0,2,"1",1,2,-2,"D"
1984-11-02,1984,"RC Lens","Tours FC","6-1",6,1,"1",1,7,5,"H"
1984-11-02,1984,"Olympique Marseille","AS Nancy","0-1",0,1,"1",1,1,-1,"D"
1984-11-02,1984,"Racing Club de France","Paris Saint-Germain","0-1",0,1,"1",1,1,-1,"D"
1984-11-02,1984,"FC Sochaux","SC Bastia","4-0",4,0,"1",1,4,4,"H"
1984-11-02,1984,"Toulouse FC","Lille OSC","1-0",1,0,"1",1,1,1,"H"
1984-11-09,1984,"FC Nantes","AS Monaco","1-0",1,0,"1",1,1,1,"H"
1984-11-09,1984,"AJ Auxerre","RC Lens","0-0",0,0,"1",1,0,0,"D"
1984-11-09,1984,"Brest Armorique FC","Stade Laval","3-0",3,0,"1",1,3,3,"H"
1984-11-09,1984,"Sporting Toulon Var","Toulouse FC","2-1",2,1,"1",1,3,1,"H"
1984-11-09,1984,"SC Bastia","FC Rouen","3-0",3,0,"1",1,3,3,"H"
1984-11-09,1984,"Lille OSC","AS Nancy","4-0",4,0,"1",1,4,4,"H"
1984-11-09,1984,"Tours FC","FC Sochaux","2-2",2,2,"1",1,4,0,"D"
1984-11-10,1984,"Girondins Bordeaux","Racing Club de France","1-0",1,0,"1",1,1,1,"H"
1984-11-10,1984,"FC Metz","Olympique Marseille","3-0",3,0,"1",1,3,3,"H"
1984-11-13,1984,"Toulouse FC","FC Nantes","1-3",1,3,"1",1,4,-2,"D"
1984-11-13,1984,"RC Strasbourg","Girondins Bordeaux","2-2",2,2,"1",1,4,0,"D"
1984-11-13,1984,"FC Sochaux","AJ Auxerre","2-1",2,1,"1",1,3,1,"H"
1984-11-13,1984,"RC Lens","FC Metz","0-0",0,0,"1",1,0,0,"D"
1984-11-13,1984,"AS Nancy","Sporting Toulon Var","0-2",0,2,"1",1,2,-2,"D"
1984-11-13,1984,"AS Monaco","Brest Armorique FC","0-0",0,0,"1",1,0,0,"D"
1984-11-13,1984,"Racing Club de France","SC Bastia","0-0",0,0,"1",1,0,0,"D"
1984-11-13,1984,"Stade Laval","Paris Saint-Germain","0-0",0,0,"1",1,0,0,"D"
1984-11-13,1984,"Olympique Marseille","Lille OSC","2-0",2,0,"1",1,2,2,"H"
1984-11-13,1984,"FC Rouen","Tours FC","0-0",0,0,"1",1,0,0,"D"
1984-11-24,1984,"FC Nantes","AS Nancy","2-1",2,1,"1",1,3,1,"H"
1984-11-24,1984,"Girondins Bordeaux","Stade Laval","5-2",5,2,"1",1,7,3,"H"
1984-11-24,1984,"AJ Auxerre","FC Rouen","2-0",2,0,"1",1,2,2,"H"
1984-11-24,1984,"Sporting Toulon Var","Lille OSC","2-1",2,1,"1",1,3,1,"H"
1984-11-24,1984,"FC Metz","FC Sochaux","1-1",1,1,"1",1,2,0,"D"
1984-11-24,1984,"SC Bastia","RC Strasbourg","2-1",2,1,"1",1,3,1,"H"
1984-11-24,1984,"RC Lens","Olympique Marseille","3-0",3,0,"1",1,3,3,"H"
1984-11-24,1984,"Brest Armorique FC","Toulouse FC","2-2",2,2,"1",1,4,0,"D"
1984-11-24,1984,"Paris Saint-Germain","AS Monaco","2-1",2,1,"1",1,3,1,"H"
1984-11-24,1984,"Tours FC","Racing Club de France","2-0",2,0,"1",1,2,2,"H"
1984-11-27,1984,"Paris Saint-Germain","RC Strasbourg","2-0",2,0,"1",1,2,2,"H"
1984-12-01,1984,"Lille OSC","FC Nantes","1-1",1,1,"1",1,2,0,"D"
1984-12-01,1984,"AS Monaco","Girondins Bordeaux","3-0",3,0,"1",1,3,3,"H"
1984-12-01,1984,"Racing Club de France","AJ Auxerre","1-3",1,3,"1",1,4,-2,"D"
1984-12-01,1984,"Toulouse FC","Paris Saint-Germain","0-1",0,1,"1",1,1,-1,"D"
1984-12-01,1984,"FC Rouen","FC Metz","1-0",1,0,"1",1,1,1,"H"
1984-12-01,1984,"Stade Laval","SC Bastia","2-1",2,1,"1",1,3,1,"H"
1984-12-02,1984,"FC Sochaux","RC Lens","1-2",1,2,"1",1,3,-1,"D"
1984-12-02,1984,"AS Nancy","Brest Armorique FC","0-2",0,2,"1",1,2,-2,"D"
1984-12-02,1984,"Olympique Marseille","Sporting Toulon Var","4-2",4,2,"1",1,6,2,"H"
1984-12-02,1984,"RC Strasbourg","Tours FC","1-0",1,0,"1",1,1,1,"H"
1984-12-14,1984,"Olympique Marseille","FC Nantes","0-2",0,2,"1",1,2,-2,"D"
1984-12-14,1984,"Girondins Bordeaux","AS Nancy","3-1",3,1,"1",1,4,2,"H"
1984-12-14,1984,"AJ Auxerre","Stade Laval","2-1",2,1,"1",1,3,1,"H"
1984-12-14,1984,"RC Lens","Racing Club de France","1-0",1,0,"1",1,1,1,"H"
1984-12-14,1984,"Brest Armorique FC","Sporting Toulon Var","0-1",0,1,"1",1,1,-1,"D"
1984-12-14,1984,"FC Metz","RC Strasbourg","1-0",1,0,"1",1,1,1,"H"
1984-12-14,1984,"Paris Saint-Germain","Lille OSC","2-3",2,3,"1",1,5,-1,"D"
1984-12-14,1984,"SC Bastia","Toulouse FC","4-0",4,0,"1",1,4,4,"H"
1984-12-14,1984,"Tours FC","AS Monaco","2-1",2,1,"1",1,3,1,"H"
1984-12-16,1984,"FC Sochaux","FC Rouen","4-0",4,0,"1",1,4,4,"H"
1984-12-21,1984,"Lille OSC","Girondins Bordeaux","0-1",0,1,"1",1,1,-1,"D"
1984-12-21,1984,"FC Nantes","Brest Armorique FC","0-2",0,2,"1",1,2,-2,"D"
1984-12-21,1984,"AS Monaco","AJ Auxerre","0-0",0,0,"1",1,0,0,"D"
1984-12-21,1984,"Sporting Toulon Var","Paris Saint-Germain","5-1",5,1,"1",1,6,4,"H"
1984-12-21,1984,"Stade Laval","FC Metz","1-4",1,4,"1",1,5,-3,"D"
1984-12-21,1984,"RC Strasbourg","RC Lens","1-1",1,1,"1",1,2,0,"D"
1984-12-21,1984,"AS Nancy","SC Bastia","2-0",2,0,"1",1,2,2,"H"
1984-12-21,1984,"Racing Club de France","FC Sochaux","0-2",0,2,"1",1,2,-2,"D"
1984-12-21,1984,"Toulouse FC","Tours FC","3-1",3,1,"1",1,4,2,"H"
1984-12-21,1984,"FC Rouen","Olympique Marseille","1-1",1,1,"1",1,2,0,"D"
1985-01-26,1984,"FC Nantes","Girondins Bordeaux","0-1",0,1,"1",1,1,-1,"D"
1985-01-26,1984,"Sporting Toulon Var","SC Bastia","1-0",1,0,"1",1,1,1,"H"
1985-01-26,1984,"Toulouse FC","FC Metz","1-1",1,1,"1",1,2,0,"D"
1985-01-26,1984,"Brest Armorique FC","Paris Saint-Germain","3-1",3,1,"1",1,4,2,"H"
1985-01-26,1984,"AS Monaco","RC Lens","3-0",3,0,"1",1,3,3,"H"
1985-01-26,1984,"Stade Laval","FC Sochaux","2-1",2,1,"1",1,3,1,"H"
1985-01-26,1984,"Lille OSC","Tours FC","3-0",3,0,"1",1,3,3,"H"
1985-01-26,1984,"Racing Club de France","Olympique Marseille","0-2",0,2,"1",1,2,-2,"D"
1985-01-27,1984,"AS Nancy","AJ Auxerre","1-1",1,1,"1",1,2,0,"D"
1985-02-02,1984,"Girondins Bordeaux","Brest Armorique FC","3-0",3,0,"1",1,3,3,"H"
1985-02-02,1984,"SC Bastia","FC Nantes","1-1",1,1,"1",1,2,0,"D"
1985-02-02,1984,"AJ Auxerre","Lille OSC","3-0",3,0,"1",1,3,3,"H"
1985-02-02,1984,"Tours FC","Sporting Toulon Var","0-1",0,1,"1",1,1,-1,"D"
1985-02-02,1984,"RC Lens","Toulouse FC","0-0",0,0,"1",1,0,0,"D"
1985-02-02,1984,"FC Rouen","Stade Laval","2-0",2,0,"1",1,2,2,"H"
1985-02-02,1984,"Racing Club de France","RC Strasbourg","2-2",2,2,"1",1,4,0,"D"
1985-02-03,1984,"FC Metz","AS Nancy","2-2",2,2,"1",1,4,0,"D"
1985-02-03,1984,"FC Sochaux","AS Monaco","1-2",1,2,"1",1,3,-1,"D"
1985-02-03,1984,"Olympique Marseille","Paris Saint-Germain","3-1",3,1,"1",1,4,2,"H"
1985-02-12,1984,"Girondins Bordeaux","Sporting Toulon Var","2-0",2,0,"1",1,2,2,"H"
1985-02-16,1984,"FC Nantes","Tours FC","4-0",4,0,"1",1,4,4,"H"
1985-02-16,1984,"Sporting Toulon Var","AJ Auxerre","2-0",2,0,"1",1,2,2,"H"
1985-02-16,1984,"Brest Armorique FC","SC Bastia","4-2",4,2,"1",1,6,2,"H"
1985-02-16,1984,"Lille OSC","FC Metz","1-0",1,0,"1",1,1,1,"H"
1985-02-16,1984,"AS Monaco","FC Rouen","2-0",2,0,"1",1,2,2,"H"
1985-02-16,1984,"Toulouse FC","FC Sochaux","0-0",0,0,"1",1,0,0,"D"
1985-02-17,1984,"AS Nancy","RC Lens","2-1",2,1,"1",1,3,1,"H"
1985-02-19,1984,"Paris Saint-Germain","Girondins Bordeaux","1-2",1,2,"1",1,3,-1,"D"
1985-02-19,1984,"Stade Laval","Racing Club de France","1-0",1,0,"1",1,1,1,"H"
1985-02-23,1984,"Olympique Marseille","Girondins Bordeaux","0-1",0,1,"1",1,1,-1,"D"
1985-02-23,1984,"FC Metz","Sporting Toulon Var","1-0",1,0,"1",1,1,1,"H"
1985-02-23,1984,"Racing Club de France","AS Monaco","0-1",0,1,"1",1,1,-1,"D"
1985-02-23,1984,"Tours FC","Brest Armorique FC","1-1",1,1,"1",1,2,0,"D"
1985-02-23,1984,"RC Lens","Lille OSC","2-0",2,0,"1",1,2,2,"H"
1985-02-23,1984,"SC Bastia","Paris Saint-Germain","1-2",1,2,"1",1,3,-1,"D"
1985-02-23,1984,"FC Rouen","Toulouse FC","0-2",0,2,"1",1,2,-2,"D"
1985-02-24,1984,"AJ Auxerre","FC Nantes","1-0",1,0,"1",1,1,1,"H"
1985-02-27,1984,"Girondins Bordeaux","SC Bastia","4-0",4,0,"1",1,4,4,"H"
1985-03-01,1984,"FC Nantes","FC Metz","1-0",1,0,"1",1,1,1,"H"
1985-03-01,1984,"Sporting Toulon Var","RC Lens","1-0",1,0,"1",1,1,1,"H"
1985-03-01,1984,"Brest Armorique FC","AJ Auxerre","2-0",2,0,"1",1,2,2,"H"
1985-03-01,1984,"AS Monaco","RC Strasbourg","3-0",3,0,"1",1,3,3,"H"
1985-03-01,1984,"Paris Saint-Germain","Tours FC","2-0",2,0,"1",1,2,2,"H"
1985-03-01,1984,"Stade Laval","Olympique Marseille","4-2",4,2,"1",1,6,2,"H"
1985-03-01,1984,"Lille OSC","FC Sochaux","1-1",1,1,"1",1,2,0,"D"
1985-03-01,1984,"AS Nancy","FC Rouen","2-2",2,2,"1",1,4,0,"D"
1985-03-01,1984,"Toulouse FC","Racing Club de France","1-3",1,3,"1",1,4,-2,"D"
1985-03-05,1984,"Paris Saint-Germain","FC Nantes","2-3",2,3,"1",1,5,-1,"D"
1985-03-05,1984,"AJ Auxerre","Toulouse FC","2-0",2,0,"1",1,2,2,"H"
1985-03-05,1984,"FC Metz","AS Monaco","1-1",1,1,"1",1,2,0,"D"
1985-03-05,1984,"Olympique Marseille","Brest Armorique FC","3-2",3,2,"1",1,5,1,"H"
1985-03-05,1984,"RC Lens","Stade Laval","3-0",3,0,"1",1,3,3,"H"
1985-03-05,1984,"SC Bastia","Lille OSC","2-1",2,1,"1",1,3,1,"H"
1985-03-05,1984,"FC Sochaux","RC Strasbourg","3-1",3,1,"1",1,4,2,"H"
1985-03-05,1984,"Tours FC","AS Nancy","1-3",1,3,"1",1,4,-2,"D"
1985-03-05,1984,"FC Rouen","Racing Club de France","1-1",1,1,"1",1,2,0,"D"
1985-03-08,1984,"RC Strasbourg","Stade Laval","2-0",2,0,"1",1,2,2,"H"
1985-03-15,1984,"Tours FC","Girondins Bordeaux","1-0",1,0,"1",1,1,1,"H"
1985-03-15,1984,"RC Lens","FC Nantes","0-1",0,1,"1",1,1,-1,"D"
1985-03-15,1984,"AJ Auxerre","Paris Saint-Germain","2-1",2,1,"1",1,3,1,"H"
1985-03-15,1984,"FC Sochaux","Sporting Toulon Var","0-0",0,0,"1",1,0,0,"D"
1985-03-15,1984,"Stade Laval","AS Monaco","0-0",0,0,"1",1,0,0,"D"
1985-03-15,1984,"FC Metz","Brest Armorique FC","2-0",2,0,"1",1,2,2,"H"
1985-03-15,1984,"Olympique Marseille","SC Bastia","5-0",5,0,"1",1,5,5,"H"
1985-03-15,1984,"FC Rouen","Lille OSC","0-0",0,0,"1",1,0,0,"D"
1985-03-15,1984,"RC Strasbourg","Toulouse FC","1-0",1,0,"1",1,1,1,"H"
1985-03-16,1984,"Racing Club de France","AS Nancy","1-0",1,0,"1",1,1,1,"H"
1985-03-19,1984,"RC Strasbourg","FC Rouen","1-1",1,1,"1",1,2,0,"D"
1985-03-22,1984,"FC Nantes","FC Sochaux","1-1",1,1,"1",1,2,0,"D"
1985-03-22,1984,"Sporting Toulon Var","FC Rouen","1-1",1,1,"1",1,2,0,"D"
1985-03-22,1984,"AS Monaco","Olympique Marseille","3-0",3,0,"1",1,3,3,"H"
1985-03-22,1984,"Paris Saint-Germain","FC Metz","1-2",1,2,"1",1,3,-1,"D"
1985-03-22,1984,"Brest Armorique FC","RC Lens","3-2",3,2,"1",1,5,1,"H"
1985-03-22,1984,"SC Bastia","Tours FC","2-2",2,2,"1",1,4,0,"D"
1985-03-22,1984,"Lille OSC","Racing Club de France","2-1",2,1,"1",1,3,1,"H"
1985-03-22,1984,"AS Nancy","RC Strasbourg","1-1",1,1,"1",1,2,0,"D"
1985-03-22,1984,"Toulouse FC","Stade Laval","1-1",1,1,"1",1,2,0,"D"
1985-03-23,1984,"Girondins Bordeaux","AJ Auxerre","6-1",6,1,"1",1,7,5,"H"
1985-03-26,1984,"FC Metz","Girondins Bordeaux","1-1",1,1,"1",1,2,0,"D"
1985-03-26,1984,"FC Rouen","FC Nantes","1-0",1,0,"1",1,1,1,"H"
1985-03-26,1984,"Racing Club de France","Sporting Toulon Var","0-1",0,1,"1",1,1,-1,"D"
1985-03-26,1984,"AS Monaco","Toulouse FC","0-0",0,0,"1",1,0,0,"D"
1985-03-26,1984,"FC Sochaux","Brest Armorique FC","4-2",4,2,"1",1,6,2,"H"
1985-03-26,1984,"RC Lens","Paris Saint-Germain","4-2",4,2,"1",1,6,2,"H"
1985-03-26,1984,"Olympique Marseille","Tours FC","3-2",3,2,"1",1,5,1,"H"
1985-03-26,1984,"Stade Laval","AS Nancy","2-2",2,2,"1",1,4,0,"D"
1985-03-26,1984,"RC Strasbourg","Lille OSC","2-1",2,1,"1",1,3,1,"H"
1985-03-27,1984,"AJ Auxerre","SC Bastia","3-1",3,1,"1",1,4,2,"H"
1985-03-29,1984,"FC Sochaux","AS Nancy","1-0",1,0,"1",1,1,1,"H"
1985-04-05,1984,"Sporting Toulon Var","RC Strasbourg","3-1",3,1,"1",1,4,2,"H"
1985-04-05,1984,"Tours FC","AJ Auxerre","3-1",3,1,"1",1,4,2,"H"
1985-04-05,1984,"SC Bastia","FC Metz","1-3",1,3,"1",1,4,-2,"D"
1985-04-05,1984,"Brest Armorique FC","FC Rouen","0-2",0,2,"1",1,2,-2,"D"
1985-04-05,1984,"Paris Saint-Germain","FC Sochaux","1-1",1,1,"1",1,2,0,"D"
1985-04-05,1984,"Lille OSC","Stade Laval","0-0",0,0,"1",1,0,0,"D"
1985-04-05,1984,"Toulouse FC","Olympique Marseille","2-0",2,0,"1",1,2,2,"H"
1985-04-06,1984,"Girondins Bordeaux","RC Lens","2-1",2,1,"1",1,3,1,"H"
1985-04-06,1984,"FC Nantes","Racing Club de France","1-1",1,1,"1",1,2,0,"D"
1985-04-06,1984,"AS Nancy","AS Monaco","1-1",1,1,"1",1,2,0,"D"
1985-04-12,1984,"RC Strasbourg","FC Nantes","1-3",1,3,"1",1,4,-2,"D"
1985-04-12,1984,"Olympique Marseille","AJ Auxerre","1-1",1,1,"1",1,2,0,"D"
1985-04-12,1984,"Stade Laval","Sporting Toulon Var","1-0",1,0,"1",1,1,1,"H"
1985-04-12,1984,"AS Monaco","Lille OSC","6-1",6,1,"1",1,7,5,"H"
1985-04-12,1984,"FC Metz","Tours FC","1-1",1,1,"1",1,2,0,"D"
1985-04-12,1984,"RC Lens","SC Bastia","3-0",3,0,"1",1,3,3,"H"
1985-04-12,1984,"Racing Club de France","Brest Armorique FC","3-0",3,0,"1",1,3,3,"H"
1985-04-12,1984,"FC Rouen","Paris Saint-Germain","0-1",0,1,"1",1,1,-1,"D"
1985-04-12,1984,"Toulouse FC","AS Nancy","1-0",1,0,"1",1,1,1,"H"
1985-04-13,1984,"FC Sochaux","Girondins Bordeaux","1-1",1,1,"1",1,2,0,"D"
1985-04-16,1984,"RC Strasbourg","Olympique Marseille","2-1",2,1,"1",1,3,1,"H"
1985-04-19,1984,"Girondins Bordeaux","FC Rouen","2-0",2,0,"1",1,2,2,"H"
1985-04-19,1984,"FC Nantes","Stade Laval","2-0",2,0,"1",1,2,2,"H"
1985-04-19,1984,"AJ Auxerre","FC Metz","2-0",2,0,"1",1,2,2,"H"
1985-04-19,1984,"Sporting Toulon Var","AS Monaco","0-1",0,1,"1",1,1,-1,"D"
1985-04-19,1984,"Tours FC","RC Lens","1-1",1,1,"1",1,2,0,"D"
1985-04-19,1984,"SC Bastia","FC Sochaux","1-1",1,1,"1",1,2,0,"D"
1985-04-19,1984,"Brest Armorique FC","RC Strasbourg","1-1",1,1,"1",1,2,0,"D"
1985-04-19,1984,"Paris Saint-Germain","Racing Club de France","2-2",2,2,"1",1,4,0,"D"
1985-04-19,1984,"AS Nancy","Olympique Marseille","3-1",3,1,"1",1,4,2,"H"
1985-04-19,1984,"Lille OSC","Toulouse FC","0-0",0,0,"1",1,0,0,"D"
1985-04-23,1984,"AS Monaco","FC Nantes","1-1",1,1,"1",1,2,0,"D"
1985-04-23,1984,"RC Lens","AJ Auxerre","1-0",1,0,"1",1,1,1,"H"
1985-04-23,1984,"Toulouse FC","Sporting Toulon Var","2-0",2,0,"1",1,2,2,"H"
1985-04-23,1984,"Olympique Marseille","FC Metz","2-1",2,1,"1",1,3,1,"H"
1985-04-23,1984,"FC Sochaux","Tours FC","2-2",2,2,"1",1,4,0,"D"
1985-04-23,1984,"Stade Laval","Brest Armorique FC","0-0",0,0,"1",1,0,0,"D"
1985-04-23,1984,"AS Nancy","Lille OSC","1-0",1,0,"1",1,1,1,"H"
1985-04-23,1984,"RC Strasbourg","Paris Saint-Germain","1-1",1,1,"1",1,2,0,"D"
1985-04-23,1984,"FC Rouen","SC Bastia","1-1",1,1,"1",1,2,0,"D"
1985-04-27,1984,"Racing Club de France","Girondins Bordeaux","0-0",0,0,"1",1,0,0,"D"
1985-05-07,1984,"Girondins Bordeaux","RC Strasbourg","3-2",3,2,"1",1,5,1,"H"
1985-05-07,1984,"FC Nantes","Toulouse FC","2-2",2,2,"1",1,4,0,"D"
1985-05-07,1984,"Brest Armorique FC","AS Monaco","0-2",0,2,"1",1,2,-2,"D"
1985-05-07,1984,"AJ Auxerre","FC Sochaux","0-0",0,0,"1",1,0,0,"D"
1985-05-07,1984,"Sporting Toulon Var","AS Nancy","3-1",3,1,"1",1,4,2,"H"
1985-05-07,1984,"FC Metz","RC Lens","4-1",4,1,"1",1,5,3,"H"
1985-05-07,1984,"Paris Saint-Germain","Stade Laval","0-1",0,1,"1",1,1,-1,"D"
1985-05-07,1984,"Lille OSC","Olympique Marseille","1-1",1,1,"1",1,2,0,"D"
1985-05-07,1984,"SC Bastia","Racing Club de France","0-0",0,0,"1",1,0,0,"D"
1985-05-07,1984,"Tours FC","FC Rouen","2-0",2,0,"1",1,2,2,"H"
1985-05-14,1984,"Stade Laval","Girondins Bordeaux","0-2",0,2,"1",1,2,-2,"D"
1985-05-14,1984,"AS Nancy","FC Nantes","1-2",1,2,"1",1,3,-1,"D"
1985-05-14,1984,"AS Monaco","Paris Saint-Germain","4-1",4,1,"1",1,5,3,"H"
1985-05-14,1984,"FC Rouen","AJ Auxerre","1-2",1,2,"1",1,3,-1,"D"
1985-05-14,1984,"Lille OSC","Sporting Toulon Var","1-1",1,1,"1",1,2,0,"D"
1985-05-14,1984,"FC Sochaux","FC Metz","1-1",1,1,"1",1,2,0,"D"
1985-05-14,1984,"Olympique Marseille","RC Lens","1-2",1,2,"1",1,3,-1,"D"
1985-05-14,1984,"Toulouse FC","Brest Armorique FC","0-0",0,0,"1",1,0,0,"D"
1985-05-14,1984,"RC Strasbourg","SC Bastia","1-1",1,1,"1",1,2,0,"D"
1985-05-14,1984,"Racing Club de France","Tours FC","3-1",3,1,"1",1,4,2,"H"
1985-05-24,1984,"Girondins Bordeaux","AS Monaco","0-0",0,0,"1",1,0,0,"D"
1985-05-24,1984,"FC Nantes","Lille OSC","1-0",1,0,"1",1,1,1,"H"
1985-05-24,1984,"AJ Auxerre","Racing Club de France","1-0",1,0,"1",1,1,1,"H"
1985-05-24,1984,"Sporting Toulon Var","Olympique Marseille","2-0",2,0,"1",1,2,2,"H"
1985-05-24,1984,"FC Metz","FC Rouen","1-0",1,0,"1",1,1,1,"H"
1985-05-24,1984,"RC Lens","FC Sochaux","3-1",3,1,"1",1,4,2,"H"
1985-05-24,1984,"Brest Armorique FC","AS Nancy","2-2",2,2,"1",1,4,0,"D"
1985-05-24,1984,"SC Bastia","Stade Laval","1-0",1,0,"1",1,1,1,"H"
1985-05-24,1984,"Paris Saint-Germain","Toulouse FC","3-1",3,1,"1",1,4,2,"H"
1985-05-24,1984,"Tours FC","RC Strasbourg","1-0",1,0,"1",1,1,1,"H"
1985-05-28,1984,"Toulouse FC","Girondins Bordeaux","2-1",2,1,"1",1,3,1,"H"
1985-05-28,1984,"Sporting Toulon Var","FC Nantes","1-2",1,2,"1",1,3,-1,"D"
1985-05-28,1984,"AS Monaco","SC Bastia","4-0",4,0,"1",1,4,4,"H"
1985-05-28,1984,"RC Strasbourg","AJ Auxerre","1-1",1,1,"1",1,2,0,"D"
1985-05-28,1984,"Racing Club de France","FC Metz","0-2",0,2,"1",1,2,-2,"D"
1985-05-28,1984,"FC Rouen","RC Lens","1-0",1,0,"1",1,1,1,"H"
1985-05-28,1984,"FC Sochaux","Olympique Marseille","2-0",2,0,"1",1,2,2,"H"
1985-05-28,1984,"Lille OSC","Brest Armorique FC","2-0",2,0,"1",1,2,2,"H"
1985-05-28,1984,"Stade Laval","Tours FC","3-1",3,1,"1",1,4,2,"H"
1985-05-28,1984,"AS Nancy","Paris Saint-Germain","6-1",6,1,"1",1,7,5,"H"
1985-07-16,1985,"Toulouse FC","AS Nancy","4-1",4,1,"1",1,5,3,"H"
1985-07-16,1985,"SC Bastia","Paris Saint-Germain","2-4",2,4,"1",1,6,-2,"D"
1985-07-16,1985,"Lille OSC","Brest Armorique FC","3-1",3,1,"1",1,4,2,"H"
1985-07-16,1985,"FC Metz","RC Lens","2-3",2,3,"1",1,5,-1,"D"
1985-07-16,1985,"Le Havre AC","Olympique Marseille","1-0",1,0,"1",1,1,1,"H"
1985-07-16,1985,"Girondins Bordeaux","OGC Nice","1-0",1,0,"1",1,1,1,"H"
1985-07-16,1985,"RC Strasbourg","Stade Rennes","1-1",1,1,"1",1,2,0,"D"
1985-07-16,1985,"AS Monaco","FC Sochaux","1-1",1,1,"1",1,2,0,"D"
1985-07-16,1985,"Sporting Toulon Var","FC Nantes","0-0",0,0,"1",1,0,0,"D"
1985-07-16,1985,"Stade Laval","AJ Auxerre","0-0",0,0,"1",1,0,0,"D"
1985-07-19,1985,"RC Lens","SC Bastia","6-0",6,0,"1",1,6,6,"H"
1985-07-19,1985,"Paris Saint-Germain","Lille OSC","3-0",3,0,"1",1,3,3,"H"
1985-07-19,1985,"Brest Armorique FC","Girondins Bordeaux","0-1",0,1,"1",1,1,-1,"D"
1985-07-19,1985,"FC Sochaux","Toulouse FC","4-1",4,1,"1",1,5,3,"H"
1985-07-19,1985,"AJ Auxerre","Olympique Marseille","2-0",2,0,"1",1,2,2,"H"
1985-07-19,1985,"Sporting Toulon Var","RC Strasbourg","1-0",1,0,"1",1,1,1,"H"
1985-07-19,1985,"AS Nancy","Le Havre AC","3-0",3,0,"1",1,3,3,"H"
1985-07-19,1985,"FC Nantes","AS Monaco","1-1",1,1,"1",1,2,0,"D"
1985-07-19,1985,"Stade Rennes","FC Metz","0-0",0,0,"1",1,0,0,"D"
1985-07-19,1985,"OGC Nice","Stade Laval","0-0",0,0,"1",1,0,0,"D"
1985-07-26,1985,"Toulouse FC","Paris Saint-Germain","1-3",1,3,"1",1,4,-2,"D"
1985-07-26,1985,"Girondins Bordeaux","RC Lens","2-1",2,1,"1",1,3,1,"H"
1985-07-26,1985,"AS Monaco","Sporting Toulon Var","0-2",0,2,"1",1,2,-2,"D"
1985-07-26,1985,"Le Havre AC","AJ Auxerre","3-3",3,3,"1",1,6,0,"D"
1985-07-26,1985,"SC Bastia","Stade Rennes","0-2",0,2,"1",1,2,-2,"D"
1985-07-26,1985,"Lille OSC","AS Nancy","3-1",3,1,"1",1,4,2,"H"
1985-07-26,1985,"RC Strasbourg","FC Nantes","1-2",1,2,"1",1,3,-1,"D"
1985-07-26,1985,"FC Metz","FC Sochaux","2-0",2,0,"1",1,2,2,"H"
1985-07-26,1985,"Stade Laval","Brest Armorique FC","0-0",0,0,"1",1,0,0,"D"
1985-07-26,1985,"Olympique Marseille","OGC Nice","2-1",2,1,"1",1,3,1,"H"
1985-07-30,1985,"Paris Saint-Germain","Girondins Bordeaux","1-0",1,0,"1",1,1,1,"H"
1985-07-30,1985,"Sporting Toulon Var","FC Metz","2-1",2,1,"1",1,3,1,"H"
1985-07-30,1985,"RC Lens","Toulouse FC","2-0",2,0,"1",1,2,2,"H"
1985-07-30,1985,"FC Nantes","SC Bastia","2-0",2,0,"1",1,2,2,"H"
1985-07-30,1985,"OGC Nice","AJ Auxerre","1-1",1,1,"1",1,2,0,"D"
1985-07-30,1985,"FC Sochaux","Le Havre AC","1-1",1,1,"1",1,2,0,"D"
1985-07-30,1985,"Stade Rennes","AS Monaco","0-1",0,1,"1",1,1,-1,"D"
1985-07-30,1985,"RC Strasbourg","Lille OSC","2-1",2,1,"1",1,3,1,"H"
1985-07-30,1985,"AS Nancy","Stade Laval","1-0",1,0,"1",1,1,1,"H"
1985-07-30,1985,"Brest Armorique FC","Olympique Marseille","2-1",2,1,"1",1,3,1,"H"
1985-08-02,1985,"Stade Laval","Paris Saint-Germain","2-2",2,2,"1",1,4,0,"D"
1985-08-02,1985,"Girondins Bordeaux","AS Nancy","1-0",1,0,"1",1,1,1,"H"
1985-08-02,1985,"Olympique Marseille","RC Lens","3-3",3,3,"1",1,6,0,"D"
1985-08-02,1985,"SC Bastia","Sporting Toulon Var","2-1",2,1,"1",1,3,1,"H"
1985-08-02,1985,"FC Metz","FC Nantes","0-0",0,0,"1",1,0,0,"D"
1985-08-02,1985,"Lille OSC","FC Sochaux","2-1",2,1,"1",1,3,1,"H"
1985-08-02,1985,"AS Monaco","RC Strasbourg","2-0",2,0,"1",1,2,2,"H"
1985-08-02,1985,"AJ Auxerre","Brest Armorique FC","1-2",1,2,"1",1,3,-1,"D"
1985-08-02,1985,"Toulouse FC","Stade Rennes","4-1",4,1,"1",1,5,3,"H"
1985-08-02,1985,"Le Havre AC","OGC Nice","1-2",1,2,"1",1,3,-1,"D"
1985-08-06,1985,"FC Sochaux","SC Bastia","2-0",2,0,"1",1,2,2,"H"
1985-08-09,1985,"Paris Saint-Germain","Olympique Marseille","2-0",2,0,"1",1,2,2,"H"
1985-08-09,1985,"RC Lens","Stade Laval","3-1",3,1,"1",1,4,2,"H"
1985-08-09,1985,"FC Nantes","Toulouse FC","1-0",1,0,"1",1,1,1,"H"
1985-08-09,1985,"Sporting Toulon Var","Girondins Bordeaux","1-1",1,1,"1",1,2,0,"D"
1985-08-09,1985,"AS Monaco","FC Metz","0-0",0,0,"1",1,0,0,"D"
1985-08-09,1985,"RC Strasbourg","Le Havre AC","2-1",2,1,"1",1,3,1,"H"
1985-08-09,1985,"Stade Rennes","Lille OSC","2-0",2,0,"1",1,2,2,"H"
1985-08-09,1985,"AS Nancy","AJ Auxerre","1-0",1,0,"1",1,1,1,"H"
1985-08-09,1985,"Brest Armorique FC","OGC Nice","1-1",1,1,"1",1,2,0,"D"
1985-08-15,1985,"FC Metz","RC Strasbourg","0-0",0,0,"1",1,0,0,"D"
1985-08-16,1985,"AJ Auxerre","Paris Saint-Germain","0-1",0,1,"1",1,1,-1,"D"
1985-08-16,1985,"Lille OSC","FC Nantes","0-1",0,1,"1",1,1,-1,"D"
1985-08-16,1985,"Girondins Bordeaux","Stade Rennes","3-2",3,2,"1",1,5,1,"H"
1985-08-16,1985,"OGC Nice","RC Lens","1-1",1,1,"1",1,2,0,"D"
1985-08-16,1985,"SC Bastia","AS Monaco","0-0",0,0,"1",1,0,0,"D"
1985-08-16,1985,"Olympique Marseille","AS Nancy","2-3",2,3,"1",1,5,-1,"D"
1985-08-16,1985,"Toulouse FC","Sporting Toulon Var","4-0",4,0,"1",1,4,4,"H"
1985-08-16,1985,"Stade Laval","FC Sochaux","3-1",3,1,"1",1,4,2,"H"
1985-08-16,1985,"Le Havre AC","Brest Armorique FC","2-0",2,0,"1",1,2,2,"H"
1985-08-23,1985,"AS Nancy","OGC Nice","3-0",3,0,"1",1,3,3,"H"
1985-08-24,1985,"Paris Saint-Germain","Brest Armorique FC","2-0",2,0,"1",1,2,2,"H"
1985-08-24,1985,"FC Nantes","Stade Laval","1-0",1,0,"1",1,1,1,"H"
1985-08-24,1985,"RC Lens","Le Havre AC","4-1",4,1,"1",1,5,3,"H"
1985-08-24,1985,"RC Strasbourg","Girondins Bordeaux","3-2",3,2,"1",1,5,1,"H"
1985-08-24,1985,"AS Monaco","Toulouse FC","3-0",3,0,"1",1,3,3,"H"
1985-08-24,1985,"Sporting Toulon Var","Lille OSC","1-1",1,1,"1",1,2,0,"D"
1985-08-24,1985,"FC Metz","SC Bastia","3-0",3,0,"1",1,3,3,"H"
1985-08-24,1985,"Stade Rennes","AJ Auxerre","4-1",4,1,"1",1,5,3,"H"
1985-08-24,1985,"FC Sochaux","Olympique Marseille","1-1",1,1,"1",1,2,0,"D"
1985-08-27,1985,"Stade Laval","Sporting Toulon Var","2-0",2,0,"1",1,2,2,"H"
1985-08-30,1985,"OGC Nice","Paris Saint-Germain","0-0",0,0,"1",1,0,0,"D"
1985-08-30,1985,"Girondins Bordeaux","AS Monaco","5-1",5,1,"1",1,6,4,"H"
1985-08-30,1985,"Olympique Marseille","FC Nantes","1-0",1,0,"1",1,1,1,"H"
1985-08-30,1985,"Lille OSC","RC Lens","1-0",1,0,"1",1,1,1,"H"
1985-08-30,1985,"Brest Armorique FC","AS Nancy","0-2",0,2,"1",1,2,-2,"D"
1985-08-30,1985,"Toulouse FC","FC Metz","2-0",2,0,"1",1,2,2,"H"
1985-08-30,1985,"Le Havre AC","Stade Rennes","1-0",1,0,"1",1,1,1,"H"
1985-08-30,1985,"SC Bastia","RC Strasbourg","2-0",2,0,"1",1,2,2,"H"
1985-08-30,1985,"AJ Auxerre","FC Sochaux","3-2",3,2,"1",1,5,1,"H"
1985-09-03,1985,"Paris Saint-Germain","AS Nancy","2-0",2,0,"1",1,2,2,"H"
1985-09-03,1985,"FC Nantes","Le Havre AC","2-1",2,1,"1",1,3,1,"H"
1985-09-03,1985,"RC Lens","Brest Armorique FC","1-0",1,0,"1",1,1,1,"H"
1985-09-03,1985,"FC Sochaux","Girondins Bordeaux","2-1",2,1,"1",1,3,1,"H"
1985-09-03,1985,"FC Metz","Lille OSC","4-0",4,0,"1",1,4,4,"H"
1985-09-03,1985,"RC Strasbourg","Toulouse FC","0-3",0,3,"1",1,3,-3,"D"
1985-09-03,1985,"Stade Rennes","Stade Laval","1-0",1,0,"1",1,1,1,"H"
1985-09-03,1985,"AS Monaco","OGC Nice","0-1",0,1,"1",1,1,-1,"D"
1985-09-03,1985,"Sporting Toulon Var","Olympique Marseille","0-0",0,0,"1",1,0,0,"D"
1985-09-03,1985,"SC Bastia","AJ Auxerre","0-0",0,0,"1",1,0,0,"D"
1985-09-13,1985,"Stade Laval","FC Metz","1-1",1,1,"1",1,2,0,"D"
1985-09-13,1985,"AJ Auxerre","RC Strasbourg","2-0",2,0,"1",1,2,2,"H"
1985-09-13,1985,"Brest Armorique FC","Sporting Toulon Var","2-1",2,1,"1",1,3,1,"H"
1985-09-13,1985,"Olympique Marseille","Stade Rennes","1-2",1,2,"1",1,3,-1,"D"
1985-09-13,1985,"AS Nancy","RC Lens","2-1",2,1,"1",1,3,1,"H"
1985-09-14,1985,"Le Havre AC","Paris Saint-Germain","1-2",1,2,"1",1,3,-1,"D"
1985-09-14,1985,"Girondins Bordeaux","FC Nantes","2-1",2,1,"1",1,3,1,"H"
1985-09-14,1985,"Toulouse FC","SC Bastia","3-1",3,1,"1",1,4,2,"H"
1985-09-14,1985,"Lille OSC","AS Monaco","2-2",2,2,"1",1,4,0,"D"
1985-09-14,1985,"OGC Nice","FC Sochaux","2-0",2,0,"1",1,2,2,"H"
1985-09-20,1985,"RC Lens","Paris Saint-Germain","2-3",2,3,"1",1,5,-1,"D"
1985-09-20,1985,"FC Sochaux","AS Nancy","1-1",1,1,"1",1,2,0,"D"
1985-09-20,1985,"Toulouse FC","Le Havre AC","1-0",1,0,"1",1,1,1,"H"
1985-09-20,1985,"Stade Rennes","Brest Armorique FC","0-4",0,4,"1",1,4,-4,"D"
1985-09-20,1985,"SC Bastia","Lille OSC","2-0",2,0,"1",1,2,2,"H"
1985-09-20,1985,"RC Strasbourg","Olympique Marseille","0-0",0,0,"1",1,0,0,"D"
1985-09-21,1985,"FC Metz","Girondins Bordeaux","2-3",2,3,"1",1,5,-1,"D"
1985-09-21,1985,"FC Nantes","OGC Nice","1-1",1,1,"1",1,2,0,"D"
1985-09-21,1985,"Sporting Toulon Var","AJ Auxerre","0-1",0,1,"1",1,1,-1,"D"
1985-09-21,1985,"AS Monaco","Stade Laval","1-1",1,1,"1",1,2,0,"D"
1985-09-27,1985,"Paris Saint-Germain","FC Sochaux","4-1",4,1,"1",1,5,3,"H"
1985-09-27,1985,"Girondins Bordeaux","SC Bastia","2-2",2,2,"1",1,4,0,"D"
1985-09-27,1985,"Brest Armorique FC","FC Nantes","1-3",1,3,"1",1,4,-2,"D"
1985-09-27,1985,"AS Nancy","Sporting Toulon Var","5-3",5,3,"1",1,8,2,"H"
1985-09-27,1985,"AJ Auxerre","RC Lens","0-0",0,0,"1",1,0,0,"D"
1985-09-27,1985,"Lille OSC","Toulouse FC","2-0",2,0,"1",1,2,2,"H"
1985-09-27,1985,"OGC Nice","Stade Rennes","2-1",2,1,"1",1,3,1,"H"
1985-09-27,1985,"Olympique Marseille","AS Monaco","2-2",2,2,"1",1,4,0,"D"
1985-09-27,1985,"Le Havre AC","FC Metz","0-0",0,0,"1",1,0,0,"D"
1985-09-27,1985,"Stade Laval","RC Strasbourg","4-1",4,1,"1",1,5,3,"H"
1985-10-04,1985,"Stade Rennes","Paris Saint-Germain","2-3",2,3,"1",1,5,-1,"D"
1985-10-04,1985,"FC Sochaux","RC Lens","1-3",1,3,"1",1,4,-2,"D"
1985-10-04,1985,"Lille OSC","Stade Laval","1-3",1,3,"1",1,4,-2,"D"
1985-10-04,1985,"Sporting Toulon Var","OGC Nice","4-0",4,0,"1",1,4,4,"H"
1985-10-04,1985,"RC Strasbourg","Brest Armorique FC","0-1",0,1,"1",1,1,-1,"D"
1985-10-04,1985,"SC Bastia","Le Havre AC","2-1",2,1,"1",1,3,1,"H"
1985-10-05,1985,"Toulouse FC","Girondins Bordeaux","1-2",1,2,"1",1,3,-1,"D"
1985-10-05,1985,"FC Nantes","AS Nancy","2-0",2,0,"1",1,2,2,"H"
1985-10-05,1985,"AS Monaco","AJ Auxerre","1-0",1,0,"1",1,1,1,"H"
1985-10-05,1985,"FC Metz","Olympique Marseille","3-0",3,0,"1",1,3,3,"H"
1985-10-11,1985,"Paris Saint-Germain","FC Nantes","2-1",2,1,"1",1,3,1,"H"
1985-10-11,1985,"Girondins Bordeaux","Lille OSC","1-1",1,1,"1",1,2,0,"D"
1985-10-11,1985,"RC Lens","Sporting Toulon Var","1-1",1,1,"1",1,2,0,"D"
1985-10-11,1985,"AS Nancy","Stade Rennes","0-0",0,0,"1",1,0,0,"D"
1985-10-11,1985,"OGC Nice","RC Strasbourg","5-1",5,1,"1",1,6,4,"H"
1985-10-11,1985,"Le Havre AC","AS Monaco","1-1",1,1,"1",1,2,0,"D"
1985-10-11,1985,"AJ Auxerre","FC Metz","2-1",2,1,"1",1,3,1,"H"
1985-10-11,1985,"Brest Armorique FC","FC Sochaux","3-1",3,1,"1",1,4,2,"H"
1985-10-11,1985,"Olympique Marseille","SC Bastia","0-0",0,0,"1",1,0,0,"D"
1985-10-12,1985,"Stade Laval","Toulouse FC","3-2",3,2,"1",1,5,1,"H"
1985-10-18,1985,"Sporting Toulon Var","Paris Saint-Germain","1-1",1,1,"1",1,2,0,"D"
1985-10-18,1985,"FC Nantes","RC Lens","4-0",4,0,"1",1,4,4,"H"
1985-10-18,1985,"Girondins Bordeaux","AJ Auxerre","0-0",0,0,"1",1,0,0,"D"
1985-10-18,1985,"RC Strasbourg","AS Nancy","1-0",1,0,"1",1,1,1,"H"
1985-10-18,1985,"AS Monaco","Brest Armorique FC","3-1",3,1,"1",1,4,2,"H"
1985-10-18,1985,"SC Bastia","Stade Laval","0-0",0,0,"1",1,0,0,"D"
1985-10-18,1985,"FC Metz","OGC Nice","3-0",3,0,"1",1,3,3,"H"
1985-10-18,1985,"Toulouse FC","Olympique Marseille","1-0",1,0,"1",1,1,1,"H"
1985-10-18,1985,"Stade Rennes","FC Sochaux","0-0",0,0,"1",1,0,0,"D"
1985-10-18,1985,"Lille OSC","Le Havre AC","0-0",0,0,"1",1,0,0,"D"
1985-10-25,1985,"Paris Saint-Germain","RC Strasbourg","1-1",1,1,"1",1,2,0,"D"
1985-10-25,1985,"RC Lens","Stade Rennes","0-0",0,0,"1",1,0,0,"D"
1985-10-25,1985,"AS Nancy","AS Monaco","1-1",1,1,"1",1,2,0,"D"
1985-10-25,1985,"AJ Auxerre","Toulouse FC","2-1",2,1,"1",1,3,1,"H"
1985-10-25,1985,"OGC Nice","SC Bastia","1-0",1,0,"1",1,1,1,"H"
1985-10-25,1985,"Brest Armorique FC","FC Metz","1-1",1,1,"1",1,2,0,"D"
1985-10-25,1985,"Le Havre AC","Sporting Toulon Var","4-3",4,3,"1",1,7,1,"H"
1985-10-25,1985,"Olympique Marseille","Lille OSC","1-0",1,0,"1",1,1,1,"H"
1985-10-25,1985,"FC Sochaux","FC Nantes","1-1",1,1,"1",1,2,0,"D"
1985-10-25,1985,"Stade Laval","Girondins Bordeaux","0-0",0,0,"1",1,0,0,"D"
1985-11-02,1985,"AS Monaco","Paris Saint-Germain","1-1",1,1,"1",1,2,0,"D"
1985-11-02,1985,"FC Nantes","Stade Rennes","1-0",1,0,"1",1,1,1,"H"
1985-11-02,1985,"Girondins Bordeaux","Olympique Marseille","2-1",2,1,"1",1,3,1,"H"
1985-11-02,1985,"RC Strasbourg","RC Lens","0-0",0,0,"1",1,0,0,"D"
1985-11-02,1985,"Lille OSC","AJ Auxerre","0-1",0,1,"1",1,1,-1,"D"
1985-11-02,1985,"FC Metz","AS Nancy","3-1",3,1,"1",1,4,2,"H"
1985-11-02,1985,"Stade Laval","Le Havre AC","2-2",2,2,"1",1,4,0,"D"
1985-11-02,1985,"Toulouse FC","OGC Nice","0-0",0,0,"1",1,0,0,"D"
1985-11-02,1985,"Sporting Toulon Var","FC Sochaux","2-2",2,2,"1",1,4,0,"D"
1985-11-02,1985,"SC Bastia","Brest Armorique FC","3-2",3,2,"1",1,5,1,"H"
1985-11-08,1985,"Paris Saint-Germain","FC Metz","2-1",2,1,"1",1,3,1,"H"
1985-11-08,1985,"Le Havre AC","Girondins Bordeaux","0-1",0,1,"1",1,1,-1,"D"
1985-11-08,1985,"RC Lens","AS Monaco","1-1",1,1,"1",1,2,0,"D"
1985-11-08,1985,"AS Nancy","SC Bastia","4-1",4,1,"1",1,5,3,"H"
1985-11-08,1985,"OGC Nice","Lille OSC","0-0",0,0,"1",1,0,0,"D"
1985-11-08,1985,"Olympique Marseille","Stade Laval","4-0",4,0,"1",1,4,4,"H"
1985-11-08,1985,"Brest Armorique FC","Toulouse FC","2-2",2,2,"1",1,4,0,"D"
1985-11-08,1985,"Stade Rennes","Sporting Toulon Var","1-0",1,0,"1",1,1,1,"H"
1985-11-08,1985,"FC Sochaux","RC Strasbourg","3-1",3,1,"1",1,4,2,"H"
1985-11-09,1985,"AJ Auxerre","FC Nantes","0-0",0,0,"1",1,0,0,"D"
1985-11-19,1985,"Girondins Bordeaux","Brest Armorique FC","4-0",4,0,"1",1,4,4,"H"
1985-11-19,1985,"SC Bastia","RC Lens","0-1",0,1,"1",1,1,-1,"D"
1985-11-19,1985,"FC Metz","Stade Rennes","4-1",4,1,"1",1,5,3,"H"
1985-11-19,1985,"Le Havre AC","AS Nancy","2-0",2,0,"1",1,2,2,"H"
1985-11-19,1985,"Stade Laval","OGC Nice","2-1",2,1,"1",1,3,1,"H"
1985-11-19,1985,"Olympique Marseille","AJ Auxerre","2-1",2,1,"1",1,3,1,"H"
1985-11-19,1985,"Toulouse FC","FC Sochaux","3-0",3,0,"1",1,3,3,"H"
1985-11-19,1985,"RC Strasbourg","Sporting Toulon Var","1-1",1,1,"1",1,2,0,"D"
1985-11-20,1985,"AS Monaco","FC Nantes","1-1",1,1,"1",1,2,0,"D"
1985-11-22,1985,"Paris Saint-Germain","Toulouse FC","3-0",3,0,"1",1,3,3,"H"
1985-11-22,1985,"RC Lens","Girondins Bordeaux","1-0",1,0,"1",1,1,1,"H"
1985-11-22,1985,"FC Sochaux","FC Metz","1-2",1,2,"1",1,3,-1,"D"
1985-11-22,1985,"AS Nancy","Lille OSC","3-0",3,0,"1",1,3,3,"H"
1985-11-22,1985,"AJ Auxerre","Le Havre AC","3-0",3,0,"1",1,3,3,"H"
1985-11-22,1985,"OGC Nice","Olympique Marseille","1-0",1,0,"1",1,1,1,"H"
1985-11-22,1985,"Brest Armorique FC","Stade Laval","2-1",2,1,"1",1,3,1,"H"
1985-11-22,1985,"Stade Rennes","SC Bastia","3-1",3,1,"1",1,4,2,"H"
1985-11-23,1985,"FC Nantes","RC Strasbourg","2-0",2,0,"1",1,2,2,"H"
1985-11-23,1985,"Sporting Toulon Var","AS Monaco","1-1",1,1,"1",1,2,0,"D"
1985-11-29,1985,"Girondins Bordeaux","Paris Saint-Germain","0-0",0,0,"1",1,0,0,"D"
1985-11-29,1985,"Toulouse FC","RC Lens","1-1",1,1,"1",1,2,0,"D"
1985-11-29,1985,"AS Monaco","Stade Rennes","1-0",1,0,"1",1,1,1,"H"
1985-11-29,1985,"Stade Laval","AS Nancy","2-0",2,0,"1",1,2,2,"H"
1985-11-29,1985,"Olympique Marseille","Brest Armorique FC","3-0",3,0,"1",1,3,3,"H"
1985-11-29,1985,"Le Havre AC","FC Sochaux","1-0",1,0,"1",1,1,1,"H"
1985-11-29,1985,"Lille OSC","RC Strasbourg","2-0",2,0,"1",1,2,2,"H"
1985-11-30,1985,"SC Bastia","FC Nantes","2-3",2,3,"1",1,5,-1,"D"
1985-11-30,1985,"AJ Auxerre","OGC Nice","1-2",1,2,"1",1,3,-1,"D"
1985-11-30,1985,"FC Metz","Sporting Toulon Var","0-2",0,2,"1",1,2,-2,"D"
1985-12-06,1985,"FC Nantes","FC Metz","1-0",1,0,"1",1,1,1,"H"
1985-12-07,1985,"Paris Saint-Germain","Stade Laval","5-1",5,1,"1",1,6,4,"H"
1985-12-07,1985,"AS Nancy","Girondins Bordeaux","1-1",1,1,"1",1,2,0,"D"
1985-12-07,1985,"RC Lens","Olympique Marseille","2-1",2,1,"1",1,3,1,"H"
1985-12-07,1985,"RC Strasbourg","AS Monaco","1-1",1,1,"1",1,2,0,"D"
1985-12-07,1985,"Brest Armorique FC","AJ Auxerre","1-3",1,3,"1",1,4,-2,"D"
1985-12-07,1985,"OGC Nice","Le Havre AC","0-3",0,3,"1",1,3,-3,"D"
1985-12-07,1985,"Stade Rennes","Toulouse FC","2-1",2,1,"1",1,3,1,"H"
1985-12-07,1985,"Sporting Toulon Var","SC Bastia","1-1",1,1,"1",1,2,0,"D"
1985-12-08,1985,"FC Sochaux","Lille OSC","3-1",3,1,"1",1,4,2,"H"
1985-12-14,1985,"Girondins Bordeaux","Sporting Toulon Var","2-1",2,1,"1",1,3,1,"H"
1985-12-14,1985,"Toulouse FC","FC Nantes","4-2",4,2,"1",1,6,2,"H"
1985-12-14,1985,"Stade Laval","RC Lens","2-1",2,1,"1",1,3,1,"H"
1985-12-14,1985,"AJ Auxerre","AS Nancy","3-0",3,0,"1",1,3,3,"H"
1985-12-14,1985,"OGC Nice","Brest Armorique FC","2-2",2,2,"1",1,4,0,"D"
1985-12-14,1985,"Le Havre AC","RC Strasbourg","4-1",4,1,"1",1,5,3,"H"
1985-12-14,1985,"Lille OSC","Stade Rennes","2-0",2,0,"1",1,2,2,"H"
1985-12-14,1985,"SC Bastia","FC Sochaux","0-0",0,0,"1",1,0,0,"D"
1985-12-15,1985,"Olympique Marseille","Paris Saint-Germain","0-0",0,0,"1",1,0,0,"D"
1985-12-15,1985,"FC Metz","AS Monaco","3-2",3,2,"1",1,5,1,"H"
1985-12-21,1985,"Paris Saint-Germain","AJ Auxerre","4-0",4,0,"1",1,4,4,"H"
1985-12-21,1985,"FC Nantes","Lille OSC","5-1",5,1,"1",1,6,4,"H"
1985-12-21,1985,"Stade Rennes","Girondins Bordeaux","0-0",0,0,"1",1,0,0,"D"
1985-12-21,1985,"RC Lens","OGC Nice","2-0",2,0,"1",1,2,2,"H"
1985-12-21,1985,"AS Monaco","SC Bastia","2-1",2,1,"1",1,3,1,"H"
1985-12-21,1985,"Sporting Toulon Var","Toulouse FC","1-1",1,1,"1",1,2,0,"D"
1985-12-21,1985,"Brest Armorique FC","Le Havre AC","1-1",1,1,"1",1,2,0,"D"
1985-12-22,1985,"RC Strasbourg","FC Metz","0-0",0,0,"1",1,0,0,"D"
1985-12-22,1985,"FC Sochaux","Stade Laval","1-0",1,0,"1",1,1,1,"H"
1985-12-22,1985,"AS Nancy","Olympique Marseille","0-2",0,2,"1",1,2,-2,"D"
1986-01-11,1985,"Brest Armorique FC","Paris Saint-Germain","1-1",1,1,"1",1,2,0,"D"
1986-01-11,1985,"Stade Laval","FC Nantes","0-0",0,0,"1",1,0,0,"D"
1986-01-11,1985,"Girondins Bordeaux","RC Strasbourg","1-0",1,0,"1",1,1,1,"H"
1986-01-11,1985,"Le Havre AC","RC Lens","3-0",3,0,"1",1,3,3,"H"
1986-01-11,1985,"AJ Auxerre","Stade Rennes","1-0",1,0,"1",1,1,1,"H"
1986-01-11,1985,"Toulouse FC","AS Monaco","2-1",2,1,"1",1,3,1,"H"
1986-01-11,1985,"SC Bastia","FC Metz","0-0",0,0,"1",1,0,0,"D"
1986-01-11,1985,"OGC Nice","AS Nancy","3-1",3,1,"1",1,4,2,"H"
1986-01-11,1985,"Lille OSC","Sporting Toulon Var","1-0",1,0,"1",1,1,1,"H"
1986-01-12,1985,"Olympique Marseille","FC Sochaux","1-2",1,2,"1",1,3,-1,"D"
1986-01-18,1985,"Paris Saint-Germain","OGC Nice","3-2",3,2,"1",1,5,1,"H"
1986-01-18,1985,"FC Nantes","Olympique Marseille","0-2",0,2,"1",1,2,-2,"D"
1986-01-18,1985,"AS Monaco","Girondins Bordeaux","9-0",9,0,"1",1,9,9,"H"
1986-01-18,1985,"RC Lens","Lille OSC","1-4",1,4,"1",1,5,-3,"D"
1986-01-18,1985,"Sporting Toulon Var","Stade Laval","3-0",3,0,"1",1,3,3,"H"
1986-01-18,1985,"Stade Rennes","Le Havre AC","2-1",2,1,"1",1,3,1,"H"
1986-01-19,1985,"FC Sochaux","AJ Auxerre","2-0",2,0,"1",1,2,2,"H"
1986-01-19,1985,"FC Metz","Toulouse FC","1-1",1,1,"1",1,2,0,"D"
1986-01-19,1985,"AS Nancy","Brest Armorique FC","2-0",2,0,"1",1,2,2,"H"
1986-01-19,1985,"RC Strasbourg","SC Bastia","6-1",6,1,"1",1,7,5,"H"
1986-01-22,1985,"Lille OSC","Paris Saint-Germain","2-0",2,0,"1",1,2,2,"H"
1986-01-31,1985,"Le Havre AC","FC Nantes","0-1",0,1,"1",1,1,-1,"D"
1986-02-01,1985,"Girondins Bordeaux","FC Sochaux","1-1",1,1,"1",1,2,0,"D"
1986-02-01,1985,"AJ Auxerre","SC Bastia","2-0",2,0,"1",1,2,2,"H"
1986-02-01,1985,"OGC Nice","AS Monaco","1-0",1,0,"1",1,1,1,"H"
1986-02-01,1985,"Brest Armorique FC","RC Lens","2-0",2,0,"1",1,2,2,"H"
1986-02-01,1985,"Toulouse FC","RC Strasbourg","3-0",3,0,"1",1,3,3,"H"
1986-02-01,1985,"Lille OSC","FC Metz","1-0",1,0,"1",1,1,1,"H"
1986-02-01,1985,"Stade Laval","Stade Rennes","1-0",1,0,"1",1,1,1,"H"
1986-02-02,1985,"AS Nancy","Paris Saint-Germain","1-0",1,0,"1",1,1,1,"H"
1986-02-02,1985,"Olympique Marseille","Sporting Toulon Var","2-3",2,3,"1",1,5,-1,"D"
1986-02-08,1985,"Paris Saint-Germain","Le Havre AC","1-0",1,0,"1",1,1,1,"H"
1986-02-08,1985,"FC Nantes","Girondins Bordeaux","0-0",0,0,"1",1,0,0,"D"
1986-02-08,1985,"AS Monaco","Lille OSC","3-2",3,2,"1",1,5,1,"H"
1986-02-08,1985,"RC Lens","AS Nancy","1-0",1,0,"1",1,1,1,"H"
1986-02-08,1985,"SC Bastia","Toulouse FC","0-2",0,2,"1",1,2,-2,"D"
1986-02-08,1985,"Stade Rennes","Olympique Marseille","1-2",1,2,"1",1,3,-1,"D"
1986-02-08,1985,"Sporting Toulon Var","Brest Armorique FC","2-3",2,3,"1",1,5,-1,"D"
1986-02-09,1985,"RC Strasbourg","AJ Auxerre","1-3",1,3,"1",1,4,-2,"D"
1986-02-09,1985,"FC Metz","Stade Laval","2-1",2,1,"1",1,3,1,"H"
1986-02-09,1985,"FC Sochaux","OGC Nice","2-0",2,0,"1",1,2,2,"H"
1986-02-22,1985,"Paris Saint-Germain","RC Lens","2-2",2,2,"1",1,4,0,"D"
1986-02-22,1985,"OGC Nice","FC Nantes","0-0",0,0,"1",1,0,0,"D"
1986-02-22,1985,"Girondins Bordeaux","FC Metz","3-1",3,1,"1",1,4,2,"H"
1986-02-22,1985,"AJ Auxerre","Sporting Toulon Var","0-0",0,0,"1",1,0,0,"D"
1986-02-22,1985,"Stade Laval","AS Monaco","0-0",0,0,"1",1,0,0,"D"
1986-02-22,1985,"Le Havre AC","Toulouse FC","1-0",1,0,"1",1,1,1,"H"
1986-02-22,1985,"Lille OSC","SC Bastia","2-2",2,2,"1",1,4,0,"D"
1986-02-23,1985,"AS Nancy","FC Sochaux","3-0",3,0,"1",1,3,3,"H"
1986-02-23,1985,"Olympique Marseille","RC Strasbourg","0-1",0,1,"1",1,1,-1,"D"
1986-03-01,1985,"Sporting Toulon Var","AS Nancy","1-0",1,0,"1",1,1,1,"H"
1986-03-01,1985,"Stade Rennes","OGC Nice","2-0",2,0,"1",1,2,2,"H"
1986-03-01,1985,"AS Monaco","Olympique Marseille","0-0",0,0,"1",1,0,0,"D"
1986-03-01,1985,"Toulouse FC","Lille OSC","1-0",1,0,"1",1,1,1,"H"
1986-03-07,1985,"OGC Nice","Sporting Toulon Var","2-1",2,1,"1",1,3,1,"H"
1986-03-07,1985,"Le Havre AC","SC Bastia","5-2",5,2,"1",1,7,3,"H"
1986-03-07,1985,"Brest Armorique FC","RC Strasbourg","2-1",2,1,"1",1,3,1,"H"
1986-03-08,1985,"Paris Saint-Germain","Stade Rennes","1-0",1,0,"1",1,1,1,"H"
1986-03-08,1985,"AS Nancy","FC Nantes","1-3",1,3,"1",1,4,-2,"D"
1986-03-08,1985,"Girondins Bordeaux","Toulouse FC","1-1",1,1,"1",1,2,0,"D"
1986-03-08,1985,"AJ Auxerre","AS Monaco","1-0",1,0,"1",1,1,1,"H"
1986-03-08,1985,"RC Lens","FC Sochaux","3-1",3,1,"1",1,4,2,"H"
1986-03-08,1985,"Olympique Marseille","FC Metz","0-0",0,0,"1",1,0,0,"D"
1986-03-08,1985,"Stade Laval","Lille OSC","2-2",2,2,"1",1,4,0,"D"
1986-03-11,1985,"Brest Armorique FC","Stade Rennes","2-1",2,1,"1",1,3,1,"H"
1986-03-11,1985,"SC Bastia","Girondins Bordeaux","0-2",0,2,"1",1,2,-2,"D"
1986-03-14,1985,"FC Nantes","Paris Saint-Germain","2-0",2,0,"1",1,2,2,"H"
1986-03-14,1985,"Lille OSC","Girondins Bordeaux","1-0",1,0,"1",1,1,1,"H"
1986-03-14,1985,"Sporting Toulon Var","RC Lens","0-0",0,0,"1",1,0,0,"D"
1986-03-14,1985,"AS Monaco","Le Havre AC","2-2",2,2,"1",1,4,0,"D"
1986-03-14,1985,"RC Strasbourg","OGC Nice","2-0",2,0,"1",1,2,2,"H"
1986-03-14,1985,"SC Bastia","Olympique Marseille","0-3",0,3,"1",1,3,-3,"D"
1986-03-15,1985,"Toulouse FC","Stade Laval","2-0",2,0,"1",1,2,2,"H"
1986-03-15,1985,"FC Metz","AJ Auxerre","2-0",2,0,"1",1,2,2,"H"
1986-03-15,1985,"Stade Rennes","AS Nancy","1-0",1,0,"1",1,1,1,"H"
1986-03-15,1985,"FC Sochaux","Brest Armorique FC","4-2",4,2,"1",1,6,2,"H"
1986-03-21,1985,"Brest Armorique FC","AS Monaco","2-1",2,1,"1",1,3,1,"H"
1986-03-21,1985,"OGC Nice","FC Metz","2-0",2,0,"1",1,2,2,"H"
1986-03-21,1985,"Le Havre AC","Lille OSC","0-0",0,0,"1",1,0,0,"D"
1986-03-21,1985,"AS Nancy","RC Strasbourg","1-1",1,1,"1",1,2,0,"D"
1986-03-22,1985,"Paris Saint-Germain","Sporting Toulon Var","1-0",1,0,"1",1,1,1,"H"
1986-03-22,1985,"RC Lens","FC Nantes","0-0",0,0,"1",1,0,0,"D"
1986-03-22,1985,"AJ Auxerre","Girondins Bordeaux","2-2",2,2,"1",1,4,0,"D"
1986-03-22,1985,"Olympique Marseille","Toulouse FC","1-1",1,1,"1",1,2,0,"D"
1986-03-22,1985,"Stade Laval","SC Bastia","1-0",1,0,"1",1,1,1,"H"
1986-03-22,1985,"FC Sochaux","Stade Rennes","0-0",0,0,"1",1,0,0,"D"
1986-03-28,1985,"FC Metz","Le Havre AC","3-0",3,0,"1",1,3,3,"H"
1986-04-04,1985,"RC Strasbourg","Paris Saint-Germain","1-0",1,0,"1",1,1,1,"H"
1986-04-04,1985,"FC Nantes","FC Sochaux","3-2",3,2,"1",1,5,1,"H"
1986-04-04,1985,"Girondins Bordeaux","Stade Laval","2-1",2,1,"1",1,3,1,"H"
1986-04-04,1985,"Toulouse FC","AJ Auxerre","2-0",2,0,"1",1,2,2,"H"
1986-04-04,1985,"FC Metz","Brest Armorique FC","3-1",3,1,"1",1,4,2,"H"
1986-04-04,1985,"Stade Rennes","RC Lens","2-0",2,0,"1",1,2,2,"H"
1986-04-04,1985,"AS Monaco","AS Nancy","1-1",1,1,"1",1,2,0,"D"
1986-04-04,1985,"SC Bastia","OGC Nice","0-1",0,1,"1",1,1,-1,"D"
1986-04-04,1985,"Lille OSC","Olympique Marseille","0-0",0,0,"1",1,0,0,"D"
1986-04-04,1985,"Sporting Toulon Var","Le Havre AC","1-0",1,0,"1",1,1,1,"H"
1986-04-08,1985,"FC Sochaux","Paris Saint-Germain","1-1",1,1,"1",1,2,0,"D"
1986-04-08,1985,"RC Lens","AJ Auxerre","2-1",2,1,"1",1,3,1,"H"
1986-04-08,1985,"RC Strasbourg","Stade Laval","2-1",2,1,"1",1,3,1,"H"
1986-04-08,1985,"FC Nantes","Brest Armorique FC","3-1",3,1,"1",1,4,2,"H"
1986-04-11,1985,"Paris Saint-Germain","AS Monaco","1-0",1,0,"1",1,1,1,"H"
1986-04-11,1985,"Stade Rennes","FC Nantes","0-0",0,0,"1",1,0,0,"D"
1986-04-11,1985,"Olympique Marseille","Girondins Bordeaux","4-0",4,0,"1",1,4,4,"H"
1986-04-11,1985,"RC Lens","RC Strasbourg","0-0",0,0,"1",1,0,0,"D"
1986-04-11,1985,"AS Nancy","FC Metz","0-2",0,2,"1",1,2,-2,"D"
1986-04-11,1985,"OGC Nice","Toulouse FC","3-1",3,1,"1",1,4,2,"H"
1986-04-11,1985,"AJ Auxerre","Lille OSC","2-0",2,0,"1",1,2,2,"H"
1986-04-11,1985,"Brest Armorique FC","SC Bastia","7-0",7,0,"1",1,7,7,"H"
1986-04-11,1985,"Le Havre AC","Stade Laval","1-1",1,1,"1",1,2,0,"D"
1986-04-12,1985,"FC Sochaux","Sporting Toulon Var","1-0",1,0,"1",1,1,1,"H"
1986-04-18,1985,"FC Metz","Paris Saint-Germain","3-1",3,1,"1",1,4,2,"H"
1986-04-18,1985,"FC Nantes","AJ Auxerre","2-1",2,1,"1",1,3,1,"H"
1986-04-18,1985,"Girondins Bordeaux","Le Havre AC","5-3",5,3,"1",1,8,2,"H"
1986-04-18,1985,"AS Monaco","RC Lens","1-2",1,2,"1",1,3,-1,"D"
1986-04-18,1985,"Toulouse FC","Brest Armorique FC","2-0",2,0,"1",1,2,2,"H"
1986-04-18,1985,"Lille OSC","OGC Nice","1-0",1,0,"1",1,1,1,"H"
1986-04-18,1985,"Stade Laval","Olympique Marseille","1-0",1,0,"1",1,1,1,"H"
1986-04-18,1985,"SC Bastia","AS Nancy","2-2",2,2,"1",1,4,0,"D"
1986-04-18,1985,"Sporting Toulon Var","Stade Rennes","1-1",1,1,"1",1,2,0,"D"
1986-04-18,1985,"RC Strasbourg","FC Sochaux","3-0",3,0,"1",1,3,3,"H"
1986-04-25,1985,"Paris Saint-Germain","SC Bastia","3-1",3,1,"1",1,4,2,"H"
1986-04-25,1985,"FC Nantes","Sporting Toulon Var","1-1",1,1,"1",1,2,0,"D"
1986-04-25,1985,"OGC Nice","Girondins Bordeaux","1-1",1,1,"1",1,2,0,"D"
1986-04-25,1985,"AS Nancy","Toulouse FC","0-1",0,1,"1",1,1,-1,"D"
1986-04-25,1985,"RC Lens","FC Metz","0-0",0,0,"1",1,0,0,"D"
1986-04-25,1985,"AJ Auxerre","Stade Laval","2-0",2,0,"1",1,2,2,"H"
1986-04-25,1985,"FC Sochaux","AS Monaco","1-1",1,1,"1",1,2,0,"D"
1986-04-25,1985,"Brest Armorique FC","Lille OSC","1-1",1,1,"1",1,2,0,"D"
1986-04-25,1985,"Olympique Marseille","Le Havre AC","1-1",1,1,"1",1,2,0,"D"
1986-04-25,1985,"Stade Rennes","RC Strasbourg","1-1",1,1,"1",1,2,0,"D"
1986-08-05,1986,"Olympique Marseille","AS Monaco","3-1",3,1,"1",1,4,2,"H"
1986-08-05,1986,"Le Havre AC","Brest Armorique FC","1-2",1,2,"1",1,3,-1,"D"
1986-08-05,1986,"Girondins Bordeaux","FC Metz","1-0",1,0,"1",1,1,1,"H"
1986-08-05,1986,"FC Nantes","Lille OSC","1-0",1,0,"1",1,1,1,"H"
1986-08-05,1986,"Stade Rennes","Racing Club de France","1-0",1,0,"1",1,1,1,"H"
1986-08-05,1986,"Paris Saint-Germain","Stade Laval","1-0",1,0,"1",1,1,1,"H"
1986-08-05,1986,"FC Sochaux","AS Saint-Etienne","3-3",3,3,"1",1,6,0,"D"
1986-08-05,1986,"OGC Nice","Sporting Toulon Var","2-2",2,2,"1",1,4,0,"D"
1986-08-05,1986,"RC Lens","Toulouse FC","1-1",1,1,"1",1,2,0,"D"
1986-08-05,1986,"AS Nancy","AJ Auxerre","1-1",1,1,"1",1,2,0,"D"
1986-08-08,1986,"AJ Auxerre","Paris Saint-Germain","1-2",1,2,"1",1,3,-1,"D"
1986-08-08,1986,"Brest Armorique FC","Olympique Marseille","0-0",0,0,"1",1,0,0,"D"
1986-08-08,1986,"OGC Nice","Stade Rennes","1-0",1,0,"1",1,1,1,"H"
1986-08-08,1986,"Toulouse FC","AS Monaco","2-1",2,1,"1",1,3,1,"H"
1986-08-08,1986,"Sporting Toulon Var","FC Nantes","1-1",1,1,"1",1,2,0,"D"
1986-08-08,1986,"Lille OSC","Girondins Bordeaux","0-0",0,0,"1",1,0,0,"D"
1986-08-08,1986,"FC Metz","FC Sochaux","5-1",5,1,"1",1,6,4,"H"
1986-08-08,1986,"AS Saint-Etienne","AS Nancy","0-0",0,0,"1",1,0,0,"D"
1986-08-08,1986,"Racing Club de France","Le Havre AC","2-1",2,1,"1",1,3,1,"H"
1986-08-08,1986,"Stade Laval","RC Lens","1-1",1,1,"1",1,2,0,"D"
1986-08-12,1986,"AS Nancy","Brest Armorique FC","0-4",0,4,"1",1,4,-4,"D"
1986-08-12,1986,"Olympique Marseille","Toulouse FC","2-1",2,1,"1",1,3,1,"H"
1986-08-12,1986,"Girondins Bordeaux","Racing Club de France","2-0",2,0,"1",1,2,2,"H"
1986-08-12,1986,"Paris Saint-Germain","FC Metz","0-0",0,0,"1",1,0,0,"D"
1986-08-12,1986,"FC Nantes","OGC Nice","1-0",1,0,"1",1,1,1,"H"
1986-08-12,1986,"Stade Rennes","Sporting Toulon Var","2-0",2,0,"1",1,2,2,"H"
1986-08-12,1986,"RC Lens","AJ Auxerre","1-1",1,1,"1",1,2,0,"D"
1986-08-12,1986,"FC Sochaux","Lille OSC","1-0",1,0,"1",1,1,1,"H"
1986-08-12,1986,"Le Havre AC","AS Saint-Etienne","1-0",1,0,"1",1,1,1,"H"
1986-08-12,1986,"AS Monaco","Stade Laval","0-0",0,0,"1",1,0,0,"D"
1986-08-15,1986,"Racing Club de France","Olympique Marseille","0-1",0,1,"1",1,1,-1,"D"
1986-08-15,1986,"FC Nantes","AS Nancy","1-0",1,0,"1",1,1,1,"H"
1986-08-15,1986,"OGC Nice","Girondins Bordeaux","0-0",0,0,"1",1,0,0,"D"
1986-08-15,1986,"FC Metz","Le Havre AC","3-0",3,0,"1",1,3,3,"H"
1986-08-15,1986,"Brest Armorique FC","RC Lens","1-3",1,3,"1",1,4,-2,"D"
1986-08-15,1986,"AS Saint-Etienne","Paris Saint-Germain","1-0",1,0,"1",1,1,1,"H"
1986-08-15,1986,"Stade Laval","Toulouse FC","0-0",0,0,"1",1,0,0,"D"
1986-08-15,1986,"Lille OSC","Stade Rennes","3-0",3,0,"1",1,3,3,"H"
1986-08-15,1986,"Sporting Toulon Var","FC Sochaux","0-0",0,0,"1",1,0,0,"D"
1986-08-15,1986,"AJ Auxerre","AS Monaco","1-1",1,1,"1",1,2,0,"D"
1986-08-22,1986,"Olympique Marseille","Stade Laval","3-0",3,0,"1",1,3,3,"H"
1986-08-22,1986,"Stade Rennes","FC Nantes","1-3",1,3,"1",1,4,-2,"D"
1986-08-22,1986,"Girondins Bordeaux","Sporting Toulon Var","2-1",2,1,"1",1,3,1,"H"
1986-08-22,1986,"RC Lens","AS Saint-Etienne","2-0",2,0,"1",1,2,2,"H"
1986-08-22,1986,"Paris Saint-Germain","Brest Armorique FC","1-0",1,0,"1",1,1,1,"H"
1986-08-22,1986,"Toulouse FC","AJ Auxerre","2-0",2,0,"1",1,2,2,"H"
1986-08-22,1986,"AS Monaco","FC Metz","2-1",2,1,"1",1,3,1,"H"
1986-08-22,1986,"FC Sochaux","OGC Nice","0-0",0,0,"1",1,0,0,"D"
1986-08-22,1986,"Le Havre AC","Lille OSC","1-1",1,1,"1",1,2,0,"D"
1986-08-22,1986,"AS Nancy","Racing Club de France","2-1",2,1,"1",1,3,1,"H"
1986-08-26,1986,"FC Nantes","Girondins Bordeaux","3-0",3,0,"1",1,3,3,"H"
1986-08-26,1986,"Stade Rennes","Olympique Marseille","0-0",0,0,"1",1,0,0,"D"
1986-08-26,1986,"OGC Nice","Paris Saint-Germain","0-2",0,2,"1",1,2,-2,"D"
1986-08-26,1986,"FC Metz","RC Lens","2-0",2,0,"1",1,2,2,"H"
1986-08-26,1986,"Brest Armorique FC","AS Monaco","1-0",1,0,"1",1,1,1,"H"
1986-08-26,1986,"AS Saint-Etienne","Toulouse FC","0-0",0,0,"1",1,0,0,"D"
1986-08-26,1986,"Racing Club de France","FC Sochaux","0-2",0,2,"1",1,2,-2,"D"
1986-08-26,1986,"Lille OSC","AS Nancy","4-3",4,3,"1",1,7,1,"H"
1986-08-26,1986,"Sporting Toulon Var","Le Havre AC","0-0",0,0,"1",1,0,0,"D"
1986-08-26,1986,"AJ Auxerre","Stade Laval","1-1",1,1,"1",1,2,0,"D"
1986-08-29,1986,"Olympique Marseille","AJ Auxerre","1-1",1,1,"1",1,2,0,"D"
1986-08-29,1986,"FC Sochaux","FC Nantes","3-1",3,1,"1",1,4,2,"H"
1986-08-29,1986,"Girondins Bordeaux","Stade Rennes","4-1",4,1,"1",1,5,3,"H"
1986-08-29,1986,"Paris Saint-Germain","Lille OSC","1-1",1,1,"1",1,2,0,"D"
1986-08-29,1986,"Toulouse FC","Brest Armorique FC","5-0",5,0,"1",1,5,5,"H"
1986-08-29,1986,"Stade Laval","FC Metz","1-1",1,1,"1",1,2,0,"D"
1986-08-29,1986,"RC Lens","Racing Club de France","0-1",0,1,"1",1,1,-1,"D"
1986-08-29,1986,"AS Nancy","Sporting Toulon Var","3-0",3,0,"1",1,3,3,"H"
1986-08-29,1986,"Le Havre AC","OGC Nice","3-0",3,0,"1",1,3,3,"H"
1986-08-29,1986,"AS Monaco","AS Saint-Etienne","0-0",0,0,"1",1,0,0,"D"
1986-09-03,1986,"FC Metz","Olympique Marseille","1-1",1,1,"1",1,2,0,"D"
1986-09-03,1986,"FC Nantes","Le Havre AC","0-0",0,0,"1",1,0,0,"D"
1986-09-03,1986,"Girondins Bordeaux","RC Lens","0-0",0,0,"1",1,0,0,"D"
1986-09-03,1986,"Sporting Toulon Var","Paris Saint-Germain","1-1",1,1,"1",1,2,0,"D"
1986-09-03,1986,"Lille OSC","Toulouse FC","1-0",1,0,"1",1,1,1,"H"
1986-09-03,1986,"Stade Rennes","FC Sochaux","1-0",1,0,"1",1,1,1,"H"
1986-09-03,1986,"Brest Armorique FC","AJ Auxerre","0-0",0,0,"1",1,0,0,"D"
1986-09-03,1986,"AS Saint-Etienne","Stade Laval","0-0",0,0,"1",1,0,0,"D"
1986-09-03,1986,"OGC Nice","AS Nancy","1-0",1,0,"1",1,1,1,"H"
1986-09-03,1986,"Racing Club de France","AS Monaco","1-1",1,1,"1",1,2,0,"D"
1986-09-12,1986,"Toulouse FC","OGC Nice","2-0",2,0,"1",1,2,2,"H"
1986-09-13,1986,"Olympique Marseille","Sporting Toulon Var","3-0",3,0,"1",1,3,3,"H"
1986-09-13,1986,"FC Sochaux","Girondins Bordeaux","0-2",0,2,"1",1,2,-2,"D"
1986-09-13,1986,"AS Monaco","FC Nantes","3-1",3,1,"1",1,4,2,"H"
1986-09-13,1986,"RC Lens","Lille OSC","1-3",1,3,"1",1,4,-2,"D"
1986-09-13,1986,"Paris Saint-Germain","Racing Club de France","1-2",1,2,"1",1,3,-1,"D"
1986-09-13,1986,"AS Nancy","FC Metz","0-0",0,0,"1",1,0,0,"D"
1986-09-13,1986,"AJ Auxerre","AS Saint-Etienne","3-0",3,0,"1",1,3,3,"H"
1986-09-13,1986,"Stade Laval","Brest Armorique FC","1-0",1,0,"1",1,1,1,"H"
1986-09-13,1986,"Le Havre AC","Stade Rennes","1-1",1,1,"1",1,2,0,"D"
1986-09-19,1986,"FC Metz","AJ Auxerre","0-1",0,1,"1",1,1,-1,"D"
1986-09-20,1986,"Lille OSC","Olympique Marseille","2-2",2,2,"1",1,4,0,"D"
1986-09-20,1986,"Girondins Bordeaux","Le Havre AC","3-0",3,0,"1",1,3,3,"H"
1986-09-20,1986,"FC Nantes","Paris Saint-Germain","0-1",0,1,"1",1,1,-1,"D"
1986-09-20,1986,"FC Sochaux","Toulouse FC","1-1",1,1,"1",1,2,0,"D"
1986-09-20,1986,"Sporting Toulon Var","AS Monaco","1-3",1,3,"1",1,4,-2,"D"
1986-09-20,1986,"AS Saint-Etienne","Brest Armorique FC","1-1",1,1,"1",1,2,0,"D"
1986-09-20,1986,"Racing Club de France","Stade Laval","1-1",1,1,"1",1,2,0,"D"
1986-09-20,1986,"OGC Nice","RC Lens","3-1",3,1,"1",1,4,2,"H"
1986-09-20,1986,"Stade Rennes","AS Nancy","0-0",0,0,"1",1,0,0,"D"
1986-09-24,1986,"Olympique Marseille","AS Saint-Etienne","1-0",1,0,"1",1,1,1,"H"
1986-09-24,1986,"AS Nancy","Girondins Bordeaux","0-1",0,1,"1",1,1,-1,"D"
1986-09-24,1986,"Paris Saint-Germain","Stade Rennes","1-0",1,0,"1",1,1,1,"H"
1986-09-24,1986,"Toulouse FC","Racing Club de France","3-0",3,0,"1",1,3,3,"H"
1986-09-24,1986,"AS Monaco","Lille OSC","1-0",1,0,"1",1,1,1,"H"
1986-09-24,1986,"AJ Auxerre","FC Nantes","1-0",1,0,"1",1,1,1,"H"
1986-09-24,1986,"Brest Armorique FC","FC Metz","0-0",0,0,"1",1,0,0,"D"
1986-09-24,1986,"RC Lens","Sporting Toulon Var","2-1",2,1,"1",1,3,1,"H"
1986-09-24,1986,"Stade Laval","OGC Nice","0-0",0,0,"1",1,0,0,"D"
1986-09-24,1986,"Le Havre AC","FC Sochaux","3-1",3,1,"1",1,4,2,"H"
1986-10-03,1986,"OGC Nice","AS Monaco","1-0",1,0,"1",1,1,1,"H"
1986-10-04,1986,"Girondins Bordeaux","Paris Saint-Germain","2-0",2,0,"1",1,2,2,"H"
1986-10-04,1986,"FC Sochaux","Olympique Marseille","2-0",2,0,"1",1,2,2,"H"
1986-10-04,1986,"FC Nantes","Toulouse FC","2-1",2,1,"1",1,3,1,"H"
1986-10-04,1986,"Lille OSC","AJ Auxerre","1-1",1,1,"1",1,2,0,"D"
1986-10-04,1986,"FC Metz","AS Saint-Etienne","1-1",1,1,"1",1,2,0,"D"
1986-10-04,1986,"Le Havre AC","AS Nancy","3-0",3,0,"1",1,3,3,"H"
1986-10-04,1986,"Stade Rennes","RC Lens","1-2",1,2,"1",1,3,-1,"D"
1986-10-04,1986,"Racing Club de France","Brest Armorique FC","2-2",2,2,"1",1,4,0,"D"
1986-10-04,1986,"Sporting Toulon Var","Stade Laval","3-0",3,0,"1",1,3,3,"H"
1986-10-17,1986,"Olympique Marseille","Girondins Bordeaux","1-1",1,1,"1",1,2,0,"D"
1986-10-17,1986,"Paris Saint-Germain","Le Havre AC","1-1",1,1,"1",1,2,0,"D"
1986-10-17,1986,"Toulouse FC","FC Metz","0-0",0,0,"1",1,0,0,"D"
1986-10-17,1986,"AJ Auxerre","Sporting Toulon Var","2-0",2,0,"1",1,2,2,"H"
1986-10-17,1986,"RC Lens","FC Nantes","2-2",2,2,"1",1,4,0,"D"
1986-10-17,1986,"AS Monaco","Stade Rennes","1-0",1,0,"1",1,1,1,"H"
1986-10-17,1986,"AS Nancy","FC Sochaux","0-1",0,1,"1",1,1,-1,"D"
1986-10-17,1986,"Brest Armorique FC","OGC Nice","1-3",1,3,"1",1,4,-2,"D"
1986-10-17,1986,"AS Saint-Etienne","Racing Club de France","4-0",4,0,"1",1,4,4,"H"
1986-10-18,1986,"Stade Laval","Lille OSC","2-1",2,1,"1",1,3,1,"H"
1986-10-24,1986,"Lille OSC","AS Saint-Etienne","1-0",1,0,"1",1,1,1,"H"
1986-10-25,1986,"Girondins Bordeaux","AS Monaco","1-1",1,1,"1",1,2,0,"D"
1986-10-25,1986,"Le Havre AC","Olympique Marseille","1-3",1,3,"1",1,4,-2,"D"
1986-10-25,1986,"FC Sochaux","Paris Saint-Germain","0-1",0,1,"1",1,1,-1,"D"
1986-10-25,1986,"Stade Rennes","Toulouse FC","0-0",0,0,"1",1,0,0,"D"
1986-10-25,1986,"FC Nantes","Stade Laval","1-1",1,1,"1",1,2,0,"D"
1986-10-25,1986,"OGC Nice","AJ Auxerre","2-0",2,0,"1",1,2,2,"H"
1986-10-25,1986,"Racing Club de France","FC Metz","1-1",1,1,"1",1,2,0,"D"
1986-10-25,1986,"AS Nancy","RC Lens","1-1",1,1,"1",1,2,0,"D"
1986-10-25,1986,"Sporting Toulon Var","Brest Armorique FC","2-3",2,3,"1",1,5,-1,"D"
1986-10-31,1986,"Olympique Marseille","FC Nantes","1-0",1,0,"1",1,1,1,"H"
1986-10-31,1986,"Toulouse FC","Girondins Bordeaux","1-1",1,1,"1",1,2,0,"D"
1986-10-31,1986,"Paris Saint-Germain","AS Nancy","0-0",0,0,"1",1,0,0,"D"
1986-10-31,1986,"AS Monaco","FC Sochaux","2-0",2,0,"1",1,2,2,"H"
1986-10-31,1986,"AJ Auxerre","Racing Club de France","2-0",2,0,"1",1,2,2,"H"
1986-10-31,1986,"FC Metz","OGC Nice","1-1",1,1,"1",1,2,0,"D"
1986-10-31,1986,"Brest Armorique FC","Lille OSC","0-0",0,0,"1",1,0,0,"D"
1986-10-31,1986,"RC Lens","Le Havre AC","0-0",0,0,"1",1,0,0,"D"
1986-10-31,1986,"Stade Laval","Stade Rennes","3-0",3,0,"1",1,3,3,"H"
1986-10-31,1986,"AS Saint-Etienne","Sporting Toulon Var","1-0",1,0,"1",1,1,1,"H"
1986-11-07,1986,"Stade Rennes","AJ Auxerre","1-3",1,3,"1",1,4,-2,"D"
1986-11-07,1986,"FC Nantes","Brest Armorique FC","0-0",0,0,"1",1,0,0,"D"
1986-11-08,1986,"AS Nancy","Olympique Marseille","0-0",0,0,"1",1,0,0,"D"
1986-11-08,1986,"Girondins Bordeaux","Stade Laval","1-1",1,1,"1",1,2,0,"D"
1986-11-08,1986,"Paris Saint-Germain","Toulouse FC","2-3",2,3,"1",1,5,-1,"D"
1986-11-08,1986,"OGC Nice","AS Saint-Etienne","1-0",1,0,"1",1,1,1,"H"
1986-11-08,1986,"Le Havre AC","AS Monaco","1-1",1,1,"1",1,2,0,"D"
1986-11-08,1986,"Lille OSC","Racing Club de France","0-1",0,1,"1",1,1,-1,"D"
1986-11-08,1986,"FC Sochaux","RC Lens","0-0",0,0,"1",1,0,0,"D"
1986-11-08,1986,"Sporting Toulon Var","FC Metz","2-0",2,0,"1",1,2,2,"H"
1986-11-11,1986,"Brest Armorique FC","Stade Rennes","2-1",2,1,"1",1,3,1,"H"
1986-11-12,1986,"Olympique Marseille","OGC Nice","3-1",3,1,"1",1,4,2,"H"
1986-11-12,1986,"AJ Auxerre","Girondins Bordeaux","0-1",0,1,"1",1,1,-1,"D"
1986-11-12,1986,"Toulouse FC","Le Havre AC","3-0",3,0,"1",1,3,3,"H"
1986-11-12,1986,"AS Monaco","AS Nancy","1-0",1,0,"1",1,1,1,"H"
1986-11-12,1986,"RC Lens","Paris Saint-Germain","1-0",1,0,"1",1,1,1,"H"
1986-11-12,1986,"AS Saint-Etienne","FC Nantes","0-0",0,0,"1",1,0,0,"D"
1986-11-12,1986,"FC Metz","Lille OSC","3-0",3,0,"1",1,3,3,"H"
1986-11-12,1986,"Stade Laval","FC Sochaux","1-1",1,1,"1",1,2,0,"D"
1986-11-12,1986,"Racing Club de France","Sporting Toulon Var","2-0",2,0,"1",1,2,2,"H"
1986-11-22,1986,"Girondins Bordeaux","Brest Armorique FC","1-2",1,2,"1",1,3,-1,"D"
1986-11-22,1986,"RC Lens","Olympique Marseille","3-0",3,0,"1",1,3,3,"H"
1986-11-22,1986,"Paris Saint-Germain","AS Monaco","0-1",0,1,"1",1,1,-1,"D"
1986-11-22,1986,"AS Nancy","Toulouse FC","2-0",2,0,"1",1,2,2,"H"
1986-11-22,1986,"OGC Nice","Racing Club de France","1-0",1,0,"1",1,1,1,"H"
1986-11-22,1986,"FC Sochaux","AJ Auxerre","2-2",2,2,"1",1,4,0,"D"
1986-11-22,1986,"FC Nantes","FC Metz","1-0",1,0,"1",1,1,1,"H"
1986-11-22,1986,"Le Havre AC","Stade Laval","2-1",2,1,"1",1,3,1,"H"
1986-11-22,1986,"Sporting Toulon Var","Lille OSC","1-0",1,0,"1",1,1,1,"H"
1986-11-22,1986,"Stade Rennes","AS Saint-Etienne","0-0",0,0,"1",1,0,0,"D"
1986-11-28,1986,"Olympique Marseille","Paris Saint-Germain","4-0",4,0,"1",1,4,4,"H"
1986-11-28,1986,"FC Metz","Stade Rennes","6-1",6,1,"1",1,7,5,"H"
1986-11-29,1986,"AS Saint-Etienne","Girondins Bordeaux","2-0",2,0,"1",1,2,2,"H"
1986-11-29,1986,"AS Monaco","RC Lens","2-1",2,1,"1",1,3,1,"H"
1986-11-29,1986,"Toulouse FC","Sporting Toulon Var","1-0",1,0,"1",1,1,1,"H"
1986-11-29,1986,"AJ Auxerre","Le Havre AC","1-0",1,0,"1",1,1,1,"H"
1986-11-29,1986,"Lille OSC","OGC Nice","1-1",1,1,"1",1,2,0,"D"
1986-11-29,1986,"Racing Club de France","FC Nantes","1-1",1,1,"1",1,2,0,"D"
1986-11-29,1986,"Brest Armorique FC","FC Sochaux","0-0",0,0,"1",1,0,0,"D"
1986-11-29,1986,"Stade Laval","AS Nancy","0-0",0,0,"1",1,0,0,"D"
1986-12-05,1986,"Olympique Marseille","Brest Armorique FC","2-2",2,2,"1",1,4,0,"D"
1986-12-05,1986,"Girondins Bordeaux","Lille OSC","3-0",3,0,"1",1,3,3,"H"
1986-12-05,1986,"AS Monaco","Toulouse FC","1-0",1,0,"1",1,1,1,"H"
1986-12-05,1986,"FC Nantes","Sporting Toulon Var","1-0",1,0,"1",1,1,1,"H"
1986-12-05,1986,"Paris Saint-Germain","AJ Auxerre","1-0",1,0,"1",1,1,1,"H"
1986-12-05,1986,"Stade Rennes","OGC Nice","1-0",1,0,"1",1,1,1,"H"
1986-12-05,1986,"FC Sochaux","FC Metz","2-2",2,2,"1",1,4,0,"D"
1986-12-05,1986,"RC Lens","Stade Laval","0-2",0,2,"1",1,2,-2,"D"
1986-12-05,1986,"Le Havre AC","Racing Club de France","2-2",2,2,"1",1,4,0,"D"
1986-12-05,1986,"AS Nancy","AS Saint-Etienne","1-0",1,0,"1",1,1,1,"H"
1986-12-12,1986,"Toulouse FC","Olympique Marseille","0-0",0,0,"1",1,0,0,"D"
1986-12-13,1986,"Racing Club de France","Girondins Bordeaux","1-2",1,2,"1",1,3,-1,"D"
1986-12-13,1986,"Stade Laval","AS Monaco","2-0",2,0,"1",1,2,2,"H"
1986-12-13,1986,"AJ Auxerre","RC Lens","3-1",3,1,"1",1,4,2,"H"
1986-12-13,1986,"OGC Nice","FC Nantes","1-1",1,1,"1",1,2,0,"D"
1986-12-13,1986,"Brest Armorique FC","AS Nancy","2-0",2,0,"1",1,2,2,"H"
1986-12-13,1986,"Lille OSC","FC Sochaux","6-0",6,0,"1",1,6,6,"H"
1986-12-13,1986,"Sporting Toulon Var","Stade Rennes","2-0",2,0,"1",1,2,2,"H"
1986-12-14,1986,"AS Saint-Etienne","Le Havre AC","1-1",1,1,"1",1,2,0,"D"
1986-12-14,1986,"FC Metz","Paris Saint-Germain","0-0",0,0,"1",1,0,0,"D"
1986-12-17,1986,"Olympique Marseille","Racing Club de France","2-0",2,0,"1",1,2,2,"H"
1986-12-17,1986,"Girondins Bordeaux","OGC Nice","4-1",4,1,"1",1,5,3,"H"
1986-12-17,1986,"AS Monaco","AJ Auxerre","2-0",2,0,"1",1,2,2,"H"
1986-12-17,1986,"Toulouse FC","Stade Laval","2-0",2,0,"1",1,2,2,"H"
1986-12-17,1986,"AS Nancy","FC Nantes","0-0",0,0,"1",1,0,0,"D"
1986-12-17,1986,"Paris Saint-Germain","AS Saint-Etienne","3-0",3,0,"1",1,3,3,"H"
1986-12-17,1986,"RC Lens","Brest Armorique FC","2-1",2,1,"1",1,3,1,"H"
1986-12-17,1986,"Le Havre AC","FC Metz","2-2",2,2,"1",1,4,0,"D"
1986-12-17,1986,"Stade Rennes","Lille OSC","1-0",1,0,"1",1,1,1,"H"
1986-12-17,1986,"FC Sochaux","Sporting Toulon Var","0-1",0,1,"1",1,1,-1,"D"
1986-12-20,1986,"Stade Laval","Olympique Marseille","0-0",0,0,"1",1,0,0,"D"
1986-12-20,1986,"FC Nantes","Stade Rennes","3-1",3,1,"1",1,4,2,"H"
1986-12-20,1986,"AJ Auxerre","Toulouse FC","2-1",2,1,"1",1,3,1,"H"
1986-12-20,1986,"Brest Armorique FC","Paris Saint-Germain","0-0",0,0,"1",1,0,0,"D"
1986-12-20,1986,"Lille OSC","Le Havre AC","3-2",3,2,"1",1,5,1,"H"
1986-12-20,1986,"Racing Club de France","AS Nancy","1-0",1,0,"1",1,1,1,"H"
1986-12-21,1986,"OGC Nice","FC Sochaux","1-0",1,0,"1",1,1,1,"H"
1986-12-21,1986,"AS Saint-Etienne","RC Lens","1-0",1,0,"1",1,1,1,"H"
1986-12-21,1986,"FC Metz","AS Monaco","4-1",4,1,"1",1,5,3,"H"
1986-12-21,1986,"Sporting Toulon Var","Girondins Bordeaux","0-0",0,0,"1",1,0,0,"D"
1987-02-27,1986,"Stade Laval","AJ Auxerre","0-2",0,2,"1",1,2,-2,"D"
1987-02-28,1986,"Girondins Bordeaux","FC Nantes","2-0",2,0,"1",1,2,2,"H"
1987-02-28,1986,"Toulouse FC","AS Saint-Etienne","2-1",2,1,"1",1,3,1,"H"
1987-02-28,1986,"AS Monaco","Brest Armorique FC","0-1",0,1,"1",1,1,-1,"D"
1987-02-28,1986,"Paris Saint-Germain","OGC Nice","0-3",0,3,"1",1,3,-3,"D"
1987-02-28,1986,"RC Lens","FC Metz","0-0",0,0,"1",1,0,0,"D"
1987-02-28,1986,"AS Nancy","Lille OSC","0-1",0,1,"1",1,1,-1,"D"
1987-02-28,1986,"Le Havre AC","Sporting Toulon Var","1-1",1,1,"1",1,2,0,"D"
1987-02-28,1986,"FC Sochaux","Matra Racing","0-1",0,1,"1",1,1,-1,"D"
1987-03-01,1986,"Olympique Marseille","Stade Rennes","1-0",1,0,"1",1,1,1,"H"
1987-03-05,1986,"Matra Racing","RC Lens","5-0",5,0,"1",1,5,5,"H"
1987-03-07,1986,"Stade Rennes","Girondins Bordeaux","0-1",0,1,"1",1,1,-1,"D"
1987-03-07,1986,"AJ Auxerre","Olympique Marseille","0-0",0,0,"1",1,0,0,"D"
1987-03-07,1986,"Brest Armorique FC","Toulouse FC","1-2",1,2,"1",1,3,-1,"D"
1987-03-07,1986,"FC Nantes","FC Sochaux","2-1",2,1,"1",1,3,1,"H"
1987-03-07,1986,"AS Saint-Etienne","AS Monaco","0-0",0,0,"1",1,0,0,"D"
1987-03-07,1986,"OGC Nice","Le Havre AC","3-1",3,1,"1",1,4,2,"H"
1987-03-07,1986,"FC Metz","Stade Laval","1-0",1,0,"1",1,1,1,"H"
1987-03-07,1986,"Lille OSC","Paris Saint-Germain","1-0",1,0,"1",1,1,1,"H"
1987-03-07,1986,"Sporting Toulon Var","AS Nancy","1-0",1,0,"1",1,1,1,"H"
1987-03-11,1986,"RC Lens","Girondins Bordeaux","0-0",0,0,"1",1,0,0,"D"
1987-03-11,1986,"Olympique Marseille","FC Metz","3-2",3,2,"1",1,5,1,"H"
1987-03-11,1986,"Toulouse FC","Lille OSC","0-0",0,0,"1",1,0,0,"D"
1987-03-11,1986,"AJ Auxerre","Brest Armorique FC","1-0",1,0,"1",1,1,1,"H"
1987-03-11,1986,"AS Monaco","Matra Racing","0-0",0,0,"1",1,0,0,"D"
1987-03-11,1986,"Le Havre AC","FC Nantes","1-0",1,0,"1",1,1,1,"H"
1987-03-11,1986,"AS Nancy","OGC Nice","1-0",1,0,"1",1,1,1,"H"
1987-03-11,1986,"Paris Saint-Germain","Sporting Toulon Var","1-1",1,1,"1",1,2,0,"D"
1987-03-11,1986,"Stade Laval","AS Saint-Etienne","2-1",2,1,"1",1,3,1,"H"
1987-03-11,1986,"FC Sochaux","Stade Rennes","1-1",1,1,"1",1,2,0,"D"
1987-03-14,1986,"Girondins Bordeaux","FC Sochaux","3-0",3,0,"1",1,3,3,"H"
1987-03-14,1986,"Sporting Toulon Var","Olympique Marseille","0-0",0,0,"1",1,0,0,"D"
1987-03-14,1986,"OGC Nice","Toulouse FC","1-4",1,4,"1",1,5,-3,"D"
1987-03-14,1986,"AS Saint-Etienne","AJ Auxerre","1-1",1,1,"1",1,2,0,"D"
1987-03-14,1986,"FC Nantes","AS Monaco","0-0",0,0,"1",1,0,0,"D"
1987-03-14,1986,"FC Metz","AS Nancy","2-0",2,0,"1",1,2,2,"H"
1987-03-14,1986,"Matra Racing","Paris Saint-Germain","0-1",0,1,"1",1,1,-1,"D"
1987-03-14,1986,"Brest Armorique FC","Stade Laval","1-2",1,2,"1",1,3,-1,"D"
1987-03-14,1986,"Lille OSC","RC Lens","0-1",0,1,"1",1,1,-1,"D"
1987-03-14,1986,"Stade Rennes","Le Havre AC","0-1",0,1,"1",1,1,-1,"D"
1987-03-24,1986,"AJ Auxerre","FC Metz","0-0",0,0,"1",1,0,0,"D"
1987-03-25,1986,"Le Havre AC","Girondins Bordeaux","1-1",1,1,"1",1,2,0,"D"
1987-03-25,1986,"Olympique Marseille","Lille OSC","2-0",2,0,"1",1,2,2,"H"
1987-03-25,1986,"Toulouse FC","FC Sochaux","2-1",2,1,"1",1,3,1,"H"
1987-03-25,1986,"Brest Armorique FC","AS Saint-Etienne","1-0",1,0,"1",1,1,1,"H"
1987-03-25,1986,"AS Monaco","Sporting Toulon Var","2-2",2,2,"1",1,4,0,"D"
1987-03-25,1986,"Paris Saint-Germain","FC Nantes","2-1",2,1,"1",1,3,1,"H"
1987-03-25,1986,"Stade Laval","Matra Racing","3-1",3,1,"1",1,4,2,"H"
1987-03-25,1986,"RC Lens","OGC Nice","4-0",4,0,"1",1,4,4,"H"
1987-03-25,1986,"AS Nancy","Stade Rennes","2-0",2,0,"1",1,2,2,"H"
1987-03-28,1986,"Girondins Bordeaux","AS Nancy","4-2",4,2,"1",1,6,2,"H"
1987-03-28,1986,"AS Saint-Etienne","Olympique Marseille","0-1",0,1,"1",1,1,-1,"D"
1987-03-28,1986,"Matra Racing","Toulouse FC","0-0",0,0,"1",1,0,0,"D"
1987-03-28,1986,"FC Nantes","AJ Auxerre","0-1",0,1,"1",1,1,-1,"D"
1987-03-28,1986,"Lille OSC","AS Monaco","1-1",1,1,"1",1,2,0,"D"
1987-03-28,1986,"FC Metz","Brest Armorique FC","3-0",3,0,"1",1,3,3,"H"
1987-03-28,1986,"Stade Rennes","Paris Saint-Germain","0-0",0,0,"1",1,0,0,"D"
1987-03-28,1986,"OGC Nice","Stade Laval","2-1",2,1,"1",1,3,1,"H"
1987-03-28,1986,"Sporting Toulon Var","RC Lens","0-0",0,0,"1",1,0,0,"D"
1987-03-28,1986,"FC Sochaux","Le Havre AC","2-1",2,1,"1",1,3,1,"H"
1987-04-04,1986,"Olympique Marseille","FC Sochaux","4-0",4,0,"1",1,4,4,"H"
1987-04-04,1986,"Paris Saint-Germain","Girondins Bordeaux","0-0",0,0,"1",1,0,0,"D"
1987-04-04,1986,"Toulouse FC","FC Nantes","1-0",1,0,"1",1,1,1,"H"
1987-04-04,1986,"AJ Auxerre","Lille OSC","1-0",1,0,"1",1,1,1,"H"
1987-04-04,1986,"AS Monaco","OGC Nice","1-0",1,0,"1",1,1,1,"H"
1987-04-04,1986,"AS Saint-Etienne","FC Metz","0-0",0,0,"1",1,0,0,"D"
1987-04-04,1986,"Stade Laval","Sporting Toulon Var","3-2",3,2,"1",1,5,1,"H"
1987-04-04,1986,"RC Lens","Stade Rennes","2-1",2,1,"1",1,3,1,"H"
1987-04-04,1986,"Brest Armorique FC","Matra Racing","2-0",2,0,"1",1,2,2,"H"
1987-04-04,1986,"AS Nancy","Le Havre AC","0-0",0,0,"1",1,0,0,"D"
1987-04-11,1986,"Girondins Bordeaux","Olympique Marseille","3-0",3,0,"1",1,3,3,"H"
1987-04-11,1986,"FC Metz","Toulouse FC","2-0",2,0,"1",1,2,2,"H"
1987-04-11,1986,"Sporting Toulon Var","AJ Auxerre","1-1",1,1,"1",1,2,0,"D"
1987-04-11,1986,"Stade Rennes","AS Monaco","0-1",0,1,"1",1,1,-1,"D"
1987-04-11,1986,"FC Nantes","RC Lens","1-0",1,0,"1",1,1,1,"H"
1987-04-11,1986,"OGC Nice","Brest Armorique FC","0-4",0,4,"1",1,4,-4,"D"
1987-04-11,1986,"Le Havre AC","Paris Saint-Germain","2-0",2,0,"1",1,2,2,"H"
1987-04-11,1986,"Lille OSC","Stade Laval","2-1",2,1,"1",1,3,1,"H"
1987-04-11,1986,"Matra Racing","AS Saint-Etienne","1-2",1,2,"1",1,3,-1,"D"
1987-04-11,1986,"FC Sochaux","AS Nancy","0-1",0,1,"1",1,1,-1,"D"
1987-04-17,1986,"AS Monaco","Girondins Bordeaux","2-2",2,2,"1",1,4,0,"D"
1987-04-17,1986,"Olympique Marseille","Le Havre AC","1-1",1,1,"1",1,2,0,"D"
1987-04-17,1986,"Toulouse FC","Stade Rennes","4-2",4,2,"1",1,6,2,"H"
1987-04-17,1986,"AJ Auxerre","OGC Nice","2-1",2,1,"1",1,3,1,"H"
1987-04-17,1986,"FC Metz","Matra Racing","0-2",0,2,"1",1,2,-2,"D"
1987-04-17,1986,"Paris Saint-Germain","FC Sochaux","2-0",2,0,"1",1,2,2,"H"
1987-04-17,1986,"Stade Laval","FC Nantes","1-1",1,1,"1",1,2,0,"D"
1987-04-17,1986,"Brest Armorique FC","Sporting Toulon Var","1-1",1,1,"1",1,2,0,"D"
1987-04-17,1986,"RC Lens","AS Nancy","0-0",0,0,"1",1,0,0,"D"
1987-04-17,1986,"AS Saint-Etienne","Lille OSC","1-0",1,0,"1",1,1,1,"H"
1987-05-01,1986,"AS Nancy","Paris Saint-Germain","0-0",0,0,"1",1,0,0,"D"
1987-05-02,1986,"FC Nantes","Olympique Marseille","0-2",0,2,"1",1,2,-2,"D"
1987-05-02,1986,"Girondins Bordeaux","Toulouse FC","2-3",2,3,"1",1,5,-1,"D"
1987-05-02,1986,"FC Sochaux","AS Monaco","2-1",2,1,"1",1,3,1,"H"
1987-05-02,1986,"OGC Nice","FC Metz","3-1",3,1,"1",1,4,2,"H"
1987-05-02,1986,"Stade Rennes","Stade Laval","1-2",1,2,"1",1,3,-1,"D"
1987-05-02,1986,"Lille OSC","Brest Armorique FC","2-1",2,1,"1",1,3,1,"H"
1987-05-02,1986,"Le Havre AC","RC Lens","0-0",0,0,"1",1,0,0,"D"
1987-05-02,1986,"Sporting Toulon Var","AS Saint-Etienne","2-1",2,1,"1",1,3,1,"H"
1987-05-03,1986,"Matra Racing","AJ Auxerre","3-0",3,0,"1",1,3,3,"H"
1987-05-09,1986,"Olympique Marseille","AS Nancy","3-2",3,2,"1",1,5,1,"H"
1987-05-09,1986,"Stade Laval","Girondins Bordeaux","1-2",1,2,"1",1,3,-1,"D"
1987-05-09,1986,"Toulouse FC","Paris Saint-Germain","1-1",1,1,"1",1,2,0,"D"
1987-05-09,1986,"AJ Auxerre","Stade Rennes","1-0",1,0,"1",1,1,1,"H"
1987-05-09,1986,"AS Monaco","Le Havre AC","2-1",2,1,"1",1,3,1,"H"
1987-05-09,1986,"FC Metz","Sporting Toulon Var","4-0",4,0,"1",1,4,4,"H"
1987-05-09,1986,"Brest Armorique FC","FC Nantes","2-1",2,1,"1",1,3,1,"H"
1987-05-09,1986,"RC Lens","FC Sochaux","0-0",0,0,"1",1,0,0,"D"
1987-05-09,1986,"AS Saint-Etienne","OGC Nice","1-0",1,0,"1",1,1,1,"H"
1987-05-09,1986,"Matra Racing","Lille OSC","1-0",1,0,"1",1,1,1,"H"
1987-05-15,1986,"Girondins Bordeaux","AJ Auxerre","2-0",2,0,"1",1,2,2,"H"
1987-05-15,1986,"OGC Nice","Olympique Marseille","2-1",2,1,"1",1,3,1,"H"
1987-05-15,1986,"Le Havre AC","Toulouse FC","1-1",1,1,"1",1,2,0,"D"
1987-05-15,1986,"AS Nancy","AS Monaco","1-1",1,1,"1",1,2,0,"D"
1987-05-15,1986,"Paris Saint-Germain","RC Lens","3-1",3,1,"1",1,4,2,"H"
1987-05-15,1986,"Lille OSC","FC Metz","3-0",3,0,"1",1,3,3,"H"
1987-05-15,1986,"Stade Rennes","Brest Armorique FC","0-2",0,2,"1",1,2,-2,"D"
1987-05-15,1986,"FC Nantes","AS Saint-Etienne","1-1",1,1,"1",1,2,0,"D"
1987-05-15,1986,"FC Sochaux","Stade Laval","4-0",4,0,"1",1,4,4,"H"
1987-05-15,1986,"Sporting Toulon Var","Matra Racing","1-0",1,0,"1",1,1,1,"H"
1987-05-22,1986,"Brest Armorique FC","Girondins Bordeaux","1-1",1,1,"1",1,2,0,"D"
1987-05-22,1986,"Olympique Marseille","RC Lens","1-3",1,3,"1",1,4,-2,"D"
1987-05-22,1986,"Toulouse FC","AS Nancy","2-1",2,1,"1",1,3,1,"H"
1987-05-22,1986,"AJ Auxerre","FC Sochaux","0-0",0,0,"1",1,0,0,"D"
1987-05-22,1986,"AS Monaco","Paris Saint-Germain","1-1",1,1,"1",1,2,0,"D"
1987-05-22,1986,"FC Metz","FC Nantes","3-1",3,1,"1",1,4,2,"H"
1987-05-22,1986,"Matra Racing","OGC Nice","3-1",3,1,"1",1,4,2,"H"
1987-05-22,1986,"Lille OSC","Sporting Toulon Var","1-1",1,1,"1",1,2,0,"D"
1987-05-22,1986,"AS Saint-Etienne","Stade Rennes","2-0",2,0,"1",1,2,2,"H"
1987-05-23,1986,"Stade Laval","Le Havre AC","2-1",2,1,"1",1,3,1,"H"
1987-05-29,1986,"Girondins Bordeaux","AS Saint-Etienne","1-0",1,0,"1",1,1,1,"H"
1987-05-29,1986,"Paris Saint-Germain","Olympique Marseille","2-0",2,0,"1",1,2,2,"H"
1987-05-29,1986,"Sporting Toulon Var","Toulouse FC","3-2",3,2,"1",1,5,1,"H"
1987-05-29,1986,"Le Havre AC","AJ Auxerre","1-4",1,4,"1",1,5,-3,"D"
1987-05-29,1986,"RC Lens","AS Monaco","1-1",1,1,"1",1,2,0,"D"
1987-05-29,1986,"Stade Rennes","FC Metz","0-1",0,1,"1",1,1,-1,"D"
1987-05-29,1986,"FC Sochaux","Brest Armorique FC","3-0",3,0,"1",1,3,3,"H"
1987-05-29,1986,"OGC Nice","Lille OSC","1-0",1,0,"1",1,1,1,"H"
1987-05-29,1986,"AS Nancy","Stade Laval","3-0",3,0,"1",1,3,3,"H"
1987-05-29,1986,"FC Nantes","Matra Racing","2-3",2,3,"1",1,5,-1,"D"
1987-06-05,1986,"FC Metz","Girondins Bordeaux","2-1",2,1,"1",1,3,1,"H"
1987-06-05,1986,"AS Monaco","Olympique Marseille","2-0",2,0,"1",1,2,2,"H"
1987-06-05,1986,"Toulouse FC","RC Lens","1-0",1,0,"1",1,1,1,"H"
1987-06-05,1986,"AJ Auxerre","AS Nancy","4-2",4,2,"1",1,6,2,"H"
1987-06-05,1986,"Stade Laval","Paris Saint-Germain","4-3",4,3,"1",1,7,1,"H"
1987-06-05,1986,"Brest Armorique FC","Le Havre AC","2-0",2,0,"1",1,2,2,"H"
1987-06-05,1986,"Sporting Toulon Var","OGC Nice","2-0",2,0,"1",1,2,2,"H"
1987-06-05,1986,"Lille OSC","FC Nantes","0-1",0,1,"1",1,1,-1,"D"
1987-06-05,1986,"Matra Racing","Stade Rennes","2-1",2,1,"1",1,3,1,"H"
1987-06-05,1986,"AS Saint-Etienne","FC Sochaux","1-1",1,1,"1",1,2,0,"D"
1987-07-18,1987,"Stade Laval","AS Saint-Etienne","4-0",4,0,"1",1,4,4,"H"
1987-07-18,1987,"Sporting Toulon Var","OGC Nice","4-1",4,1,"1",1,5,3,"H"
1987-07-18,1987,"Lille OSC","FC Nantes","3-0",3,0,"1",1,3,3,"H"
1987-07-18,1987,"Toulouse FC","Montpellier La Paillade SC","3-1",3,1,"1",1,4,2,"H"
1987-07-18,1987,"AS Monaco","Olympique Marseille","3-1",3,1,"1",1,4,2,"H"
1987-07-18,1987,"Paris Saint-Germain","Le Havre AC","2-0",2,0,"1",1,2,2,"H"
1987-07-18,1987,"Girondins Bordeaux","FC Metz","3-2",3,2,"1",1,5,1,"H"
1987-07-18,1987,"Chamois Niortais","RC Lens","1-1",1,1,"1",1,2,0,"D"
1987-07-18,1987,"AS Cannes","AJ Auxerre","0-0",0,0,"1",1,0,0,"D"
1987-07-18,1987,"Brest Armorique FC","Matra Racing","0-0",0,0,"1",1,0,0,"D"
1987-07-25,1987,"RC Lens","AS Monaco","1-3",1,3,"1",1,4,-2,"D"
1987-07-25,1987,"AJ Auxerre","Girondins Bordeaux","1-3",1,3,"1",1,4,-2,"D"
1987-07-25,1987,"Toulouse FC","Stade Laval","1-0",1,0,"1",1,1,1,"H"
1987-07-25,1987,"OGC Nice","Lille OSC","2-1",2,1,"1",1,3,1,"H"
1987-07-25,1987,"Montpellier La Paillade SC","Paris Saint-Germain","4-1",4,1,"1",1,5,3,"H"
1987-07-25,1987,"FC Metz","Sporting Toulon Var","2-0",2,0,"1",1,2,2,"H"
1987-07-25,1987,"Olympique Marseille","AS Cannes","3-0",3,0,"1",1,3,3,"H"
1987-07-25,1987,"Le Havre AC","Chamois Niortais","3-0",3,0,"1",1,3,3,"H"
1987-07-25,1987,"Matra Racing","AS Saint-Etienne","2-2",2,2,"1",1,4,0,"D"
1987-07-25,1987,"FC Nantes","Brest Armorique FC","1-0",1,0,"1",1,1,1,"H"
1987-08-01,1987,"AS Monaco","Le Havre AC","2-0",2,0,"1",1,2,2,"H"
1987-08-01,1987,"Girondins Bordeaux","Olympique Marseille","2-0",2,0,"1",1,2,2,"H"
1987-08-01,1987,"Lille OSC","FC Metz","1-0",1,0,"1",1,1,1,"H"
1987-08-01,1987,"Paris Saint-Germain","Toulouse FC","2-0",2,0,"1",1,2,2,"H"
1987-08-01,1987,"Brest Armorique FC","OGC Nice","0-1",0,1,"1",1,1,-1,"D"
1987-08-01,1987,"Stade Laval","Matra Racing","1-1",1,1,"1",1,2,0,"D"
1987-08-01,1987,"Sporting Toulon Var","AJ Auxerre","0-0",0,0,"1",1,0,0,"D"
1987-08-01,1987,"AS Saint-Etienne","FC Nantes","1-1",1,1,"1",1,2,0,"D"
1987-08-01,1987,"Chamois Niortais","Montpellier La Paillade SC","1-0",1,0,"1",1,1,1,"H"
1987-08-01,1987,"AS Cannes","RC Lens","2-1",2,1,"1",1,3,1,"H"
1987-08-08,1987,"Montpellier La Paillade SC","AS Monaco","2-1",2,1,"1",1,3,1,"H"
1987-08-08,1987,"RC Lens","Girondins Bordeaux","1-0",1,0,"1",1,1,1,"H"
1987-08-08,1987,"Toulouse FC","Chamois Niortais","1-0",1,0,"1",1,1,1,"H"
1987-08-08,1987,"Paris Saint-Germain","Brest Armorique FC","0-0",0,0,"1",1,0,0,"D"
1987-08-08,1987,"AJ Auxerre","Lille OSC","2-1",2,1,"1",1,3,1,"H"
1987-08-08,1987,"FC Metz","Stade Laval","2-1",2,1,"1",1,3,1,"H"
1987-08-08,1987,"Olympique Marseille","Sporting Toulon Var","1-1",1,1,"1",1,2,0,"D"
1987-08-08,1987,"FC Nantes","Matra Racing","1-1",1,1,"1",1,2,0,"D"
1987-08-08,1987,"OGC Nice","AS Saint-Etienne","2-3",2,3,"1",1,5,-1,"D"
1987-08-08,1987,"Le Havre AC","AS Cannes","2-2",2,2,"1",1,4,0,"D"
1987-08-15,1987,"AS Monaco","Toulouse FC","5-1",5,1,"1",1,6,4,"H"
1987-08-15,1987,"Girondins Bordeaux","Le Havre AC","2-2",2,2,"1",1,4,0,"D"
1987-08-15,1987,"Chamois Niortais","Paris Saint-Germain","1-2",1,2,"1",1,3,-1,"D"
1987-08-15,1987,"Sporting Toulon Var","RC Lens","2-0",2,0,"1",1,2,2,"H"
1987-08-15,1987,"Matra Racing","OGC Nice","2-1",2,1,"1",1,3,1,"H"
1987-08-15,1987,"AS Saint-Etienne","FC Metz","2-0",2,0,"1",1,2,2,"H"
1987-08-15,1987,"Lille OSC","Olympique Marseille","1-1",1,1,"1",1,2,0,"D"
1987-08-15,1987,"AS Cannes","Montpellier La Paillade SC","0-0",0,0,"1",1,0,0,"D"
1987-08-15,1987,"Brest Armorique FC","AJ Auxerre","1-1",1,1,"1",1,2,0,"D"
1987-08-15,1987,"Stade Laval","FC Nantes","1-1",1,1,"1",1,2,0,"D"
1987-08-19,1987,"Paris Saint-Germain","AS Monaco","0-1",0,1,"1",1,1,-1,"D"
1987-08-19,1987,"Montpellier La Paillade SC","Girondins Bordeaux","0-0",0,0,"1",1,0,0,"D"
1987-08-19,1987,"Le Havre AC","Sporting Toulon Var","1-1",1,1,"1",1,2,0,"D"
1987-08-19,1987,"FC Metz","Matra Racing","0-0",0,0,"1",1,0,0,"D"
1987-08-19,1987,"Toulouse FC","AS Cannes","0-1",0,1,"1",1,1,-1,"D"
1987-08-19,1987,"RC Lens","Lille OSC","1-1",1,1,"1",1,2,0,"D"
1987-08-19,1987,"Olympique Marseille","Brest Armorique FC","1-0",1,0,"1",1,1,1,"H"
1987-08-19,1987,"OGC Nice","FC Nantes","3-1",3,1,"1",1,4,2,"H"
1987-08-19,1987,"AJ Auxerre","Stade Laval","1-1",1,1,"1",1,2,0,"D"
1987-08-19,1987,"Chamois Niortais","AS Saint-Etienne","2-1",2,1,"1",1,3,1,"H"
1987-08-22,1987,"AS Monaco","Chamois Niortais","1-3",1,3,"1",1,4,-2,"D"
1987-08-22,1987,"Girondins Bordeaux","Toulouse FC","2-2",2,2,"1",1,4,0,"D"
1987-08-22,1987,"AS Cannes","Paris Saint-Germain","1-3",1,3,"1",1,4,-2,"D"
1987-08-22,1987,"Sporting Toulon Var","Montpellier La Paillade SC","0-0",0,0,"1",1,0,0,"D"
1987-08-22,1987,"Matra Racing","Olympique Marseille","0-0",0,0,"1",1,0,0,"D"
1987-08-22,1987,"Stade Laval","OGC Nice","1-2",1,2,"1",1,3,-1,"D"
1987-08-22,1987,"AS Saint-Etienne","AJ Auxerre","2-1",2,1,"1",1,3,1,"H"
1987-08-22,1987,"Lille OSC","Le Havre AC","0-0",0,0,"1",1,0,0,"D"
1987-08-22,1987,"FC Nantes","FC Metz","0-0",0,0,"1",1,0,0,"D"
1987-08-22,1987,"Brest Armorique FC","RC Lens","4-1",4,1,"1",1,5,3,"H"
1987-08-29,1987,"AS Monaco","Stade Laval","2-0",2,0,"1",1,2,2,"H"
1987-08-29,1987,"Paris Saint-Germain","Girondins Bordeaux","1-0",1,0,"1",1,1,1,"H"
1987-08-29,1987,"Olympique Marseille","AS Saint-Etienne","5-1",5,1,"1",1,6,4,"H"
1987-08-29,1987,"Montpellier La Paillade SC","Lille OSC","3-1",3,1,"1",1,4,2,"H"
1987-08-29,1987,"Chamois Niortais","AS Cannes","2-0",2,0,"1",1,2,2,"H"
1987-08-29,1987,"Toulouse FC","Sporting Toulon Var","1-0",1,0,"1",1,1,1,"H"
1987-08-29,1987,"FC Metz","OGC Nice","2-0",2,0,"1",1,2,2,"H"
1987-08-29,1987,"Le Havre AC","Brest Armorique FC","3-2",3,2,"1",1,5,1,"H"
1987-08-29,1987,"RC Lens","Matra Racing","2-1",2,1,"1",1,3,1,"H"
1987-08-29,1987,"AJ Auxerre","FC Nantes","1-0",1,0,"1",1,1,1,"H"
1987-09-01,1987,"FC Nantes","Olympique Marseille","5-0",5,0,"1",1,5,5,"H"
1987-09-02,1987,"AS Cannes","AS Monaco","1-1",1,1,"1",1,2,0,"D"
1987-09-02,1987,"Girondins Bordeaux","Chamois Niortais","1-0",1,0,"1",1,1,1,"H"
1987-09-02,1987,"Sporting Toulon Var","Paris Saint-Germain","1-0",1,0,"1",1,1,1,"H"
1987-09-02,1987,"Matra Racing","Le Havre AC","2-0",2,0,"1",1,2,2,"H"
1987-09-02,1987,"OGC Nice","AJ Auxerre","1-0",1,0,"1",1,1,1,"H"
1987-09-02,1987,"AS Saint-Etienne","RC Lens","2-1",2,1,"1",1,3,1,"H"
1987-09-02,1987,"Lille OSC","Toulouse FC","2-0",2,0,"1",1,2,2,"H"
1987-09-02,1987,"Stade Laval","Montpellier La Paillade SC","1-0",1,0,"1",1,1,1,"H"
1987-09-02,1987,"Brest Armorique FC","FC Metz","1-0",1,0,"1",1,1,1,"H"
1987-09-12,1987,"AS Monaco","Girondins Bordeaux","1-0",1,0,"1",1,1,1,"H"
1987-09-12,1987,"Montpellier La Paillade SC","Matra Racing","6-1",6,1,"1",1,7,5,"H"
1987-09-12,1987,"Paris Saint-Germain","Lille OSC","1-3",1,3,"1",1,4,-2,"D"
1987-09-12,1987,"Olympique Marseille","OGC Nice","2-0",2,0,"1",1,2,2,"H"
1987-09-12,1987,"Chamois Niortais","Sporting Toulon Var","2-1",2,1,"1",1,3,1,"H"
1987-09-12,1987,"Toulouse FC","Brest Armorique FC","2-1",2,1,"1",1,3,1,"H"
1987-09-12,1987,"Le Havre AC","AS Saint-Etienne","1-1",1,1,"1",1,2,0,"D"
1987-09-12,1987,"RC Lens","FC Nantes","1-2",1,2,"1",1,3,-1,"D"
1987-09-12,1987,"AJ Auxerre","FC Metz","0-1",0,1,"1",1,1,-1,"D"
1987-09-12,1987,"AS Cannes","Stade Laval","1-0",1,0,"1",1,1,1,"H"
1987-09-19,1987,"Sporting Toulon Var","AS Monaco","0-0",0,0,"1",1,0,0,"D"
1987-09-19,1987,"Lille OSC","Chamois Niortais","0-1",0,1,"1",1,1,-1,"D"
1987-09-19,1987,"AS Saint-Etienne","Toulouse FC","2-0",2,0,"1",1,2,2,"H"
1987-09-19,1987,"Girondins Bordeaux","AS Cannes","3-3",3,3,"1",1,6,0,"D"
1987-09-19,1987,"FC Nantes","Le Havre AC","2-0",2,0,"1",1,2,2,"H"
1987-09-19,1987,"FC Metz","Olympique Marseille","3-1",3,1,"1",1,4,2,"H"
1987-09-19,1987,"Brest Armorique FC","Montpellier La Paillade SC","4-0",4,0,"1",1,4,4,"H"
1987-09-19,1987,"Stade Laval","Paris Saint-Germain","2-0",2,0,"1",1,2,2,"H"
1987-09-19,1987,"OGC Nice","RC Lens","0-1",0,1,"1",1,1,-1,"D"
1987-09-20,1987,"Matra Racing","AJ Auxerre","1-0",1,0,"1",1,1,1,"H"
1987-09-26,1987,"AS Monaco","Lille OSC","1-0",1,0,"1",1,1,1,"H"
1987-09-26,1987,"Chamois Niortais","Brest Armorique FC","3-0",3,0,"1",1,3,3,"H"
1987-09-26,1987,"Girondins Bordeaux","Stade Laval","1-0",1,0,"1",1,1,1,"H"
1987-09-26,1987,"Montpellier La Paillade SC","FC Nantes","0-0",0,0,"1",1,0,0,"D"
1987-09-26,1987,"Paris Saint-Germain","AS Saint-Etienne","3-0",3,0,"1",1,3,3,"H"
1987-09-26,1987,"Toulouse FC","Matra Racing","0-0",0,0,"1",1,0,0,"D"
1987-09-26,1987,"AS Cannes","Sporting Toulon Var","1-0",1,0,"1",1,1,1,"H"
1987-09-26,1987,"RC Lens","FC Metz","2-0",2,0,"1",1,2,2,"H"
1987-09-26,1987,"Olympique Marseille","AJ Auxerre","0-1",0,1,"1",1,1,-1,"D"
1987-09-26,1987,"Le Havre AC","OGC Nice","2-1",2,1,"1",1,3,1,"H"
1987-10-02,1987,"Matra Racing","Paris Saint-Germain","2-1",2,1,"1",1,3,1,"H"
1987-10-03,1987,"Brest Armorique FC","AS Monaco","0-2",0,2,"1",1,2,-2,"D"
1987-10-03,1987,"Sporting Toulon Var","Girondins Bordeaux","0-1",0,1,"1",1,1,-1,"D"
1987-10-03,1987,"FC Nantes","Toulouse FC","3-1",3,1,"1",1,4,2,"H"
1987-10-03,1987,"OGC Nice","Chamois Niortais","1-0",1,0,"1",1,1,1,"H"
1987-10-03,1987,"AS Saint-Etienne","Montpellier La Paillade SC","2-1",2,1,"1",1,3,1,"H"
1987-10-03,1987,"FC Metz","Le Havre AC","1-0",1,0,"1",1,1,1,"H"
1987-10-03,1987,"Lille OSC","AS Cannes","0-0",0,0,"1",1,0,0,"D"
1987-10-03,1987,"Stade Laval","Olympique Marseille","0-2",0,2,"1",1,2,-2,"D"
1987-10-03,1987,"AJ Auxerre","RC Lens","2-0",2,0,"1",1,2,2,"H"
1987-10-06,1987,"Montpellier La Paillade SC","FC Metz","1-0",1,0,"1",1,1,1,"H"
1987-10-07,1987,"AS Monaco","AS Saint-Etienne","2-1",2,1,"1",1,3,1,"H"
1987-10-07,1987,"Girondins Bordeaux","Lille OSC","1-0",1,0,"1",1,1,1,"H"
1987-10-07,1987,"Paris Saint-Germain","FC Nantes","0-2",0,2,"1",1,2,-2,"D"
1987-10-07,1987,"Chamois Niortais","Matra Racing","2-2",2,2,"1",1,4,0,"D"
1987-10-07,1987,"AS Cannes","Brest Armorique FC","2-1",2,1,"1",1,3,1,"H"
1987-10-07,1987,"RC Lens","Olympique Marseille","2-4",2,4,"1",1,6,-2,"D"
1987-10-07,1987,"Le Havre AC","AJ Auxerre","1-2",1,2,"1",1,3,-1,"D"
1987-10-07,1987,"Toulouse FC","OGC Nice","2-0",2,0,"1",1,2,2,"H"
1987-10-07,1987,"Sporting Toulon Var","Stade Laval","3-0",3,0,"1",1,3,3,"H"
1987-10-17,1987,"Matra Racing","AS Monaco","1-0",1,0,"1",1,1,1,"H"
1987-10-17,1987,"FC Nantes","Chamois Niortais","2-1",2,1,"1",1,3,1,"H"
1987-10-17,1987,"Brest Armorique FC","Girondins Bordeaux","1-1",1,1,"1",1,2,0,"D"
1987-10-17,1987,"Olympique Marseille","Le Havre AC","3-1",3,1,"1",1,4,2,"H"
1987-10-17,1987,"AS Saint-Etienne","AS Cannes","1-0",1,0,"1",1,1,1,"H"
1987-10-17,1987,"FC Metz","Toulouse FC","4-1",4,1,"1",1,5,3,"H"
1987-10-17,1987,"AJ Auxerre","Montpellier La Paillade SC","1-1",1,1,"1",1,2,0,"D"
1987-10-17,1987,"Lille OSC","Sporting Toulon Var","1-0",1,0,"1",1,1,1,"H"
1987-10-17,1987,"OGC Nice","Paris Saint-Germain","2-0",2,0,"1",1,2,2,"H"
1987-10-17,1987,"Stade Laval","RC Lens","4-0",4,0,"1",1,4,4,"H"
1987-10-24,1987,"AS Monaco","FC Nantes","2-1",2,1,"1",1,3,1,"H"
1987-10-24,1987,"Girondins Bordeaux","AS Saint-Etienne","1-0",1,0,"1",1,1,1,"H"
1987-10-24,1987,"Paris Saint-Germain","FC Metz","0-2",0,2,"1",1,2,-2,"D"
1987-10-24,1987,"Chamois Niortais","Olympique Marseille","1-0",1,0,"1",1,1,1,"H"
1987-10-24,1987,"AS Cannes","Matra Racing","3-1",3,1,"1",1,4,2,"H"
1987-10-24,1987,"Montpellier La Paillade SC","OGC Nice","4-1",4,1,"1",1,5,3,"H"
1987-10-24,1987,"Toulouse FC","AJ Auxerre","0-0",0,0,"1",1,0,0,"D"
1987-10-24,1987,"Sporting Toulon Var","Brest Armorique FC","3-0",3,0,"1",1,3,3,"H"
1987-10-24,1987,"Lille OSC","Stade Laval","0-0",0,0,"1",1,0,0,"D"
1987-10-24,1987,"Le Havre AC","RC Lens","0-1",0,1,"1",1,1,-1,"D"
1987-10-31,1987,"OGC Nice","AS Monaco","0-0",0,0,"1",1,0,0,"D"
1987-11-01,1987,"FC Nantes","AS Cannes","2-1",2,1,"1",1,3,1,"H"
1987-11-01,1987,"Matra Racing","Girondins Bordeaux","1-0",1,0,"1",1,1,1,"H"
1987-11-01,1987,"FC Metz","Chamois Niortais","2-0",2,0,"1",1,2,2,"H"
1987-11-01,1987,"Olympique Marseille","Toulouse FC","1-0",1,0,"1",1,1,1,"H"
1987-11-01,1987,"AJ Auxerre","Paris Saint-Germain","3-0",3,0,"1",1,3,3,"H"
1987-11-01,1987,"AS Saint-Etienne","Sporting Toulon Var","0-0",0,0,"1",1,0,0,"D"
1987-11-01,1987,"RC Lens","Montpellier La Paillade SC","2-1",2,1,"1",1,3,1,"H"
1987-11-01,1987,"Brest Armorique FC","Lille OSC","2-2",2,2,"1",1,4,0,"D"
1987-11-01,1987,"Stade Laval","Le Havre AC","4-3",4,3,"1",1,7,1,"H"
1987-11-07,1987,"AS Monaco","FC Metz","2-1",2,1,"1",1,3,1,"H"
1987-11-07,1987,"Girondins Bordeaux","FC Nantes","2-1",2,1,"1",1,3,1,"H"
1987-11-07,1987,"Lille OSC","AS Saint-Etienne","1-2",1,2,"1",1,3,-1,"D"
1987-11-07,1987,"Montpellier La Paillade SC","Le Havre AC","3-1",3,1,"1",1,4,2,"H"
1987-11-07,1987,"Chamois Niortais","AJ Auxerre","0-0",0,0,"1",1,0,0,"D"
1987-11-07,1987,"AS Cannes","OGC Nice","0-1",0,1,"1",1,1,-1,"D"
1987-11-07,1987,"Toulouse FC","RC Lens","0-1",0,1,"1",1,1,-1,"D"
1987-11-08,1987,"Paris Saint-Germain","Olympique Marseille","1-1",1,1,"1",1,2,0,"D"
1987-11-10,1987,"Matra Racing","Lille OSC","3-0",3,0,"1",1,3,3,"H"
1987-11-11,1987,"AJ Auxerre","AS Monaco","0-0",0,0,"1",1,0,0,"D"
1987-11-11,1987,"OGC Nice","Girondins Bordeaux","0-1",0,1,"1",1,1,-1,"D"
1987-11-11,1987,"FC Nantes","Sporting Toulon Var","1-1",1,1,"1",1,2,0,"D"
1987-11-11,1987,"AS Saint-Etienne","Brest Armorique FC","4-0",4,0,"1",1,4,4,"H"
1987-11-11,1987,"Olympique Marseille","Montpellier La Paillade SC","1-1",1,1,"1",1,2,0,"D"
1987-11-11,1987,"FC Metz","AS Cannes","2-3",2,3,"1",1,5,-1,"D"
1987-11-11,1987,"Stade Laval","Chamois Niortais","2-0",2,0,"1",1,2,2,"H"
1987-11-11,1987,"Le Havre AC","Toulouse FC","0-1",0,1,"1",1,1,-1,"D"
1987-11-11,1987,"RC Lens","Paris Saint-Germain","0-0",0,0,"1",1,0,0,"D"
1987-11-21,1987,"AS Monaco","RC Lens","3-0",3,0,"1",1,3,3,"H"
1987-11-21,1987,"Girondins Bordeaux","AJ Auxerre","0-0",0,0,"1",1,0,0,"D"
1987-11-21,1987,"AS Saint-Etienne","Matra Racing","0-2",0,2,"1",1,2,-2,"D"
1987-11-21,1987,"Brest Armorique FC","FC Nantes","0-0",0,0,"1",1,0,0,"D"
1987-11-21,1987,"AS Cannes","Olympique Marseille","1-0",1,0,"1",1,1,1,"H"
1987-11-21,1987,"Paris Saint-Germain","Montpellier La Paillade SC","2-1",2,1,"1",1,3,1,"H"
1987-11-21,1987,"Sporting Toulon Var","FC Metz","1-0",1,0,"1",1,1,1,"H"
1987-11-21,1987,"Chamois Niortais","Le Havre AC","1-2",1,2,"1",1,3,-1,"D"
1987-11-21,1987,"Stade Laval","Toulouse FC","1-0",1,0,"1",1,1,1,"H"
1987-11-21,1987,"Lille OSC","OGC Nice","1-0",1,0,"1",1,1,1,"H"
1987-11-27,1987,"Olympique Marseille","Girondins Bordeaux","1-0",1,0,"1",1,1,1,"H"
1987-11-28,1987,"Le Havre AC","AS Monaco","0-0",0,0,"1",1,0,0,"D"
1987-11-28,1987,"Matra Racing","Stade Laval","1-0",1,0,"1",1,1,1,"H"
1987-11-28,1987,"FC Nantes","AS Saint-Etienne","2-3",2,3,"1",1,5,-1,"D"
1987-11-28,1987,"RC Lens","AS Cannes","0-0",0,0,"1",1,0,0,"D"
1987-11-28,1987,"Montpellier La Paillade SC","Chamois Niortais","1-0",1,0,"1",1,1,1,"H"
1987-11-28,1987,"FC Metz","Lille OSC","3-1",3,1,"1",1,4,2,"H"
1987-11-28,1987,"AJ Auxerre","Sporting Toulon Var","0-0",0,0,"1",1,0,0,"D"
1987-11-28,1987,"OGC Nice","Brest Armorique FC","2-0",2,0,"1",1,2,2,"H"
1987-11-28,1987,"Toulouse FC","Paris Saint-Germain","2-1",2,1,"1",1,3,1,"H"
1987-12-02,1987,"Brest Armorique FC","Stade Laval","2-1",2,1,"1",1,3,1,"H"
1987-12-02,1987,"Sporting Toulon Var","Matra Racing","0-0",0,0,"1",1,0,0,"D"
1987-12-05,1987,"AS Monaco","Montpellier La Paillade SC","0-0",0,0,"1",1,0,0,"D"
1987-12-05,1987,"Girondins Bordeaux","RC Lens","5-2",5,2,"1",1,7,3,"H"
1987-12-05,1987,"Matra Racing","FC Nantes","2-2",2,2,"1",1,4,0,"D"
1987-12-05,1987,"AS Saint-Etienne","OGC Nice","3-2",3,2,"1",1,5,1,"H"
1987-12-05,1987,"Sporting Toulon Var","Olympique Marseille","1-2",1,2,"1",1,3,-1,"D"
1987-12-05,1987,"AS Cannes","Le Havre AC","3-0",3,0,"1",1,3,3,"H"
1987-12-05,1987,"Lille OSC","AJ Auxerre","0-1",0,1,"1",1,1,-1,"D"
1987-12-05,1987,"Stade Laval","FC Metz","3-0",3,0,"1",1,3,3,"H"
1987-12-05,1987,"Chamois Niortais","Toulouse FC","0-0",0,0,"1",1,0,0,"D"
1987-12-05,1987,"Brest Armorique FC","Paris Saint-Germain","0-0",0,0,"1",1,0,0,"D"
1987-12-12,1987,"Toulouse FC","AS Monaco","1-1",1,1,"1",1,2,0,"D"
1987-12-12,1987,"Le Havre AC","Girondins Bordeaux","0-1",0,1,"1",1,1,-1,"D"
1987-12-12,1987,"OGC Nice","Matra Racing","1-2",1,2,"1",1,3,-1,"D"
1987-12-12,1987,"AJ Auxerre","Brest Armorique FC","4-0",4,0,"1",1,4,4,"H"
1987-12-12,1987,"FC Metz","AS Saint-Etienne","2-1",2,1,"1",1,3,1,"H"
1987-12-12,1987,"Montpellier La Paillade SC","AS Cannes","4-2",4,2,"1",1,6,2,"H"
1987-12-12,1987,"Olympique Marseille","Lille OSC","0-1",0,1,"1",1,1,-1,"D"
1987-12-12,1987,"FC Nantes","Stade Laval","1-2",1,2,"1",1,3,-1,"D"
1987-12-12,1987,"Paris Saint-Germain","Chamois Niortais","1-3",1,3,"1",1,4,-2,"D"
1987-12-12,1987,"RC Lens","Sporting Toulon Var","3-1",3,1,"1",1,4,2,"H"
1987-12-18,1987,"AS Monaco","Paris Saint-Germain","2-1",2,1,"1",1,3,1,"H"
1987-12-19,1987,"Girondins Bordeaux","Montpellier La Paillade SC","1-0",1,0,"1",1,1,1,"H"
1987-12-19,1987,"Matra Racing","FC Metz","2-0",2,0,"1",1,2,2,"H"
1987-12-19,1987,"AS Saint-Etienne","Chamois Niortais","2-0",2,0,"1",1,2,2,"H"
1987-12-19,1987,"Stade Laval","AJ Auxerre","0-0",0,0,"1",1,0,0,"D"
1987-12-19,1987,"AS Cannes","Toulouse FC","1-1",1,1,"1",1,2,0,"D"
1987-12-19,1987,"Brest Armorique FC","Olympique Marseille","2-1",2,1,"1",1,3,1,"H"
1987-12-19,1987,"FC Nantes","OGC Nice","0-1",0,1,"1",1,1,-1,"D"
1987-12-19,1987,"Sporting Toulon Var","Le Havre AC","3-0",3,0,"1",1,3,3,"H"
1987-12-19,1987,"Lille OSC","RC Lens","1-1",1,1,"1",1,2,0,"D"
1988-02-19,1987,"Olympique Marseille","Matra Racing","2-0",2,0,"1",1,2,2,"H"
1988-02-20,1987,"Chamois Niortais","AS Monaco","0-0",0,0,"1",1,0,0,"D"
1988-02-20,1987,"Toulouse FC","Girondins Bordeaux","2-1",2,1,"1",1,3,1,"H"
1988-02-20,1987,"AJ Auxerre","AS Saint-Etienne","0-1",0,1,"1",1,1,-1,"D"
1988-02-20,1987,"FC Metz","FC Nantes","1-0",1,0,"1",1,1,1,"H"
1988-02-20,1987,"Montpellier La Paillade SC","Sporting Toulon Var","0-1",0,1,"1",1,1,-1,"D"
1988-02-20,1987,"OGC Nice","Stade Laval","0-1",0,1,"1",1,1,-1,"D"
1988-02-20,1987,"RC Lens","Brest Armorique FC","2-1",2,1,"1",1,3,1,"H"
1988-02-20,1987,"Le Havre AC","Lille OSC","0-0",0,0,"1",1,0,0,"D"
1988-02-23,1987,"Paris Saint-Germain","AS Cannes","1-1",1,1,"1",1,2,0,"D"
1988-02-26,1987,"Stade Laval","AS Monaco","0-0",0,0,"1",1,0,0,"D"
1988-02-27,1987,"Girondins Bordeaux","Paris Saint-Germain","0-0",0,0,"1",1,0,0,"D"
1988-02-27,1987,"FC Nantes","AJ Auxerre","0-0",0,0,"1",1,0,0,"D"
1988-02-27,1987,"OGC Nice","FC Metz","0-0",0,0,"1",1,0,0,"D"
1988-02-27,1987,"Matra Racing","RC Lens","1-0",1,0,"1",1,1,1,"H"
1988-02-27,1987,"AS Saint-Etienne","Olympique Marseille","0-1",0,1,"1",1,1,-1,"D"
1988-02-27,1987,"AS Cannes","Chamois Niortais","2-1",2,1,"1",1,3,1,"H"
1988-02-27,1987,"Sporting Toulon Var","Toulouse FC","1-0",1,0,"1",1,1,1,"H"
1988-02-27,1987,"Lille OSC","Montpellier La Paillade SC","3-1",3,1,"1",1,4,2,"H"
1988-02-27,1987,"Brest Armorique FC","Le Havre AC","3-1",3,1,"1",1,4,2,"H"
1988-03-04,1987,"RC Lens","AS Saint-Etienne","1-0",1,0,"1",1,1,1,"H"
1988-03-05,1987,"AS Monaco","AS Cannes","4-1",4,1,"1",1,5,3,"H"
1988-03-05,1987,"Le Havre AC","Matra Racing","1-1",1,1,"1",1,2,0,"D"
1988-03-05,1987,"Chamois Niortais","Girondins Bordeaux","0-0",0,0,"1",1,0,0,"D"
1988-03-05,1987,"Olympique Marseille","FC Nantes","3-0",3,0,"1",1,3,3,"H"
1988-03-05,1987,"AJ Auxerre","OGC Nice","2-0",2,0,"1",1,2,2,"H"
1988-03-05,1987,"FC Metz","Brest Armorique FC","1-1",1,1,"1",1,2,0,"D"
1988-03-05,1987,"Paris Saint-Germain","Sporting Toulon Var","1-0",1,0,"1",1,1,1,"H"
1988-03-05,1987,"Montpellier La Paillade SC","Stade Laval","2-1",2,1,"1",1,3,1,"H"
1988-03-05,1987,"Toulouse FC","Lille OSC","2-1",2,1,"1",1,3,1,"H"
1988-03-19,1987,"Girondins Bordeaux","AS Monaco","3-1",3,1,"1",1,4,2,"H"
1988-03-19,1987,"Matra Racing","Montpellier La Paillade SC","0-2",0,2,"1",1,2,-2,"D"
1988-03-19,1987,"AS Saint-Etienne","Le Havre AC","2-1",2,1,"1",1,3,1,"H"
1988-03-19,1987,"OGC Nice","Olympique Marseille","3-1",3,1,"1",1,4,2,"H"
1988-03-19,1987,"FC Metz","AJ Auxerre","1-0",1,0,"1",1,1,1,"H"
1988-03-19,1987,"Stade Laval","AS Cannes","2-1",2,1,"1",1,3,1,"H"
1988-03-19,1987,"Sporting Toulon Var","Chamois Niortais","1-1",1,1,"1",1,2,0,"D"
1988-03-19,1987,"FC Nantes","RC Lens","2-0",2,0,"1",1,2,2,"H"
1988-03-19,1987,"Lille OSC","Paris Saint-Germain","1-0",1,0,"1",1,1,1,"H"
1988-03-19,1987,"Brest Armorique FC","Toulouse FC","1-0",1,0,"1",1,1,1,"H"
1988-03-26,1987,"AS Monaco","Sporting Toulon Var","0-0",0,0,"1",1,0,0,"D"
1988-03-26,1987,"AS Cannes","Girondins Bordeaux","1-0",1,0,"1",1,1,1,"H"
1988-03-26,1987,"AJ Auxerre","Matra Racing","3-0",3,0,"1",1,3,3,"H"
1988-03-26,1987,"Toulouse FC","AS Saint-Etienne","2-3",2,3,"1",1,5,-1,"D"
1988-03-26,1987,"Olympique Marseille","FC Metz","1-0",1,0,"1",1,1,1,"H"
1988-03-26,1987,"Montpellier La Paillade SC","Brest Armorique FC","6-0",6,0,"1",1,6,6,"H"
1988-03-26,1987,"Paris Saint-Germain","Stade Laval","0-0",0,0,"1",1,0,0,"D"
1988-03-26,1987,"Le Havre AC","FC Nantes","1-0",1,0,"1",1,1,1,"H"
1988-03-26,1987,"Chamois Niortais","Lille OSC","1-0",1,0,"1",1,1,1,"H"
1988-03-26,1987,"RC Lens","OGC Nice","0-1",0,1,"1",1,1,-1,"D"
1988-04-02,1987,"Lille OSC","AS Monaco","0-1",0,1,"1",1,1,-1,"D"
1988-04-02,1987,"Stade Laval","Girondins Bordeaux","0-0",0,0,"1",1,0,0,"D"
1988-04-02,1987,"Matra Racing","Toulouse FC","0-0",0,0,"1",1,0,0,"D"
1988-04-02,1987,"AJ Auxerre","Olympique Marseille","2-0",2,0,"1",1,2,2,"H"
1988-04-02,1987,"AS Saint-Etienne","Paris Saint-Germain","1-3",1,3,"1",1,4,-2,"D"
1988-04-02,1987,"FC Nantes","Montpellier La Paillade SC","0-0",0,0,"1",1,0,0,"D"
1988-04-02,1987,"Sporting Toulon Var","AS Cannes","1-0",1,0,"1",1,1,1,"H"
1988-04-02,1987,"FC Metz","RC Lens","2-2",2,2,"1",1,4,0,"D"
1988-04-02,1987,"Brest Armorique FC","Chamois Niortais","1-0",1,0,"1",1,1,1,"H"
1988-04-02,1987,"OGC Nice","Le Havre AC","1-2",1,2,"1",1,3,-1,"D"
1988-04-08,1987,"Paris Saint-Germain","Matra Racing","1-1",1,1,"1",1,2,0,"D"
1988-04-09,1987,"AS Monaco","Brest Armorique FC","2-0",2,0,"1",1,2,2,"H"
1988-04-09,1987,"Girondins Bordeaux","Sporting Toulon Var","3-0",3,0,"1",1,3,3,"H"
1988-04-09,1987,"Olympique Marseille","Stade Laval","2-1",2,1,"1",1,3,1,"H"
1988-04-09,1987,"Montpellier La Paillade SC","AS Saint-Etienne","5-0",5,0,"1",1,5,5,"H"
1988-04-09,1987,"RC Lens","AJ Auxerre","2-1",2,1,"1",1,3,1,"H"
1988-04-09,1987,"Le Havre AC","FC Metz","1-1",1,1,"1",1,2,0,"D"
1988-04-09,1987,"AS Cannes","Lille OSC","1-5",1,5,"1",1,6,-4,"D"
1988-04-09,1987,"Toulouse FC","FC Nantes","0-1",0,1,"1",1,1,-1,"D"
1988-04-09,1987,"Chamois Niortais","OGC Nice","0-0",0,0,"1",1,0,0,"D"
1988-04-15,1987,"AS Saint-Etienne","AS Monaco","3-0",3,0,"1",1,3,3,"H"
1988-04-16,1987,"Lille OSC","Girondins Bordeaux","1-0",1,0,"1",1,1,1,"H"
1988-04-16,1987,"Matra Racing","Chamois Niortais","1-1",1,1,"1",1,2,0,"D"
1988-04-16,1987,"Olympique Marseille","RC Lens","4-1",4,1,"1",1,5,3,"H"
1988-04-16,1987,"FC Metz","Montpellier La Paillade SC","0-1",0,1,"1",1,1,-1,"D"
1988-04-16,1987,"AJ Auxerre","Le Havre AC","1-1",1,1,"1",1,2,0,"D"
1988-04-16,1987,"Stade Laval","Sporting Toulon Var","0-3",0,3,"1",1,3,-3,"D"
1988-04-16,1987,"FC Nantes","Paris Saint-Germain","0-0",0,0,"1",1,0,0,"D"
1988-04-16,1987,"Brest Armorique FC","AS Cannes","1-0",1,0,"1",1,1,1,"H"
1988-04-16,1987,"OGC Nice","Toulouse FC","3-0",3,0,"1",1,3,3,"H"
1988-04-30,1987,"AS Monaco","Matra Racing","3-0",3,0,"1",1,3,3,"H"
1988-04-30,1987,"Girondins Bordeaux","Brest Armorique FC","2-0",2,0,"1",1,2,2,"H"
1988-04-30,1987,"Toulouse FC","FC Metz","2-0",2,0,"1",1,2,2,"H"
1988-04-30,1987,"Sporting Toulon Var","Lille OSC","3-0",3,0,"1",1,3,3,"H"
1988-04-30,1987,"Montpellier La Paillade SC","AJ Auxerre","2-2",2,2,"1",1,4,0,"D"
1988-04-30,1987,"Le Havre AC","Olympique Marseille","1-0",1,0,"1",1,1,1,"H"
1988-04-30,1987,"AS Cannes","AS Saint-Etienne","1-0",1,0,"1",1,1,1,"H"
1988-04-30,1987,"Chamois Niortais","FC Nantes","1-3",1,3,"1",1,4,-2,"D"
1988-04-30,1987,"RC Lens","Stade Laval","1-2",1,2,"1",1,3,-1,"D"
1988-04-30,1987,"Paris Saint-Germain","OGC Nice","0-4",0,4,"1",1,4,-4,"D"
1988-05-06,1987,"Olympique Marseille","Chamois Niortais","1-0",1,0,"1",1,1,1,"H"
1988-05-07,1987,"Brest Armorique FC","Sporting Toulon Var","1-0",1,0,"1",1,1,1,"H"
1988-05-07,1987,"FC Metz","Paris Saint-Germain","1-0",1,0,"1",1,1,1,"H"
1988-05-07,1987,"AS Saint-Etienne","Girondins Bordeaux","1-1",1,1,"1",1,2,0,"D"
1988-05-07,1987,"Matra Racing","AS Cannes","0-0",0,0,"1",1,0,0,"D"
1988-05-07,1987,"RC Lens","Le Havre AC","0-0",0,0,"1",1,0,0,"D"
1988-05-07,1987,"OGC Nice","Montpellier La Paillade SC","2-0",2,0,"1",1,2,2,"H"
1988-05-07,1987,"AJ Auxerre","Toulouse FC","0-2",0,2,"1",1,2,-2,"D"
1988-05-07,1987,"Stade Laval","Lille OSC","0-1",0,1,"1",1,1,-1,"D"
1988-05-07,1987,"FC Nantes","AS Monaco","1-1",1,1,"1",1,2,0,"D"
1988-05-13,1987,"AS Monaco","OGC Nice","1-0",1,0,"1",1,1,1,"H"
1988-05-14,1987,"Girondins Bordeaux","Matra Racing","1-0",1,0,"1",1,1,1,"H"
1988-05-14,1987,"Toulouse FC","Olympique Marseille","1-0",1,0,"1",1,1,1,"H"
1988-05-14,1987,"Montpellier La Paillade SC","RC Lens","4-0",4,0,"1",1,4,4,"H"
1988-05-14,1987,"Sporting Toulon Var","AS Saint-Etienne","1-1",1,1,"1",1,2,0,"D"
1988-05-14,1987,"Paris Saint-Germain","AJ Auxerre","1-1",1,1,"1",1,2,0,"D"
1988-05-14,1987,"AS Cannes","FC Nantes","1-4",1,4,"1",1,5,-3,"D"
1988-05-14,1987,"Chamois Niortais","FC Metz","1-3",1,3,"1",1,4,-2,"D"
1988-05-14,1987,"Lille OSC","Brest Armorique FC","2-0",2,0,"1",1,2,2,"H"
1988-05-14,1987,"Le Havre AC","Stade Laval","2-1",2,1,"1",1,3,1,"H"
1988-05-20,1987,"FC Nantes","Girondins Bordeaux","1-0",1,0,"1",1,1,1,"H"
1988-05-21,1987,"FC Metz","AS Monaco","2-2",2,2,"1",1,4,0,"D"
1988-05-21,1987,"Le Havre AC","Montpellier La Paillade SC","1-3",1,3,"1",1,4,-2,"D"
1988-05-21,1987,"AS Saint-Etienne","Lille OSC","4-3",4,3,"1",1,7,1,"H"
1988-05-21,1987,"Matra Racing","Sporting Toulon Var","0-0",0,0,"1",1,0,0,"D"
1988-05-21,1987,"Olympique Marseille","Paris Saint-Germain","1-2",1,2,"1",1,3,-1,"D"
1988-05-21,1987,"AJ Auxerre","Chamois Niortais","1-3",1,3,"1",1,4,-2,"D"
1988-05-21,1987,"OGC Nice","AS Cannes","1-2",1,2,"1",1,3,-1,"D"
1988-05-21,1987,"Stade Laval","Brest Armorique FC","0-0",0,0,"1",1,0,0,"D"
1988-05-21,1987,"RC Lens","Toulouse FC","2-0",2,0,"1",1,2,2,"H"
1988-05-27,1987,"AS Monaco","AJ Auxerre","3-2",3,2,"1",1,5,1,"H"
1988-05-27,1987,"Girondins Bordeaux","OGC Nice","4-2",4,2,"1",1,6,2,"H"
1988-05-27,1987,"Montpellier La Paillade SC","Olympique Marseille","4-0",4,0,"1",1,4,4,"H"
1988-05-27,1987,"Brest Armorique FC","AS Saint-Etienne","1-0",1,0,"1",1,1,1,"H"
1988-05-27,1987,"Lille OSC","Matra Racing","5-0",5,0,"1",1,5,5,"H"
1988-05-27,1987,"Sporting Toulon Var","FC Nantes","5-2",5,2,"1",1,7,3,"H"
1988-05-27,1987,"AS Cannes","FC Metz","3-3",3,3,"1",1,6,0,"D"
1988-05-27,1987,"Toulouse FC","Le Havre AC","2-1",2,1,"1",1,3,1,"H"
1988-05-27,1987,"Chamois Niortais","Stade Laval","0-0",0,0,"1",1,0,0,"D"
1988-05-27,1987,"Paris Saint-Germain","RC Lens","4-1",4,1,"1",1,5,3,"H"
1988-06-04,1987,"Olympique Marseille","AS Monaco","2-0",2,0,"1",1,2,2,"H"
1988-06-04,1987,"FC Metz","Girondins Bordeaux","2-0",2,0,"1",1,2,2,"H"
1988-06-04,1987,"Montpellier La Paillade SC","Toulouse FC","4-2",4,2,"1",1,6,2,"H"
1988-06-04,1987,"AS Saint-Etienne","Stade Laval","2-1",2,1,"1",1,3,1,"H"
1988-06-04,1987,"OGC Nice","Sporting Toulon Var","0-2",0,2,"1",1,2,-2,"D"
1988-06-04,1987,"Matra Racing","Brest Armorique FC","1-1",1,1,"1",1,2,0,"D"
1988-06-04,1987,"AJ Auxerre","AS Cannes","1-0",1,0,"1",1,1,1,"H"
1988-06-04,1987,"FC Nantes","Lille OSC","1-1",1,1,"1",1,2,0,"D"
1988-06-04,1987,"Le Havre AC","Paris Saint-Germain","0-1",0,1,"1",1,1,-1,"D"
1988-06-04,1987,"RC Lens","Chamois Niortais","3-1",3,1,"1",1,4,2,"H"
1988-07-15,1988,"FC Nantes","AS Monaco","1-1",1,1,"1",1,2,0,"D"
1988-07-16,1988,"RC Strasbourg","FC Sochaux","0-3",0,3,"1",1,3,-3,"D"
1988-07-16,1988,"Girondins Bordeaux","AJ Auxerre","2-0",2,0,"1",1,2,2,"H"
1988-07-16,1988,"AS Cannes","SM Caen","2-0",2,0,"1",1,2,2,"H"
1988-07-16,1988,"Stade Laval","Lille OSC","1-2",1,2,"1",1,3,-1,"D"
1988-07-16,1988,"RC Lens","Sporting Toulon Var","0-1",0,1,"1",1,1,-1,"D"
1988-07-16,1988,"Matra Racing","Toulouse FC","0-1",0,1,"1",1,1,-1,"D"
1988-07-16,1988,"OGC Nice","AS Saint-Etienne","1-0",1,0,"1",1,1,1,"H"
1988-07-16,1988,"FC Metz","Paris Saint-Germain","0-1",0,1,"1",1,1,-1,"D"
1988-07-16,1988,"Olympique Marseille","Montpellier La Paillade SC","1-1",1,1,"1",1,2,0,"D"
1988-07-23,1988,"FC Sochaux","Matra Racing","2-0",2,0,"1",1,2,2,"H"
1988-07-23,1988,"Lille OSC","Olympique Marseille","2-1",2,1,"1",1,3,1,"H"
1988-07-23,1988,"Toulouse FC","RC Lens","2-1",2,1,"1",1,3,1,"H"
1988-07-23,1988,"Sporting Toulon Var","FC Metz","1-0",1,0,"1",1,1,1,"H"
1988-07-23,1988,"AS Monaco","AS Cannes","2-0",2,0,"1",1,2,2,"H"
1988-07-23,1988,"SM Caen","FC Nantes","2-3",2,3,"1",1,5,-1,"D"
1988-07-23,1988,"Montpellier La Paillade SC","OGC Nice","1-1",1,1,"1",1,2,0,"D"
1988-07-23,1988,"AJ Auxerre","Stade Laval","2-1",2,1,"1",1,3,1,"H"
1988-07-23,1988,"AS Saint-Etienne","RC Strasbourg","0-0",0,0,"1",1,0,0,"D"
1988-07-26,1988,"Girondins Bordeaux","Montpellier La Paillade SC","2-1",2,1,"1",1,3,1,"H"
1988-07-27,1988,"Olympique Marseille","FC Sochaux","0-0",0,0,"1",1,0,0,"D"
1988-07-27,1988,"AS Monaco","Lille OSC","1-1",1,1,"1",1,2,0,"D"
1988-07-27,1988,"FC Nantes","Sporting Toulon Var","0-0",0,0,"1",1,0,0,"D"
1988-07-27,1988,"AS Cannes","Paris Saint-Germain","0-3",0,3,"1",1,3,-3,"D"
1988-07-27,1988,"Stade Laval","Toulouse FC","2-0",2,0,"1",1,2,2,"H"
1988-07-27,1988,"RC Lens","AJ Auxerre","0-1",0,1,"1",1,1,-1,"D"
1988-07-27,1988,"RC Strasbourg","OGC Nice","3-0",3,0,"1",1,3,3,"H"
1988-07-27,1988,"Matra Racing","AS Saint-Etienne","3-1",3,1,"1",1,4,2,"H"
1988-07-27,1988,"FC Metz","SM Caen","1-0",1,0,"1",1,1,1,"H"
1988-07-30,1988,"FC Sochaux","Stade Laval","3-0",3,0,"1",1,3,3,"H"
1988-07-30,1988,"Sporting Toulon Var","AS Cannes","3-0",3,0,"1",1,3,3,"H"
1988-07-30,1988,"SM Caen","AS Monaco","0-3",0,3,"1",1,3,-3,"D"
1988-07-30,1988,"Paris Saint-Germain","FC Nantes","1-0",1,0,"1",1,1,1,"H"
1988-07-30,1988,"Lille OSC","Girondins Bordeaux","0-1",0,1,"1",1,1,-1,"D"
1988-07-30,1988,"AJ Auxerre","FC Metz","2-1",2,1,"1",1,3,1,"H"
1988-07-30,1988,"Toulouse FC","Olympique Marseille","0-0",0,0,"1",1,0,0,"D"
1988-07-30,1988,"OGC Nice","Matra Racing","3-2",3,2,"1",1,5,1,"H"
1988-07-30,1988,"Montpellier La Paillade SC","RC Strasbourg","1-0",1,0,"1",1,1,1,"H"
1988-07-30,1988,"AS Saint-Etienne","RC Lens","2-4",2,4,"1",1,6,-2,"D"
1988-08-06,1988,"RC Lens","FC Sochaux","2-2",2,2,"1",1,4,0,"D"
1988-08-06,1988,"AS Monaco","Paris Saint-Germain","1-0",1,0,"1",1,1,1,"H"
1988-08-06,1988,"Girondins Bordeaux","Sporting Toulon Var","1-1",1,1,"1",1,2,0,"D"
1988-08-06,1988,"FC Nantes","AJ Auxerre","3-2",3,2,"1",1,5,1,"H"
1988-08-06,1988,"SM Caen","Montpellier La Paillade SC","0-1",0,1,"1",1,1,-1,"D"
1988-08-06,1988,"Olympique Marseille","OGC Nice","3-2",3,2,"1",1,5,1,"H"
1988-08-06,1988,"FC Metz","Lille OSC","3-1",3,1,"1",1,4,2,"H"
1988-08-06,1988,"AS Cannes","Toulouse FC","5-1",5,1,"1",1,6,4,"H"
1988-08-06,1988,"Matra Racing","RC Strasbourg","2-1",2,1,"1",1,3,1,"H"
1988-08-06,1988,"Stade Laval","AS Saint-Etienne","1-1",1,1,"1",1,2,0,"D"
1988-08-12,1988,"AS Saint-Etienne","Olympique Marseille","0-0",0,0,"1",1,0,0,"D"
1988-08-13,1988,"Sporting Toulon Var","AS Monaco","1-0",1,0,"1",1,1,1,"H"
1988-08-13,1988,"FC Sochaux","Girondins Bordeaux","1-1",1,1,"1",1,2,0,"D"
1988-08-13,1988,"Paris Saint-Germain","SM Caen","3-0",3,0,"1",1,3,3,"H"
1988-08-13,1988,"Lille OSC","FC Nantes","0-1",0,1,"1",1,1,-1,"D"
1988-08-13,1988,"Montpellier La Paillade SC","Matra Racing","0-0",0,0,"1",1,0,0,"D"
1988-08-13,1988,"AJ Auxerre","AS Cannes","0-0",0,0,"1",1,0,0,"D"
1988-08-13,1988,"OGC Nice","Stade Laval","1-0",1,0,"1",1,1,1,"H"
1988-08-13,1988,"Toulouse FC","FC Metz","2-1",2,1,"1",1,3,1,"H"
1988-08-13,1988,"RC Strasbourg","RC Lens","4-1",4,1,"1",1,5,3,"H"
1988-08-17,1988,"Girondins Bordeaux","AS Saint-Etienne","5-0",5,0,"1",1,5,5,"H"
1988-08-17,1988,"Paris Saint-Germain","FC Sochaux","1-0",1,0,"1",1,1,1,"H"
1988-08-17,1988,"SM Caen","Sporting Toulon Var","2-1",2,1,"1",1,3,1,"H"
1988-08-17,1988,"AS Monaco","AJ Auxerre","1-2",1,2,"1",1,3,-1,"D"
1988-08-17,1988,"FC Nantes","Toulouse FC","1-2",1,2,"1",1,3,-1,"D"
1988-08-17,1988,"Olympique Marseille","Matra Racing","2-0",2,0,"1",1,2,2,"H"
1988-08-17,1988,"RC Lens","Montpellier La Paillade SC","0-0",0,0,"1",1,0,0,"D"
1988-08-17,1988,"AS Cannes","Lille OSC","1-0",1,0,"1",1,1,1,"H"
1988-08-17,1988,"FC Metz","OGC Nice","1-0",1,0,"1",1,1,1,"H"
1988-08-17,1988,"Stade Laval","RC Strasbourg","1-0",1,0,"1",1,1,1,"H"
1988-08-20,1988,"Sporting Toulon Var","Paris Saint-Germain","0-1",0,1,"1",1,1,-1,"D"
1988-08-20,1988,"Toulouse FC","Girondins Bordeaux","1-1",1,1,"1",1,2,0,"D"
1988-08-20,1988,"FC Sochaux","FC Metz","1-0",1,0,"1",1,1,1,"H"
1988-08-20,1988,"AJ Auxerre","SM Caen","3-0",3,0,"1",1,3,3,"H"
1988-08-20,1988,"AS Saint-Etienne","AS Monaco","0-1",0,1,"1",1,1,-1,"D"
1988-08-20,1988,"Montpellier La Paillade SC","FC Nantes","1-4",1,4,"1",1,5,-3,"D"
1988-08-20,1988,"RC Strasbourg","Olympique Marseille","2-3",2,3,"1",1,5,-1,"D"
1988-08-20,1988,"OGC Nice","AS Cannes","2-1",2,1,"1",1,3,1,"H"
1988-08-20,1988,"Lille OSC","RC Lens","1-0",1,0,"1",1,1,1,"H"
1988-08-20,1988,"Matra Racing","Stade Laval","2-2",2,2,"1",1,4,0,"D"
1988-08-27,1988,"Girondins Bordeaux","RC Strasbourg","2-0",2,0,"1",1,2,2,"H"
1988-08-27,1988,"Paris Saint-Germain","AJ Auxerre","2-2",2,2,"1",1,4,0,"D"
1988-08-27,1988,"AS Monaco","Toulouse FC","1-0",1,0,"1",1,1,1,"H"
1988-08-27,1988,"Stade Laval","Olympique Marseille","0-1",0,1,"1",1,1,-1,"D"
1988-08-27,1988,"AS Cannes","FC Sochaux","2-0",2,0,"1",1,2,2,"H"
1988-08-27,1988,"FC Nantes","AS Saint-Etienne","1-1",1,1,"1",1,2,0,"D"
1988-08-27,1988,"Sporting Toulon Var","OGC Nice","0-0",0,0,"1",1,0,0,"D"
1988-08-27,1988,"FC Metz","Montpellier La Paillade SC","1-2",1,2,"1",1,3,-1,"D"
1988-08-27,1988,"RC Lens","Matra Racing","1-1",1,1,"1",1,2,0,"D"
1988-08-27,1988,"SM Caen","Lille OSC","2-1",2,1,"1",1,3,1,"H"
1988-09-02,1988,"Matra Racing","AS Monaco","3-0",3,0,"1",1,3,3,"H"
1988-09-03,1988,"AJ Auxerre","Sporting Toulon Var","3-0",3,0,"1",1,3,3,"H"
1988-09-03,1988,"Olympique Marseille","RC Lens","5-2",5,2,"1",1,7,3,"H"
1988-09-03,1988,"OGC Nice","Girondins Bordeaux","1-0",1,0,"1",1,1,1,"H"
1988-09-03,1988,"Lille OSC","Paris Saint-Germain","2-1",2,1,"1",1,3,1,"H"
1988-09-03,1988,"FC Sochaux","FC Nantes","0-1",0,1,"1",1,1,-1,"D"
1988-09-03,1988,"Montpellier La Paillade SC","Stade Laval","6-2",6,2,"1",1,8,4,"H"
1988-09-03,1988,"AS Saint-Etienne","FC Metz","0-1",0,1,"1",1,1,-1,"D"
1988-09-03,1988,"Toulouse FC","SM Caen","0-0",0,0,"1",1,0,0,"D"
1988-09-03,1988,"RC Strasbourg","AS Cannes","0-0",0,0,"1",1,0,0,"D"
1988-09-10,1988,"AJ Auxerre","Lille OSC","1-0",1,0,"1",1,1,1,"H"
1988-09-10,1988,"Paris Saint-Germain","Toulouse FC","2-1",2,1,"1",1,3,1,"H"
1988-09-10,1988,"Girondins Bordeaux","Olympique Marseille","0-0",0,0,"1",1,0,0,"D"
1988-09-10,1988,"FC Nantes","RC Strasbourg","2-2",2,2,"1",1,4,0,"D"
1988-09-10,1988,"Sporting Toulon Var","Montpellier La Paillade SC","1-1",1,1,"1",1,2,0,"D"
1988-09-10,1988,"AS Monaco","OGC Nice","1-1",1,1,"1",1,2,0,"D"
1988-09-10,1988,"SM Caen","FC Sochaux","0-0",0,0,"1",1,0,0,"D"
1988-09-10,1988,"AS Cannes","AS Saint-Etienne","1-0",1,0,"1",1,1,1,"H"
1988-09-10,1988,"FC Metz","Matra Racing","1-1",1,1,"1",1,2,0,"D"
1988-09-10,1988,"RC Lens","Stade Laval","0-2",0,2,"1",1,2,-2,"D"
1988-09-14,1988,"Paris Saint-Germain","Girondins Bordeaux","1-1",1,1,"1",1,2,0,"D"
1988-09-17,1988,"Montpellier La Paillade SC","Paris Saint-Germain","0-0",0,0,"1",1,0,0,"D"
1988-09-17,1988,"Toulouse FC","AJ Auxerre","0-0",0,0,"1",1,0,0,"D"
1988-09-17,1988,"Olympique Marseille","AS Cannes","2-1",2,1,"1",1,3,1,"H"
1988-09-17,1988,"Stade Laval","Girondins Bordeaux","1-0",1,0,"1",1,1,1,"H"
1988-09-17,1988,"OGC Nice","RC Lens","3-0",3,0,"1",1,3,3,"H"
1988-09-17,1988,"Matra Racing","FC Nantes","2-0",2,0,"1",1,2,2,"H"
1988-09-17,1988,"FC Sochaux","AS Monaco","0-0",0,0,"1",1,0,0,"D"
1988-09-17,1988,"Lille OSC","Sporting Toulon Var","0-0",0,0,"1",1,0,0,"D"
1988-09-17,1988,"RC Strasbourg","FC Metz","1-2",1,2,"1",1,3,-1,"D"
1988-09-17,1988,"AS Saint-Etienne","SM Caen","1-1",1,1,"1",1,2,0,"D"
1988-09-20,1988,"Sporting Toulon Var","Toulouse FC","1-1",1,1,"1",1,2,0,"D"
1988-09-21,1988,"Paris Saint-Germain","AS Saint-Etienne","3-1",3,1,"1",1,4,2,"H"
1988-09-21,1988,"AJ Auxerre","Montpellier La Paillade SC","1-0",1,0,"1",1,1,1,"H"
1988-09-21,1988,"FC Nantes","Olympique Marseille","1-1",1,1,"1",1,2,0,"D"
1988-09-21,1988,"Girondins Bordeaux","RC Lens","4-1",4,1,"1",1,5,3,"H"
1988-09-21,1988,"AS Monaco","RC Strasbourg","4-1",4,1,"1",1,5,3,"H"
1988-09-21,1988,"SM Caen","OGC Nice","2-1",2,1,"1",1,3,1,"H"
1988-09-21,1988,"AS Cannes","Matra Racing","2-1",2,1,"1",1,3,1,"H"
1988-09-21,1988,"Lille OSC","FC Sochaux","2-0",2,0,"1",1,2,2,"H"
1988-09-21,1988,"FC Metz","Stade Laval","0-0",0,0,"1",1,0,0,"D"
1988-10-01,1988,"Olympique Marseille","FC Metz","3-2",3,2,"1",1,5,1,"H"
1988-10-01,1988,"OGC Nice","Paris Saint-Germain","3-1",3,1,"1",1,4,2,"H"
1988-10-01,1988,"FC Sochaux","AJ Auxerre","3-2",3,2,"1",1,5,1,"H"
1988-10-01,1988,"Matra Racing","Girondins Bordeaux","4-1",4,1,"1",1,5,3,"H"
1988-10-01,1988,"Stade Laval","FC Nantes","0-2",0,2,"1",1,2,-2,"D"
1988-10-01,1988,"Montpellier La Paillade SC","AS Monaco","4-2",4,2,"1",1,6,2,"H"
1988-10-01,1988,"RC Lens","AS Cannes","2-2",2,2,"1",1,4,0,"D"
1988-10-01,1988,"AS Saint-Etienne","Sporting Toulon Var","2-1",2,1,"1",1,3,1,"H"
1988-10-01,1988,"Toulouse FC","Lille OSC","1-1",1,1,"1",1,2,0,"D"
1988-10-01,1988,"RC Strasbourg","SM Caen","1-2",1,2,"1",1,3,-1,"D"
1988-10-08,1988,"AJ Auxerre","AS Saint-Etienne","2-0",2,0,"1",1,2,2,"H"
1988-10-08,1988,"Paris Saint-Germain","RC Strasbourg","1-0",1,0,"1",1,1,1,"H"
1988-10-08,1988,"AS Monaco","Olympique Marseille","3-0",3,0,"1",1,3,3,"H"
1988-10-08,1988,"FC Nantes","RC Lens","3-1",3,1,"1",1,4,2,"H"
1988-10-08,1988,"FC Metz","Girondins Bordeaux","3-0",3,0,"1",1,3,3,"H"
1988-10-08,1988,"Toulouse FC","OGC Nice","2-1",2,1,"1",1,3,1,"H"
1988-10-08,1988,"AS Cannes","Stade Laval","3-2",3,2,"1",1,5,1,"H"
1988-10-08,1988,"Sporting Toulon Var","FC Sochaux","0-0",0,0,"1",1,0,0,"D"
1988-10-08,1988,"Lille OSC","Montpellier La Paillade SC","3-1",3,1,"1",1,4,2,"H"
1988-10-08,1988,"SM Caen","Matra Racing","1-1",1,1,"1",1,2,0,"D"
1988-10-14,1988,"Matra Racing","Paris Saint-Germain","0-2",0,2,"1",1,2,-2,"D"
1988-10-15,1988,"Olympique Marseille","SM Caen","4-2",4,2,"1",1,6,2,"H"
1988-10-15,1988,"OGC Nice","AJ Auxerre","1-0",1,0,"1",1,1,1,"H"
1988-10-15,1988,"Girondins Bordeaux","FC Nantes","5-0",5,0,"1",1,5,5,"H"
1988-10-15,1988,"Stade Laval","AS Monaco","0-0",0,0,"1",1,0,0,"D"
1988-10-15,1988,"Montpellier La Paillade SC","AS Cannes","0-0",0,0,"1",1,0,0,"D"
1988-10-15,1988,"FC Sochaux","Toulouse FC","2-2",2,2,"1",1,4,0,"D"
1988-10-15,1988,"RC Lens","FC Metz","0-2",0,2,"1",1,2,-2,"D"
1988-10-15,1988,"AS Saint-Etienne","Lille OSC","2-0",2,0,"1",1,2,2,"H"
1988-10-15,1988,"RC Strasbourg","Sporting Toulon Var","2-1",2,1,"1",1,3,1,"H"
1988-10-29,1988,"Paris Saint-Germain","Olympique Marseille","0-0",0,0,"1",1,0,0,"D"
1988-10-29,1988,"AJ Auxerre","RC Strasbourg","2-1",2,1,"1",1,3,1,"H"
1988-10-29,1988,"AS Monaco","RC Lens","1-0",1,0,"1",1,1,1,"H"
1988-10-29,1988,"FC Nantes","FC Metz","1-0",1,0,"1",1,1,1,"H"
1988-10-29,1988,"AS Cannes","Girondins Bordeaux","1-1",1,1,"1",1,2,0,"D"
1988-10-29,1988,"FC Sochaux","Montpellier La Paillade SC","2-0",2,0,"1",1,2,2,"H"
1988-10-29,1988,"Lille OSC","OGC Nice","2-0",2,0,"1",1,2,2,"H"
1988-10-29,1988,"Toulouse FC","AS Saint-Etienne","3-1",3,1,"1",1,4,2,"H"
1988-10-29,1988,"Sporting Toulon Var","Matra Racing","1-0",1,0,"1",1,1,1,"H"
1988-10-29,1988,"SM Caen","Stade Laval","1-1",1,1,"1",1,2,0,"D"
1988-11-04,1988,"Girondins Bordeaux","AS Monaco","1-1",1,1,"1",1,2,0,"D"
1988-11-05,1988,"Stade Laval","Paris Saint-Germain","1-2",1,2,"1",1,3,-1,"D"
1988-11-05,1988,"Matra Racing","AJ Auxerre","1-2",1,2,"1",1,3,-1,"D"
1988-11-05,1988,"Olympique Marseille","Sporting Toulon Var","1-0",1,0,"1",1,1,1,"H"
1988-11-05,1988,"RC Lens","SM Caen","5-0",5,0,"1",1,5,5,"H"
1988-11-05,1988,"AS Saint-Etienne","FC Sochaux","1-2",1,2,"1",1,3,-1,"D"
1988-11-05,1988,"OGC Nice","FC Nantes","1-0",1,0,"1",1,1,1,"H"
1988-11-05,1988,"RC Strasbourg","Lille OSC","1-3",1,3,"1",1,4,-2,"D"
1988-11-05,1988,"FC Metz","AS Cannes","2-1",2,1,"1",1,3,1,"H"
1988-11-05,1988,"Montpellier La Paillade SC","Toulouse FC","1-0",1,0,"1",1,1,1,"H"
1988-11-12,1988,"Paris Saint-Germain","RC Lens","3-2",3,2,"1",1,5,1,"H"
1988-11-12,1988,"AJ Auxerre","Olympique Marseille","1-0",1,0,"1",1,1,1,"H"
1988-11-12,1988,"AS Monaco","FC Metz","1-1",1,1,"1",1,2,0,"D"
1988-11-12,1988,"FC Sochaux","OGC Nice","1-0",1,0,"1",1,1,1,"H"
1988-11-12,1988,"AS Cannes","FC Nantes","1-2",1,2,"1",1,3,-1,"D"
1988-11-12,1988,"SM Caen","Girondins Bordeaux","3-0",3,0,"1",1,3,3,"H"
1988-11-12,1988,"Lille OSC","Matra Racing","3-0",3,0,"1",1,3,3,"H"
1988-11-12,1988,"Montpellier La Paillade SC","AS Saint-Etienne","2-0",2,0,"1",1,2,2,"H"
1988-11-12,1988,"Toulouse FC","RC Strasbourg","4-0",4,0,"1",1,4,4,"H"
1988-11-12,1988,"Sporting Toulon Var","Stade Laval","0-0",0,0,"1",1,0,0,"D"
1988-11-25,1988,"Olympique Marseille","Lille OSC","1-1",1,1,"1",1,2,0,"D"
1988-11-26,1988,"Girondins Bordeaux","Paris Saint-Germain","0-1",0,1,"1",1,1,-1,"D"
1988-11-26,1988,"Stade Laval","AJ Auxerre","0-1",0,1,"1",1,1,-1,"D"
1988-11-26,1988,"Matra Racing","FC Sochaux","0-2",0,2,"1",1,2,-2,"D"
1988-11-26,1988,"FC Nantes","SM Caen","3-1",3,1,"1",1,4,2,"H"
1988-11-26,1988,"AS Cannes","AS Monaco","3-2",3,2,"1",1,5,1,"H"
1988-11-26,1988,"OGC Nice","Montpellier La Paillade SC","3-3",3,3,"1",1,6,0,"D"
1988-11-26,1988,"RC Lens","Toulouse FC","1-1",1,1,"1",1,2,0,"D"
1988-11-26,1988,"FC Metz","Sporting Toulon Var","1-2",1,2,"1",1,3,-1,"D"
1988-11-26,1988,"RC Strasbourg","AS Saint-Etienne","0-1",0,1,"1",1,1,-1,"D"
1988-12-03,1988,"Paris Saint-Germain","AS Cannes","1-0",1,0,"1",1,1,1,"H"
1988-12-03,1988,"AJ Auxerre","RC Lens","1-0",1,0,"1",1,1,1,"H"
1988-12-03,1988,"FC Sochaux","Olympique Marseille","0-0",0,0,"1",1,0,0,"D"
1988-12-03,1988,"Lille OSC","AS Monaco","2-4",2,4,"1",1,6,-2,"D"
1988-12-03,1988,"Sporting Toulon Var","FC Nantes","1-0",1,0,"1",1,1,1,"H"
1988-12-03,1988,"OGC Nice","RC Strasbourg","1-0",1,0,"1",1,1,1,"H"
1988-12-03,1988,"Montpellier La Paillade SC","Girondins Bordeaux","2-2",2,2,"1",1,4,0,"D"
1988-12-03,1988,"Toulouse FC","Stade Laval","0-0",0,0,"1",1,0,0,"D"
1988-12-03,1988,"SM Caen","FC Metz","0-0",0,0,"1",1,0,0,"D"
1988-12-03,1988,"AS Saint-Etienne","Matra Racing","4-3",4,3,"1",1,7,1,"H"
1988-12-10,1988,"FC Nantes","Paris Saint-Germain","1-1",1,1,"1",1,2,0,"D"
1988-12-10,1988,"FC Metz","AJ Auxerre","2-1",2,1,"1",1,3,1,"H"
1988-12-10,1988,"Olympique Marseille","Toulouse FC","3-1",3,1,"1",1,4,2,"H"
1988-12-10,1988,"AS Monaco","SM Caen","3-1",3,1,"1",1,4,2,"H"
1988-12-10,1988,"Stade Laval","FC Sochaux","1-1",1,1,"1",1,2,0,"D"
1988-12-10,1988,"Matra Racing","OGC Nice","1-1",1,1,"1",1,2,0,"D"
1988-12-10,1988,"Girondins Bordeaux","Lille OSC","0-0",0,0,"1",1,0,0,"D"
1988-12-10,1988,"RC Strasbourg","Montpellier La Paillade SC","3-1",3,1,"1",1,4,2,"H"
1988-12-10,1988,"AS Cannes","Sporting Toulon Var","1-0",1,0,"1",1,1,1,"H"
1988-12-10,1988,"RC Lens","AS Saint-Etienne","1-3",1,3,"1",1,4,-2,"D"
1988-12-10,1988,"FC Nantes","Montpellier La Paillade SC","2-1",2,1,"1",1,3,1,"H"
1988-12-11,1988,"Olympique Marseille","RC Strasbourg","3-1",3,1,"1",1,4,2,"H"
1988-12-11,1988,"Paris Saint-Germain","Sporting Toulon Var","0-0",0,0,"1",1,0,0,"D"
1988-12-11,1988,"SM Caen","AJ Auxerre","1-0",1,0,"1",1,1,1,"H"
1988-12-11,1988,"AS Monaco","AS Saint-Etienne","2-2",2,2,"1",1,4,0,"D"
1988-12-11,1988,"AS Cannes","OGC Nice","2-0",2,0,"1",1,2,2,"H"
1988-12-11,1988,"RC Lens","Lille OSC","1-2",1,2,"1",1,3,-1,"D"
1988-12-11,1988,"Girondins Bordeaux","Toulouse FC","1-1",1,1,"1",1,2,0,"D"
1988-12-11,1988,"Stade Laval","Matra Racing","4-2",4,2,"1",1,6,2,"H"
1988-12-12,1988,"FC Metz","FC Sochaux","1-0",1,0,"1",1,1,1,"H"
1988-12-13,1988,"OGC Nice","Olympique Marseille","2-2",2,2,"1",1,4,0,"D"
1988-12-13,1988,"FC Sochaux","RC Lens","2-1",2,1,"1",1,3,1,"H"
1988-12-14,1988,"Toulouse FC","AS Cannes","4-1",4,1,"1",1,5,3,"H"
1988-12-14,1988,"AJ Auxerre","FC Nantes","1-0",1,0,"1",1,1,1,"H"
1988-12-14,1988,"Paris Saint-Germain","AS Monaco","0-2",0,2,"1",1,2,-2,"D"
1988-12-14,1988,"Montpellier La Paillade SC","SM Caen","1-0",1,0,"1",1,1,1,"H"
1988-12-14,1988,"Lille OSC","FC Metz","1-1",1,1,"1",1,2,0,"D"
1988-12-14,1988,"Sporting Toulon Var","Girondins Bordeaux","1-0",1,0,"1",1,1,1,"H"
1988-12-14,1988,"RC Strasbourg","Matra Racing","1-1",1,1,"1",1,2,0,"D"
1988-12-14,1988,"AS Saint-Etienne","Stade Laval","1-0",1,0,"1",1,1,1,"H"
1988-12-17,1988,"SM Caen","Paris Saint-Germain","0-1",0,1,"1",1,1,-1,"D"
1988-12-17,1988,"AS Cannes","AJ Auxerre","3-0",3,0,"1",1,3,3,"H"
1988-12-17,1988,"Olympique Marseille","AS Saint-Etienne","2-0",2,0,"1",1,2,2,"H"
1988-12-17,1988,"Girondins Bordeaux","FC Sochaux","1-2",1,2,"1",1,3,-1,"D"
1988-12-17,1988,"AS Monaco","Sporting Toulon Var","2-2",2,2,"1",1,4,0,"D"
1988-12-17,1988,"FC Nantes","Lille OSC","1-0",1,0,"1",1,1,1,"H"
1988-12-17,1988,"Stade Laval","OGC Nice","1-2",1,2,"1",1,3,-1,"D"
1988-12-17,1988,"FC Metz","Toulouse FC","1-1",1,1,"1",1,2,0,"D"
1988-12-17,1988,"Matra Racing","Montpellier La Paillade SC","4-0",4,0,"1",1,4,4,"H"
1988-12-17,1988,"RC Lens","RC Strasbourg","1-3",1,3,"1",1,4,-2,"D"
1989-02-04,1988,"Racing Club de France","Olympique Marseille","0-2",0,2,"1",1,2,-2,"D"
1989-02-04,1988,"AJ Auxerre","AS Monaco","0-0",0,0,"1",1,0,0,"D"
1989-02-04,1988,"Toulouse FC","FC Nantes","1-2",1,2,"1",1,3,-1,"D"
1989-02-04,1988,"OGC Nice","FC Metz","1-1",1,1,"1",1,2,0,"D"
1989-02-04,1988,"Sporting Toulon Var","SM Caen","1-0",1,0,"1",1,1,1,"H"
1989-02-04,1988,"Montpellier La Paillade SC","RC Lens","2-0",2,0,"1",1,2,2,"H"
1989-02-04,1988,"Lille OSC","AS Cannes","1-0",1,0,"1",1,1,1,"H"
1989-02-04,1988,"AS Saint-Etienne","Girondins Bordeaux","1-0",1,0,"1",1,1,1,"H"
1989-02-04,1988,"RC Strasbourg","Stade Laval","3-0",3,0,"1",1,3,3,"H"
1989-02-05,1988,"FC Sochaux","Paris Saint-Germain","2-1",2,1,"1",1,3,1,"H"
1989-02-18,1988,"Olympique Marseille","Stade Laval","1-0",1,0,"1",1,1,1,"H"
1989-02-18,1988,"AJ Auxerre","Paris Saint-Germain","0-0",0,0,"1",1,0,0,"D"
1989-02-18,1988,"FC Sochaux","AS Cannes","4-0",4,0,"1",1,4,4,"H"
1989-02-18,1988,"AS Saint-Etienne","FC Nantes","1-1",1,1,"1",1,2,0,"D"
1989-02-18,1988,"Toulouse FC","AS Monaco","2-0",2,0,"1",1,2,2,"H"
1989-02-18,1988,"OGC Nice","Sporting Toulon Var","1-0",1,0,"1",1,1,1,"H"
1989-02-18,1988,"Lille OSC","SM Caen","1-1",1,1,"1",1,2,0,"D"
1989-02-18,1988,"Montpellier La Paillade SC","FC Metz","5-3",5,3,"1",1,8,2,"H"
1989-02-19,1988,"RC Strasbourg","Girondins Bordeaux","3-2",3,2,"1",1,5,1,"H"
1989-02-21,1988,"SM Caen","Toulouse FC","3-0",3,0,"1",1,3,3,"H"
1989-02-21,1988,"AS Monaco","Racing Club de France","1-0",1,0,"1",1,1,1,"H"
1989-02-22,1988,"RC Lens","Olympique Marseille","0-1",0,1,"1",1,1,-1,"D"
1989-02-22,1988,"Paris Saint-Germain","Lille OSC","1-1",1,1,"1",1,2,0,"D"
1989-02-22,1988,"Sporting Toulon Var","AJ Auxerre","1-2",1,2,"1",1,3,-1,"D"
1989-02-22,1988,"FC Nantes","FC Sochaux","0-0",0,0,"1",1,0,0,"D"
1989-02-22,1988,"Stade Laval","Montpellier La Paillade SC","0-1",0,1,"1",1,1,-1,"D"
1989-02-22,1988,"Girondins Bordeaux","OGC Nice","2-0",2,0,"1",1,2,2,"H"
1989-02-22,1988,"AS Cannes","RC Strasbourg","4-1",4,1,"1",1,5,3,"H"
1989-02-22,1988,"FC Metz","AS Saint-Etienne","1-2",1,2,"1",1,3,-1,"D"
1989-02-28,1988,"Racing Club de France","RC Lens","3-0",3,0,"1",1,3,3,"H"
1989-03-11,1988,"Olympique Marseille","Girondins Bordeaux","2-2",2,2,"1",1,4,0,"D"
1989-03-11,1988,"Toulouse FC","Paris Saint-Germain","0-0",0,0,"1",1,0,0,"D"
1989-03-11,1988,"FC Sochaux","SM Caen","1-0",1,0,"1",1,1,1,"H"
1989-03-11,1988,"Lille OSC","AJ Auxerre","1-0",1,0,"1",1,1,1,"H"
1989-03-11,1988,"OGC Nice","AS Monaco","1-1",1,1,"1",1,2,0,"D"
1989-03-11,1988,"RC Strasbourg","FC Nantes","2-0",2,0,"1",1,2,2,"H"
1989-03-11,1988,"Montpellier La Paillade SC","Sporting Toulon Var","0-1",0,1,"1",1,1,-1,"D"
1989-03-11,1988,"Racing Club de France","FC Metz","1-4",1,4,"1",1,5,-3,"D"
1989-03-11,1988,"AS Saint-Etienne","AS Cannes","1-0",1,0,"1",1,1,1,"H"
1989-03-11,1988,"Stade Laval","RC Lens","2-1",2,1,"1",1,3,1,"H"
1989-03-14,1988,"Paris Saint-Germain","Montpellier La Paillade SC","3-2",3,2,"1",1,5,1,"H"
1989-03-17,1988,"FC Metz","RC Strasbourg","1-1",1,1,"1",1,2,0,"D"
1989-03-18,1988,"AS Cannes","Olympique Marseille","3-1",3,1,"1",1,4,2,"H"
1989-03-18,1988,"AS Monaco","FC Sochaux","0-0",0,0,"1",1,0,0,"D"
1989-03-18,1988,"AJ Auxerre","Toulouse FC","0-0",0,0,"1",1,0,0,"D"
1989-03-18,1988,"FC Nantes","Racing Club de France","1-0",1,0,"1",1,1,1,"H"
1989-03-18,1988,"Sporting Toulon Var","Lille OSC","2-1",2,1,"1",1,3,1,"H"
1989-03-18,1988,"RC Lens","OGC Nice","2-0",2,0,"1",1,2,2,"H"
1989-03-18,1988,"Girondins Bordeaux","Stade Laval","2-1",2,1,"1",1,3,1,"H"
1989-03-18,1988,"SM Caen","AS Saint-Etienne","2-3",2,3,"1",1,5,-1,"D"
1989-03-25,1988,"AS Saint-Etienne","Paris Saint-Germain","0-0",0,0,"1",1,0,0,"D"
1989-03-25,1988,"FC Sochaux","Lille OSC","2-0",2,0,"1",1,2,2,"H"
1989-03-25,1988,"RC Strasbourg","AS Monaco","1-2",1,2,"1",1,3,-1,"D"
1989-03-25,1988,"Montpellier La Paillade SC","AJ Auxerre","1-0",1,0,"1",1,1,1,"H"
1989-03-25,1988,"OGC Nice","SM Caen","5-0",5,0,"1",1,5,5,"H"
1989-03-25,1988,"Toulouse FC","Sporting Toulon Var","1-0",1,0,"1",1,1,1,"H"
1989-03-25,1988,"RC Lens","Girondins Bordeaux","0-2",0,2,"1",1,2,-2,"D"
1989-03-25,1988,"Racing Club de France","AS Cannes","1-0",1,0,"1",1,1,1,"H"
1989-03-25,1988,"Stade Laval","FC Metz","3-0",3,0,"1",1,3,3,"H"
1989-04-01,1988,"Paris Saint-Germain","OGC Nice","1-0",1,0,"1",1,1,1,"H"
1989-04-01,1988,"FC Metz","Olympique Marseille","1-3",1,3,"1",1,4,-2,"D"
1989-04-01,1988,"AJ Auxerre","FC Sochaux","2-1",2,1,"1",1,3,1,"H"
1989-04-01,1988,"AS Monaco","Montpellier La Paillade SC","4-2",4,2,"1",1,6,2,"H"
1989-04-01,1988,"FC Nantes","Stade Laval","1-1",1,1,"1",1,2,0,"D"
1989-04-01,1988,"Lille OSC","Toulouse FC","0-0",0,0,"1",1,0,0,"D"
1989-04-01,1988,"Girondins Bordeaux","Racing Club de France","3-2",3,2,"1",1,5,1,"H"
1989-04-01,1988,"AS Cannes","RC Lens","3-0",3,0,"1",1,3,3,"H"
1989-04-01,1988,"Sporting Toulon Var","AS Saint-Etienne","0-0",0,0,"1",1,0,0,"D"
1989-04-01,1988,"SM Caen","RC Strasbourg","3-3",3,3,"1",1,6,0,"D"
1989-04-04,1988,"Olympique Marseille","FC Nantes","1-0",1,0,"1",1,1,1,"H"
1989-04-11,1988,"Olympique Marseille","AS Monaco","2-2",2,2,"1",1,4,0,"D"
1989-04-12,1988,"RC Strasbourg","Paris Saint-Germain","0-0",0,0,"1",1,0,0,"D"
1989-04-12,1988,"FC Sochaux","Sporting Toulon Var","2-1",2,1,"1",1,3,1,"H"
1989-04-12,1988,"AS Saint-Etienne","AJ Auxerre","1-1",1,1,"1",1,2,0,"D"
1989-04-12,1988,"RC Lens","FC Nantes","0-0",0,0,"1",1,0,0,"D"
1989-04-12,1988,"OGC Nice","Toulouse FC","2-0",2,0,"1",1,2,2,"H"
1989-04-12,1988,"Girondins Bordeaux","FC Metz","4-1",4,1,"1",1,5,3,"H"
1989-04-12,1988,"Montpellier La Paillade SC","Lille OSC","2-3",2,3,"1",1,5,-1,"D"
1989-04-12,1988,"Stade Laval","AS Cannes","2-0",2,0,"1",1,2,2,"H"
1989-04-12,1988,"Racing Club de France","SM Caen","3-1",3,1,"1",1,4,2,"H"
1989-04-21,1988,"FC Nantes","Girondins Bordeaux","1-0",1,0,"1",1,1,1,"H"
1989-04-22,1988,"SM Caen","Olympique Marseille","0-0",0,0,"1",1,0,0,"D"
1989-04-22,1988,"Paris Saint-Germain","Racing Club de France","2-1",2,1,"1",1,3,1,"H"
1989-04-22,1988,"Toulouse FC","FC Sochaux","2-1",2,1,"1",1,3,1,"H"
1989-04-22,1988,"AS Monaco","Stade Laval","1-0",1,0,"1",1,1,1,"H"
1989-04-22,1988,"AJ Auxerre","OGC Nice","1-0",1,0,"1",1,1,1,"H"
1989-04-22,1988,"Lille OSC","AS Saint-Etienne","2-2",2,2,"1",1,4,0,"D"
1989-04-22,1988,"AS Cannes","Montpellier La Paillade SC","0-1",0,1,"1",1,1,-1,"D"
1989-04-22,1988,"Sporting Toulon Var","RC Strasbourg","0-0",0,0,"1",1,0,0,"D"
1989-04-22,1988,"FC Metz","RC Lens","4-0",4,0,"1",1,4,4,"H"
1989-05-05,1988,"Olympique Marseille","Paris Saint-Germain","1-0",1,0,"1",1,1,1,"H"
1989-05-06,1988,"Montpellier La Paillade SC","FC Sochaux","1-2",1,2,"1",1,3,-1,"D"
1989-05-06,1988,"RC Lens","AS Monaco","1-1",1,1,"1",1,2,0,"D"
1989-05-06,1988,"RC Strasbourg","AJ Auxerre","1-0",1,0,"1",1,1,1,"H"
1989-05-06,1988,"FC Metz","FC Nantes","0-0",0,0,"1",1,0,0,"D"
1989-05-06,1988,"OGC Nice","Lille OSC","0-1",0,1,"1",1,1,-1,"D"
1989-05-06,1988,"Girondins Bordeaux","AS Cannes","0-0",0,0,"1",1,0,0,"D"
1989-05-06,1988,"AS Saint-Etienne","Toulouse FC","3-2",3,2,"1",1,5,1,"H"
1989-05-06,1988,"Racing Club de France","Sporting Toulon Var","1-1",1,1,"1",1,2,0,"D"
1989-05-06,1988,"Stade Laval","SM Caen","1-1",1,1,"1",1,2,0,"D"
1989-05-12,1988,"Paris Saint-Germain","Stade Laval","3-0",3,0,"1",1,3,3,"H"
1989-05-13,1988,"Sporting Toulon Var","Olympique Marseille","1-2",1,2,"1",1,3,-1,"D"
1989-05-13,1988,"FC Sochaux","AS Saint-Etienne","1-0",1,0,"1",1,1,1,"H"
1989-05-13,1988,"AS Monaco","Girondins Bordeaux","4-2",4,2,"1",1,6,2,"H"
1989-05-13,1988,"AJ Auxerre","Racing Club de France","1-1",1,1,"1",1,2,0,"D"
1989-05-13,1988,"FC Nantes","OGC Nice","0-1",0,1,"1",1,1,-1,"D"
1989-05-13,1988,"Lille OSC","RC Strasbourg","1-1",1,1,"1",1,2,0,"D"
1989-05-13,1988,"Toulouse FC","Montpellier La Paillade SC","2-2",2,2,"1",1,4,0,"D"
1989-05-13,1988,"AS Cannes","FC Metz","1-1",1,1,"1",1,2,0,"D"
1989-05-13,1988,"SM Caen","RC Lens","1-0",1,0,"1",1,1,1,"H"
1989-05-20,1988,"Olympique Marseille","AJ Auxerre","2-1",2,1,"1",1,3,1,"H"
1989-05-20,1988,"RC Lens","Paris Saint-Germain","0-0",0,0,"1",1,0,0,"D"
1989-05-20,1988,"FC Metz","AS Monaco","0-3",0,3,"1",1,3,-3,"D"
1989-05-20,1988,"OGC Nice","FC Sochaux","3-2",3,2,"1",1,5,1,"H"
1989-05-20,1988,"FC Nantes","AS Cannes","1-1",1,1,"1",1,2,0,"D"
1989-05-20,1988,"Racing Club de France","Lille OSC","1-0",1,0,"1",1,1,1,"H"
1989-05-20,1988,"RC Strasbourg","Toulouse FC","4-1",4,1,"1",1,5,3,"H"
1989-05-20,1988,"Girondins Bordeaux","SM Caen","2-3",2,3,"1",1,5,-1,"D"
1989-05-20,1988,"Stade Laval","Sporting Toulon Var","0-0",0,0,"1",1,0,0,"D"
1989-05-20,1988,"AS Saint-Etienne","Montpellier La Paillade SC","1-0",1,0,"1",1,1,1,"H"
1989-05-31,1988,"Montpellier La Paillade SC","Olympique Marseille","1-0",1,0,"1",1,1,1,"H"
1989-05-31,1988,"Paris Saint-Germain","FC Metz","2-2",2,2,"1",1,4,0,"D"
1989-05-31,1988,"AS Monaco","FC Nantes","4-1",4,1,"1",1,5,3,"H"
1989-05-31,1988,"FC Sochaux","RC Strasbourg","3-0",3,0,"1",1,3,3,"H"
1989-05-31,1988,"AJ Auxerre","Girondins Bordeaux","1-1",1,1,"1",1,2,0,"D"
1989-05-31,1988,"Lille OSC","Stade Laval","8-0",8,0,"1",1,8,8,"H"
1989-05-31,1988,"AS Saint-Etienne","OGC Nice","0-0",0,0,"1",1,0,0,"D"
1989-05-31,1988,"Toulouse FC","Racing Club de France","2-1",2,1,"1",1,3,1,"H"
1989-05-31,1988,"Sporting Toulon Var","RC Lens","3-1",3,1,"1",1,4,2,"H"
1989-05-31,1988,"SM Caen","AS Cannes","3-0",3,0,"1",1,3,3,"H"
1989-07-21,1989,"Olympique Lyon","Olympique Marseille","1-4",1,4,"1",1,5,-3,"D"
1989-07-22,1989,"Montpellier HSC","AS Cannes","4-1",4,1,"1",1,5,3,"H"
1989-07-22,1989,"Toulouse FC","FC Mulhouse","3-0",3,0,"1",1,3,3,"H"
1989-07-22,1989,"Sporting Toulon Var","AS Saint-Etienne","2-0",2,0,"1",1,2,2,"H"
1989-07-22,1989,"FC Nantes","AJ Auxerre","2-1",2,1,"1",1,3,1,"H"
1989-07-22,1989,"Lille OSC","SM Caen","1-0",1,0,"1",1,1,1,"H"
1989-07-22,1989,"FC Sochaux","Brest Armorique FC","1-0",1,0,"1",1,1,1,"H"
1989-07-22,1989,"OGC Nice","Paris Saint-Germain","3-3",3,3,"1",1,6,0,"D"
1989-07-22,1989,"FC Metz","Girondins Bordeaux","0-0",0,0,"1",1,0,0,"D"
1989-07-22,1989,"Racing Club de France","AS Monaco","0-0",0,0,"1",1,0,0,"D"
1989-07-29,1989,"Olympique Marseille","FC Nantes","1-0",1,0,"1",1,1,1,"H"
1989-07-29,1989,"Girondins Bordeaux","Racing Club de France","4-0",4,0,"1",1,4,4,"H"
1989-07-29,1989,"AS Cannes","Sporting Toulon Var","0-0",0,0,"1",1,0,0,"D"
1989-07-29,1989,"Paris Saint-Germain","FC Metz","1-0",1,0,"1",1,1,1,"H"
1989-07-29,1989,"AS Monaco","FC Sochaux","2-1",2,1,"1",1,3,1,"H"
1989-07-29,1989,"FC Mulhouse","Montpellier HSC","2-0",2,0,"1",1,2,2,"H"
1989-07-29,1989,"Olympique Lyon","Toulouse FC","3-0",3,0,"1",1,3,3,"H"
1989-07-29,1989,"SM Caen","AS Saint-Etienne","3-2",3,2,"1",1,5,1,"H"
1989-07-29,1989,"AJ Auxerre","OGC Nice","1-0",1,0,"1",1,1,1,"H"
1989-07-29,1989,"Brest Armorique FC","Lille OSC","1-0",1,0,"1",1,1,1,"H"
1989-08-01,1989,"Lille OSC","AS Monaco","1-1",1,1,"1",1,2,0,"D"
1989-08-02,1989,"Montpellier HSC","Girondins Bordeaux","1-2",1,2,"1",1,3,-1,"D"
1989-08-02,1989,"Sporting Toulon Var","SM Caen","2-0",2,0,"1",1,2,2,"H"
1989-08-02,1989,"Toulouse FC","Olympique Marseille","2-1",2,1,"1",1,3,1,"H"
1989-08-02,1989,"FC Nantes","Olympique Lyon","2-1",2,1,"1",1,3,1,"H"
1989-08-02,1989,"FC Sochaux","Paris Saint-Germain","1-0",1,0,"1",1,1,1,"H"
1989-08-02,1989,"OGC Nice","FC Mulhouse","2-0",2,0,"1",1,2,2,"H"
1989-08-02,1989,"FC Metz","AJ Auxerre","2-1",2,1,"1",1,3,1,"H"
1989-08-02,1989,"Racing Club de France","AS Cannes","3-2",3,2,"1",1,5,1,"H"
1989-08-02,1989,"AS Saint-Etienne","Brest Armorique FC","2-0",2,0,"1",1,2,2,"H"
1989-08-05,1989,"Girondins Bordeaux","FC Sochaux","1-0",1,0,"1",1,1,1,"H"
1989-08-05,1989,"FC Nantes","Racing Club de France","5-1",5,1,"1",1,6,4,"H"
1989-08-05,1989,"Olympique Marseille","FC Metz","2-1",2,1,"1",1,3,1,"H"
1989-08-05,1989,"AJ Auxerre","Toulouse FC","2-2",2,2,"1",1,4,0,"D"
1989-08-05,1989,"Paris Saint-Germain","Montpellier HSC","2-1",2,1,"1",1,3,1,"H"
1989-08-05,1989,"AS Monaco","AS Saint-Etienne","0-0",0,0,"1",1,0,0,"D"
1989-08-05,1989,"FC Mulhouse","Sporting Toulon Var","4-0",4,0,"1",1,4,4,"H"
1989-08-05,1989,"Olympique Lyon","OGC Nice","2-0",2,0,"1",1,2,2,"H"
1989-08-05,1989,"Brest Armorique FC","SM Caen","2-1",2,1,"1",1,3,1,"H"
1989-08-05,1989,"AS Cannes","Lille OSC","3-0",3,0,"1",1,3,3,"H"
1989-08-12,1989,"Lille OSC","Girondins Bordeaux","0-1",0,1,"1",1,1,-1,"D"
1989-08-12,1989,"Toulouse FC","FC Nantes","1-1",1,1,"1",1,2,0,"D"
1989-08-12,1989,"OGC Nice","Olympique Marseille","1-1",1,1,"1",1,2,0,"D"
1989-08-12,1989,"AS Saint-Etienne","Paris Saint-Germain","1-2",1,2,"1",1,3,-1,"D"
1989-08-12,1989,"Sporting Toulon Var","Brest Armorique FC","2-0",2,0,"1",1,2,2,"H"
1989-08-12,1989,"FC Sochaux","AS Cannes","3-0",3,0,"1",1,3,3,"H"
1989-08-12,1989,"FC Metz","Olympique Lyon","2-3",2,3,"1",1,5,-1,"D"
1989-08-12,1989,"SM Caen","AS Monaco","1-1",1,1,"1",1,2,0,"D"
1989-08-12,1989,"Racing Club de France","FC Mulhouse","2-1",2,1,"1",1,3,1,"H"
1989-08-12,1989,"Montpellier HSC","AJ Auxerre","1-0",1,0,"1",1,1,1,"H"
1989-08-19,1989,"Girondins Bordeaux","AS Saint-Etienne","1-0",1,0,"1",1,1,1,"H"
1989-08-19,1989,"Olympique Marseille","Montpellier HSC","2-0",2,0,"1",1,2,2,"H"
1989-08-19,1989,"Paris Saint-Germain","Lille OSC","2-1",2,1,"1",1,3,1,"H"
1989-08-19,1989,"Olympique Lyon","FC Sochaux","0-4",0,4,"1",1,4,-4,"D"
1989-08-19,1989,"FC Nantes","OGC Nice","2-2",2,2,"1",1,4,0,"D"
1989-08-19,1989,"AS Monaco","Brest Armorique FC","2-0",2,0,"1",1,2,2,"H"
1989-08-19,1989,"Toulouse FC","Sporting Toulon Var","0-0",0,0,"1",1,0,0,"D"
1989-08-19,1989,"FC Mulhouse","FC Metz","2-2",2,2,"1",1,4,0,"D"
1989-08-19,1989,"AJ Auxerre","Racing Club de France","2-0",2,0,"1",1,2,2,"H"
1989-08-19,1989,"AS Cannes","SM Caen","3-1",3,1,"1",1,4,2,"H"
1989-08-26,1989,"SM Caen","Girondins Bordeaux","1-0",1,0,"1",1,1,1,"H"
1989-08-26,1989,"Brest Armorique FC","Paris Saint-Germain","0-1",0,1,"1",1,1,-1,"D"
1989-08-26,1989,"Racing Club de France","Olympique Marseille","1-1",1,1,"1",1,2,0,"D"
1989-08-26,1989,"Sporting Toulon Var","AS Monaco","2-0",2,0,"1",1,2,2,"H"
1989-08-26,1989,"FC Sochaux","AJ Auxerre","0-0",0,0,"1",1,0,0,"D"
1989-08-26,1989,"FC Metz","FC Nantes","1-1",1,1,"1",1,2,0,"D"
1989-08-26,1989,"OGC Nice","Toulouse FC","1-1",1,1,"1",1,2,0,"D"
1989-08-26,1989,"Lille OSC","FC Mulhouse","1-1",1,1,"1",1,2,0,"D"
1989-08-26,1989,"Montpellier HSC","Olympique Lyon","2-0",2,0,"1",1,2,2,"H"
1989-08-26,1989,"AS Saint-Etienne","AS Cannes","1-0",1,0,"1",1,1,1,"H"
1989-08-29,1989,"FC Mulhouse","AS Saint-Etienne","1-2",1,2,"1",1,3,-1,"D"
1989-08-30,1989,"Girondins Bordeaux","Brest Armorique FC","3-0",3,0,"1",1,3,3,"H"
1989-08-30,1989,"Olympique Marseille","FC Sochaux","6-1",6,1,"1",1,7,5,"H"
1989-08-30,1989,"Paris Saint-Germain","Sporting Toulon Var","1-1",1,1,"1",1,2,0,"D"
1989-08-30,1989,"FC Nantes","Montpellier HSC","1-1",1,1,"1",1,2,0,"D"
1989-08-30,1989,"Toulouse FC","FC Metz","2-0",2,0,"1",1,2,2,"H"
1989-08-30,1989,"AS Cannes","AS Monaco","0-0",0,0,"1",1,0,0,"D"
1989-08-30,1989,"AJ Auxerre","SM Caen","3-0",3,0,"1",1,3,3,"H"
1989-08-30,1989,"OGC Nice","Lille OSC","1-1",1,1,"1",1,2,0,"D"
1989-08-30,1989,"Olympique Lyon","Racing Club de France","1-1",1,1,"1",1,2,0,"D"
1989-09-09,1989,"SM Caen","FC Nantes","2-0",2,0,"1",1,2,2,"H"
1989-09-09,1989,"Racing Club de France","Paris Saint-Germain","2-2",2,2,"1",1,4,0,"D"
1989-09-09,1989,"Sporting Toulon Var","Girondins Bordeaux","0-2",0,2,"1",1,2,-2,"D"
1989-09-09,1989,"FC Sochaux","FC Mulhouse","0-0",0,0,"1",1,0,0,"D"
1989-09-09,1989,"Montpellier HSC","Toulouse FC","1-0",1,0,"1",1,1,1,"H"
1989-09-09,1989,"AS Saint-Etienne","Olympique Lyon","1-0",1,0,"1",1,1,1,"H"
1989-09-09,1989,"Lille OSC","AJ Auxerre","2-1",2,1,"1",1,3,1,"H"
1989-09-09,1989,"FC Metz","OGC Nice","0-0",0,0,"1",1,0,0,"D"
1989-09-09,1989,"Brest Armorique FC","AS Cannes","2-0",2,0,"1",1,2,2,"H"
1989-09-16,1989,"Girondins Bordeaux","AS Cannes","2-0",2,0,"1",1,2,2,"H"
1989-09-16,1989,"Paris Saint-Germain","AS Monaco","2-1",2,1,"1",1,3,1,"H"
1989-09-16,1989,"Olympique Marseille","AS Saint-Etienne","2-0",2,0,"1",1,2,2,"H"
1989-09-16,1989,"FC Nantes","FC Sochaux","0-1",0,1,"1",1,1,-1,"D"
1989-09-16,1989,"Toulouse FC","Racing Club de France","1-0",1,0,"1",1,1,1,"H"
1989-09-16,1989,"AJ Auxerre","Sporting Toulon Var","2-0",2,0,"1",1,2,2,"H"
1989-09-16,1989,"OGC Nice","Montpellier HSC","3-0",3,0,"1",1,3,3,"H"
1989-09-16,1989,"FC Mulhouse","Brest Armorique FC","2-0",2,0,"1",1,2,2,"H"
1989-09-16,1989,"Olympique Lyon","Lille OSC","2-1",2,1,"1",1,3,1,"H"
1989-09-16,1989,"FC Metz","SM Caen","0-0",0,0,"1",1,0,0,"D"
1989-09-22,1989,"AS Monaco","Girondins Bordeaux","2-0",2,0,"1",1,2,2,"H"
1989-09-23,1989,"Sporting Toulon Var","Olympique Marseille","0-4",0,4,"1",1,4,-4,"D"
1989-09-23,1989,"AS Cannes","Paris Saint-Germain","3-1",3,1,"1",1,4,2,"H"
1989-09-23,1989,"FC Sochaux","Toulouse FC","1-0",1,0,"1",1,1,1,"H"
1989-09-23,1989,"AS Saint-Etienne","AJ Auxerre","4-1",4,1,"1",1,5,3,"H"
1989-09-23,1989,"Brest Armorique FC","Olympique Lyon","0-2",0,2,"1",1,2,-2,"D"
1989-09-23,1989,"Lille OSC","FC Nantes","1-0",1,0,"1",1,1,1,"H"
1989-09-23,1989,"Racing Club de France","OGC Nice","5-1",5,1,"1",1,6,4,"H"
1989-09-23,1989,"SM Caen","FC Mulhouse","1-0",1,0,"1",1,1,1,"H"
1989-09-23,1989,"Montpellier HSC","FC Metz","1-2",1,2,"1",1,3,-1,"D"
1989-09-30,1989,"Olympique Marseille","Brest Armorique FC","1-0",1,0,"1",1,1,1,"H"
1989-09-30,1989,"Paris Saint-Germain","Girondins Bordeaux","1-1",1,1,"1",1,2,0,"D"
1989-09-30,1989,"OGC Nice","FC Sochaux","2-4",2,4,"1",1,6,-2,"D"
1989-09-30,1989,"Toulouse FC","Lille OSC","3-1",3,1,"1",1,4,2,"H"
1989-09-30,1989,"Olympique Lyon","SM Caen","2-1",2,1,"1",1,3,1,"H"
1989-09-30,1989,"FC Nantes","AS Saint-Etienne","2-0",2,0,"1",1,2,2,"H"
1989-09-30,1989,"AJ Auxerre","AS Monaco","0-0",0,0,"1",1,0,0,"D"
1989-09-30,1989,"FC Metz","Sporting Toulon Var","0-0",0,0,"1",1,0,0,"D"
1989-09-30,1989,"FC Mulhouse","AS Cannes","1-0",1,0,"1",1,1,1,"H"
1989-09-30,1989,"Montpellier HSC","Racing Club de France","2-1",2,1,"1",1,3,1,"H"
1989-10-03,1989,"Sporting Toulon Var","OGC Nice","1-1",1,1,"1",1,2,0,"D"
1989-10-04,1989,"Girondins Bordeaux","FC Mulhouse","1-0",1,0,"1",1,1,1,"H"
1989-10-04,1989,"Lille OSC","Olympique Marseille","2-0",2,0,"1",1,2,2,"H"
1989-10-04,1989,"FC Sochaux","Montpellier HSC","3-1",3,1,"1",1,4,2,"H"
1989-10-04,1989,"AS Saint-Etienne","Toulouse FC","0-3",0,3,"1",1,3,-3,"D"
1989-10-04,1989,"SM Caen","Paris Saint-Germain","2-0",2,0,"1",1,2,2,"H"
1989-10-04,1989,"AS Monaco","FC Nantes","0-0",0,0,"1",1,0,0,"D"
1989-10-04,1989,"AS Cannes","Olympique Lyon","2-1",2,1,"1",1,3,1,"H"
1989-10-04,1989,"Brest Armorique FC","AJ Auxerre","2-1",2,1,"1",1,3,1,"H"
1989-10-06,1989,"Racing Club de France","FC Metz","1-1",1,1,"1",1,2,0,"D"
1989-10-13,1989,"Olympique Lyon","AS Monaco","0-2",0,2,"1",1,2,-2,"D"
1989-10-14,1989,"AJ Auxerre","Girondins Bordeaux","1-1",1,1,"1",1,2,0,"D"
1989-10-14,1989,"Olympique Marseille","AS Cannes","1-1",1,1,"1",1,2,0,"D"
1989-10-14,1989,"Toulouse FC","SM Caen","2-1",2,1,"1",1,3,1,"H"
1989-10-14,1989,"FC Metz","FC Sochaux","2-0",2,0,"1",1,2,2,"H"
1989-10-14,1989,"FC Mulhouse","Paris Saint-Germain","1-0",1,0,"1",1,1,1,"H"
1989-10-14,1989,"FC Nantes","Brest Armorique FC","1-0",1,0,"1",1,1,1,"H"
1989-10-14,1989,"Montpellier HSC","Sporting Toulon Var","3-0",3,0,"1",1,3,3,"H"
1989-10-14,1989,"OGC Nice","AS Saint-Etienne","1-3",1,3,"1",1,4,-2,"D"
1989-10-14,1989,"Racing Club de France","Lille OSC","2-0",2,0,"1",1,2,2,"H"
1989-10-21,1989,"Girondins Bordeaux","Olympique Marseille","3-0",3,0,"1",1,3,3,"H"
1989-10-21,1989,"FC Sochaux","Racing Club de France","2-0",2,0,"1",1,2,2,"H"
1989-10-21,1989,"Brest Armorique FC","Toulouse FC","0-0",0,0,"1",1,0,0,"D"
1989-10-21,1989,"Sporting Toulon Var","FC Nantes","0-0",0,0,"1",1,0,0,"D"
1989-10-21,1989,"AS Monaco","FC Mulhouse","0-0",0,0,"1",1,0,0,"D"
1989-10-21,1989,"Paris Saint-Germain","Olympique Lyon","0-1",0,1,"1",1,1,-1,"D"
1989-10-21,1989,"AS Saint-Etienne","FC Metz","4-3",4,3,"1",1,7,1,"H"
1989-10-21,1989,"AS Cannes","AJ Auxerre","2-2",2,2,"1",1,4,0,"D"
1989-10-21,1989,"Lille OSC","Montpellier HSC","1-0",1,0,"1",1,1,1,"H"
1989-10-21,1989,"SM Caen","OGC Nice","1-1",1,1,"1",1,2,0,"D"
1989-10-26,1989,"Toulouse FC","AS Monaco","0-1",0,1,"1",1,1,-1,"D"
1989-10-27,1989,"Olympique Marseille","Paris Saint-Germain","2-1",2,1,"1",1,3,1,"H"
1989-10-28,1989,"Olympique Lyon","Girondins Bordeaux","0-0",0,0,"1",1,0,0,"D"
1989-10-28,1989,"FC Sochaux","SM Caen","5-0",5,0,"1",1,5,5,"H"
1989-10-28,1989,"FC Nantes","AS Cannes","1-0",1,0,"1",1,1,1,"H"
1989-10-28,1989,"Montpellier HSC","AS Saint-Etienne","3-3",3,3,"1",1,6,0,"D"
1989-10-28,1989,"Racing Club de France","Sporting Toulon Var","0-2",0,2,"1",1,2,-2,"D"
1989-10-28,1989,"AJ Auxerre","FC Mulhouse","3-1",3,1,"1",1,4,2,"H"
1989-10-28,1989,"FC Metz","Lille OSC","1-1",1,1,"1",1,2,0,"D"
1989-10-28,1989,"OGC Nice","Brest Armorique FC","0-1",0,1,"1",1,1,-1,"D"
1989-11-04,1989,"Girondins Bordeaux","FC Nantes","3-0",3,0,"1",1,3,3,"H"
1989-11-04,1989,"FC Mulhouse","Olympique Marseille","1-2",1,2,"1",1,3,-1,"D"
1989-11-04,1989,"Lille OSC","FC Sochaux","5-0",5,0,"1",1,5,5,"H"
1989-11-04,1989,"AS Cannes","Toulouse FC","2-2",2,2,"1",1,4,0,"D"
1989-11-04,1989,"AS Monaco","OGC Nice","1-0",1,0,"1",1,1,1,"H"
1989-11-04,1989,"Paris Saint-Germain","AJ Auxerre","1-1",1,1,"1",1,2,0,"D"
1989-11-04,1989,"Sporting Toulon Var","Olympique Lyon","1-1",1,1,"1",1,2,0,"D"
1989-11-04,1989,"AS Saint-Etienne","Racing Club de France","0-1",0,1,"1",1,1,-1,"D"
1989-11-04,1989,"SM Caen","Montpellier HSC","3-2",3,2,"1",1,5,1,"H"
1989-11-04,1989,"Brest Armorique FC","FC Metz","2-0",2,0,"1",1,2,2,"H"
1989-11-07,1989,"Toulouse FC","Girondins Bordeaux","0-1",0,1,"1",1,1,-1,"D"
1989-11-08,1989,"Olympique Marseille","AJ Auxerre","1-1",1,1,"1",1,2,0,"D"
1989-11-08,1989,"FC Sochaux","AS Saint-Etienne","2-3",2,3,"1",1,5,-1,"D"
1989-11-08,1989,"FC Metz","AS Monaco","1-0",1,0,"1",1,1,1,"H"
1989-11-08,1989,"Olympique Lyon","FC Mulhouse","3-1",3,1,"1",1,4,2,"H"
1989-11-08,1989,"FC Nantes","Paris Saint-Germain","0-1",0,1,"1",1,1,-1,"D"
1989-11-08,1989,"Lille OSC","Sporting Toulon Var","3-0",3,0,"1",1,3,3,"H"
1989-11-08,1989,"Racing Club de France","SM Caen","0-0",0,0,"1",1,0,0,"D"
1989-11-08,1989,"Montpellier HSC","Brest Armorique FC","1-1",1,1,"1",1,2,0,"D"
1989-11-08,1989,"OGC Nice","AS Cannes","2-0",2,0,"1",1,2,2,"H"
1989-11-11,1989,"Girondins Bordeaux","OGC Nice","3-0",3,0,"1",1,3,3,"H"
1989-11-11,1989,"SM Caen","Olympique Marseille","0-2",0,2,"1",1,2,-2,"D"
1989-11-11,1989,"Paris Saint-Germain","Toulouse FC","0-1",0,1,"1",1,1,-1,"D"
1989-11-11,1989,"Sporting Toulon Var","FC Sochaux","2-1",2,1,"1",1,3,1,"H"
1989-11-11,1989,"AS Monaco","Montpellier HSC","1-0",1,0,"1",1,1,1,"H"
1989-11-11,1989,"AJ Auxerre","Olympique Lyon","0-1",0,1,"1",1,1,-1,"D"
1989-11-11,1989,"FC Mulhouse","FC Nantes","0-2",0,2,"1",1,2,-2,"D"
1989-11-11,1989,"AS Saint-Etienne","Lille OSC","2-1",2,1,"1",1,3,1,"H"
1989-11-11,1989,"AS Cannes","FC Metz","1-0",1,0,"1",1,1,1,"H"
1989-11-11,1989,"Brest Armorique FC","Racing Club de France","2-0",2,0,"1",1,2,2,"H"
1989-11-22,1989,"AS Monaco","Olympique Marseille","1-3",1,3,"1",1,4,-2,"D"
1989-11-24,1989,"Racing Club de France","Girondins Bordeaux","1-3",1,3,"1",1,4,-2,"D"
1989-11-25,1989,"FC Nantes","Olympique Marseille","0-0",0,0,"1",1,0,0,"D"
1989-11-25,1989,"FC Sochaux","AS Monaco","1-0",1,0,"1",1,1,1,"H"
1989-11-25,1989,"Toulouse FC","Olympique Lyon","0-0",0,0,"1",1,0,0,"D"
1989-11-25,1989,"AS Saint-Etienne","SM Caen","0-0",0,0,"1",1,0,0,"D"
1989-11-25,1989,"FC Metz","Paris Saint-Germain","0-1",0,1,"1",1,1,-1,"D"
1989-11-25,1989,"Sporting Toulon Var","AS Cannes","0-1",0,1,"1",1,1,-1,"D"
1989-11-25,1989,"Lille OSC","Brest Armorique FC","1-2",1,2,"1",1,3,-1,"D"
1989-11-25,1989,"OGC Nice","AJ Auxerre","1-1",1,1,"1",1,2,0,"D"
1989-11-25,1989,"Montpellier HSC","FC Mulhouse","3-3",3,3,"1",1,6,0,"D"
1989-12-01,1989,"AJ Auxerre","FC Metz","1-1",1,1,"1",1,2,0,"D"
1989-12-02,1989,"Paris Saint-Germain","FC Sochaux","1-0",1,0,"1",1,1,1,"H"
1989-12-03,1989,"Girondins Bordeaux","Montpellier HSC","2-0",2,0,"1",1,2,2,"H"
1989-12-03,1989,"Olympique Marseille","Toulouse FC","6-1",6,1,"1",1,7,5,"H"
1989-12-03,1989,"AS Monaco","Lille OSC","1-1",1,1,"1",1,2,0,"D"
1989-12-03,1989,"Brest Armorique FC","AS Saint-Etienne","0-0",0,0,"1",1,0,0,"D"
1989-12-03,1989,"SM Caen","Sporting Toulon Var","2-2",2,2,"1",1,4,0,"D"
1989-12-03,1989,"AS Cannes","Racing Club de France","3-1",3,1,"1",1,4,2,"H"
1989-12-03,1989,"FC Mulhouse","OGC Nice","1-0",1,0,"1",1,1,1,"H"
1989-12-09,1989,"AS Saint-Etienne","AS Monaco","0-2",0,2,"1",1,2,-2,"D"
1989-12-10,1989,"FC Sochaux","Girondins Bordeaux","2-0",2,0,"1",1,2,2,"H"
1989-12-10,1989,"FC Metz","Olympique Marseille","3-2",3,2,"1",1,5,1,"H"
1989-12-10,1989,"Toulouse FC","AJ Auxerre","1-1",1,1,"1",1,2,0,"D"
1989-12-10,1989,"Montpellier HSC","Paris Saint-Germain","2-0",2,0,"1",1,2,2,"H"
1989-12-10,1989,"OGC Nice","Olympique Lyon","1-0",1,0,"1",1,1,1,"H"
1989-12-10,1989,"Sporting Toulon Var","FC Mulhouse","2-1",2,1,"1",1,3,1,"H"
1989-12-10,1989,"Lille OSC","AS Cannes","2-1",2,1,"1",1,3,1,"H"
1989-12-10,1989,"Racing Club de France","FC Nantes","2-1",2,1,"1",1,3,1,"H"
1989-12-10,1989,"SM Caen","Brest Armorique FC","2-1",2,1,"1",1,3,1,"H"
1989-12-16,1989,"FC Nantes","Toulouse FC","0-1",0,1,"1",1,1,-1,"D"
1989-12-17,1989,"Girondins Bordeaux","Lille OSC","3-1",3,1,"1",1,4,2,"H"
1989-12-17,1989,"Olympique Marseille","OGC Nice","3-0",3,0,"1",1,3,3,"H"
1989-12-17,1989,"AS Cannes","FC Sochaux","1-1",1,1,"1",1,2,0,"D"
1989-12-17,1989,"AS Monaco","SM Caen","2-1",2,1,"1",1,3,1,"H"
1989-12-17,1989,"Paris Saint-Germain","AS Saint-Etienne","2-0",2,0,"1",1,2,2,"H"
1989-12-17,1989,"Olympique Lyon","FC Metz","0-0",0,0,"1",1,0,0,"D"
1989-12-17,1989,"AJ Auxerre","Montpellier HSC","2-1",2,1,"1",1,3,1,"H"
1989-12-17,1989,"Brest Armorique FC","Sporting Toulon Var","2-1",2,1,"1",1,3,1,"H"
1989-12-17,1989,"FC Mulhouse","Racing Club de France","4-2",4,2,"1",1,6,2,"H"
1990-02-04,1989,"AS Saint-Etienne","Girondins Bordeaux","1-1",1,1,"1",1,2,0,"D"
1990-02-04,1989,"Montpellier HSC","Olympique Marseille","1-1",1,1,"1",1,2,0,"D"
1990-02-04,1989,"FC Sochaux","Olympique Lyon","1-0",1,0,"1",1,1,1,"H"
1990-02-04,1989,"Brest Armorique FC","AS Monaco","1-1",1,1,"1",1,2,0,"D"
1990-02-04,1989,"Sporting Toulon Var","Toulouse FC","0-0",0,0,"1",1,0,0,"D"
1990-02-04,1989,"Lille OSC","Paris Saint-Germain","2-0",2,0,"1",1,2,2,"H"
1990-02-04,1989,"OGC Nice","FC Nantes","1-2",1,2,"1",1,3,-1,"D"
1990-02-04,1989,"Racing Club de France","AJ Auxerre","3-1",3,1,"1",1,4,2,"H"
1990-02-04,1989,"SM Caen","AS Cannes","1-0",1,0,"1",1,1,1,"H"
1990-02-04,1989,"FC Metz","FC Mulhouse","1-1",1,1,"1",1,2,0,"D"
1990-02-09,1989,"AS Cannes","AS Saint-Etienne","0-0",0,0,"1",1,0,0,"D"
1990-02-11,1989,"Girondins Bordeaux","SM Caen","2-1",2,1,"1",1,3,1,"H"
1990-02-11,1989,"Olympique Marseille","Racing Club de France","4-1",4,1,"1",1,5,3,"H"
1990-02-11,1989,"AJ Auxerre","FC Sochaux","1-1",1,1,"1",1,2,0,"D"
1990-02-11,1989,"AS Monaco","Sporting Toulon Var","2-1",2,1,"1",1,3,1,"H"
1990-02-11,1989,"Toulouse FC","OGC Nice","0-1",0,1,"1",1,1,-1,"D"
1990-02-11,1989,"Paris Saint-Germain","Brest Armorique FC","3-1",3,1,"1",1,4,2,"H"
1990-02-11,1989,"Olympique Lyon","Montpellier HSC","3-1",3,1,"1",1,4,2,"H"
1990-02-11,1989,"FC Nantes","FC Metz","0-0",0,0,"1",1,0,0,"D"
1990-02-11,1989,"FC Mulhouse","Lille OSC","2-1",2,1,"1",1,3,1,"H"
1990-02-21,1989,"Brest Armorique FC","Girondins Bordeaux","2-0",2,0,"1",1,2,2,"H"
1990-02-21,1989,"AS Monaco","AS Cannes","0-0",0,0,"1",1,0,0,"D"
1990-02-21,1989,"Sporting Toulon Var","Paris Saint-Germain","0-3",0,3,"1",1,3,-3,"D"
1990-02-21,1989,"Racing Club de France","Olympique Lyon","0-1",0,1,"1",1,1,-1,"D"
1990-02-21,1989,"FC Metz","Toulouse FC","3-0",3,0,"1",1,3,3,"H"
1990-02-21,1989,"AS Saint-Etienne","FC Mulhouse","3-0",3,0,"1",1,3,3,"H"
1990-02-21,1989,"Lille OSC","OGC Nice","1-1",1,1,"1",1,2,0,"D"
1990-02-21,1989,"Montpellier HSC","FC Nantes","2-1",2,1,"1",1,3,1,"H"
1990-02-21,1989,"SM Caen","AJ Auxerre","1-0",1,0,"1",1,1,1,"H"
1990-02-25,1989,"Girondins Bordeaux","Sporting Toulon Var","2-1",2,1,"1",1,3,1,"H"
1990-02-25,1989,"Olympique Marseille","AS Monaco","2-2",2,2,"1",1,4,0,"D"
1990-02-25,1989,"FC Mulhouse","FC Sochaux","1-2",1,2,"1",1,3,-1,"D"
1990-02-25,1989,"Paris Saint-Germain","Racing Club de France","1-2",1,2,"1",1,3,-1,"D"
1990-02-25,1989,"Olympique Lyon","AS Saint-Etienne","0-0",0,0,"1",1,0,0,"D"
1990-02-25,1989,"Toulouse FC","Montpellier HSC","0-0",0,0,"1",1,0,0,"D"
1990-02-25,1989,"AJ Auxerre","Lille OSC","3-0",3,0,"1",1,3,3,"H"
1990-02-25,1989,"FC Nantes","SM Caen","0-0",0,0,"1",1,0,0,"D"
1990-02-25,1989,"OGC Nice","FC Metz","0-0",0,0,"1",1,0,0,"D"
1990-02-25,1989,"AS Cannes","Brest Armorique FC","1-1",1,1,"1",1,2,0,"D"
1990-03-02,1989,"AS Monaco","Paris Saint-Germain","2-0",2,0,"1",1,2,2,"H"
1990-03-03,1989,"AS Cannes","Girondins Bordeaux","3-0",3,0,"1",1,3,3,"H"
1990-03-03,1989,"FC Sochaux","FC Nantes","1-3",1,3,"1",1,4,-2,"D"
1990-03-03,1989,"Lille OSC","Olympique Lyon","0-0",0,0,"1",1,0,0,"D"
1990-03-03,1989,"Racing Club de France","Toulouse FC","1-0",1,0,"1",1,1,1,"H"
1990-03-03,1989,"Brest Armorique FC","FC Mulhouse","2-0",2,0,"1",1,2,2,"H"
1990-03-03,1989,"SM Caen","FC Metz","1-0",1,0,"1",1,1,1,"H"
1990-03-03,1989,"Sporting Toulon Var","AJ Auxerre","1-0",1,0,"1",1,1,1,"H"
1990-03-03,1989,"Montpellier HSC","OGC Nice","1-0",1,0,"1",1,1,1,"H"
1990-03-13,1989,"Olympique Lyon","FC Nantes","0-0",0,0,"1",1,0,0,"D"
1990-03-14,1989,"FC Sochaux","Olympique Marseille","0-2",0,2,"1",1,2,-2,"D"
1990-03-15,1989,"Girondins Bordeaux","AS Monaco","0-0",0,0,"1",1,0,0,"D"
1990-03-15,1989,"AJ Auxerre","AS Saint-Etienne","2-1",2,1,"1",1,3,1,"H"
1990-03-17,1989,"Olympique Marseille","Sporting Toulon Var","3-0",3,0,"1",1,3,3,"H"
1990-03-17,1989,"Toulouse FC","FC Sochaux","0-0",0,0,"1",1,0,0,"D"
1990-03-17,1989,"Olympique Lyon","Brest Armorique FC","4-0",4,0,"1",1,4,4,"H"
1990-03-17,1989,"Paris Saint-Germain","AS Cannes","5-1",5,1,"1",1,6,4,"H"
1990-03-17,1989,"FC Nantes","Lille OSC","1-0",1,0,"1",1,1,1,"H"
1990-03-17,1989,"FC Mulhouse","SM Caen","0-0",0,0,"1",1,0,0,"D"
1990-03-17,1989,"FC Metz","Montpellier HSC","1-0",1,0,"1",1,1,1,"H"
1990-03-17,1989,"OGC Nice","Racing Club de France","2-0",2,0,"1",1,2,2,"H"
1990-03-24,1989,"Girondins Bordeaux","Paris Saint-Germain","3-0",3,0,"1",1,3,3,"H"
1990-03-24,1989,"Brest Armorique FC","Olympique Marseille","2-1",2,1,"1",1,3,1,"H"
1990-03-24,1989,"AS Monaco","AJ Auxerre","2-4",2,4,"1",1,6,-2,"D"
1990-03-24,1989,"FC Sochaux","OGC Nice","1-1",1,1,"1",1,2,0,"D"
1990-03-24,1989,"SM Caen","Olympique Lyon","1-1",1,1,"1",1,2,0,"D"
1990-03-24,1989,"AS Saint-Etienne","FC Nantes","0-0",0,0,"1",1,0,0,"D"
1990-03-24,1989,"Lille OSC","Toulouse FC","3-0",3,0,"1",1,3,3,"H"
1990-03-24,1989,"Sporting Toulon Var","FC Metz","1-1",1,1,"1",1,2,0,"D"
1990-03-24,1989,"AS Cannes","FC Mulhouse","4-1",4,1,"1",1,5,3,"H"
1990-03-24,1989,"Racing Club de France","Montpellier HSC","0-0",0,0,"1",1,0,0,"D"
1990-03-31,1989,"FC Mulhouse","Girondins Bordeaux","0-0",0,0,"1",1,0,0,"D"
1990-03-31,1989,"Olympique Marseille","Lille OSC","4-1",4,1,"1",1,5,3,"H"
1990-03-31,1989,"FC Nantes","AS Monaco","0-0",0,0,"1",1,0,0,"D"
1990-03-31,1989,"Montpellier HSC","FC Sochaux","2-0",2,0,"1",1,2,2,"H"
1990-03-31,1989,"Olympique Lyon","AS Cannes","0-1",0,1,"1",1,1,-1,"D"
1990-03-31,1989,"Paris Saint-Germain","SM Caen","3-1",3,1,"1",1,4,2,"H"
1990-03-31,1989,"AJ Auxerre","Brest Armorique FC","3-1",3,1,"1",1,4,2,"H"
1990-03-31,1989,"Toulouse FC","AS Saint-Etienne","1-1",1,1,"1",1,2,0,"D"
1990-03-31,1989,"FC Metz","Racing Club de France","0-0",0,0,"1",1,0,0,"D"
1990-03-31,1989,"OGC Nice","Sporting Toulon Var","1-2",1,2,"1",1,3,-1,"D"
1990-04-06,1989,"Brest Armorique FC","FC Nantes","3-2",3,2,"1",1,5,1,"H"
1990-04-07,1989,"SM Caen","Toulouse FC","0-1",0,1,"1",1,1,-1,"D"
1990-04-07,1989,"AS Saint-Etienne","OGC Nice","0-0",0,0,"1",1,0,0,"D"
1990-04-07,1989,"Sporting Toulon Var","Montpellier HSC","3-0",3,0,"1",1,3,3,"H"
1990-04-07,1989,"Lille OSC","Racing Club de France","2-1",2,1,"1",1,3,1,"H"
1990-04-07,1989,"Girondins Bordeaux","AJ Auxerre","0-1",0,1,"1",1,1,-1,"D"
1990-04-07,1989,"AS Cannes","Olympique Marseille","2-2",2,2,"1",1,4,0,"D"
1990-04-07,1989,"AS Monaco","Olympique Lyon","1-0",1,0,"1",1,1,1,"H"
1990-04-07,1989,"Paris Saint-Germain","FC Mulhouse","1-0",1,0,"1",1,1,1,"H"
1990-04-07,1989,"FC Sochaux","FC Metz","0-0",0,0,"1",1,0,0,"D"
1990-04-14,1989,"Olympique Marseille","Girondins Bordeaux","2-0",2,0,"1",1,2,2,"H"
1990-04-14,1989,"FC Mulhouse","AS Monaco","1-1",1,1,"1",1,2,0,"D"
1990-04-14,1989,"Olympique Lyon","Paris Saint-Germain","1-2",1,2,"1",1,3,-1,"D"
1990-04-14,1989,"Racing Club de France","FC Sochaux","1-1",1,1,"1",1,2,0,"D"
1990-04-14,1989,"AJ Auxerre","AS Cannes","1-0",1,0,"1",1,1,1,"H"
1990-04-14,1989,"FC Nantes","Sporting Toulon Var","4-0",4,0,"1",1,4,4,"H"
1990-04-14,1989,"Toulouse FC","Brest Armorique FC","2-1",2,1,"1",1,3,1,"H"
1990-04-14,1989,"FC Metz","AS Saint-Etienne","1-0",1,0,"1",1,1,1,"H"
1990-04-14,1989,"Montpellier HSC","Lille OSC","5-0",5,0,"1",1,5,5,"H"
1990-04-14,1989,"OGC Nice","SM Caen","1-0",1,0,"1",1,1,1,"H"
1990-04-20,1989,"Girondins Bordeaux","Olympique Lyon","2-0",2,0,"1",1,2,2,"H"
1990-04-21,1989,"Paris Saint-Germain","Olympique Marseille","2-1",2,1,"1",1,3,1,"H"
1990-04-21,1989,"AS Monaco","Toulouse FC","2-0",2,0,"1",1,2,2,"H"
1990-04-21,1989,"FC Mulhouse","AJ Auxerre","1-2",1,2,"1",1,3,-1,"D"
1990-04-21,1989,"SM Caen","FC Sochaux","1-1",1,1,"1",1,2,0,"D"
1990-04-21,1989,"AS Cannes","FC Nantes","2-1",2,1,"1",1,3,1,"H"
1990-04-21,1989,"Brest Armorique FC","OGC Nice","3-0",3,0,"1",1,3,3,"H"
1990-04-21,1989,"Lille OSC","FC Metz","2-1",2,1,"1",1,3,1,"H"
1990-04-21,1989,"AS Saint-Etienne","Montpellier HSC","1-0",1,0,"1",1,1,1,"H"
1990-04-21,1989,"Sporting Toulon Var","Racing Club de France","1-0",1,0,"1",1,1,1,"H"
1990-04-25,1989,"AS Saint-Etienne","Olympique Marseille","0-0",0,0,"1",1,0,0,"D"
1990-04-28,1989,"Olympique Marseille","FC Mulhouse","3-1",3,1,"1",1,4,2,"H"
1990-04-28,1989,"FC Nantes","Girondins Bordeaux","2-1",2,1,"1",1,3,1,"H"
1990-04-28,1989,"OGC Nice","AS Monaco","1-0",1,0,"1",1,1,1,"H"
1990-04-28,1989,"AJ Auxerre","Paris Saint-Germain","2-0",2,0,"1",1,2,2,"H"
1990-04-28,1989,"FC Sochaux","Lille OSC","1-0",1,0,"1",1,1,1,"H"
1990-04-28,1989,"Toulouse FC","AS Cannes","4-0",4,0,"1",1,4,4,"H"
1990-04-28,1989,"Olympique Lyon","Sporting Toulon Var","3-2",3,2,"1",1,5,1,"H"
1990-04-28,1989,"FC Metz","Brest Armorique FC","1-1",1,1,"1",1,2,0,"D"
1990-04-28,1989,"Racing Club de France","AS Saint-Etienne","3-0",3,0,"1",1,3,3,"H"
1990-04-28,1989,"Montpellier HSC","SM Caen","5-1",5,1,"1",1,6,4,"H"
1990-05-05,1989,"AJ Auxerre","Olympique Marseille","0-2",0,2,"1",1,2,-2,"D"
1990-05-05,1989,"Girondins Bordeaux","Toulouse FC","2-1",2,1,"1",1,3,1,"H"
1990-05-05,1989,"AS Monaco","FC Metz","1-0",1,0,"1",1,1,1,"H"
1990-05-05,1989,"AS Saint-Etienne","FC Sochaux","0-2",0,2,"1",1,2,-2,"D"
1990-05-05,1989,"Paris Saint-Germain","FC Nantes","2-2",2,2,"1",1,4,0,"D"
1990-05-05,1989,"FC Mulhouse","Olympique Lyon","4-4",4,4,"1",1,8,0,"D"
1990-05-05,1989,"Brest Armorique FC","Montpellier HSC","1-1",1,1,"1",1,2,0,"D"
1990-05-05,1989,"AS Cannes","OGC Nice","1-0",1,0,"1",1,1,1,"H"
1990-05-05,1989,"Sporting Toulon Var","Lille OSC","1-1",1,1,"1",1,2,0,"D"
1990-05-05,1989,"SM Caen","Racing Club de France","1-0",1,0,"1",1,1,1,"H"
1990-05-12,1989,"Olympique Marseille","SM Caen","1-0",1,0,"1",1,1,1,"H"
1990-05-12,1989,"OGC Nice","Girondins Bordeaux","1-0",1,0,"1",1,1,1,"H"
1990-05-12,1989,"Montpellier HSC","AS Monaco","0-0",0,0,"1",1,0,0,"D"
1990-05-12,1989,"FC Sochaux","Sporting Toulon Var","1-0",1,0,"1",1,1,1,"H"
1990-05-12,1989,"Olympique Lyon","AJ Auxerre","1-1",1,1,"1",1,2,0,"D"
1990-05-12,1989,"Toulouse FC","Paris Saint-Germain","4-1",4,1,"1",1,5,3,"H"
1990-05-12,1989,"FC Nantes","FC Mulhouse","3-2",3,2,"1",1,5,1,"H"
1990-05-12,1989,"Racing Club de France","Brest Armorique FC","1-1",1,1,"1",1,2,0,"D"
1990-05-12,1989,"FC Metz","AS Cannes","2-2",2,2,"1",1,4,0,"D"
1990-05-12,1989,"Lille OSC","AS Saint-Etienne","2-2",2,2,"1",1,4,0,"D"
1990-05-19,1989,"Olympique Marseille","Olympique Lyon","0-1",0,1,"1",1,1,-1,"D"
1990-05-19,1989,"Girondins Bordeaux","FC Metz","1-0",1,0,"1",1,1,1,"H"
1990-05-19,1989,"AS Monaco","Racing Club de France","4-0",4,0,"1",1,4,4,"H"
1990-05-19,1989,"Brest Armorique FC","FC Sochaux","1-0",1,0,"1",1,1,1,"H"
1990-05-19,1989,"Paris Saint-Germain","OGC Nice","2-1",2,1,"1",1,3,1,"H"
1990-05-19,1989,"AJ Auxerre","FC Nantes","0-0",0,0,"1",1,0,0,"D"
1990-05-19,1989,"FC Mulhouse","Toulouse FC","1-0",1,0,"1",1,1,1,"H"
1990-05-19,1989,"AS Cannes","Montpellier HSC","1-1",1,1,"1",1,2,0,"D"
1990-05-19,1989,"AS Saint-Etienne","Sporting Toulon Var","1-2",1,2,"1",1,3,-1,"D"
1990-05-19,1989,"SM Caen","Lille OSC","2-0",2,0,"1",1,2,2,"H"
1990-07-21,1990,"AS Cannes","Montpellier HSC","2-1",2,1,"1",1,3,1,"H"
1990-07-21,1990,"Paris Saint-Germain","AS Nancy","2-1",2,1,"1",1,3,1,"H"
1990-07-21,1990,"Olympique Marseille","OGC Nice","1-0",1,0,"1",1,1,1,"H"
1990-07-21,1990,"FC Metz","Lille OSC","2-2",2,2,"1",1,4,0,"D"
1990-07-21,1990,"FC Sochaux","Brest Armorique FC","1-1",1,1,"1",1,2,0,"D"
1990-07-21,1990,"Toulouse FC","AJ Auxerre","0-0",0,0,"1",1,0,0,"D"
1990-07-21,1990,"Girondins Bordeaux","Olympique Lyon","0-0",0,0,"1",1,0,0,"D"
1990-07-21,1990,"FC Nantes","SM Caen","0-0",0,0,"1",1,0,0,"D"
1990-07-21,1990,"AS Saint-Etienne","Stade Rennes","0-0",0,0,"1",1,0,0,"D"
1990-07-21,1990,"AS Monaco","Sporting Toulon Var","2-1",2,1,"1",1,3,1,"H"
1990-07-27,1990,"FC Metz","Olympique Marseille","0-2",0,2,"1",1,2,-2,"D"
1990-07-28,1990,"AJ Auxerre","AS Monaco","0-1",0,1,"1",1,1,-1,"D"
1990-07-28,1990,"SM Caen","Girondins Bordeaux","2-0",2,0,"1",1,2,2,"H"
1990-07-28,1990,"Stade Rennes","Paris Saint-Germain","2-1",2,1,"1",1,3,1,"H"
1990-07-28,1990,"Olympique Lyon","AS Cannes","1-0",1,0,"1",1,1,1,"H"
1990-07-28,1990,"Montpellier HSC","FC Sochaux","2-0",2,0,"1",1,2,2,"H"
1990-07-28,1990,"Lille OSC","FC Nantes","1-1",1,1,"1",1,2,0,"D"
1990-07-28,1990,"AS Nancy","Brest Armorique FC","0-0",0,0,"1",1,0,0,"D"
1990-07-28,1990,"OGC Nice","Toulouse FC","1-1",1,1,"1",1,2,0,"D"
1990-07-28,1990,"Sporting Toulon Var","AS Saint-Etienne","3-0",3,0,"1",1,3,3,"H"
1990-08-04,1990,"AS Monaco","Montpellier HSC","3-1",3,1,"1",1,4,2,"H"
1990-08-04,1990,"Olympique Marseille","SM Caen","2-1",2,1,"1",1,3,1,"H"
1990-08-04,1990,"Toulouse FC","Olympique Lyon","3-1",3,1,"1",1,4,2,"H"
1990-08-04,1990,"Brest Armorique FC","Stade Rennes","0-0",0,0,"1",1,0,0,"D"
1990-08-04,1990,"AS Cannes","AJ Auxerre","0-3",0,3,"1",1,3,-3,"D"
1990-08-04,1990,"Girondins Bordeaux","Lille OSC","1-1",1,1,"1",1,2,0,"D"
1990-08-04,1990,"FC Nantes","FC Metz","1-1",1,1,"1",1,2,0,"D"
1990-08-04,1990,"FC Sochaux","AS Nancy","1-0",1,0,"1",1,1,1,"H"
1990-08-04,1990,"AS Saint-Etienne","OGC Nice","1-0",1,0,"1",1,1,1,"H"
1990-08-04,1990,"Paris Saint-Germain","Sporting Toulon Var","4-0",4,0,"1",1,4,4,"H"
1990-08-10,1990,"Montpellier HSC","Paris Saint-Germain","4-0",4,0,"1",1,4,4,"H"
1990-08-10,1990,"OGC Nice","AS Cannes","0-0",0,0,"1",1,0,0,"D"
1990-08-11,1990,"Olympique Lyon","Olympique Marseille","2-2",2,2,"1",1,4,0,"D"
1990-08-11,1990,"FC Nantes","AS Monaco","3-1",3,1,"1",1,4,2,"H"
1990-08-11,1990,"Stade Rennes","AS Nancy","1-0",1,0,"1",1,1,1,"H"
1990-08-11,1990,"AJ Auxerre","AS Saint-Etienne","2-0",2,0,"1",1,2,2,"H"
1990-08-11,1990,"Lille OSC","Toulouse FC","3-0",3,0,"1",1,3,3,"H"
1990-08-11,1990,"SM Caen","FC Sochaux","2-0",2,0,"1",1,2,2,"H"
1990-08-11,1990,"FC Metz","Girondins Bordeaux","1-0",1,0,"1",1,1,1,"H"
1990-08-11,1990,"Sporting Toulon Var","Brest Armorique FC","1-2",1,2,"1",1,3,-1,"D"
1990-08-18,1990,"Olympique Marseille","Lille OSC","2-0",2,0,"1",1,2,2,"H"
1990-08-18,1990,"Brest Armorique FC","OGC Nice","4-0",4,0,"1",1,4,4,"H"
1990-08-18,1990,"AS Monaco","Olympique Lyon","0-0",0,0,"1",1,0,0,"D"
1990-08-18,1990,"Paris Saint-Germain","AJ Auxerre","1-1",1,1,"1",1,2,0,"D"
1990-08-18,1990,"AS Cannes","SM Caen","1-1",1,1,"1",1,2,0,"D"
1990-08-18,1990,"Toulouse FC","FC Metz","2-1",2,1,"1",1,3,1,"H"
1990-08-18,1990,"FC Sochaux","Stade Rennes","4-0",4,0,"1",1,4,4,"H"
1990-08-18,1990,"Girondins Bordeaux","FC Nantes","2-0",2,0,"1",1,2,2,"H"
1990-08-18,1990,"AS Saint-Etienne","Montpellier HSC","1-0",1,0,"1",1,1,1,"H"
1990-08-18,1990,"AS Nancy","Sporting Toulon Var","2-1",2,1,"1",1,3,1,"H"
1990-08-24,1990,"Girondins Bordeaux","AS Monaco","0-0",0,0,"1",1,0,0,"D"
1990-08-25,1990,"FC Nantes","Olympique Marseille","1-1",1,1,"1",1,2,0,"D"
1990-08-25,1990,"AJ Auxerre","Brest Armorique FC","2-2",2,2,"1",1,4,0,"D"
1990-08-25,1990,"SM Caen","Toulouse FC","2-0",2,0,"1",1,2,2,"H"
1990-08-25,1990,"Olympique Lyon","FC Sochaux","1-0",1,0,"1",1,1,1,"H"
1990-08-25,1990,"Montpellier HSC","AS Nancy","5-0",5,0,"1",1,5,5,"H"
1990-08-25,1990,"OGC Nice","Paris Saint-Germain","1-1",1,1,"1",1,2,0,"D"
1990-08-25,1990,"FC Metz","AS Saint-Etienne","3-1",3,1,"1",1,4,2,"H"
1990-08-25,1990,"Lille OSC","AS Cannes","0-2",0,2,"1",1,2,-2,"D"
1990-08-25,1990,"Sporting Toulon Var","Stade Rennes","1-0",1,0,"1",1,1,1,"H"
1990-08-29,1990,"Olympique Marseille","Girondins Bordeaux","2-0",2,0,"1",1,2,2,"H"
1990-08-29,1990,"Brest Armorique FC","Montpellier HSC","1-1",1,1,"1",1,2,0,"D"
1990-08-29,1990,"AS Saint-Etienne","SM Caen","0-0",0,0,"1",1,0,0,"D"
1990-08-29,1990,"AS Monaco","Lille OSC","1-1",1,1,"1",1,2,0,"D"
1990-08-29,1990,"AS Nancy","AJ Auxerre","1-1",1,1,"1",1,2,0,"D"
1990-08-29,1990,"Paris Saint-Germain","Olympique Lyon","3-0",3,0,"1",1,3,3,"H"
1990-08-29,1990,"AS Cannes","FC Metz","0-1",0,1,"1",1,1,-1,"D"
1990-08-29,1990,"Toulouse FC","FC Nantes","2-0",2,0,"1",1,2,2,"H"
1990-08-29,1990,"Stade Rennes","OGC Nice","0-3",0,3,"1",1,3,-3,"D"
1990-08-29,1990,"FC Sochaux","Sporting Toulon Var","0-0",0,0,"1",1,0,0,"D"
1990-09-08,1990,"Olympique Marseille","Paris Saint-Germain","2-1",2,1,"1",1,3,1,"H"
1990-09-08,1990,"SM Caen","AS Nancy","4-1",4,1,"1",1,5,3,"H"
1990-09-08,1990,"AJ Auxerre","Stade Rennes","4-0",4,0,"1",1,4,4,"H"
1990-09-08,1990,"FC Metz","AS Monaco","1-1",1,1,"1",1,2,0,"D"
1990-09-08,1990,"Olympique Lyon","Brest Armorique FC","2-0",2,0,"1",1,2,2,"H"
1990-09-08,1990,"Lille OSC","AS Saint-Etienne","3-2",3,2,"1",1,5,1,"H"
1990-09-08,1990,"Girondins Bordeaux","Toulouse FC","2-1",2,1,"1",1,3,1,"H"
1990-09-08,1990,"FC Nantes","AS Cannes","1-0",1,0,"1",1,1,1,"H"
1990-09-08,1990,"OGC Nice","FC Sochaux","3-0",3,0,"1",1,3,3,"H"
1990-09-08,1990,"Montpellier HSC","Sporting Toulon Var","0-0",0,0,"1",1,0,0,"D"
1990-09-14,1990,"OGC Nice","AS Monaco","0-0",0,0,"1",1,0,0,"D"
1990-09-15,1990,"Toulouse FC","Olympique Marseille","0-2",0,2,"1",1,2,-2,"D"
1990-09-15,1990,"FC Sochaux","AJ Auxerre","0-1",0,1,"1",1,1,-1,"D"
1990-09-15,1990,"Paris Saint-Germain","SM Caen","3-2",3,2,"1",1,5,1,"H"
1990-09-15,1990,"Brest Armorique FC","FC Metz","1-0",1,0,"1",1,1,1,"H"
1990-09-15,1990,"AS Saint-Etienne","Olympique Lyon","0-1",0,1,"1",1,1,-1,"D"
1990-09-15,1990,"Stade Rennes","Montpellier HSC","1-2",1,2,"1",1,3,-1,"D"
1990-09-15,1990,"AS Nancy","FC Nantes","3-2",3,2,"1",1,5,1,"H"
1990-09-15,1990,"AS Cannes","Girondins Bordeaux","1-1",1,1,"1",1,2,0,"D"
1990-09-15,1990,"Sporting Toulon Var","Lille OSC","0-0",0,0,"1",1,0,0,"D"
1990-09-22,1990,"Olympique Marseille","AS Cannes","0-1",0,1,"1",1,1,-1,"D"
1990-09-22,1990,"SM Caen","AS Monaco","0-2",0,2,"1",1,2,-2,"D"
1990-09-22,1990,"Olympique Lyon","Stade Rennes","0-0",0,0,"1",1,0,0,"D"
1990-09-22,1990,"FC Metz","Paris Saint-Germain","2-2",2,2,"1",1,4,0,"D"
1990-09-22,1990,"Lille OSC","Brest Armorique FC","1-0",1,0,"1",1,1,1,"H"
1990-09-22,1990,"FC Nantes","AS Saint-Etienne","2-1",2,1,"1",1,3,1,"H"
1990-09-22,1990,"Girondins Bordeaux","FC Sochaux","1-0",1,0,"1",1,1,1,"H"
1990-09-22,1990,"Toulouse FC","AS Nancy","0-0",0,0,"1",1,0,0,"D"
1990-09-22,1990,"OGC Nice","Sporting Toulon Var","0-0",0,0,"1",1,0,0,"D"
1990-09-23,1990,"AJ Auxerre","Montpellier HSC","3-2",3,2,"1",1,5,1,"H"
1990-09-28,1990,"AS Monaco","Olympique Marseille","1-3",1,3,"1",1,4,-2,"D"
1990-09-29,1990,"Brest Armorique FC","SM Caen","5-0",5,0,"1",1,5,5,"H"
1990-09-29,1990,"Montpellier HSC","OGC Nice","3-0",3,0,"1",1,3,3,"H"
1990-09-29,1990,"Paris Saint-Germain","FC Nantes","1-1",1,1,"1",1,2,0,"D"
1990-09-29,1990,"Stade Rennes","FC Metz","0-2",0,2,"1",1,2,-2,"D"
1990-09-29,1990,"FC Sochaux","Lille OSC","0-0",0,0,"1",1,0,0,"D"
1990-09-29,1990,"AS Nancy","Olympique Lyon","2-0",2,0,"1",1,2,2,"H"
1990-09-29,1990,"AS Saint-Etienne","Girondins Bordeaux","0-0",0,0,"1",1,0,0,"D"
1990-09-29,1990,"AS Cannes","Toulouse FC","0-0",0,0,"1",1,0,0,"D"
1990-09-29,1990,"Sporting Toulon Var","AJ Auxerre","2-3",2,3,"1",1,5,-1,"D"
1990-10-05,1990,"FC Nantes","Brest Armorique FC","1-0",1,0,"1",1,1,1,"H"
1990-10-05,1990,"Lille OSC","Stade Rennes","1-1",1,1,"1",1,2,0,"D"
1990-10-06,1990,"Olympique Marseille","AS Saint-Etienne","3-1",3,1,"1",1,4,2,"H"
1990-10-06,1990,"OGC Nice","AJ Auxerre","1-1",1,1,"1",1,2,0,"D"
1990-10-06,1990,"AS Cannes","AS Monaco","1-2",1,2,"1",1,3,-1,"D"
1990-10-06,1990,"FC Metz","AS Nancy","4-0",4,0,"1",1,4,4,"H"
1990-10-06,1990,"Olympique Lyon","Montpellier HSC","3-3",3,3,"1",1,6,0,"D"
1990-10-06,1990,"SM Caen","Sporting Toulon Var","2-0",2,0,"1",1,2,2,"H"
1990-10-06,1990,"Girondins Bordeaux","Paris Saint-Germain","3-0",3,0,"1",1,3,3,"H"
1990-10-06,1990,"Toulouse FC","FC Sochaux","0-0",0,0,"1",1,0,0,"D"
1990-10-19,1990,"AS Monaco","Toulouse FC","2-1",2,1,"1",1,3,1,"H"
1990-10-19,1990,"Brest Armorique FC","Girondins Bordeaux","4-0",4,0,"1",1,4,4,"H"
1990-10-20,1990,"FC Sochaux","Olympique Marseille","2-1",2,1,"1",1,3,1,"H"
1990-10-20,1990,"AJ Auxerre","Olympique Lyon","1-0",1,0,"1",1,1,1,"H"
1990-10-20,1990,"Montpellier HSC","FC Metz","5-2",5,2,"1",1,7,3,"H"
1990-10-20,1990,"Paris Saint-Germain","Lille OSC","2-0",2,0,"1",1,2,2,"H"
1990-10-20,1990,"Stade Rennes","SM Caen","1-1",1,1,"1",1,2,0,"D"
1990-10-20,1990,"AS Nancy","OGC Nice","2-1",2,1,"1",1,3,1,"H"
1990-10-20,1990,"AS Saint-Etienne","AS Cannes","1-0",1,0,"1",1,1,1,"H"
1990-10-20,1990,"Sporting Toulon Var","FC Nantes","3-1",3,1,"1",1,4,2,"H"
1990-10-26,1990,"SM Caen","AJ Auxerre","0-1",0,1,"1",1,1,-1,"D"
1990-10-27,1990,"Girondins Bordeaux","AS Nancy","5-0",5,0,"1",1,5,5,"H"
1990-10-27,1990,"FC Nantes","Stade Rennes","2-0",2,0,"1",1,2,2,"H"
1990-10-27,1990,"Lille OSC","Montpellier HSC","1-0",1,0,"1",1,1,1,"H"
1990-10-27,1990,"Olympique Lyon","OGC Nice","1-0",1,0,"1",1,1,1,"H"
1990-10-27,1990,"Toulouse FC","AS Saint-Etienne","0-0",0,0,"1",1,0,0,"D"
1990-10-27,1990,"AS Cannes","FC Sochaux","1-1",1,1,"1",1,2,0,"D"
1990-10-27,1990,"FC Metz","Sporting Toulon Var","0-0",0,0,"1",1,0,0,"D"
1990-10-28,1990,"AS Monaco","Paris Saint-Germain","2-0",2,0,"1",1,2,2,"H"
1990-10-28,1990,"Olympique Marseille","Brest Armorique FC","3-1",3,1,"1",1,4,2,"H"
1990-11-02,1990,"Stade Rennes","Girondins Bordeaux","2-1",2,1,"1",1,3,1,"H"
1990-11-02,1990,"Montpellier HSC","SM Caen","0-0",0,0,"1",1,0,0,"D"
1990-11-03,1990,"AJ Auxerre","Lille OSC","3-2",3,2,"1",1,5,1,"H"
1990-11-03,1990,"AS Nancy","Olympique Marseille","2-0",2,0,"1",1,2,2,"H"
1990-11-03,1990,"AS Saint-Etienne","AS Monaco","1-0",1,0,"1",1,1,1,"H"
1990-11-03,1990,"OGC Nice","FC Metz","1-2",1,2,"1",1,3,-1,"D"
1990-11-03,1990,"Brest Armorique FC","Toulouse FC","0-0",0,0,"1",1,0,0,"D"
1990-11-03,1990,"FC Sochaux","FC Nantes","1-1",1,1,"1",1,2,0,"D"
1990-11-03,1990,"Paris Saint-Germain","AS Cannes","0-0",0,0,"1",1,0,0,"D"
1990-11-03,1990,"Sporting Toulon Var","Olympique Lyon","1-0",1,0,"1",1,1,1,"H"
1990-11-10,1990,"AS Monaco","FC Sochaux","1-0",1,0,"1",1,1,1,"H"
1990-11-10,1990,"AS Cannes","Brest Armorique FC","0-0",0,0,"1",1,0,0,"D"
1990-11-10,1990,"SM Caen","Olympique Lyon","1-0",1,0,"1",1,1,1,"H"
1990-11-10,1990,"FC Nantes","Montpellier HSC","1-1",1,1,"1",1,2,0,"D"
1990-11-10,1990,"Lille OSC","OGC Nice","0-0",0,0,"1",1,0,0,"D"
1990-11-10,1990,"Toulouse FC","Paris Saint-Germain","2-1",2,1,"1",1,3,1,"H"
1990-11-10,1990,"AS Saint-Etienne","AS Nancy","4-1",4,1,"1",1,5,3,"H"
1990-11-10,1990,"FC Metz","AJ Auxerre","1-0",1,0,"1",1,1,1,"H"
1990-11-10,1990,"Girondins Bordeaux","Sporting Toulon Var","0-1",0,1,"1",1,1,-1,"D"
1990-11-11,1990,"Olympique Marseille","Stade Rennes","4-1",4,1,"1",1,5,3,"H"
1990-11-23,1990,"Brest Armorique FC","AS Monaco","1-2",1,2,"1",1,3,-1,"D"
1990-11-24,1990,"AJ Auxerre","FC Nantes","0-2",0,2,"1",1,2,-2,"D"
1990-11-24,1990,"FC Sochaux","FC Metz","1-1",1,1,"1",1,2,0,"D"
1990-11-24,1990,"Montpellier HSC","Girondins Bordeaux","2-1",2,1,"1",1,3,1,"H"
1990-11-24,1990,"OGC Nice","SM Caen","0-0",0,0,"1",1,0,0,"D"
1990-11-24,1990,"Paris Saint-Germain","AS Saint-Etienne","4-2",4,2,"1",1,6,2,"H"
1990-11-24,1990,"Olympique Lyon","Lille OSC","2-1",2,1,"1",1,3,1,"H"
1990-11-24,1990,"Stade Rennes","Toulouse FC","2-0",2,0,"1",1,2,2,"H"
1990-11-24,1990,"AS Nancy","AS Cannes","2-0",2,0,"1",1,2,2,"H"
1990-11-24,1990,"Sporting Toulon Var","Olympique Marseille","0-1",0,1,"1",1,1,-1,"D"
1990-12-02,1990,"Olympique Marseille","Montpellier HSC","2-0",2,0,"1",1,2,2,"H"
1990-12-02,1990,"Girondins Bordeaux","AJ Auxerre","1-1",1,1,"1",1,2,0,"D"
1990-12-02,1990,"AS Monaco","AS Nancy","2-2",2,2,"1",1,4,0,"D"
1990-12-02,1990,"FC Metz","Olympique Lyon","1-2",1,2,"1",1,3,-1,"D"
1990-12-02,1990,"FC Nantes","OGC Nice","2-2",2,2,"1",1,4,0,"D"
1990-12-02,1990,"Lille OSC","SM Caen","1-0",1,0,"1",1,1,1,"H"
1990-12-02,1990,"AS Saint-Etienne","Brest Armorique FC","6-1",6,1,"1",1,7,5,"H"
1990-12-02,1990,"Paris Saint-Germain","FC Sochaux","0-2",0,2,"1",1,2,-2,"D"
1990-12-02,1990,"AS Cannes","Stade Rennes","1-0",1,0,"1",1,1,1,"H"
1990-12-02,1990,"Toulouse FC","Sporting Toulon Var","1-1",1,1,"1",1,2,0,"D"
1990-12-07,1990,"Stade Rennes","AS Monaco","1-1",1,1,"1",1,2,0,"D"
1990-12-07,1990,"OGC Nice","Girondins Bordeaux","0-0",0,0,"1",1,0,0,"D"
1990-12-09,1990,"AJ Auxerre","Olympique Marseille","4-0",4,0,"1",1,4,4,"H"
1990-12-09,1990,"Montpellier HSC","Toulouse FC","2-0",2,0,"1",1,2,2,"H"
1990-12-09,1990,"SM Caen","FC Metz","4-1",4,1,"1",1,5,3,"H"
1990-12-09,1990,"AS Nancy","Lille OSC","1-1",1,1,"1",1,2,0,"D"
1990-12-09,1990,"FC Sochaux","AS Saint-Etienne","2-0",2,0,"1",1,2,2,"H"
1990-12-09,1990,"Sporting Toulon Var","AS Cannes","0-0",0,0,"1",1,0,0,"D"
1990-12-16,1990,"Olympique Marseille","FC Metz","3-0",3,0,"1",1,3,3,"H"
1990-12-16,1990,"AS Monaco","AJ Auxerre","0-0",0,0,"1",1,0,0,"D"
1990-12-16,1990,"Girondins Bordeaux","SM Caen","1-1",1,1,"1",1,2,0,"D"
1990-12-16,1990,"FC Nantes","Lille OSC","0-0",0,0,"1",1,0,0,"D"
1990-12-16,1990,"AS Cannes","Olympique Lyon","3-2",3,2,"1",1,5,1,"H"
1990-12-16,1990,"Brest Armorique FC","AS Nancy","3-3",3,3,"1",1,6,0,"D"
1990-12-16,1990,"Paris Saint-Germain","Stade Rennes","1-1",1,1,"1",1,2,0,"D"
1990-12-16,1990,"Toulouse FC","OGC Nice","1-2",1,2,"1",1,3,-1,"D"
1990-12-21,1990,"AJ Auxerre","AS Cannes","0-3",0,3,"1",1,3,-3,"D"
1990-12-22,1990,"Sporting Toulon Var","Paris Saint-Germain","0-0",0,0,"1",1,0,0,"D"
1990-12-23,1990,"SM Caen","Olympique Marseille","0-0",0,0,"1",1,0,0,"D"
1990-12-23,1990,"Montpellier HSC","AS Monaco","2-1",2,1,"1",1,3,1,"H"
1990-12-23,1990,"Olympique Lyon","Toulouse FC","4-1",4,1,"1",1,5,3,"H"
1990-12-23,1990,"Lille OSC","Girondins Bordeaux","0-0",0,0,"1",1,0,0,"D"
1990-12-23,1990,"Stade Rennes","Brest Armorique FC","3-0",3,0,"1",1,3,3,"H"
1990-12-23,1990,"OGC Nice","AS Saint-Etienne","2-0",2,0,"1",1,2,2,"H"
1991-01-13,1990,"Olympique Marseille","Olympique Lyon","7-0",7,0,"1",1,7,7,"H"
1991-01-13,1990,"AS Monaco","FC Nantes","2-1",2,1,"1",1,3,1,"H"
1991-01-13,1990,"AS Saint-Etienne","AJ Auxerre","2-1",2,1,"1",1,3,1,"H"
1991-01-13,1990,"Paris Saint-Germain","Montpellier HSC","2-0",2,0,"1",1,2,2,"H"
1991-01-13,1990,"FC Sochaux","SM Caen","1-0",1,0,"1",1,1,1,"H"
1991-01-13,1990,"AS Cannes","OGC Nice","2-1",2,1,"1",1,3,1,"H"
1991-01-13,1990,"Toulouse FC","Lille OSC","2-2",2,2,"1",1,4,0,"D"
1991-01-13,1990,"Girondins Bordeaux","FC Metz","1-1",1,1,"1",1,2,0,"D"
1991-01-13,1990,"AS Nancy","Stade Rennes","0-0",0,0,"1",1,0,0,"D"
1991-01-13,1990,"Stade Brest","Sporting Toulon Var","2-2",2,2,"1",1,4,0,"D"
1991-01-18,1990,"Olympique Lyon","AS Monaco","1-0",1,0,"1",1,1,1,"H"
1991-01-19,1990,"FC Nantes","Girondins Bordeaux","0-0",0,0,"1",1,0,0,"D"
1991-01-20,1990,"Lille OSC","Olympique Marseille","1-0",1,0,"1",1,1,1,"H"
1991-01-20,1990,"AJ Auxerre","Paris Saint-Germain","0-1",0,1,"1",1,1,-1,"D"
1991-01-20,1990,"Montpellier HSC","AS Saint-Etienne","0-0",0,0,"1",1,0,0,"D"
1991-01-20,1990,"SM Caen","AS Cannes","0-1",0,1,"1",1,1,-1,"D"
1991-01-20,1990,"FC Metz","Toulouse FC","2-1",2,1,"1",1,3,1,"H"
1991-01-20,1990,"Stade Rennes","FC Sochaux","1-1",1,1,"1",1,2,0,"D"
1991-01-20,1990,"OGC Nice","Stade Brest","2-0",2,0,"1",1,2,2,"H"
1991-01-20,1990,"Sporting Toulon Var","AS Nancy","2-0",2,0,"1",1,2,2,"H"
1991-01-23,1990,"Stade Brest","Paris Saint-Germain","0-0",0,0,"1",1,0,0,"D"
1991-01-23,1990,"FC Sochaux","Montpellier HSC","0-0",0,0,"1",1,0,0,"D"
1991-01-23,1990,"AS Saint-Etienne","Sporting Toulon Var","3-0",3,0,"1",1,3,3,"H"
1991-01-23,1990,"FC Metz","FC Nantes","2-0",2,0,"1",1,2,2,"H"
1991-01-26,1990,"Toulouse FC","SM Caen","3-2",3,2,"1",1,5,1,"H"
1991-01-27,1990,"Olympique Marseille","FC Nantes","6-0",6,0,"1",1,6,6,"H"
1991-01-27,1990,"AS Monaco","Girondins Bordeaux","2-0",2,0,"1",1,2,2,"H"
1991-01-27,1990,"Stade Brest","AJ Auxerre","1-3",1,3,"1",1,4,-2,"D"
1991-01-27,1990,"AS Nancy","Montpellier HSC","1-1",1,1,"1",1,2,0,"D"
1991-01-27,1990,"AS Cannes","Lille OSC","2-1",2,1,"1",1,3,1,"H"
1991-01-27,1990,"AS Saint-Etienne","FC Metz","2-1",2,1,"1",1,3,1,"H"
1991-01-27,1990,"FC Sochaux","Olympique Lyon","1-2",1,2,"1",1,3,-1,"D"
1991-01-27,1990,"Paris Saint-Germain","OGC Nice","0-2",0,2,"1",1,2,-2,"D"
1991-01-27,1990,"Stade Rennes","Sporting Toulon Var","0-0",0,0,"1",1,0,0,"D"
1991-01-30,1990,"Olympique Lyon","FC Nantes","2-0",2,0,"1",1,2,2,"H"
1991-01-30,1990,"AS Nancy","FC Sochaux","2-0",2,0,"1",1,2,2,"H"
1991-02-01,1990,"Girondins Bordeaux","Olympique Marseille","1-1",1,1,"1",1,2,0,"D"
1991-02-02,1990,"SM Caen","AS Saint-Etienne","1-0",1,0,"1",1,1,1,"H"
1991-02-03,1990,"Lille OSC","AS Monaco","0-0",0,0,"1",1,0,0,"D"
1991-02-03,1990,"AJ Auxerre","AS Nancy","1-1",1,1,"1",1,2,0,"D"
1991-02-03,1990,"Montpellier HSC","Stade Brest","1-0",1,0,"1",1,1,1,"H"
1991-02-03,1990,"Olympique Lyon","Paris Saint-Germain","0-0",0,0,"1",1,0,0,"D"
1991-02-03,1990,"FC Metz","AS Cannes","0-0",0,0,"1",1,0,0,"D"
1991-02-03,1990,"OGC Nice","Stade Rennes","2-2",2,2,"1",1,4,0,"D"
1991-02-03,1990,"FC Nantes","Toulouse FC","0-0",0,0,"1",1,0,0,"D"
1991-02-03,1990,"Sporting Toulon Var","FC Sochaux","1-0",1,0,"1",1,1,1,"H"
1991-02-08,1990,"Sporting Toulon Var","Montpellier HSC","1-1",1,1,"1",1,2,0,"D"
1991-02-09,1990,"AS Monaco","FC Metz","2-0",2,0,"1",1,2,2,"H"
1991-02-10,1990,"Paris Saint-Germain","Olympique Marseille","0-1",0,1,"1",1,1,-1,"D"
1991-02-10,1990,"Stade Rennes","AJ Auxerre","2-2",2,2,"1",1,4,0,"D"
1991-02-10,1990,"AS Cannes","FC Nantes","2-1",2,1,"1",1,3,1,"H"
1991-02-10,1990,"AS Saint-Etienne","Lille OSC","0-0",0,0,"1",1,0,0,"D"
1991-02-10,1990,"Toulouse FC","Girondins Bordeaux","0-0",0,0,"1",1,0,0,"D"
1991-02-13,1990,"Olympique Marseille","Toulouse FC","1-0",1,0,"1",1,1,1,"H"
1991-02-13,1990,"AS Monaco","OGC Nice","2-1",2,1,"1",1,3,1,"H"
1991-02-13,1990,"Montpellier HSC","Stade Rennes","1-0",1,0,"1",1,1,1,"H"
1991-02-13,1990,"Girondins Bordeaux","AS Cannes","1-1",1,1,"1",1,2,0,"D"
1991-02-13,1990,"SM Caen","Paris Saint-Germain","2-0",2,0,"1",1,2,2,"H"
1991-02-23,1990,"Montpellier HSC","AJ Auxerre","1-2",1,2,"1",1,3,-1,"D"
1991-02-24,1990,"AS Cannes","Olympique Marseille","0-0",0,0,"1",1,0,0,"D"
1991-02-24,1990,"AS Monaco","SM Caen","2-0",2,0,"1",1,2,2,"H"
1991-02-24,1990,"Stade Rennes","Olympique Lyon","2-0",2,0,"1",1,2,2,"H"
1991-02-24,1990,"Paris Saint-Germain","FC Metz","2-1",2,1,"1",1,3,1,"H"
1991-02-24,1990,"Stade Brest","Lille OSC","1-0",1,0,"1",1,1,1,"H"
1991-02-24,1990,"AS Saint-Etienne","FC Nantes","1-3",1,3,"1",1,4,-2,"D"
1991-02-24,1990,"FC Sochaux","Girondins Bordeaux","1-0",1,0,"1",1,1,1,"H"
1991-02-24,1990,"AS Nancy","Toulouse FC","1-1",1,1,"1",1,2,0,"D"
1991-02-24,1990,"Sporting Toulon Var","OGC Nice","1-2",1,2,"1",1,3,-1,"D"
1991-02-27,1990,"Stade Brest","Olympique Lyon","3-0",3,0,"1",1,3,3,"H"
1991-02-27,1990,"FC Nantes","AS Nancy","1-0",1,0,"1",1,1,1,"H"
1991-02-27,1990,"Lille OSC","Sporting Toulon Var","4-1",4,1,"1",1,5,3,"H"
1991-03-01,1990,"Olympique Marseille","AS Monaco","1-0",1,0,"1",1,1,1,"H"
1991-03-01,1990,"OGC Nice","Montpellier HSC","2-0",2,0,"1",1,2,2,"H"
1991-03-02,1990,"Toulouse FC","AS Cannes","2-2",2,2,"1",1,4,0,"D"
1991-03-02,1990,"FC Nantes","Paris Saint-Germain","2-0",2,0,"1",1,2,2,"H"
1991-03-02,1990,"Lille OSC","FC Sochaux","0-1",0,1,"1",1,1,-1,"D"
1991-03-02,1990,"FC Metz","Stade Rennes","2-0",2,0,"1",1,2,2,"H"
1991-03-02,1990,"Olympique Lyon","AS Nancy","0-1",0,1,"1",1,1,-1,"D"
1991-03-02,1990,"SM Caen","Stade Brest","1-2",1,2,"1",1,3,-1,"D"
1991-03-02,1990,"Girondins Bordeaux","AS Saint-Etienne","2-1",2,1,"1",1,3,1,"H"
1991-03-02,1990,"AJ Auxerre","Sporting Toulon Var","3-0",3,0,"1",1,3,3,"H"
1991-03-05,1990,"FC Sochaux","OGC Nice","0-0",0,0,"1",1,0,0,"D"
1991-03-05,1990,"AS Nancy","SM Caen","0-0",0,0,"1",1,0,0,"D"
1991-03-12,1990,"AJ Auxerre","FC Sochaux","4-1",4,1,"1",1,5,3,"H"
1991-03-12,1990,"FC Metz","Stade Brest","0-0",0,0,"1",1,0,0,"D"
1991-03-14,1990,"Montpellier HSC","Olympique Lyon","1-0",1,0,"1",1,1,1,"H"
1991-03-15,1990,"AS Saint-Etienne","Olympique Marseille","1-1",1,1,"1",1,2,0,"D"
1991-03-15,1990,"AS Nancy","FC Metz","0-1",0,1,"1",1,1,-1,"D"
1991-03-15,1990,"AJ Auxerre","OGC Nice","5-1",5,1,"1",1,6,4,"H"
1991-03-15,1990,"AS Monaco","AS Cannes","0-0",0,0,"1",1,0,0,"D"
1991-03-16,1990,"Stade Rennes","Lille OSC","1-3",1,3,"1",1,4,-2,"D"
1991-03-16,1990,"Stade Brest","FC Nantes","1-0",1,0,"1",1,1,1,"H"
1991-03-16,1990,"Paris Saint-Germain","Girondins Bordeaux","1-0",1,0,"1",1,1,1,"H"
1991-03-16,1990,"FC Sochaux","Toulouse FC","0-1",0,1,"1",1,1,-1,"D"
1991-03-16,1990,"Sporting Toulon Var","SM Caen","0-0",0,0,"1",1,0,0,"D"
1991-03-22,1990,"OGC Nice","AS Nancy","3-0",3,0,"1",1,3,3,"H"
1991-03-23,1990,"Olympique Marseille","FC Sochaux","0-0",0,0,"1",1,0,0,"D"
1991-03-23,1990,"Toulouse FC","AS Monaco","1-2",1,2,"1",1,3,-1,"D"
1991-03-23,1990,"Olympique Lyon","AJ Auxerre","1-0",1,0,"1",1,1,1,"H"
1991-03-23,1990,"FC Metz","Montpellier HSC","0-0",0,0,"1",1,0,0,"D"
1991-03-23,1990,"AS Cannes","AS Saint-Etienne","0-1",0,1,"1",1,1,-1,"D"
1991-03-23,1990,"Girondins Bordeaux","Stade Brest","1-4",1,4,"1",1,5,-3,"D"
1991-03-23,1990,"Lille OSC","Paris Saint-Germain","0-0",0,0,"1",1,0,0,"D"
1991-03-23,1990,"SM Caen","Stade Rennes","2-0",2,0,"1",1,2,2,"H"
1991-03-23,1990,"FC Nantes","Sporting Toulon Var","0-0",0,0,"1",1,0,0,"D"
1991-03-26,1990,"Olympique Lyon","AS Saint-Etienne","1-1",1,1,"1",1,2,0,"D"
1991-04-06,1990,"Paris Saint-Germain","AS Monaco","0-2",0,2,"1",1,2,-2,"D"
1991-04-06,1990,"AJ Auxerre","SM Caen","3-0",3,0,"1",1,3,3,"H"
1991-04-06,1990,"Montpellier HSC","Lille OSC","1-2",1,2,"1",1,3,-1,"D"
1991-04-06,1990,"FC Sochaux","AS Cannes","0-0",0,0,"1",1,0,0,"D"
1991-04-06,1990,"OGC Nice","Olympique Lyon","1-1",1,1,"1",1,2,0,"D"
1991-04-06,1990,"Stade Rennes","FC Nantes","2-0",2,0,"1",1,2,2,"H"
1991-04-06,1990,"AS Nancy","Girondins Bordeaux","0-2",0,2,"1",1,2,-2,"D"
1991-04-06,1990,"AS Saint-Etienne","Toulouse FC","1-4",1,4,"1",1,5,-3,"D"
1991-04-06,1990,"Sporting Toulon Var","FC Metz","2-1",2,1,"1",1,3,1,"H"
1991-04-12,1990,"Lille OSC","AJ Auxerre","1-0",1,0,"1",1,1,1,"H"
1991-04-13,1990,"Olympique Marseille","AS Nancy","6-2",6,2,"1",1,8,4,"H"
1991-04-13,1990,"AS Monaco","AS Saint-Etienne","2-0",2,0,"1",1,2,2,"H"
1991-04-13,1990,"AS Cannes","Paris Saint-Germain","2-0",2,0,"1",1,2,2,"H"
1991-04-13,1990,"SM Caen","Montpellier HSC","1-0",1,0,"1",1,1,1,"H"
1991-04-13,1990,"FC Metz","OGC Nice","1-0",1,0,"1",1,1,1,"H"
1991-04-13,1990,"Toulouse FC","Stade Brest","0-0",0,0,"1",1,0,0,"D"
1991-04-13,1990,"Olympique Lyon","Sporting Toulon Var","1-1",1,1,"1",1,2,0,"D"
1991-04-13,1990,"FC Nantes","FC Sochaux","0-0",0,0,"1",1,0,0,"D"
1991-04-13,1990,"Girondins Bordeaux","Stade Rennes","1-0",1,0,"1",1,1,1,"H"
1991-04-19,1990,"Stade Rennes","Olympique Marseille","1-1",1,1,"1",1,2,0,"D"
1991-04-19,1990,"FC Sochaux","AS Monaco","0-2",0,2,"1",1,2,-2,"D"
1991-04-20,1990,"AJ Auxerre","FC Metz","3-1",3,1,"1",1,4,2,"H"
1991-04-20,1990,"Stade Brest","AS Cannes","3-2",3,2,"1",1,5,1,"H"
1991-04-20,1990,"Montpellier HSC","FC Nantes","1-1",1,1,"1",1,2,0,"D"
1991-04-20,1990,"OGC Nice","Lille OSC","4-1",4,1,"1",1,5,3,"H"
1991-04-20,1990,"Olympique Lyon","SM Caen","3-2",3,2,"1",1,5,1,"H"
1991-04-20,1990,"Sporting Toulon Var","Girondins Bordeaux","0-2",0,2,"1",1,2,-2,"D"
1991-04-20,1990,"Paris Saint-Germain","Toulouse FC","3-0",3,0,"1",1,3,3,"H"
1991-04-20,1990,"AS Nancy","AS Saint-Etienne","1-0",1,0,"1",1,1,1,"H"
1991-05-01,1990,"Stade Brest","Olympique Marseille","1-1",1,1,"1",1,2,0,"D"
1991-05-03,1990,"AS Cannes","AS Nancy","1-0",1,0,"1",1,1,1,"H"
1991-05-04,1990,"Olympique Marseille","Sporting Toulon Var","3-3",3,3,"1",1,6,0,"D"
1991-05-04,1990,"AS Monaco","Stade Brest","5-0",5,0,"1",1,5,5,"H"
1991-05-04,1990,"FC Nantes","AJ Auxerre","2-3",2,3,"1",1,5,-1,"D"
1991-05-04,1990,"Lille OSC","Olympique Lyon","1-1",1,1,"1",1,2,0,"D"
1991-05-04,1990,"Girondins Bordeaux","Montpellier HSC","1-0",1,0,"1",1,1,1,"H"
1991-05-04,1990,"FC Metz","FC Sochaux","2-2",2,2,"1",1,4,0,"D"
1991-05-04,1990,"SM Caen","OGC Nice","2-1",2,1,"1",1,3,1,"H"
1991-05-04,1990,"AS Saint-Etienne","Paris Saint-Germain","1-1",1,1,"1",1,2,0,"D"
1991-05-04,1990,"Toulouse FC","Stade Rennes","2-0",2,0,"1",1,2,2,"H"
1991-05-10,1990,"Montpellier HSC","Olympique Marseille","0-0",0,0,"1",1,0,0,"D"
1991-05-10,1990,"AS Nancy","AS Monaco","4-0",4,0,"1",1,4,4,"H"
1991-05-10,1990,"AJ Auxerre","Girondins Bordeaux","0-0",0,0,"1",1,0,0,"D"
1991-05-10,1990,"Stade Rennes","AS Cannes","1-1",1,1,"1",1,2,0,"D"
1991-05-10,1990,"Olympique Lyon","FC Metz","3-1",3,1,"1",1,4,2,"H"
1991-05-10,1990,"SM Caen","Lille OSC","0-0",0,0,"1",1,0,0,"D"
1991-05-10,1990,"Stade Brest","AS Saint-Etienne","0-1",0,1,"1",1,1,-1,"D"
1991-05-10,1990,"OGC Nice","FC Nantes","1-1",1,1,"1",1,2,0,"D"
1991-05-10,1990,"FC Sochaux","Paris Saint-Germain","0-0",0,0,"1",1,0,0,"D"
1991-05-10,1990,"Sporting Toulon Var","Toulouse FC","1-0",1,0,"1",1,1,1,"H"
1991-05-17,1990,"Olympique Marseille","AJ Auxerre","1-0",1,0,"1",1,1,1,"H"
1991-05-17,1990,"AS Monaco","Stade Rennes","2-1",2,1,"1",1,3,1,"H"
1991-05-17,1990,"AS Cannes","Sporting Toulon Var","0-0",0,0,"1",1,0,0,"D"
1991-05-17,1990,"FC Nantes","Olympique Lyon","0-0",0,0,"1",1,0,0,"D"
1991-05-17,1990,"Toulouse FC","Montpellier HSC","0-0",0,0,"1",1,0,0,"D"
1991-05-17,1990,"Girondins Bordeaux","OGC Nice","3-0",3,0,"1",1,3,3,"H"
1991-05-17,1990,"Lille OSC","AS Nancy","0-2",0,2,"1",1,2,-2,"D"
1991-05-17,1990,"FC Metz","SM Caen","1-1",1,1,"1",1,2,0,"D"
1991-05-17,1990,"Paris Saint-Germain","Stade Brest","1-1",1,1,"1",1,2,0,"D"
1991-05-17,1990,"AS Saint-Etienne","FC Sochaux","2-1",2,1,"1",1,3,1,"H"
1991-05-22,1990,"OGC Nice","Olympique Marseille","0-1",0,1,"1",1,1,-1,"D"
1991-05-24,1990,"Sporting Toulon Var","AS Monaco","1-1",1,1,"1",1,2,0,"D"
1991-05-24,1990,"AJ Auxerre","Toulouse FC","2-1",2,1,"1",1,3,1,"H"
1991-05-24,1990,"Montpellier HSC","AS Cannes","0-0",0,0,"1",1,0,0,"D"
1991-05-24,1990,"Olympique Lyon","Girondins Bordeaux","1-0",1,0,"1",1,1,1,"H"
1991-05-24,1990,"Lille OSC","FC Metz","4-1",4,1,"1",1,5,3,"H"
1991-05-24,1990,"SM Caen","FC Nantes","1-0",1,0,"1",1,1,1,"H"
1991-05-24,1990,"Stade Brest","FC Sochaux","0-0",0,0,"1",1,0,0,"D"
1991-05-24,1990,"AS Nancy","Paris Saint-Germain","0-2",0,2,"1",1,2,-2,"D"
1991-05-24,1990,"Stade Rennes","AS Saint-Etienne","0-2",0,2,"1",1,2,-2,"D"
1991-07-20,1991,"Montpellier HSC","AS Monaco","1-4",1,4,"1",1,5,-3,"D"
1991-07-20,1991,"AJ Auxerre","Stade Rennes","3-1",3,1,"1",1,4,2,"H"
1991-07-20,1991,"RC Lens","FC Metz","0-2",0,2,"1",1,2,-2,"D"
1991-07-20,1991,"Le Havre AC","Olympique Lyon","1-0",1,0,"1",1,1,1,"H"
1991-07-20,1991,"Olympique Marseille","Lille OSC","1-0",1,0,"1",1,1,1,"H"
1991-07-20,1991,"AS Nancy","AS Cannes","1-0",1,0,"1",1,1,1,"H"
1991-07-20,1991,"FC Sochaux","Nimes Olympique","1-1",1,1,"1",1,2,0,"D"
1991-07-20,1991,"FC Nantes","Paris Saint-Germain","0-0",0,0,"1",1,0,0,"D"
1991-07-20,1991,"Toulouse FC","SM Caen","0-0",0,0,"1",1,0,0,"D"
1991-07-20,1991,"AS Saint-Etienne","Sporting Toulon Var","3-1",3,1,"1",1,4,2,"H"
1991-07-26,1991,"Stade Rennes","FC Nantes","0-1",0,1,"1",1,1,-1,"D"
1991-07-26,1991,"AS Cannes","Montpellier HSC","2-0",2,0,"1",1,2,2,"H"
1991-07-27,1991,"AS Monaco","AS Nancy","4-1",4,1,"1",1,5,3,"H"
1991-07-27,1991,"FC Metz","FC Sochaux","3-1",3,1,"1",1,4,2,"H"
1991-07-27,1991,"Paris Saint-Germain","AJ Auxerre","1-1",1,1,"1",1,2,0,"D"
1991-07-27,1991,"Olympique Lyon","Olympique Marseille","1-1",1,1,"1",1,2,0,"D"
1991-07-27,1991,"Lille OSC","Le Havre AC","0-0",0,0,"1",1,0,0,"D"
1991-07-27,1991,"SM Caen","AS Saint-Etienne","1-0",1,0,"1",1,1,1,"H"
1991-07-27,1991,"Nimes Olympique","Toulouse FC","2-2",2,2,"1",1,4,0,"D"
1991-07-27,1991,"Sporting Toulon Var","RC Lens","0-1",0,1,"1",1,1,-1,"D"
1991-07-31,1991,"AS Monaco","Stade Rennes","3-1",3,1,"1",1,4,2,"H"
1991-07-31,1991,"Olympique Marseille","FC Metz","2-0",2,0,"1",1,2,2,"H"
1991-07-31,1991,"Le Havre AC","AS Cannes","1-0",1,0,"1",1,1,1,"H"
1991-07-31,1991,"AS Saint-Etienne","Nimes Olympique","3-0",3,0,"1",1,3,3,"H"
1991-07-31,1991,"Toulouse FC","FC Sochaux","2-1",2,1,"1",1,3,1,"H"
1991-07-31,1991,"RC Lens","SM Caen","0-0",0,0,"1",1,0,0,"D"
1991-07-31,1991,"FC Nantes","Lille OSC","1-2",1,2,"1",1,3,-1,"D"
1991-07-31,1991,"Montpellier HSC","Paris Saint-Germain","1-1",1,1,"1",1,2,0,"D"
1991-07-31,1991,"AS Nancy","Olympique Lyon","0-0",0,0,"1",1,0,0,"D"
1991-07-31,1991,"AJ Auxerre","Sporting Toulon Var","1-0",1,0,"1",1,1,1,"H"
1991-08-03,1991,"Stade Rennes","Olympique Marseille","1-2",1,2,"1",1,3,-1,"D"
1991-08-03,1991,"FC Metz","Toulouse FC","4-0",4,0,"1",1,4,4,"H"
1991-08-03,1991,"Paris Saint-Germain","Le Havre AC","1-1",1,1,"1",1,2,0,"D"
1991-08-03,1991,"SM Caen","AJ Auxerre","1-0",1,0,"1",1,1,1,"H"
1991-08-03,1991,"Lille OSC","AS Nancy","2-1",2,1,"1",1,3,1,"H"
1991-08-03,1991,"Nimes Olympique","RC Lens","0-2",0,2,"1",1,2,-2,"D"
1991-08-03,1991,"FC Sochaux","AS Saint-Etienne","1-0",1,0,"1",1,1,1,"H"
1991-08-03,1991,"Olympique Lyon","Montpellier HSC","1-0",1,0,"1",1,1,1,"H"
1991-08-03,1991,"Sporting Toulon Var","FC Nantes","0-2",0,2,"1",1,2,-2,"D"
1991-08-04,1991,"AS Cannes","AS Monaco","1-2",1,2,"1",1,3,-1,"D"
1991-08-09,1991,"Olympique Marseille","Paris Saint-Germain","0-0",0,0,"1",1,0,0,"D"
1991-08-10,1991,"AS Monaco","Olympique Lyon","1-0",1,0,"1",1,1,1,"H"
1991-08-10,1991,"AS Nancy","FC Metz","1-3",1,3,"1",1,4,-2,"D"
1991-08-10,1991,"FC Nantes","SM Caen","2-1",2,1,"1",1,3,1,"H"
1991-08-10,1991,"Le Havre AC","Stade Rennes","0-0",0,0,"1",1,0,0,"D"
1991-08-10,1991,"AS Saint-Etienne","Toulouse FC","2-1",2,1,"1",1,3,1,"H"
1991-08-10,1991,"AJ Auxerre","Nimes Olympique","0-0",0,0,"1",1,0,0,"D"
1991-08-10,1991,"AS Cannes","Lille OSC","1-1",1,1,"1",1,2,0,"D"
1991-08-10,1991,"RC Lens","FC Sochaux","1-1",1,1,"1",1,2,0,"D"
1991-08-10,1991,"Montpellier HSC","Sporting Toulon Var","1-0",1,0,"1",1,1,1,"H"
1991-08-17,1991,"FC Metz","AS Saint-Etienne","1-0",1,0,"1",1,1,1,"H"
1991-08-17,1991,"Paris Saint-Germain","AS Monaco","2-0",2,0,"1",1,2,2,"H"
1991-08-17,1991,"Nimes Olympique","FC Nantes","0-0",0,0,"1",1,0,0,"D"
1991-08-17,1991,"Lille OSC","Montpellier HSC","1-0",1,0,"1",1,1,1,"H"
1991-08-17,1991,"Toulouse FC","RC Lens","1-1",1,1,"1",1,2,0,"D"
1991-08-17,1991,"FC Sochaux","AJ Auxerre","1-0",1,0,"1",1,1,1,"H"
1991-08-17,1991,"Olympique Lyon","AS Cannes","0-0",0,0,"1",1,0,0,"D"
1991-08-17,1991,"Stade Rennes","AS Nancy","3-1",3,1,"1",1,4,2,"H"
1991-08-17,1991,"Sporting Toulon Var","Le Havre AC","4-0",4,0,"1",1,4,4,"H"
1991-08-18,1991,"SM Caen","Olympique Marseille","1-3",1,3,"1",1,4,-2,"D"
1991-08-23,1991,"RC Lens","AS Saint-Etienne","1-1",1,1,"1",1,2,0,"D"
1991-08-24,1991,"AS Monaco","Lille OSC","1-0",1,0,"1",1,1,1,"H"
1991-08-24,1991,"Olympique Marseille","Nimes Olympique","4-2",4,2,"1",1,6,2,"H"
1991-08-24,1991,"FC Nantes","FC Metz","4-1",4,1,"1",1,5,3,"H"
1991-08-24,1991,"Le Havre AC","FC Sochaux","1-0",1,0,"1",1,1,1,"H"
1991-08-24,1991,"AJ Auxerre","Toulouse FC","3-0",3,0,"1",1,3,3,"H"
1991-08-24,1991,"AS Cannes","Paris Saint-Germain","1-1",1,1,"1",1,2,0,"D"
1991-08-24,1991,"Olympique Lyon","SM Caen","2-2",2,2,"1",1,4,0,"D"
1991-08-24,1991,"Montpellier HSC","Stade Rennes","0-0",0,0,"1",1,0,0,"D"
1991-08-24,1991,"AS Nancy","Sporting Toulon Var","0-0",0,0,"1",1,0,0,"D"
1991-08-28,1991,"FC Sochaux","AS Monaco","1-3",1,3,"1",1,4,-2,"D"
1991-08-28,1991,"Toulouse FC","FC Nantes","2-1",2,1,"1",1,3,1,"H"
1991-08-28,1991,"Paris Saint-Germain","AS Nancy","1-0",1,0,"1",1,1,1,"H"
1991-08-28,1991,"Lille OSC","Olympique Lyon","1-0",1,0,"1",1,1,1,"H"
1991-08-28,1991,"AS Saint-Etienne","AJ Auxerre","1-1",1,1,"1",1,2,0,"D"
1991-08-28,1991,"Stade Rennes","RC Lens","0-0",0,0,"1",1,0,0,"D"
1991-08-28,1991,"SM Caen","Le Havre AC","2-1",2,1,"1",1,3,1,"H"
1991-08-28,1991,"Nimes Olympique","AS Cannes","2-1",2,1,"1",1,3,1,"H"
1991-08-28,1991,"Sporting Toulon Var","Olympique Marseille","1-0",1,0,"1",1,1,1,"H"
1991-08-29,1991,"FC Metz","Montpellier HSC","1-3",1,3,"1",1,4,-2,"D"
1991-09-07,1991,"FC Nantes","AS Saint-Etienne","1-0",1,0,"1",1,1,1,"H"
1991-09-07,1991,"Olympique Lyon","Paris Saint-Germain","0-1",0,1,"1",1,1,-1,"D"
1991-09-07,1991,"AJ Auxerre","RC Lens","1-0",1,0,"1",1,1,1,"H"
1991-09-07,1991,"Le Havre AC","FC Metz","0-0",0,0,"1",1,0,0,"D"
1991-09-07,1991,"Lille OSC","FC Sochaux","0-0",0,0,"1",1,0,0,"D"
1991-09-07,1991,"Montpellier HSC","SM Caen","3-1",3,1,"1",1,4,2,"H"
1991-09-07,1991,"AS Nancy","Nimes Olympique","2-3",2,3,"1",1,5,-1,"D"
1991-09-07,1991,"AS Cannes","Stade Rennes","3-1",3,1,"1",1,4,2,"H"
1991-09-07,1991,"AS Monaco","Sporting Toulon Var","3-0",3,0,"1",1,3,3,"H"
1991-09-08,1991,"Olympique Marseille","Toulouse FC","2-0",2,0,"1",1,2,2,"H"
1991-09-12,1991,"AS Saint-Etienne","AS Monaco","0-1",0,1,"1",1,1,-1,"D"
1991-09-12,1991,"FC Metz","AJ Auxerre","2-1",2,1,"1",1,3,1,"H"
1991-09-13,1991,"Paris Saint-Germain","Lille OSC","2-0",2,0,"1",1,2,2,"H"
1991-09-14,1991,"FC Sochaux","Olympique Marseille","2-3",2,3,"1",1,5,-1,"D"
1991-09-14,1991,"RC Lens","FC Nantes","0-0",0,0,"1",1,0,0,"D"
1991-09-14,1991,"SM Caen","AS Nancy","5-1",5,1,"1",1,6,4,"H"
1991-09-14,1991,"Nimes Olympique","Le Havre AC","1-0",1,0,"1",1,1,1,"H"
1991-09-14,1991,"Toulouse FC","Montpellier HSC","1-1",1,1,"1",1,2,0,"D"
1991-09-14,1991,"Stade Rennes","Olympique Lyon","0-2",0,2,"1",1,2,-2,"D"
1991-09-14,1991,"Sporting Toulon Var","AS Cannes","4-3",4,3,"1",1,7,1,"H"
1991-09-21,1991,"AS Monaco","Nimes Olympique","1-1",1,1,"1",1,2,0,"D"
1991-09-21,1991,"Olympique Marseille","RC Lens","1-1",1,1,"1",1,2,0,"D"
1991-09-21,1991,"Paris Saint-Germain","FC Metz","3-0",3,0,"1",1,3,3,"H"
1991-09-21,1991,"FC Nantes","AJ Auxerre","2-0",2,0,"1",1,2,2,"H"
1991-09-21,1991,"Lille OSC","Stade Rennes","1-1",1,1,"1",1,2,0,"D"
1991-09-21,1991,"Le Havre AC","AS Saint-Etienne","2-1",2,1,"1",1,3,1,"H"
1991-09-21,1991,"Montpellier HSC","FC Sochaux","3-2",3,2,"1",1,5,1,"H"
1991-09-21,1991,"AS Nancy","Toulouse FC","1-1",1,1,"1",1,2,0,"D"
1991-09-21,1991,"Olympique Lyon","Sporting Toulon Var","1-1",1,1,"1",1,2,0,"D"
1991-09-22,1991,"AS Cannes","SM Caen","2-0",2,0,"1",1,2,2,"H"
1991-09-26,1991,"SM Caen","AS Monaco","1-0",1,0,"1",1,1,1,"H"
1991-09-27,1991,"AJ Auxerre","Olympique Marseille","1-1",1,1,"1",1,2,0,"D"
1991-09-28,1991,"Stade Rennes","Paris Saint-Germain","0-0",0,0,"1",1,0,0,"D"
1991-09-28,1991,"FC Sochaux","FC Nantes","3-1",3,1,"1",1,4,2,"H"
1991-09-28,1991,"FC Metz","AS Cannes","1-2",1,2,"1",1,3,-1,"D"
1991-09-28,1991,"Toulouse FC","Le Havre AC","0-0",0,0,"1",1,0,0,"D"
1991-09-28,1991,"Nimes Olympique","Olympique Lyon","2-1",2,1,"1",1,3,1,"H"
1991-09-28,1991,"RC Lens","Montpellier HSC","1-1",1,1,"1",1,2,0,"D"
1991-09-28,1991,"AS Saint-Etienne","AS Nancy","3-0",3,0,"1",1,3,3,"H"
1991-09-28,1991,"Sporting Toulon Var","Lille OSC","1-2",1,2,"1",1,3,-1,"D"
1991-10-05,1991,"Olympique Marseille","FC Nantes","4-0",4,0,"1",1,4,4,"H"
1991-10-05,1991,"AS Monaco","Toulouse FC","0-2",0,2,"1",1,2,-2,"D"
1991-10-05,1991,"Lille OSC","FC Metz","0-2",0,2,"1",1,2,-2,"D"
1991-10-05,1991,"Le Havre AC","AJ Auxerre","1-0",1,0,"1",1,1,1,"H"
1991-10-05,1991,"Montpellier HSC","Nimes Olympique","0-0",0,0,"1",1,0,0,"D"
1991-10-05,1991,"Stade Rennes","SM Caen","1-0",1,0,"1",1,1,1,"H"
1991-10-05,1991,"AS Nancy","RC Lens","3-1",3,1,"1",1,4,2,"H"
1991-10-05,1991,"Paris Saint-Germain","Sporting Toulon Var","2-3",2,3,"1",1,5,-1,"D"
1991-10-06,1991,"Olympique Lyon","AS Saint-Etienne","0-0",0,0,"1",1,0,0,"D"
1991-10-06,1991,"AS Cannes","FC Sochaux","2-1",2,1,"1",1,3,1,"H"
1991-10-17,1991,"FC Metz","AS Monaco","2-0",2,0,"1",1,2,2,"H"
1991-10-17,1991,"Toulouse FC","AS Cannes","2-0",2,0,"1",1,2,2,"H"
1991-10-18,1991,"FC Sochaux","Olympique Lyon","1-0",1,0,"1",1,1,1,"H"
1991-10-18,1991,"AJ Auxerre","AS Nancy","3-1",3,1,"1",1,4,2,"H"
1991-10-19,1991,"SM Caen","Paris Saint-Germain","2-0",2,0,"1",1,2,2,"H"
1991-10-19,1991,"FC Nantes","Montpellier HSC","0-0",0,0,"1",1,0,0,"D"
1991-10-19,1991,"RC Lens","Le Havre AC","0-0",0,0,"1",1,0,0,"D"
1991-10-19,1991,"Nimes Olympique","Lille OSC","1-0",1,0,"1",1,1,1,"H"
1991-10-20,1991,"Sporting Toulon Var","Stade Rennes","1-0",1,0,"1",1,1,1,"H"
1991-10-26,1991,"Le Havre AC","Olympique Marseille","0-2",0,2,"1",1,2,-2,"D"
1991-10-26,1991,"AS Monaco","RC Lens","0-0",0,0,"1",1,0,0,"D"
1991-10-26,1991,"Paris Saint-Germain","Nimes Olympique","2-0",2,0,"1",1,2,2,"H"
1991-10-26,1991,"Stade Rennes","FC Metz","3-1",3,1,"1",1,4,2,"H"
1991-10-26,1991,"Lille OSC","SM Caen","1-2",1,2,"1",1,3,-1,"D"
1991-10-26,1991,"AS Nancy","FC Nantes","3-1",3,1,"1",1,4,2,"H"
1991-10-26,1991,"Montpellier HSC","AJ Auxerre","1-1",1,1,"1",1,2,0,"D"
1991-10-26,1991,"Olympique Lyon","Toulouse FC","1-0",1,0,"1",1,1,1,"H"
1991-10-26,1991,"AS Cannes","AS Saint-Etienne","0-2",0,2,"1",1,2,-2,"D"
1991-10-26,1991,"Sporting Toulon Var","FC Sochaux","2-0",2,0,"1",1,2,2,"H"
1991-10-31,1991,"AJ Auxerre","AS Monaco","1-1",1,1,"1",1,2,0,"D"
1991-11-01,1991,"Olympique Marseille","AS Nancy","4-0",4,0,"1",1,4,4,"H"
1991-11-01,1991,"FC Metz","Olympique Lyon","1-1",1,1,"1",1,2,0,"D"
1991-11-01,1991,"AS Saint-Etienne","Montpellier HSC","1-1",1,1,"1",1,2,0,"D"
1991-11-01,1991,"RC Lens","AS Cannes","1-1",1,1,"1",1,2,0,"D"
1991-11-02,1991,"FC Sochaux","Paris Saint-Germain","0-2",0,2,"1",1,2,-2,"D"
1991-11-02,1991,"FC Nantes","Le Havre AC","0-0",0,0,"1",1,0,0,"D"
1991-11-02,1991,"Toulouse FC","Lille OSC","1-0",1,0,"1",1,1,1,"H"
1991-11-02,1991,"Nimes Olympique","Stade Rennes","1-2",1,2,"1",1,3,-1,"D"
1991-11-02,1991,"SM Caen","Sporting Toulon Var","4-1",4,1,"1",1,5,3,"H"
1991-11-09,1991,"Montpellier HSC","Olympique Marseille","0-0",0,0,"1",1,0,0,"D"
1991-11-09,1991,"AS Monaco","FC Nantes","1-0",1,0,"1",1,1,1,"H"
1991-11-09,1991,"Paris Saint-Germain","Toulouse FC","0-0",0,0,"1",1,0,0,"D"
1991-11-09,1991,"SM Caen","FC Metz","1-0",1,0,"1",1,1,1,"H"
1991-11-09,1991,"AS Nancy","Le Havre AC","1-3",1,3,"1",1,4,-2,"D"
1991-11-09,1991,"AS Cannes","AJ Auxerre","1-1",1,1,"1",1,2,0,"D"
1991-11-09,1991,"Lille OSC","AS Saint-Etienne","2-0",2,0,"1",1,2,2,"H"
1991-11-09,1991,"Olympique Lyon","RC Lens","1-1",1,1,"1",1,2,0,"D"
1991-11-09,1991,"Stade Rennes","FC Sochaux","2-0",2,0,"1",1,2,2,"H"
1991-11-09,1991,"Sporting Toulon Var","Nimes Olympique","5-0",5,0,"1",1,5,5,"H"
1991-11-14,1991,"Olympique Marseille","AS Monaco","1-1",1,1,"1",1,2,0,"D"
1991-11-16,1991,"Nimes Olympique","SM Caen","0-1",0,1,"1",1,1,-1,"D"
1991-11-16,1991,"AS Saint-Etienne","Paris Saint-Germain","3-0",3,0,"1",1,3,3,"H"
1991-11-16,1991,"Le Havre AC","Montpellier HSC","3-1",3,1,"1",1,4,2,"H"
1991-11-16,1991,"AJ Auxerre","Olympique Lyon","3-0",3,0,"1",1,3,3,"H"
1991-11-16,1991,"FC Nantes","AS Cannes","1-0",1,0,"1",1,1,1,"H"
1991-11-16,1991,"Toulouse FC","Stade Rennes","2-0",2,0,"1",1,2,2,"H"
1991-11-16,1991,"RC Lens","Lille OSC","0-0",0,0,"1",1,0,0,"D"
1991-11-16,1991,"FC Sochaux","AS Nancy","2-2",2,2,"1",1,4,0,"D"
1991-11-16,1991,"FC Metz","Sporting Toulon Var","4-1",4,1,"1",1,5,3,"H"
1991-11-23,1991,"AS Cannes","Olympique Marseille","1-2",1,2,"1",1,3,-1,"D"
1991-11-23,1991,"AS Monaco","Le Havre AC","0-2",0,2,"1",1,2,-2,"D"
1991-11-23,1991,"SM Caen","FC Sochaux","1-1",1,1,"1",1,2,0,"D"
1991-11-23,1991,"Paris Saint-Germain","RC Lens","1-0",1,0,"1",1,1,1,"H"
1991-11-23,1991,"FC Metz","Nimes Olympique","4-0",4,0,"1",1,4,4,"H"
1991-11-23,1991,"Olympique Lyon","FC Nantes","0-1",0,1,"1",1,1,-1,"D"
1991-11-23,1991,"Lille OSC","AJ Auxerre","1-0",1,0,"1",1,1,1,"H"
1991-11-23,1991,"Montpellier HSC","AS Nancy","2-0",2,0,"1",1,2,2,"H"
1991-11-23,1991,"Stade Rennes","AS Saint-Etienne","0-0",0,0,"1",1,0,0,"D"
1991-11-23,1991,"Sporting Toulon Var","Toulouse FC","1-0",1,0,"1",1,1,1,"H"
1991-11-29,1991,"FC Nantes","Stade Rennes","1-0",1,0,"1",1,1,1,"H"
1991-11-30,1991,"Olympique Marseille","Olympique Lyon","0-0",0,0,"1",1,0,0,"D"
1991-11-30,1991,"AS Nancy","AS Monaco","1-4",1,4,"1",1,5,-3,"D"
1991-11-30,1991,"AJ Auxerre","Paris Saint-Germain","2-2",2,2,"1",1,4,0,"D"
1991-11-30,1991,"Le Havre AC","Lille OSC","0-0",0,0,"1",1,0,0,"D"
1991-11-30,1991,"FC Sochaux","FC Metz","0-0",0,0,"1",1,0,0,"D"
1991-11-30,1991,"Montpellier HSC","AS Cannes","3-0",3,0,"1",1,3,3,"H"
1991-11-30,1991,"Toulouse FC","Nimes Olympique","0-1",0,1,"1",1,1,-1,"D"
1991-11-30,1991,"RC Lens","Sporting Toulon Var","2-1",2,1,"1",1,3,1,"H"
1991-12-01,1991,"AS Saint-Etienne","SM Caen","1-1",1,1,"1",1,2,0,"D"
1991-12-06,1991,"SM Caen","RC Lens","2-0",2,0,"1",1,2,2,"H"
1991-12-07,1991,"FC Metz","Olympique Marseille","0-0",0,0,"1",1,0,0,"D"
1991-12-07,1991,"Stade Rennes","AS Monaco","0-0",0,0,"1",1,0,0,"D"
1991-12-07,1991,"Paris Saint-Germain","Montpellier HSC","1-1",1,1,"1",1,2,0,"D"
1991-12-07,1991,"AS Cannes","Le Havre AC","0-0",0,0,"1",1,0,0,"D"
1991-12-07,1991,"Lille OSC","FC Nantes","0-0",0,0,"1",1,0,0,"D"
1991-12-07,1991,"FC Sochaux","Toulouse FC","0-0",0,0,"1",1,0,0,"D"
1991-12-07,1991,"Nimes Olympique","AS Saint-Etienne","1-1",1,1,"1",1,2,0,"D"
1991-12-07,1991,"Olympique Lyon","AS Nancy","2-1",2,1,"1",1,3,1,"H"
1991-12-07,1991,"Sporting Toulon Var","AJ Auxerre","0-3",0,3,"1",1,3,-3,"D"
1991-12-14,1991,"Olympique Marseille","Stade Rennes","5-1",5,1,"1",1,6,4,"H"
1991-12-14,1991,"AS Monaco","AS Cannes","3-1",3,1,"1",1,4,2,"H"
1991-12-14,1991,"Le Havre AC","Paris Saint-Germain","1-1",1,1,"1",1,2,0,"D"
1991-12-14,1991,"AJ Auxerre","SM Caen","5-1",5,1,"1",1,6,4,"H"
1991-12-14,1991,"Toulouse FC","FC Metz","1-0",1,0,"1",1,1,1,"H"
1991-12-14,1991,"Montpellier HSC","Olympique Lyon","3-0",3,0,"1",1,3,3,"H"
1991-12-14,1991,"AS Nancy","Lille OSC","1-2",1,2,"1",1,3,-1,"D"
1991-12-14,1991,"AS Saint-Etienne","FC Sochaux","2-1",2,1,"1",1,3,1,"H"
1991-12-14,1991,"RC Lens","Nimes Olympique","0-0",0,0,"1",1,0,0,"D"
1991-12-14,1991,"FC Nantes","Sporting Toulon Var","1-2",1,2,"1",1,3,-1,"D"
1991-12-17,1991,"Paris Saint-Germain","Olympique Marseille","0-0",0,0,"1",1,0,0,"D"
1991-12-18,1991,"Olympique Lyon","AS Monaco","2-0",2,0,"1",1,2,2,"H"
1991-12-18,1991,"SM Caen","FC Nantes","1-1",1,1,"1",1,2,0,"D"
1991-12-18,1991,"Stade Rennes","Le Havre AC","0-2",0,2,"1",1,2,-2,"D"
1991-12-18,1991,"Nimes Olympique","AJ Auxerre","0-0",0,0,"1",1,0,0,"D"
1991-12-18,1991,"Lille OSC","AS Cannes","0-0",0,0,"1",1,0,0,"D"
1991-12-18,1991,"Toulouse FC","AS Saint-Etienne","1-1",1,1,"1",1,2,0,"D"
1991-12-18,1991,"FC Sochaux","RC Lens","1-2",1,2,"1",1,3,-1,"D"
1991-12-18,1991,"Sporting Toulon Var","Montpellier HSC","0-1",0,1,"1",1,1,-1,"D"
1991-12-21,1991,"Olympique Marseille","SM Caen","5-0",5,0,"1",1,5,5,"H"
1991-12-21,1991,"AS Monaco","Paris Saint-Germain","1-0",1,0,"1",1,1,1,"H"
1991-12-21,1991,"AJ Auxerre","FC Sochaux","4-0",4,0,"1",1,4,4,"H"
1991-12-21,1991,"Montpellier HSC","Lille OSC","0-0",0,0,"1",1,0,0,"D"
1991-12-21,1991,"FC Nantes","Nimes Olympique","3-2",3,2,"1",1,5,1,"H"
1991-12-21,1991,"AS Saint-Etienne","FC Metz","2-0",2,0,"1",1,2,2,"H"
1991-12-21,1991,"RC Lens","Toulouse FC","4-0",4,0,"1",1,4,4,"H"
1991-12-21,1991,"AS Cannes","Olympique Lyon","0-0",0,0,"1",1,0,0,"D"
1991-12-21,1991,"AS Nancy","Stade Rennes","1-1",1,1,"1",1,2,0,"D"
1991-12-21,1991,"Le Havre AC","Sporting Toulon Var","3-0",3,0,"1",1,3,3,"H"
1992-01-18,1991,"Lille OSC","AS Monaco","1-2",1,2,"1",1,3,-1,"D"
1992-01-18,1991,"Paris Saint-Germain","AS Cannes","3-2",3,2,"1",1,5,1,"H"
1992-01-18,1991,"SM Caen","Olympique Lyon","1-0",1,0,"1",1,1,1,"H"
1992-01-18,1991,"Toulouse FC","AJ Auxerre","2-3",2,3,"1",1,5,-1,"D"
1992-01-18,1991,"Stade Rennes","Montpellier HSC","0-2",0,2,"1",1,2,-2,"D"
1992-01-18,1991,"FC Metz","FC Nantes","1-1",1,1,"1",1,2,0,"D"
1992-01-18,1991,"Sporting Toulon Var","AS Nancy","4-2",4,2,"1",1,6,2,"H"
1992-01-19,1991,"AS Saint-Etienne","RC Lens","0-4",0,4,"1",1,4,-4,"D"
1992-01-19,1991,"Nimes Olympique","Olympique Marseille","1-2",1,2,"1",1,3,-1,"D"
1992-01-19,1991,"FC Sochaux","Le Havre AC","0-0",0,0,"1",1,0,0,"D"
1992-01-24,1991,"Le Havre AC","SM Caen","0-1",0,1,"1",1,1,-1,"D"
1992-01-25,1991,"AS Monaco","FC Sochaux","2-0",2,0,"1",1,2,2,"H"
1992-01-25,1991,"AJ Auxerre","AS Saint-Etienne","2-0",2,0,"1",1,2,2,"H"
1992-01-25,1991,"Montpellier HSC","FC Metz","1-0",1,0,"1",1,1,1,"H"
1992-01-25,1991,"AS Nancy","Paris Saint-Germain","0-0",0,0,"1",1,0,0,"D"
1992-01-25,1991,"FC Nantes","Toulouse FC","1-1",1,1,"1",1,2,0,"D"
1992-01-25,1991,"RC Lens","Stade Rennes","0-0",0,0,"1",1,0,0,"D"
1992-01-25,1991,"Olympique Lyon","Lille OSC","1-0",1,0,"1",1,1,1,"H"
1992-01-25,1991,"AS Cannes","Nimes Olympique","0-0",0,0,"1",1,0,0,"D"
1992-01-26,1991,"Olympique Marseille","Sporting Toulon Var","0-1",0,1,"1",1,1,-1,"D"
1992-01-29,1991,"AS Saint-Etienne","Olympique Marseille","1-1",1,1,"1",1,2,0,"D"
1992-02-01,1991,"Toulouse FC","Olympique Marseille","0-2",0,2,"1",1,2,-2,"D"
1992-02-01,1991,"Paris Saint-Germain","Olympique Lyon","3-0",3,0,"1",1,3,3,"H"
1992-02-01,1991,"SM Caen","Montpellier HSC","0-0",0,0,"1",1,0,0,"D"
1992-02-01,1991,"RC Lens","AJ Auxerre","0-0",0,0,"1",1,0,0,"D"
1992-02-01,1991,"FC Metz","Le Havre AC","1-1",1,1,"1",1,2,0,"D"
1992-02-01,1991,"Stade Rennes","AS Cannes","0-0",0,0,"1",1,0,0,"D"
1992-02-01,1991,"Sporting Toulon Var","AS Monaco","1-1",1,1,"1",1,2,0,"D"
1992-02-02,1991,"Nimes Olympique","AS Nancy","1-2",1,2,"1",1,3,-1,"D"
1992-02-02,1991,"FC Sochaux","Lille OSC","2-1",2,1,"1",1,3,1,"H"
1992-02-07,1991,"AJ Auxerre","FC Metz","3-0",3,0,"1",1,3,3,"H"
1992-02-08,1991,"AS Monaco","AS Saint-Etienne","2-0",2,0,"1",1,2,2,"H"
1992-02-08,1991,"Lille OSC","Paris Saint-Germain","0-0",0,0,"1",1,0,0,"D"
1992-02-08,1991,"Montpellier HSC","Toulouse FC","0-0",0,0,"1",1,0,0,"D"
1992-02-08,1991,"Le Havre AC","Nimes Olympique","1-1",1,1,"1",1,2,0,"D"
1992-02-08,1991,"AS Nancy","SM Caen","3-0",3,0,"1",1,3,3,"H"
1992-02-08,1991,"FC Nantes","RC Lens","1-0",1,0,"1",1,1,1,"H"
1992-02-08,1991,"Olympique Lyon","Stade Rennes","3-1",3,1,"1",1,4,2,"H"
1992-02-08,1991,"AS Cannes","Sporting Toulon Var","0-1",0,1,"1",1,1,-1,"D"
1992-02-09,1991,"Olympique Marseille","FC Sochaux","2-2",2,2,"1",1,4,0,"D"
1992-02-14,1991,"Nimes Olympique","AS Monaco","0-1",0,1,"1",1,1,-1,"D"
1992-02-15,1991,"RC Lens","Olympique Marseille","2-1",2,1,"1",1,3,1,"H"
1992-02-15,1991,"AJ Auxerre","FC Nantes","2-2",2,2,"1",1,4,0,"D"
1992-02-15,1991,"SM Caen","AS Cannes","3-1",3,1,"1",1,4,2,"H"
1992-02-15,1991,"Stade Rennes","Lille OSC","2-3",2,3,"1",1,5,-1,"D"
1992-02-15,1991,"Toulouse FC","AS Nancy","1-0",1,0,"1",1,1,1,"H"
1992-02-15,1991,"Sporting Toulon Var","Olympique Lyon","1-0",1,0,"1",1,1,1,"H"
1992-02-16,1991,"FC Metz","Paris Saint-Germain","0-0",0,0,"1",1,0,0,"D"
1992-02-16,1991,"FC Sochaux","Montpellier HSC","1-1",1,1,"1",1,2,0,"D"
1992-02-16,1991,"AS Saint-Etienne","Le Havre AC","4-0",4,0,"1",1,4,4,"H"
1992-02-28,1991,"AS Monaco","SM Caen","2-1",2,1,"1",1,3,1,"H"
1992-02-29,1991,"Olympique Marseille","AJ Auxerre","2-0",2,0,"1",1,2,2,"H"
1992-02-29,1991,"Paris Saint-Germain","Stade Rennes","1-0",1,0,"1",1,1,1,"H"
1992-02-29,1991,"Montpellier HSC","RC Lens","0-0",0,0,"1",1,0,0,"D"
1992-02-29,1991,"Le Havre AC","Toulouse FC","1-1",1,1,"1",1,2,0,"D"
1992-02-29,1991,"FC Nantes","FC Sochaux","0-0",0,0,"1",1,0,0,"D"
1992-02-29,1991,"AS Nancy","AS Saint-Etienne","0-2",0,2,"1",1,2,-2,"D"
1992-02-29,1991,"AS Cannes","FC Metz","1-1",1,1,"1",1,2,0,"D"
1992-02-29,1991,"Olympique Lyon","Nimes Olympique","1-0",1,0,"1",1,1,1,"H"
1992-02-29,1991,"Lille OSC","Sporting Toulon Var","1-0",1,0,"1",1,1,1,"H"
1992-03-03,1991,"FC Metz","AS Nancy","0-1",0,1,"1",1,1,-1,"D"
1992-03-06,1991,"Sporting Toulon Var","Paris Saint-Germain","2-5",2,5,"1",1,7,-3,"D"
1992-03-07,1991,"FC Nantes","Olympique Marseille","0-1",0,1,"1",1,1,-1,"D"
1992-03-07,1991,"Toulouse FC","AS Monaco","0-0",0,0,"1",1,0,0,"D"
1992-03-07,1991,"AJ Auxerre","Le Havre AC","3-0",3,0,"1",1,3,3,"H"
1992-03-07,1991,"SM Caen","Stade Rennes","0-0",0,0,"1",1,0,0,"D"
1992-03-07,1991,"Nimes Olympique","Montpellier HSC","2-1",2,1,"1",1,3,1,"H"
1992-03-07,1991,"RC Lens","AS Nancy","1-0",1,0,"1",1,1,1,"H"
1992-03-07,1991,"FC Metz","Lille OSC","1-0",1,0,"1",1,1,1,"H"
1992-03-07,1991,"AS Saint-Etienne","Olympique Lyon","1-2",1,2,"1",1,3,-1,"D"
1992-03-07,1991,"FC Sochaux","AS Cannes","1-0",1,0,"1",1,1,1,"H"
1992-03-17,1991,"AS Saint-Etienne","FC Nantes","2-1",2,1,"1",1,3,1,"H"
1992-03-19,1991,"Paris Saint-Germain","SM Caen","3-1",3,1,"1",1,4,2,"H"
1992-03-20,1991,"Montpellier HSC","FC Nantes","2-1",2,1,"1",1,3,1,"H"
1992-03-21,1991,"Olympique Marseille","AS Saint-Etienne","2-0",2,0,"1",1,2,2,"H"
1992-03-21,1991,"AS Monaco","FC Metz","3-1",3,1,"1",1,4,2,"H"
1992-03-21,1991,"AS Nancy","AJ Auxerre","2-1",2,1,"1",1,3,1,"H"
1992-03-21,1991,"Le Havre AC","RC Lens","1-0",1,0,"1",1,1,1,"H"
1992-03-21,1991,"Lille OSC","Nimes Olympique","1-1",1,1,"1",1,2,0,"D"
1992-03-21,1991,"AS Cannes","Toulouse FC","2-0",2,0,"1",1,2,2,"H"
1992-03-21,1991,"Olympique Lyon","FC Sochaux","0-1",0,1,"1",1,1,-1,"D"
1992-03-21,1991,"Stade Rennes","Sporting Toulon Var","0-0",0,0,"1",1,0,0,"D"
1992-03-27,1991,"RC Lens","AS Monaco","0-1",0,1,"1",1,1,-1,"D"
1992-03-28,1991,"Olympique Marseille","Le Havre AC","2-0",2,0,"1",1,2,2,"H"
1992-03-28,1991,"Nimes Olympique","Paris Saint-Germain","0-1",0,1,"1",1,1,-1,"D"
1992-03-28,1991,"AJ Auxerre","Montpellier HSC","1-0",1,0,"1",1,1,1,"H"
1992-03-28,1991,"SM Caen","Lille OSC","3-3",3,3,"1",1,6,0,"D"
1992-03-28,1991,"FC Nantes","AS Nancy","0-0",0,0,"1",1,0,0,"D"
1992-03-28,1991,"AS Saint-Etienne","AS Cannes","2-0",2,0,"1",1,2,2,"H"
1992-03-28,1991,"FC Metz","Stade Rennes","0-0",0,0,"1",1,0,0,"D"
1992-03-28,1991,"Toulouse FC","Olympique Lyon","1-0",1,0,"1",1,1,1,"H"
1992-03-28,1991,"FC Sochaux","Sporting Toulon Var","2-0",2,0,"1",1,2,2,"H"
1992-04-03,1991,"AS Nancy","Olympique Marseille","1-3",1,3,"1",1,4,-2,"D"
1992-04-04,1991,"AS Monaco","AJ Auxerre","2-0",2,0,"1",1,2,2,"H"
1992-04-04,1991,"Paris Saint-Germain","FC Sochaux","2-0",2,0,"1",1,2,2,"H"
1992-04-04,1991,"Montpellier HSC","AS Saint-Etienne","2-0",2,0,"1",1,2,2,"H"
1992-04-04,1991,"Le Havre AC","FC Nantes","1-1",1,1,"1",1,2,0,"D"
1992-04-04,1991,"Lille OSC","Toulouse FC","3-1",3,1,"1",1,4,2,"H"
1992-04-04,1991,"AS Cannes","RC Lens","2-1",2,1,"1",1,3,1,"H"
1992-04-04,1991,"Olympique Lyon","FC Metz","0-0",0,0,"1",1,0,0,"D"
1992-04-04,1991,"Stade Rennes","Nimes Olympique","1-1",1,1,"1",1,2,0,"D"
1992-04-04,1991,"Sporting Toulon Var","SM Caen","0-0",0,0,"1",1,0,0,"D"
1992-04-10,1991,"FC Nantes","AS Monaco","1-4",1,4,"1",1,5,-3,"D"
1992-04-10,1991,"Toulouse FC","Paris Saint-Germain","3-0",3,0,"1",1,3,3,"H"
1992-04-11,1991,"Olympique Marseille","Montpellier HSC","0-0",0,0,"1",1,0,0,"D"
1992-04-11,1991,"AJ Auxerre","AS Cannes","3-1",3,1,"1",1,4,2,"H"
1992-04-11,1991,"FC Metz","SM Caen","1-2",1,2,"1",1,3,-1,"D"
1992-04-11,1991,"Le Havre AC","AS Nancy","1-2",1,2,"1",1,3,-1,"D"
1992-04-11,1991,"RC Lens","Olympique Lyon","4-2",4,2,"1",1,6,2,"H"
1992-04-11,1991,"AS Saint-Etienne","Lille OSC","1-1",1,1,"1",1,2,0,"D"
1992-04-11,1991,"FC Sochaux","Stade Rennes","0-0",0,0,"1",1,0,0,"D"
1992-04-11,1991,"Nimes Olympique","Sporting Toulon Var","1-0",1,0,"1",1,1,1,"H"
1992-04-18,1991,"AS Monaco","Olympique Marseille","0-3",0,3,"1",1,3,-3,"D"
1992-04-18,1991,"Paris Saint-Germain","AS Saint-Etienne","0-0",0,0,"1",1,0,0,"D"
1992-04-18,1991,"SM Caen","Nimes Olympique","2-0",2,0,"1",1,2,2,"H"
1992-04-18,1991,"Olympique Lyon","AJ Auxerre","1-0",1,0,"1",1,1,1,"H"
1992-04-18,1991,"Montpellier HSC","Le Havre AC","2-2",2,2,"1",1,4,0,"D"
1992-04-18,1991,"Lille OSC","RC Lens","1-2",1,2,"1",1,3,-1,"D"
1992-04-18,1991,"AS Cannes","FC Nantes","2-0",2,0,"1",1,2,2,"H"
1992-04-18,1991,"Stade Rennes","Toulouse FC","1-1",1,1,"1",1,2,0,"D"
1992-04-18,1991,"AS Nancy","FC Sochaux","3-1",3,1,"1",1,4,2,"H"
1992-04-18,1991,"Sporting Toulon Var","FC Metz","1-1",1,1,"1",1,2,0,"D"
1992-04-25,1991,"Olympique Marseille","AS Cannes","2-0",2,0,"1",1,2,2,"H"
1992-04-25,1991,"Le Havre AC","AS Monaco","3-0",3,0,"1",1,3,3,"H"
1992-04-25,1991,"RC Lens","Paris Saint-Germain","1-0",1,0,"1",1,1,1,"H"
1992-04-25,1991,"AJ Auxerre","Lille OSC","1-0",1,0,"1",1,1,1,"H"
1992-04-25,1991,"FC Sochaux","SM Caen","2-0",2,0,"1",1,2,2,"H"
1992-04-25,1991,"AS Nancy","Montpellier HSC","3-1",3,1,"1",1,4,2,"H"
1992-04-25,1991,"FC Nantes","Olympique Lyon","3-0",3,0,"1",1,3,3,"H"
1992-04-25,1991,"AS Saint-Etienne","Stade Rennes","0-1",0,1,"1",1,1,-1,"D"
1992-04-25,1991,"Nimes Olympique","FC Metz","1-0",1,0,"1",1,1,1,"H"
1992-04-25,1991,"Toulouse FC","Sporting Toulon Var","3-0",3,0,"1",1,3,3,"H"
1992-05-01,1991,"Lille OSC","Olympique Marseille","0-1",0,1,"1",1,1,-1,"D"
1992-05-01,1991,"AS Monaco","Montpellier HSC","1-1",1,1,"1",1,2,0,"D"
1992-05-01,1991,"Paris Saint-Germain","FC Nantes","1-1",1,1,"1",1,2,0,"D"
1992-05-01,1991,"Stade Rennes","AJ Auxerre","1-1",1,1,"1",1,2,0,"D"
1992-05-01,1991,"SM Caen","Toulouse FC","1-0",1,0,"1",1,1,1,"H"
1992-05-01,1991,"Olympique Lyon","Le Havre AC","0-2",0,2,"1",1,2,-2,"D"
1992-05-01,1991,"FC Metz","RC Lens","3-2",3,2,"1",1,5,1,"H"
1992-05-01,1991,"Nimes Olympique","FC Sochaux","2-2",2,2,"1",1,4,0,"D"
1992-05-01,1991,"AS Cannes","AS Nancy","1-1",1,1,"1",1,2,0,"D"
1992-05-01,1991,"Sporting Toulon Var","AS Saint-Etienne","1-2",1,2,"1",1,3,-1,"D"
1992-08-08,1992,"RC Lens","AJ Auxerre","0-3",0,3,"1",1,3,-3,"D"
1992-08-08,1992,"Le Havre AC","Nimes Olympique","2-0",2,0,"1",1,2,2,"H"
1992-08-08,1992,"Montpellier HSC","SM Caen","2-0",2,0,"1",1,2,2,"H"
1992-08-08,1992,"RC Strasbourg","Lille OSC","2-0",2,0,"1",1,2,2,"H"
1992-08-08,1992,"Olympique Marseille","Toulouse FC","2-1",2,1,"1",1,3,1,"H"
1992-08-08,1992,"AS Saint-Etienne","Paris Saint-Germain","1-2",1,2,"1",1,3,-1,"D"
1992-08-08,1992,"FC Sochaux","US Valenciennes-Anzin","2-1",2,1,"1",1,3,1,"H"
1992-08-08,1992,"Girondins Bordeaux","Olympique Lyon","0-0",0,0,"1",1,0,0,"D"
1992-08-08,1992,"FC Nantes","FC Metz","0-0",0,0,"1",1,0,0,"D"
1992-08-08,1992,"AS Monaco","Sporting Toulon Var","4-0",4,0,"1",1,4,4,"H"
1992-08-14,1992,"Le Havre AC","Girondins Bordeaux","0-1",0,1,"1",1,1,-1,"D"
1992-08-15,1992,"AJ Auxerre","AS Monaco","4-1",4,1,"1",1,5,3,"H"
1992-08-15,1992,"Toulouse FC","Montpellier HSC","1-3",1,3,"1",1,4,-2,"D"
1992-08-15,1992,"Paris Saint-Germain","FC Sochaux","2-0",2,0,"1",1,2,2,"H"
1992-08-15,1992,"US Valenciennes-Anzin","RC Strasbourg","1-2",1,2,"1",1,3,-1,"D"
1992-08-15,1992,"Olympique Lyon","FC Nantes","0-2",0,2,"1",1,2,-2,"D"
1992-08-15,1992,"FC Metz","AS Saint-Etienne","2-2",2,2,"1",1,4,0,"D"
1992-08-15,1992,"Nimes Olympique","RC Lens","1-1",1,1,"1",1,2,0,"D"
1992-08-15,1992,"Lille OSC","SM Caen","1-0",1,0,"1",1,1,1,"H"
1992-08-15,1992,"Sporting Toulon Var","Olympique Marseille","0-0",0,0,"1",1,0,0,"D"
1992-08-21,1992,"FC Nantes","AJ Auxerre","2-1",2,1,"1",1,3,1,"H"
1992-08-22,1992,"Montpellier HSC","Lille OSC","3-0",3,0,"1",1,3,3,"H"
1992-08-22,1992,"RC Strasbourg","Paris Saint-Germain","0-4",0,4,"1",1,4,-4,"D"
1992-08-22,1992,"Olympique Marseille","FC Metz","3-2",3,2,"1",1,5,1,"H"
1992-08-22,1992,"AS Monaco","Nimes Olympique","3-1",3,1,"1",1,4,2,"H"
1992-08-22,1992,"FC Sochaux","Olympique Lyon","1-0",1,0,"1",1,1,1,"H"
1992-08-22,1992,"RC Lens","Le Havre AC","0-0",0,0,"1",1,0,0,"D"
1992-08-22,1992,"AS Saint-Etienne","Toulouse FC","3-2",3,2,"1",1,5,1,"H"
1992-08-22,1992,"SM Caen","US Valenciennes-Anzin","3-0",3,0,"1",1,3,3,"H"
1992-08-22,1992,"Girondins Bordeaux","Sporting Toulon Var","1-1",1,1,"1",1,2,0,"D"
1992-08-29,1992,"Paris Saint-Germain","SM Caen","2-0",2,0,"1",1,2,2,"H"
1992-08-29,1992,"AJ Auxerre","Girondins Bordeaux","1-0",1,0,"1",1,1,1,"H"
1992-08-29,1992,"Nimes Olympique","FC Nantes","1-1",1,1,"1",1,2,0,"D"
1992-08-29,1992,"Olympique Lyon","Olympique Marseille","2-2",2,2,"1",1,4,0,"D"
1992-08-29,1992,"Le Havre AC","AS Monaco","0-0",0,0,"1",1,0,0,"D"
1992-08-29,1992,"Toulouse FC","RC Strasbourg","1-1",1,1,"1",1,2,0,"D"
1992-08-29,1992,"FC Metz","FC Sochaux","5-1",5,1,"1",1,6,4,"H"
1992-08-29,1992,"RC Lens","AS Saint-Etienne","1-1",1,1,"1",1,2,0,"D"
1992-08-29,1992,"US Valenciennes-Anzin","Lille OSC","0-1",0,1,"1",1,1,-1,"D"
1992-08-29,1992,"Sporting Toulon Var","Montpellier HSC","1-0",1,0,"1",1,1,1,"H"
1992-09-01,1992,"Lille OSC","Paris Saint-Germain","0-0",0,0,"1",1,0,0,"D"
1992-09-02,1992,"FC Nantes","Le Havre AC","5-2",5,2,"1",1,7,3,"H"
1992-09-02,1992,"Olympique Marseille","AJ Auxerre","2-0",2,0,"1",1,2,2,"H"
1992-09-02,1992,"AS Monaco","RC Lens","2-1",2,1,"1",1,3,1,"H"
1992-09-02,1992,"Montpellier HSC","US Valenciennes-Anzin","1-3",1,3,"1",1,4,-2,"D"
1992-09-02,1992,"RC Strasbourg","FC Metz","1-1",1,1,"1",1,2,0,"D"
1992-09-02,1992,"FC Sochaux","Toulouse FC","1-0",1,0,"1",1,1,1,"H"
1992-09-02,1992,"SM Caen","Olympique Lyon","3-2",3,2,"1",1,5,1,"H"
1992-09-02,1992,"AS Saint-Etienne","Sporting Toulon Var","2-0",2,0,"1",1,2,2,"H"
1992-09-04,1992,"Girondins Bordeaux","Nimes Olympique","1-1",1,1,"1",1,2,0,"D"
1992-09-11,1992,"FC Metz","SM Caen","1-0",1,0,"1",1,1,1,"H"
1992-09-12,1992,"Paris Saint-Germain","US Valenciennes-Anzin","2-0",2,0,"1",1,2,2,"H"
1992-09-12,1992,"Nimes Olympique","Olympique Marseille","1-3",1,3,"1",1,4,-2,"D"
1992-09-12,1992,"AJ Auxerre","AS Saint-Etienne","1-0",1,0,"1",1,1,1,"H"
1992-09-12,1992,"AS Monaco","Montpellier HSC","0-0",0,0,"1",1,0,0,"D"
1992-09-12,1992,"RC Lens","Girondins Bordeaux","1-2",1,2,"1",1,3,-1,"D"
1992-09-12,1992,"Olympique Lyon","RC Strasbourg","2-2",2,2,"1",1,4,0,"D"
1992-09-12,1992,"Le Havre AC","FC Sochaux","0-0",0,0,"1",1,0,0,"D"
1992-09-12,1992,"Toulouse FC","Lille OSC","0-0",0,0,"1",1,0,0,"D"
1992-09-12,1992,"Sporting Toulon Var","FC Nantes","1-3",1,3,"1",1,4,-2,"D"
1992-09-19,1992,"Montpellier HSC","Paris Saint-Germain","0-0",0,0,"1",1,0,0,"D"
1992-09-19,1992,"FC Nantes","RC Lens","3-2",3,2,"1",1,5,1,"H"
1992-09-19,1992,"Olympique Marseille","Le Havre AC","1-1",1,1,"1",1,2,0,"D"
1992-09-19,1992,"FC Sochaux","AJ Auxerre","0-3",0,3,"1",1,3,-3,"D"
1992-09-19,1992,"Girondins Bordeaux","AS Monaco","1-0",1,0,"1",1,1,1,"H"
1992-09-19,1992,"Lille OSC","FC Metz","1-1",1,1,"1",1,2,0,"D"
1992-09-19,1992,"AS Saint-Etienne","Nimes Olympique","1-0",1,0,"1",1,1,1,"H"
1992-09-19,1992,"SM Caen","Toulouse FC","4-1",4,1,"1",1,5,3,"H"
1992-09-19,1992,"US Valenciennes-Anzin","Olympique Lyon","0-0",0,0,"1",1,0,0,"D"
1992-09-19,1992,"RC Strasbourg","Sporting Toulon Var","1-1",1,1,"1",1,2,0,"D"
1992-09-24,1992,"AJ Auxerre","Lille OSC","2-0",2,0,"1",1,2,2,"H"
1992-09-24,1992,"RC Lens","Olympique Marseille","2-2",2,2,"1",1,4,0,"D"
1992-09-25,1992,"Toulouse FC","Paris Saint-Germain","2-2",2,2,"1",1,4,0,"D"
1992-09-25,1992,"AS Monaco","FC Nantes","3-1",3,1,"1",1,4,2,"H"
1992-09-25,1992,"Le Havre AC","AS Saint-Etienne","0-1",0,1,"1",1,1,-1,"D"
1992-09-25,1992,"Girondins Bordeaux","RC Strasbourg","1-1",1,1,"1",1,2,0,"D"
1992-09-25,1992,"FC Metz","US Valenciennes-Anzin","0-0",0,0,"1",1,0,0,"D"
1992-09-25,1992,"Olympique Lyon","Montpellier HSC","2-1",2,1,"1",1,3,1,"H"
1992-09-25,1992,"Nimes Olympique","FC Sochaux","1-1",1,1,"1",1,2,0,"D"
1992-09-25,1992,"Sporting Toulon Var","SM Caen","1-1",1,1,"1",1,2,0,"D"
1992-10-03,1992,"FC Nantes","Girondins Bordeaux","1-0",1,0,"1",1,1,1,"H"
1992-10-03,1992,"Olympique Marseille","AS Monaco","1-0",1,0,"1",1,1,1,"H"
1992-10-03,1992,"Montpellier HSC","AJ Auxerre","1-0",1,0,"1",1,1,1,"H"
1992-10-03,1992,"AS Saint-Etienne","Olympique Lyon","0-0",0,0,"1",1,0,0,"D"
1992-10-03,1992,"RC Strasbourg","Nimes Olympique","1-1",1,1,"1",1,2,0,"D"
1992-10-03,1992,"Lille OSC","RC Lens","0-0",0,0,"1",1,0,0,"D"
1992-10-03,1992,"US Valenciennes-Anzin","Toulouse FC","1-1",1,1,"1",1,2,0,"D"
1992-10-03,1992,"FC Sochaux","Sporting Toulon Var","2-1",2,1,"1",1,3,1,"H"
1992-10-04,1992,"Paris Saint-Germain","FC Metz","5-1",5,1,"1",1,6,4,"H"
1992-10-04,1992,"SM Caen","Le Havre AC","3-3",3,3,"1",1,6,0,"D"
1992-10-06,1992,"Nimes Olympique","Montpellier HSC","0-0",0,0,"1",1,0,0,"D"
1992-10-07,1992,"Olympique Lyon","Paris Saint-Germain","1-1",1,1,"1",1,2,0,"D"
1992-10-07,1992,"FC Nantes","Lille OSC","4-0",4,0,"1",1,4,4,"H"
1992-10-07,1992,"AJ Auxerre","SM Caen","3-2",3,2,"1",1,5,1,"H"
1992-10-07,1992,"Girondins Bordeaux","Olympique Marseille","1-0",1,0,"1",1,1,1,"H"
1992-10-07,1992,"AS Monaco","AS Saint-Etienne","1-0",1,0,"1",1,1,1,"H"
1992-10-07,1992,"RC Lens","FC Sochaux","0-0",0,0,"1",1,0,0,"D"
1992-10-07,1992,"FC Metz","Toulouse FC","1-1",1,1,"1",1,2,0,"D"
1992-10-07,1992,"Le Havre AC","RC Strasbourg","3-0",3,0,"1",1,3,3,"H"
1992-10-07,1992,"Sporting Toulon Var","US Valenciennes-Anzin","1-2",1,2,"1",1,3,-1,"D"
1992-10-17,1992,"Olympique Marseille","FC Nantes","0-1",0,1,"1",1,1,-1,"D"
1992-10-17,1992,"Paris Saint-Germain","RC Lens","1-1",1,1,"1",1,2,0,"D"
1992-10-17,1992,"RC Strasbourg","AJ Auxerre","1-1",1,1,"1",1,2,0,"D"
1992-10-17,1992,"FC Sochaux","AS Monaco","1-2",1,2,"1",1,3,-1,"D"
1992-10-17,1992,"Montpellier HSC","FC Metz","1-0",1,0,"1",1,1,1,"H"
1992-10-17,1992,"AS Saint-Etienne","Girondins Bordeaux","2-1",2,1,"1",1,3,1,"H"
1992-10-17,1992,"SM Caen","Nimes Olympique","2-2",2,2,"1",1,4,0,"D"
1992-10-17,1992,"US Valenciennes-Anzin","Le Havre AC","4-1",4,1,"1",1,5,3,"H"
1992-10-17,1992,"Toulouse FC","Olympique Lyon","0-0",0,0,"1",1,0,0,"D"
1992-10-17,1992,"Lille OSC","Sporting Toulon Var","1-0",1,0,"1",1,1,1,"H"
1992-10-24,1992,"FC Nantes","Montpellier HSC","6-0",6,0,"1",1,6,6,"H"
1992-10-24,1992,"AJ Auxerre","Toulouse FC","0-0",0,0,"1",1,0,0,"D"
1992-10-24,1992,"AS Monaco","RC Strasbourg","2-1",2,1,"1",1,3,1,"H"
1992-10-24,1992,"Olympique Marseille","AS Saint-Etienne","1-0",1,0,"1",1,1,1,"H"
1992-10-24,1992,"Girondins Bordeaux","FC Sochaux","3-0",3,0,"1",1,3,3,"H"
1992-10-24,1992,"RC Lens","SM Caen","0-3",0,3,"1",1,3,-3,"D"
1992-10-24,1992,"Olympique Lyon","FC Metz","1-1",1,1,"1",1,2,0,"D"
1992-10-24,1992,"Le Havre AC","Lille OSC","1-0",1,0,"1",1,1,1,"H"
1992-10-24,1992,"Nimes Olympique","US Valenciennes-Anzin","2-1",2,1,"1",1,3,1,"H"
1992-10-24,1992,"Sporting Toulon Var","Paris Saint-Germain","0-2",0,2,"1",1,2,-2,"D"
1992-10-29,1992,"AS Saint-Etienne","FC Nantes","1-0",1,0,"1",1,1,1,"H"
1992-10-30,1992,"Paris Saint-Germain","Nimes Olympique","2-3",2,3,"1",1,5,-1,"D"
1992-10-30,1992,"US Valenciennes-Anzin","AJ Auxerre","3-3",3,3,"1",1,6,0,"D"
1992-10-30,1992,"FC Sochaux","Olympique Marseille","2-2",2,2,"1",1,4,0,"D"
1992-10-30,1992,"SM Caen","AS Monaco","1-0",1,0,"1",1,1,1,"H"
1992-10-30,1992,"Montpellier HSC","Girondins Bordeaux","2-0",2,0,"1",1,2,2,"H"
1992-10-30,1992,"RC Strasbourg","RC Lens","4-1",4,1,"1",1,5,3,"H"
1992-10-30,1992,"Toulouse FC","Le Havre AC","1-0",1,0,"1",1,1,1,"H"
1992-10-30,1992,"Lille OSC","Olympique Lyon","1-1",1,1,"1",1,2,0,"D"
1992-10-30,1992,"FC Metz","Sporting Toulon Var","0-0",0,0,"1",1,0,0,"D"
1992-11-07,1992,"FC Nantes","FC Sochaux","1-1",1,1,"1",1,2,0,"D"
1992-11-07,1992,"Le Havre AC","Paris Saint-Germain","1-1",1,1,"1",1,2,0,"D"
1992-11-07,1992,"AJ Auxerre","FC Metz","4-0",4,0,"1",1,4,4,"H"
1992-11-07,1992,"AS Monaco","Lille OSC","3-0",3,0,"1",1,3,3,"H"
1992-11-07,1992,"Olympique Marseille","Montpellier HSC","1-1",1,1,"1",1,2,0,"D"
1992-11-07,1992,"Girondins Bordeaux","SM Caen","2-0",2,0,"1",1,2,2,"H"
1992-11-07,1992,"AS Saint-Etienne","RC Strasbourg","1-2",1,2,"1",1,3,-1,"D"
1992-11-07,1992,"Nimes Olympique","Toulouse FC","1-1",1,1,"1",1,2,0,"D"
1992-11-07,1992,"RC Lens","US Valenciennes-Anzin","2-1",2,1,"1",1,3,1,"H"
1992-11-07,1992,"Sporting Toulon Var","Olympique Lyon","0-0",0,0,"1",1,0,0,"D"
1992-11-19,1992,"Paris Saint-Germain","AJ Auxerre","2-0",2,0,"1",1,2,2,"H"
1992-11-20,1992,"RC Strasbourg","Olympique Marseille","2-2",2,2,"1",1,4,0,"D"
1992-11-20,1992,"SM Caen","FC Nantes","1-1",1,1,"1",1,2,0,"D"
1992-11-20,1992,"Lille OSC","Girondins Bordeaux","0-2",0,2,"1",1,2,-2,"D"
1992-11-20,1992,"Montpellier HSC","RC Lens","1-2",1,2,"1",1,3,-1,"D"
1992-11-20,1992,"FC Sochaux","AS Saint-Etienne","1-0",1,0,"1",1,1,1,"H"
1992-11-20,1992,"FC Metz","Nimes Olympique","3-0",3,0,"1",1,3,3,"H"
1992-11-20,1992,"Olympique Lyon","Le Havre AC","1-1",1,1,"1",1,2,0,"D"
1992-11-20,1992,"US Valenciennes-Anzin","AS Monaco","1-1",1,1,"1",1,2,0,"D"
1992-11-20,1992,"Toulouse FC","Sporting Toulon Var","1-1",1,1,"1",1,2,0,"D"
1992-11-28,1992,"FC Nantes","RC Strasbourg","2-2",2,2,"1",1,4,0,"D"
1992-11-28,1992,"AS Monaco","Paris Saint-Germain","3-1",3,1,"1",1,4,2,"H"
1992-11-28,1992,"Olympique Marseille","SM Caen","2-1",2,1,"1",1,3,1,"H"
1992-11-28,1992,"Girondins Bordeaux","US Valenciennes-Anzin","3-0",3,0,"1",1,3,3,"H"
1992-11-28,1992,"AS Saint-Etienne","Montpellier HSC","1-0",1,0,"1",1,1,1,"H"
1992-11-28,1992,"FC Sochaux","Lille OSC","1-0",1,0,"1",1,1,1,"H"
1992-11-28,1992,"Le Havre AC","FC Metz","2-1",2,1,"1",1,3,1,"H"
1992-11-28,1992,"Nimes Olympique","Olympique Lyon","2-3",2,3,"1",1,5,-1,"D"
1992-11-28,1992,"RC Lens","Toulouse FC","0-2",0,2,"1",1,2,-2,"D"
1992-11-28,1992,"AJ Auxerre","Sporting Toulon Var","2-1",2,1,"1",1,3,1,"H"
1992-12-03,1992,"Olympique Lyon","AJ Auxerre","1-1",1,1,"1",1,2,0,"D"
1992-12-04,1992,"Paris Saint-Germain","Girondins Bordeaux","5-0",5,0,"1",1,5,5,"H"
1992-12-04,1992,"US Valenciennes-Anzin","FC Nantes","1-1",1,1,"1",1,2,0,"D"
1992-12-04,1992,"Toulouse FC","AS Monaco","0-2",0,2,"1",1,2,-2,"D"
1992-12-04,1992,"RC Strasbourg","FC Sochaux","6-1",6,1,"1",1,7,5,"H"
1992-12-04,1992,"SM Caen","AS Saint-Etienne","0-0",0,0,"1",1,0,0,"D"
1992-12-04,1992,"Montpellier HSC","Le Havre AC","2-0",2,0,"1",1,2,2,"H"
1992-12-04,1992,"FC Metz","RC Lens","1-2",1,2,"1",1,3,-1,"D"
1992-12-04,1992,"Lille OSC","Olympique Marseille","2-0",2,0,"1",1,2,2,"H"
1992-12-04,1992,"Sporting Toulon Var","Nimes Olympique","1-0",1,0,"1",1,1,1,"H"
1992-12-12,1992,"FC Nantes","Paris Saint-Germain","1-0",1,0,"1",1,1,1,"H"
1992-12-12,1992,"AS Monaco","FC Metz","2-0",2,0,"1",1,2,2,"H"
1992-12-12,1992,"Nimes Olympique","AJ Auxerre","1-2",1,2,"1",1,3,-1,"D"
1992-12-12,1992,"Olympique Marseille","US Valenciennes-Anzin","2-1",2,1,"1",1,3,1,"H"
1992-12-12,1992,"RC Strasbourg","Montpellier HSC","3-1",3,1,"1",1,4,2,"H"
1992-12-12,1992,"AS Saint-Etienne","Lille OSC","0-0",0,0,"1",1,0,0,"D"
1992-12-12,1992,"FC Sochaux","SM Caen","1-0",1,0,"1",1,1,1,"H"
1992-12-12,1992,"RC Lens","Olympique Lyon","0-3",0,3,"1",1,3,-3,"D"
1992-12-12,1992,"Le Havre AC","Sporting Toulon Var","2-1",2,1,"1",1,3,1,"H"
1992-12-18,1992,"Paris Saint-Germain","Olympique Marseille","0-1",0,1,"1",1,1,-1,"D"
1992-12-19,1992,"Toulouse FC","FC Nantes","2-0",2,0,"1",1,2,2,"H"
1992-12-19,1992,"AJ Auxerre","Le Havre AC","4-1",4,1,"1",1,5,3,"H"
1992-12-19,1992,"Olympique Lyon","AS Monaco","0-0",0,0,"1",1,0,0,"D"
1992-12-19,1992,"FC Metz","Girondins Bordeaux","1-1",1,1,"1",1,2,0,"D"
1992-12-19,1992,"SM Caen","RC Strasbourg","3-0",3,0,"1",1,3,3,"H"
1992-12-19,1992,"US Valenciennes-Anzin","AS Saint-Etienne","0-0",0,0,"1",1,0,0,"D"
1992-12-19,1992,"Montpellier HSC","FC Sochaux","1-0",1,0,"1",1,1,1,"H"
1992-12-19,1992,"Lille OSC","Nimes Olympique","2-2",2,2,"1",1,4,0,"D"
1992-12-19,1992,"Sporting Toulon Var","RC Lens","2-2",2,2,"1",1,4,0,"D"
1993-01-09,1992,"AS Monaco","AJ Auxerre","4-0",4,0,"1",1,4,4,"H"
1993-01-09,1992,"FC Nantes","Olympique Lyon","1-0",1,0,"1",1,1,1,"H"
1993-01-09,1992,"FC Sochaux","Paris Saint-Germain","1-3",1,3,"1",1,4,-2,"D"
1993-01-09,1992,"Girondins Bordeaux","Le Havre AC","3-0",3,0,"1",1,3,3,"H"
1993-01-09,1992,"AS Saint-Etienne","FC Metz","2-0",2,0,"1",1,2,2,"H"
1993-01-09,1992,"RC Strasbourg","US Valenciennes-Anzin","0-0",0,0,"1",1,0,0,"D"
1993-01-09,1992,"Montpellier HSC","Toulouse FC","0-1",0,1,"1",1,1,-1,"D"
1993-01-09,1992,"SM Caen","Lille OSC","4-3",4,3,"1",1,7,1,"H"
1993-01-09,1992,"RC Lens","Nimes Olympique","0-0",0,0,"1",1,0,0,"D"
1993-01-09,1992,"Olympique Marseille","Sporting Toulon Var","5-2",5,2,"1",1,7,3,"H"
1993-01-16,1992,"Nimes Olympique","AS Monaco","0-1",0,1,"1",1,1,-1,"D"
1993-01-16,1992,"AJ Auxerre","FC Nantes","1-1",1,1,"1",1,2,0,"D"
1993-01-16,1992,"Paris Saint-Germain","RC Strasbourg","1-1",1,1,"1",1,2,0,"D"
1993-01-16,1992,"FC Metz","Olympique Marseille","2-1",2,1,"1",1,3,1,"H"
1993-01-16,1992,"Toulouse FC","AS Saint-Etienne","0-0",0,0,"1",1,0,0,"D"
1993-01-16,1992,"Olympique Lyon","FC Sochaux","3-1",3,1,"1",1,4,2,"H"
1993-01-16,1992,"Lille OSC","Montpellier HSC","0-0",0,0,"1",1,0,0,"D"
1993-01-16,1992,"US Valenciennes-Anzin","SM Caen","3-2",3,2,"1",1,5,1,"H"
1993-01-16,1992,"Le Havre AC","RC Lens","0-1",0,1,"1",1,1,-1,"D"
1993-01-16,1992,"Sporting Toulon Var","Girondins Bordeaux","0-0",0,0,"1",1,0,0,"D"
1993-01-22,1992,"SM Caen","Paris Saint-Germain","0-2",0,2,"1",1,2,-2,"D"
1993-01-23,1992,"AS Monaco","Le Havre AC","2-0",2,0,"1",1,2,2,"H"
1993-01-23,1992,"FC Nantes","Nimes Olympique","2-0",2,0,"1",1,2,2,"H"
1993-01-23,1992,"Olympique Marseille","Olympique Lyon","2-1",2,1,"1",1,3,1,"H"
1993-01-23,1992,"Girondins Bordeaux","AJ Auxerre","1-0",1,0,"1",1,1,1,"H"
1993-01-23,1992,"AS Saint-Etienne","RC Lens","0-0",0,0,"1",1,0,0,"D"
1993-01-23,1992,"RC Strasbourg","Toulouse FC","0-0",0,0,"1",1,0,0,"D"
1993-01-23,1992,"FC Sochaux","FC Metz","2-0",2,0,"1",1,2,2,"H"
1993-01-23,1992,"Lille OSC","US Valenciennes-Anzin","1-2",1,2,"1",1,3,-1,"D"
1993-01-23,1992,"Montpellier HSC","Sporting Toulon Var","1-1",1,1,"1",1,2,0,"D"
1993-01-27,1992,"Girondins Bordeaux","Toulouse FC","2-0",2,0,"1",1,2,2,"H"
1993-01-29,1992,"FC Metz","RC Strasbourg","3-0",3,0,"1",1,3,3,"H"
1993-01-30,1992,"RC Lens","AS Monaco","0-0",0,0,"1",1,0,0,"D"
1993-01-30,1992,"Paris Saint-Germain","Lille OSC","3-0",3,0,"1",1,3,3,"H"
1993-01-30,1992,"Le Havre AC","FC Nantes","2-0",2,0,"1",1,2,2,"H"
1993-01-30,1992,"AJ Auxerre","Olympique Marseille","0-2",0,2,"1",1,2,-2,"D"
1993-01-30,1992,"Nimes Olympique","Girondins Bordeaux","0-0",0,0,"1",1,0,0,"D"
1993-01-30,1992,"US Valenciennes-Anzin","Montpellier HSC","1-3",1,3,"1",1,4,-2,"D"
1993-01-30,1992,"Olympique Lyon","SM Caen","1-0",1,0,"1",1,1,1,"H"
1993-01-30,1992,"Toulouse FC","FC Sochaux","1-0",1,0,"1",1,1,1,"H"
1993-01-30,1992,"Sporting Toulon Var","AS Saint-Etienne","0-0",0,0,"1",1,0,0,"D"
1993-02-05,1992,"Girondins Bordeaux","RC Lens","0-0",0,0,"1",1,0,0,"D"
1993-02-06,1992,"Montpellier HSC","AS Monaco","0-0",0,0,"1",1,0,0,"D"
1993-02-06,1992,"Olympique Marseille","Nimes Olympique","6-1",6,1,"1",1,7,5,"H"
1993-02-06,1992,"US Valenciennes-Anzin","Paris Saint-Germain","1-1",1,1,"1",1,2,0,"D"
1993-02-06,1992,"AS Saint-Etienne","AJ Auxerre","1-0",1,0,"1",1,1,1,"H"
1993-02-06,1992,"RC Strasbourg","Olympique Lyon","2-1",2,1,"1",1,3,1,"H"
1993-02-06,1992,"FC Sochaux","Le Havre AC","3-2",3,2,"1",1,5,1,"H"
1993-02-06,1992,"Lille OSC","Toulouse FC","2-2",2,2,"1",1,4,0,"D"
1993-02-06,1992,"SM Caen","FC Metz","0-1",0,1,"1",1,1,-1,"D"
1993-02-06,1992,"FC Nantes","Sporting Toulon Var","0-0",0,0,"1",1,0,0,"D"
1993-02-10,1992,"AS Monaco","Girondins Bordeaux","0-0",0,0,"1",1,0,0,"D"
1993-02-10,1992,"Le Havre AC","Olympique Marseille","1-3",1,3,"1",1,4,-2,"D"
1993-02-10,1992,"Paris Saint-Germain","Montpellier HSC","1-0",1,0,"1",1,1,1,"H"
1993-02-10,1992,"RC Lens","FC Nantes","1-0",1,0,"1",1,1,1,"H"
1993-02-10,1992,"Nimes Olympique","AS Saint-Etienne","1-1",1,1,"1",1,2,0,"D"
1993-02-10,1992,"AJ Auxerre","FC Sochaux","0-3",0,3,"1",1,3,-3,"D"
1993-02-10,1992,"Olympique Lyon","US Valenciennes-Anzin","2-1",2,1,"1",1,3,1,"H"
1993-02-10,1992,"Toulouse FC","SM Caen","1-1",1,1,"1",1,2,0,"D"
1993-02-10,1992,"FC Metz","Lille OSC","0-0",0,0,"1",1,0,0,"D"
1993-02-10,1992,"Sporting Toulon Var","RC Strasbourg","0-2",0,2,"1",1,2,-2,"D"
1993-02-21,1992,"Olympique Marseille","RC Lens","2-0",2,0,"1",1,2,2,"H"
1993-02-21,1992,"Paris Saint-Germain","Toulouse FC","0-0",0,0,"1",1,0,0,"D"
1993-02-21,1992,"FC Nantes","AS Monaco","1-0",1,0,"1",1,1,1,"H"
1993-02-21,1992,"RC Strasbourg","Girondins Bordeaux","0-1",0,1,"1",1,1,-1,"D"
1993-02-21,1992,"AS Saint-Etienne","Le Havre AC","0-0",0,0,"1",1,0,0,"D"
1993-02-21,1992,"Lille OSC","AJ Auxerre","1-0",1,0,"1",1,1,1,"H"
1993-02-21,1992,"Montpellier HSC","Olympique Lyon","0-2",0,2,"1",1,2,-2,"D"
1993-02-21,1992,"FC Sochaux","Nimes Olympique","1-1",1,1,"1",1,2,0,"D"
1993-02-21,1992,"US Valenciennes-Anzin","FC Metz","0-2",0,2,"1",1,2,-2,"D"
1993-02-21,1992,"SM Caen","Sporting Toulon Var","2-1",2,1,"1",1,3,1,"H"
1993-02-25,1992,"AS Monaco","Olympique Marseille","1-0",1,0,"1",1,1,1,"H"
1993-02-26,1992,"FC Metz","Paris Saint-Germain","2-1",2,1,"1",1,3,1,"H"
1993-02-26,1992,"Girondins Bordeaux","FC Nantes","3-0",3,0,"1",1,3,3,"H"
1993-02-26,1992,"Olympique Lyon","AS Saint-Etienne","0-2",0,2,"1",1,2,-2,"D"
1993-02-26,1992,"Nimes Olympique","RC Strasbourg","2-6",2,6,"1",1,8,-4,"D"
1993-02-26,1992,"AJ Auxerre","Montpellier HSC","2-0",2,0,"1",1,2,2,"H"
1993-02-26,1992,"Le Havre AC","SM Caen","2-3",2,3,"1",1,5,-1,"D"
1993-02-26,1992,"RC Lens","Lille OSC","0-0",0,0,"1",1,0,0,"D"
1993-02-26,1992,"Toulouse FC","US Valenciennes-Anzin","1-2",1,2,"1",1,3,-1,"D"
1993-02-26,1992,"Sporting Toulon Var","FC Sochaux","0-4",0,4,"1",1,4,-4,"D"
1993-03-11,1992,"SM Caen","AJ Auxerre","2-1",2,1,"1",1,3,1,"H"
1993-03-12,1992,"AS Saint-Etienne","AS Monaco","0-0",0,0,"1",1,0,0,"D"
1993-03-12,1992,"Olympique Marseille","Girondins Bordeaux","0-0",0,0,"1",1,0,0,"D"
1993-03-12,1992,"Paris Saint-Germain","Olympique Lyon","1-1",1,1,"1",1,2,0,"D"
1993-03-12,1992,"Lille OSC","FC Nantes","1-1",1,1,"1",1,2,0,"D"
1993-03-12,1992,"RC Strasbourg","Le Havre AC","3-1",3,1,"1",1,4,2,"H"
1993-03-12,1992,"FC Sochaux","RC Lens","1-1",1,1,"1",1,2,0,"D"
1993-03-12,1992,"Montpellier HSC","Nimes Olympique","1-0",1,0,"1",1,1,1,"H"
1993-03-12,1992,"Toulouse FC","FC Metz","0-0",0,0,"1",1,0,0,"D"
1993-03-12,1992,"US Valenciennes-Anzin","Sporting Toulon Var","3-1",3,1,"1",1,4,2,"H"
1993-03-20,1992,"AS Monaco","FC Sochaux","1-0",1,0,"1",1,1,1,"H"
1993-03-20,1992,"FC Nantes","Olympique Marseille","0-2",0,2,"1",1,2,-2,"D"
1993-03-20,1992,"Girondins Bordeaux","AS Saint-Etienne","0-0",0,0,"1",1,0,0,"D"
1993-03-20,1992,"Olympique Lyon","Toulouse FC","1-0",1,0,"1",1,1,1,"H"
1993-03-20,1992,"AJ Auxerre","RC Strasbourg","2-0",2,0,"1",1,2,2,"H"
1993-03-20,1992,"Le Havre AC","US Valenciennes-Anzin","0-0",0,0,"1",1,0,0,"D"
1993-03-20,1992,"Sporting Toulon Var","Lille OSC","1-0",1,0,"1",1,1,1,"H"
1993-03-21,1992,"RC Lens","Paris Saint-Germain","2-1",2,1,"1",1,3,1,"H"
1993-03-21,1992,"FC Metz","Montpellier HSC","1-1",1,1,"1",1,2,0,"D"
1993-03-21,1992,"Nimes Olympique","SM Caen","1-2",1,2,"1",1,3,-1,"D"
1993-04-02,1992,"AS Saint-Etienne","Olympique Marseille","0-2",0,2,"1",1,2,-2,"D"
1993-04-02,1992,"RC Strasbourg","AS Monaco","3-0",3,0,"1",1,3,3,"H"
1993-04-02,1992,"FC Sochaux","Girondins Bordeaux","0-1",0,1,"1",1,1,-1,"D"
1993-04-02,1992,"Montpellier HSC","FC Nantes","1-0",1,0,"1",1,1,1,"H"
1993-04-02,1992,"Toulouse FC","AJ Auxerre","2-1",2,1,"1",1,3,1,"H"
1993-04-02,1992,"FC Metz","Olympique Lyon","2-0",2,0,"1",1,2,2,"H"
1993-04-02,1992,"SM Caen","RC Lens","0-1",0,1,"1",1,1,-1,"D"
1993-04-02,1992,"US Valenciennes-Anzin","Nimes Olympique","1-1",1,1,"1",1,2,0,"D"
1993-04-02,1992,"Lille OSC","Le Havre AC","2-1",2,1,"1",1,3,1,"H"
1993-04-02,1992,"Paris Saint-Germain","Sporting Toulon Var","2-0",2,0,"1",1,2,2,"H"
1993-04-10,1992,"Olympique Marseille","FC Sochaux","2-0",2,0,"1",1,2,2,"H"
1993-04-10,1992,"AS Monaco","SM Caen","4-2",4,2,"1",1,6,2,"H"
1993-04-10,1992,"Girondins Bordeaux","Montpellier HSC","2-1",2,1,"1",1,3,1,"H"
1993-04-10,1992,"Nimes Olympique","Paris Saint-Germain","0-1",0,1,"1",1,1,-1,"D"
1993-04-10,1992,"FC Nantes","AS Saint-Etienne","0-0",0,0,"1",1,0,0,"D"
1993-04-10,1992,"RC Lens","RC Strasbourg","2-0",2,0,"1",1,2,2,"H"
1993-04-10,1992,"AJ Auxerre","US Valenciennes-Anzin","3-2",3,2,"1",1,5,1,"H"
1993-04-10,1992,"Olympique Lyon","Lille OSC","1-3",1,3,"1",1,4,-2,"D"
1993-04-10,1992,"Le Havre AC","Toulouse FC","3-2",3,2,"1",1,5,1,"H"
1993-04-10,1992,"Sporting Toulon Var","FC Metz","1-0",1,0,"1",1,1,1,"H"
1993-04-14,1992,"Montpellier HSC","Olympique Marseille","1-1",1,1,"1",1,2,0,"D"
1993-04-14,1992,"Lille OSC","AS Monaco","1-1",1,1,"1",1,2,0,"D"
1993-04-14,1992,"Paris Saint-Germain","Le Havre AC","1-0",1,0,"1",1,1,1,"H"
1993-04-14,1992,"SM Caen","Girondins Bordeaux","1-0",1,0,"1",1,1,1,"H"
1993-04-14,1992,"FC Metz","AJ Auxerre","0-1",0,1,"1",1,1,-1,"D"
1993-04-14,1992,"RC Strasbourg","AS Saint-Etienne","2-2",2,2,"1",1,4,0,"D"
1993-04-14,1992,"US Valenciennes-Anzin","RC Lens","0-2",0,2,"1",1,2,-2,"D"
1993-04-14,1992,"Olympique Lyon","Sporting Toulon Var","1-1",1,1,"1",1,2,0,"D"
1993-04-15,1992,"FC Sochaux","FC Nantes","0-1",0,1,"1",1,1,-1,"D"
1993-05-01,1992,"Olympique Marseille","RC Strasbourg","5-0",5,0,"1",1,5,5,"H"
1993-05-01,1992,"AS Monaco","US Valenciennes-Anzin","2-1",2,1,"1",1,3,1,"H"
1993-05-01,1992,"AJ Auxerre","Paris Saint-Germain","1-2",1,2,"1",1,3,-1,"D"
1993-05-01,1992,"Girondins Bordeaux","Lille OSC","3-0",3,0,"1",1,3,3,"H"
1993-05-01,1992,"FC Nantes","SM Caen","1-1",1,1,"1",1,2,0,"D"
1993-05-01,1992,"AS Saint-Etienne","FC Sochaux","2-0",2,0,"1",1,2,2,"H"
1993-05-01,1992,"RC Lens","Montpellier HSC","2-0",2,0,"1",1,2,2,"H"
1993-05-01,1992,"Le Havre AC","Olympique Lyon","2-0",2,0,"1",1,2,2,"H"
1993-05-01,1992,"Nimes Olympique","FC Metz","2-2",2,2,"1",1,4,0,"D"
1993-05-01,1992,"Sporting Toulon Var","Toulouse FC","2-0",2,0,"1",1,2,2,"H"
1993-05-08,1992,"SM Caen","Olympique Marseille","2-3",2,3,"1",1,5,-1,"D"
1993-05-08,1992,"Paris Saint-Germain","AS Monaco","1-0",1,0,"1",1,1,1,"H"
1993-05-08,1992,"US Valenciennes-Anzin","Girondins Bordeaux","1-0",1,0,"1",1,1,1,"H"
1993-05-08,1992,"RC Strasbourg","FC Nantes","2-4",2,4,"1",1,6,-2,"D"
1993-05-08,1992,"Montpellier HSC","AS Saint-Etienne","1-2",1,2,"1",1,3,-1,"D"
1993-05-08,1992,"Toulouse FC","RC Lens","0-0",0,0,"1",1,0,0,"D"
1993-05-08,1992,"FC Metz","Le Havre AC","2-3",2,3,"1",1,5,-1,"D"
1993-05-08,1992,"Olympique Lyon","Nimes Olympique","0-1",0,1,"1",1,1,-1,"D"
1993-05-08,1992,"Lille OSC","FC Sochaux","0-0",0,0,"1",1,0,0,"D"
1993-05-08,1992,"Sporting Toulon Var","AJ Auxerre","1-2",1,2,"1",1,3,-1,"D"
1993-05-12,1992,"Toulouse FC","Nimes Olympique","3-0",3,0,"1",1,3,3,"H"
1993-05-14,1992,"Girondins Bordeaux","Paris Saint-Germain","1-1",1,1,"1",1,2,0,"D"
1993-05-15,1992,"Olympique Marseille","Lille OSC","4-1",4,1,"1",1,5,3,"H"
1993-05-15,1992,"AS Monaco","Toulouse FC","4-0",4,0,"1",1,4,4,"H"
1993-05-15,1992,"FC Nantes","US Valenciennes-Anzin","3-1",3,1,"1",1,4,2,"H"
1993-05-15,1992,"AS Saint-Etienne","SM Caen","1-1",1,1,"1",1,2,0,"D"
1993-05-15,1992,"AJ Auxerre","Olympique Lyon","2-1",2,1,"1",1,3,1,"H"
1993-05-15,1992,"RC Lens","FC Metz","2-0",2,0,"1",1,2,2,"H"
1993-05-15,1992,"FC Sochaux","RC Strasbourg","0-0",0,0,"1",1,0,0,"D"
1993-05-15,1992,"Le Havre AC","Montpellier HSC","1-1",1,1,"1",1,2,0,"D"
1993-05-15,1992,"Nimes Olympique","Sporting Toulon Var","0-1",0,1,"1",1,1,-1,"D"
1993-05-20,1992,"US Valenciennes-Anzin","Olympique Marseille","0-0",0,0,"1",1,0,0,"D"
1993-05-22,1992,"Paris Saint-Germain","FC Nantes","1-0",1,0,"1",1,1,1,"H"
1993-05-22,1992,"FC Metz","AS Monaco","1-0",1,0,"1",1,1,1,"H"
1993-05-22,1992,"Toulouse FC","Girondins Bordeaux","2-0",2,0,"1",1,2,2,"H"
1993-05-22,1992,"AJ Auxerre","Nimes Olympique","5-2",5,2,"1",1,7,3,"H"
1993-05-22,1992,"Lille OSC","AS Saint-Etienne","0-0",0,0,"1",1,0,0,"D"
1993-05-22,1992,"Montpellier HSC","RC Strasbourg","1-1",1,1,"1",1,2,0,"D"
1993-05-22,1992,"Olympique Lyon","RC Lens","3-1",3,1,"1",1,4,2,"H"
1993-05-22,1992,"SM Caen","FC Sochaux","2-0",2,0,"1",1,2,2,"H"
1993-05-22,1992,"Sporting Toulon Var","Le Havre AC","1-2",1,2,"1",1,3,-1,"D"
1993-05-29,1992,"Olympique Marseille","Paris Saint-Germain","3-1",3,1,"1",1,4,2,"H"
1993-05-29,1992,"AS Monaco","Olympique Lyon","2-1",2,1,"1",1,3,1,"H"
1993-05-29,1992,"Girondins Bordeaux","FC Metz","2-1",2,1,"1",1,3,1,"H"
1993-05-29,1992,"FC Nantes","Toulouse FC","4-1",4,1,"1",1,5,3,"H"
1993-05-29,1992,"AS Saint-Etienne","US Valenciennes-Anzin","4-2",4,2,"1",1,6,2,"H"
1993-05-29,1992,"Le Havre AC","AJ Auxerre","0-0",0,0,"1",1,0,0,"D"
1993-05-29,1992,"RC Strasbourg","SM Caen","1-1",1,1,"1",1,2,0,"D"
1993-05-29,1992,"FC Sochaux","Montpellier HSC","1-1",1,1,"1",1,2,0,"D"
1993-05-29,1992,"Nimes Olympique","Lille OSC","0-0",0,0,"1",1,0,0,"D"
1993-05-29,1992,"RC Lens","Sporting Toulon Var","2-1",2,1,"1",1,3,1,"H"
1993-06-02,1992,"Toulouse FC","Olympique Marseille","3-1",3,1,"1",1,4,2,"H"
1993-06-02,1992,"Paris Saint-Germain","AS Saint-Etienne","3-1",3,1,"1",1,4,2,"H"
1993-06-02,1992,"Olympique Lyon","Girondins Bordeaux","2-3",2,3,"1",1,5,-1,"D"
1993-06-02,1992,"FC Metz","FC Nantes","4-0",4,0,"1",1,4,4,"H"
1993-06-02,1992,"AJ Auxerre","RC Lens","1-1",1,1,"1",1,2,0,"D"
1993-06-02,1992,"Lille OSC","RC Strasbourg","2-3",2,3,"1",1,5,-1,"D"
1993-06-02,1992,"SM Caen","Montpellier HSC","2-3",2,3,"1",1,5,-1,"D"
1993-06-02,1992,"Nimes Olympique","Le Havre AC","0-2",0,2,"1",1,2,-2,"D"
1993-06-02,1992,"US Valenciennes-Anzin","FC Sochaux","1-0",1,0,"1",1,1,1,"H"
1993-06-02,1992,"Sporting Toulon Var","AS Monaco","4-5",4,5,"1",1,9,-1,"D"
1993-07-23,1993,"FC Nantes","AS Monaco","1-0",1,0,"1",1,1,1,"H"
1993-07-24,1993,"Toulouse FC","Le Havre AC","0-0",0,0,"1",1,0,0,"D"
1993-07-24,1993,"Girondins Bordeaux","Paris Saint-Germain","1-0",1,0,"1",1,1,1,"H"
1993-07-24,1993,"SM Caen","FC Metz","1-1",1,1,"1",1,2,0,"D"
1993-07-24,1993,"Lille OSC","FC Martigues","1-1",1,1,"1",1,2,0,"D"
1993-07-24,1993,"Olympique Marseille","RC Lens","1-0",1,0,"1",1,1,1,"H"
1993-07-24,1993,"Montpellier HSC","Olympique Lyon","1-1",1,1,"1",1,2,0,"D"
1993-07-24,1993,"RC Strasbourg","AJ Auxerre","1-1",1,1,"1",1,2,0,"D"
1993-07-24,1993,"AS Saint-Etienne","AS Cannes","1-2",1,2,"1",1,3,-1,"D"
1993-07-24,1993,"FC Sochaux","Angers SCO","4-1",4,1,"1",1,5,3,"H"
1993-07-31,1993,"AS Monaco","Toulouse FC","3-0",3,0,"1",1,3,3,"H"
1993-07-31,1993,"Le Havre AC","Girondins Bordeaux","0-3",0,3,"1",1,3,-3,"D"
1993-07-31,1993,"RC Lens","RC Strasbourg","0-0",0,0,"1",1,0,0,"D"
1993-07-31,1993,"Olympique Lyon","SM Caen","2-0",2,0,"1",1,2,2,"H"
1993-07-31,1993,"FC Martigues","FC Sochaux","1-1",1,1,"1",1,2,0,"D"
1993-07-31,1993,"FC Metz","Angers SCO","2-0",2,0,"1",1,2,2,"H"
1993-07-31,1993,"FC Nantes","AS Saint-Etienne","1-0",1,0,"1",1,1,1,"H"
1993-07-31,1993,"AJ Auxerre","Montpellier HSC","3-1",3,1,"1",1,4,2,"H"
1993-07-31,1993,"Paris Saint-Germain","Lille OSC","2-1",2,1,"1",1,3,1,"H"
1993-08-01,1993,"AS Cannes","Olympique Marseille","2-1",2,1,"1",1,3,1,"H"
1993-08-06,1993,"Lille OSC","RC Lens","0-0",0,0,"1",1,0,0,"D"
1993-08-07,1993,"RC Strasbourg","Paris Saint-Germain","2-2",2,2,"1",1,4,0,"D"
1993-08-07,1993,"Toulouse FC","FC Nantes","0-3",0,3,"1",1,3,-3,"D"
1993-08-07,1993,"AS Saint-Etienne","AS Monaco","2-0",2,0,"1",1,2,2,"H"
1993-08-07,1993,"Montpellier HSC","FC Martigues","1-0",1,0,"1",1,1,1,"H"
1993-08-07,1993,"Olympique Marseille","Le Havre AC","1-1",1,1,"1",1,2,0,"D"
1993-08-07,1993,"SM Caen","AJ Auxerre","1-0",1,0,"1",1,1,1,"H"
1993-08-07,1993,"Girondins Bordeaux","AS Cannes","0-0",0,0,"1",1,0,0,"D"
1993-08-07,1993,"Angers SCO","Olympique Lyon","3-1",3,1,"1",1,4,2,"H"
1993-08-07,1993,"FC Sochaux","FC Metz","2-1",2,1,"1",1,3,1,"H"
1993-08-10,1993,"AS Monaco","Girondins Bordeaux","3-2",3,2,"1",1,5,1,"H"
1993-08-11,1993,"AJ Auxerre","Angers SCO","0-0",0,0,"1",1,0,0,"D"
1993-08-11,1993,"Toulouse FC","RC Strasbourg","0-0",0,0,"1",1,0,0,"D"
1993-08-11,1993,"Paris Saint-Germain","FC Sochaux","1-0",1,0,"1",1,1,1,"H"
1993-08-11,1993,"FC Nantes","Olympique Marseille","0-0",0,0,"1",1,0,0,"D"
1993-08-11,1993,"FC Martigues","SM Caen","4-1",4,1,"1",1,5,3,"H"
1993-08-11,1993,"Olympique Lyon","FC Metz","2-0",2,0,"1",1,2,2,"H"
1993-08-11,1993,"RC Lens","Montpellier HSC","2-1",2,1,"1",1,3,1,"H"
1993-08-11,1993,"AS Cannes","Lille OSC","2-1",2,1,"1",1,3,1,"H"
1993-08-11,1993,"Le Havre AC","AS Saint-Etienne","0-0",0,0,"1",1,0,0,"D"
1993-08-14,1993,"Montpellier HSC","AS Monaco","0-3",0,3,"1",1,3,-3,"D"
1993-08-14,1993,"Angers SCO","FC Martigues","1-3",1,3,"1",1,4,-2,"D"
1993-08-14,1993,"FC Sochaux","Olympique Lyon","0-1",0,1,"1",1,1,-1,"D"
1993-08-14,1993,"RC Strasbourg","AS Cannes","2-2",2,2,"1",1,4,0,"D"
1993-08-14,1993,"Girondins Bordeaux","FC Nantes","2-0",2,0,"1",1,2,2,"H"
1993-08-14,1993,"FC Metz","AJ Auxerre","0-0",0,0,"1",1,0,0,"D"
1993-08-14,1993,"Lille OSC","Le Havre AC","2-2",2,2,"1",1,4,0,"D"
1993-08-14,1993,"SM Caen","RC Lens","1-0",1,0,"1",1,1,1,"H"
1993-08-14,1993,"AS Saint-Etienne","Toulouse FC","2-2",2,2,"1",1,4,0,"D"
1993-08-15,1993,"Olympique Marseille","Paris Saint-Germain","1-0",1,0,"1",1,1,1,"H"
1993-08-27,1993,"AS Monaco","Olympique Marseille","0-0",0,0,"1",1,0,0,"D"
1993-08-28,1993,"RC Lens","Angers SCO","0-1",0,1,"1",1,1,-1,"D"
1993-08-28,1993,"AS Saint-Etienne","Girondins Bordeaux","0-0",0,0,"1",1,0,0,"D"
1993-08-28,1993,"AJ Auxerre","Olympique Lyon","3-2",3,2,"1",1,5,1,"H"
1993-08-28,1993,"Le Havre AC","RC Strasbourg","0-1",0,1,"1",1,1,-1,"D"
1993-08-28,1993,"FC Martigues","FC Metz","1-1",1,1,"1",1,2,0,"D"
1993-08-28,1993,"Toulouse FC","Lille OSC","1-1",1,1,"1",1,2,0,"D"
1993-08-28,1993,"FC Nantes","Montpellier HSC","0-0",0,0,"1",1,0,0,"D"
1993-08-28,1993,"Paris Saint-Germain","SM Caen","2-0",2,0,"1",1,2,2,"H"
1993-08-28,1993,"AS Cannes","FC Sochaux","1-1",1,1,"1",1,2,0,"D"
1993-08-31,1993,"Girondins Bordeaux","Toulouse FC","2-0",2,0,"1",1,2,2,"H"
1993-09-01,1993,"Angers SCO","Paris Saint-Germain","1-1",1,1,"1",1,2,0,"D"
1993-09-01,1993,"FC Sochaux","AJ Auxerre","1-0",1,0,"1",1,1,1,"H"
1993-09-01,1993,"FC Metz","RC Lens","2-1",2,1,"1",1,3,1,"H"
1993-09-01,1993,"RC Strasbourg","AS Monaco","1-1",1,1,"1",1,2,0,"D"
1993-09-01,1993,"Montpellier HSC","Le Havre AC","2-1",2,1,"1",1,3,1,"H"
1993-09-01,1993,"Olympique Marseille","AS Saint-Etienne","3-1",3,1,"1",1,4,2,"H"
1993-09-01,1993,"Olympique Lyon","FC Martigues","0-0",0,0,"1",1,0,0,"D"
1993-09-01,1993,"SM Caen","AS Cannes","1-1",1,1,"1",1,2,0,"D"
1993-09-01,1993,"Lille OSC","FC Nantes","0-0",0,0,"1",1,0,0,"D"
1993-09-10,1993,"Le Havre AC","SM Caen","1-2",1,2,"1",1,3,-1,"D"
1993-09-11,1993,"Girondins Bordeaux","FC Metz","2-0",2,0,"1",1,2,2,"H"
1993-09-11,1993,"FC Nantes","RC Strasbourg","2-2",2,2,"1",1,4,0,"D"
1993-09-11,1993,"Toulouse FC","Olympique Marseille","0-0",0,0,"1",1,0,0,"D"
1993-09-11,1993,"AS Saint-Etienne","FC Sochaux","0-0",0,0,"1",1,0,0,"D"
1993-09-11,1993,"Paris Saint-Germain","Montpellier HSC","1-0",1,0,"1",1,1,1,"H"
1993-09-11,1993,"FC Martigues","AJ Auxerre","0-1",0,1,"1",1,1,-1,"D"
1993-09-11,1993,"AS Cannes","Angers SCO","4-3",4,3,"1",1,7,1,"H"
1993-09-11,1993,"RC Lens","Olympique Lyon","2-0",2,0,"1",1,2,2,"H"
1993-09-11,1993,"AS Monaco","Lille OSC","1-0",1,0,"1",1,1,1,"H"
1993-09-18,1993,"Olympique Marseille","Girondins Bordeaux","3-1",3,1,"1",1,4,2,"H"
1993-09-18,1993,"FC Sochaux","AS Monaco","2-0",2,0,"1",1,2,2,"H"
1993-09-18,1993,"RC Strasbourg","FC Martigues","3-0",3,0,"1",1,3,3,"H"
1993-09-18,1993,"FC Metz","Le Havre AC","2-0",2,0,"1",1,2,2,"H"
1993-09-18,1993,"Olympique Lyon","Paris Saint-Germain","1-3",1,3,"1",1,4,-2,"D"
1993-09-18,1993,"Lille OSC","AS Saint-Etienne","0-2",0,2,"1",1,2,-2,"D"
1993-09-18,1993,"SM Caen","Toulouse FC","1-0",1,0,"1",1,1,1,"H"
1993-09-18,1993,"AJ Auxerre","RC Lens","1-0",1,0,"1",1,1,1,"H"
1993-09-18,1993,"Montpellier HSC","AS Cannes","2-1",2,1,"1",1,3,1,"H"
1993-09-19,1993,"Angers SCO","FC Nantes","0-0",0,0,"1",1,0,0,"D"
1993-09-23,1993,"Paris Saint-Germain","AJ Auxerre","4-0",4,0,"1",1,4,4,"H"
1993-09-24,1993,"RC Lens","FC Martigues","1-1",1,1,"1",1,2,0,"D"
1993-09-24,1993,"Olympique Marseille","FC Metz","0-3",0,3,"1",1,3,-3,"D"
1993-09-24,1993,"AS Saint-Etienne","RC Strasbourg","0-0",0,0,"1",1,0,0,"D"
1993-09-24,1993,"FC Nantes","SM Caen","1-0",1,0,"1",1,1,1,"H"
1993-09-24,1993,"Le Havre AC","FC Sochaux","0-0",0,0,"1",1,0,0,"D"
1993-09-24,1993,"AS Cannes","Olympique Lyon","1-0",1,0,"1",1,1,1,"H"
1993-09-24,1993,"Girondins Bordeaux","Lille OSC","2-1",2,1,"1",1,3,1,"H"
1993-09-24,1993,"AS Monaco","Angers SCO","3-0",3,0,"1",1,3,3,"H"
1993-10-02,1993,"FC Martigues","Paris Saint-Germain","1-1",1,1,"1",1,2,0,"D"
1993-10-02,1993,"FC Sochaux","RC Lens","1-1",1,1,"1",1,2,0,"D"
1993-10-02,1993,"RC Strasbourg","Girondins Bordeaux","0-2",0,2,"1",1,2,-2,"D"
1993-10-02,1993,"FC Metz","AS Cannes","0-0",0,0,"1",1,0,0,"D"
1993-10-02,1993,"Olympique Lyon","FC Nantes","2-1",2,1,"1",1,3,1,"H"
1993-10-02,1993,"Lille OSC","Olympique Marseille","1-2",1,2,"1",1,3,-1,"D"
1993-10-02,1993,"AJ Auxerre","Toulouse FC","5-1",5,1,"1",1,6,4,"H"
1993-10-02,1993,"Angers SCO","Le Havre AC","0-0",0,0,"1",1,0,0,"D"
1993-10-02,1993,"Montpellier HSC","AS Saint-Etienne","3-0",3,0,"1",1,3,3,"H"
1993-10-03,1993,"SM Caen","AS Monaco","0-1",0,1,"1",1,1,-1,"D"
1993-10-05,1993,"Girondins Bordeaux","Montpellier HSC","1-1",1,1,"1",1,2,0,"D"
1993-10-06,1993,"AS Monaco","Olympique Lyon","1-1",1,1,"1",1,2,0,"D"
1993-10-06,1993,"AS Saint-Etienne","SM Caen","5-0",5,0,"1",1,5,5,"H"
1993-10-06,1993,"Toulouse FC","Angers SCO","2-1",2,1,"1",1,3,1,"H"
1993-10-06,1993,"Paris Saint-Germain","RC Lens","1-0",1,0,"1",1,1,1,"H"
1993-10-06,1993,"FC Nantes","FC Metz","2-0",2,0,"1",1,2,2,"H"
1993-10-06,1993,"Lille OSC","FC Sochaux","3-1",3,1,"1",1,4,2,"H"
1993-10-06,1993,"Le Havre AC","AJ Auxerre","1-0",1,0,"1",1,1,1,"H"
1993-10-06,1993,"AS Cannes","FC Martigues","2-1",2,1,"1",1,3,1,"H"
1993-10-06,1993,"Olympique Marseille","RC Strasbourg","2-1",2,1,"1",1,3,1,"H"
1993-10-16,1993,"Olympique Lyon","Le Havre AC","1-1",1,1,"1",1,2,0,"D"
1993-10-16,1993,"RC Strasbourg","Lille OSC","1-1",1,1,"1",1,2,0,"D"
1993-10-16,1993,"FC Martigues","Toulouse FC","1-1",1,1,"1",1,2,0,"D"
1993-10-16,1993,"RC Lens","AS Cannes","2-1",2,1,"1",1,3,1,"H"
1993-10-16,1993,"SM Caen","Girondins Bordeaux","1-0",1,0,"1",1,1,1,"H"
1993-10-16,1993,"AJ Auxerre","AS Monaco","4-0",4,0,"1",1,4,4,"H"
1993-10-16,1993,"Angers SCO","AS Saint-Etienne","1-1",1,1,"1",1,2,0,"D"
1993-10-16,1993,"FC Metz","Paris Saint-Germain","0-1",0,1,"1",1,1,-1,"D"
1993-10-17,1993,"FC Sochaux","FC Nantes","1-1",1,1,"1",1,2,0,"D"
1993-10-22,1993,"RC Strasbourg","SM Caen","3-0",3,0,"1",1,3,3,"H"
1993-10-23,1993,"AS Monaco","FC Martigues","7-0",7,0,"1",1,7,7,"H"
1993-10-23,1993,"Toulouse FC","Olympique Lyon","2-0",2,0,"1",1,2,2,"H"
1993-10-23,1993,"AS Saint-Etienne","FC Metz","1-0",1,0,"1",1,1,1,"H"
1993-10-23,1993,"FC Nantes","AJ Auxerre","1-2",1,2,"1",1,3,-1,"D"
1993-10-23,1993,"Olympique Marseille","FC Sochaux","1-1",1,1,"1",1,2,0,"D"
1993-10-23,1993,"Lille OSC","Montpellier HSC","0-0",0,0,"1",1,0,0,"D"
1993-10-23,1993,"Le Havre AC","RC Lens","1-1",1,1,"1",1,2,0,"D"
1993-10-23,1993,"Girondins Bordeaux","Angers SCO","1-0",1,0,"1",1,1,1,"H"
1993-10-23,1993,"AS Cannes","Paris Saint-Germain","0-1",0,1,"1",1,1,-1,"D"
1993-10-28,1993,"AJ Auxerre","AS Cannes","0-0",0,0,"1",1,0,0,"D"
1993-10-29,1993,"SM Caen","Lille OSC","2-3",2,3,"1",1,5,-1,"D"
1993-10-29,1993,"Montpellier HSC","RC Strasbourg","4-0",4,0,"1",1,4,4,"H"
1993-10-29,1993,"FC Sochaux","Girondins Bordeaux","2-2",2,2,"1",1,4,0,"D"
1993-10-29,1993,"Paris Saint-Germain","FC Nantes","1-0",1,0,"1",1,1,1,"H"
1993-10-29,1993,"Olympique Lyon","AS Saint-Etienne","1-0",1,0,"1",1,1,1,"H"
1993-10-29,1993,"FC Martigues","Le Havre AC","3-0",3,0,"1",1,3,3,"H"
1993-10-29,1993,"Angers SCO","Olympique Marseille","0-1",0,1,"1",1,1,-1,"D"
1993-10-29,1993,"RC Lens","AS Monaco","3-3",3,3,"1",1,6,0,"D"
1993-10-29,1993,"FC Metz","Toulouse FC","1-0",1,0,"1",1,1,1,"H"
1993-11-02,1993,"Toulouse FC","Montpellier HSC","0-0",0,0,"1",1,0,0,"D"
1993-11-06,1993,"AS Monaco","Paris Saint-Germain","1-1",1,1,"1",1,2,0,"D"
1993-11-06,1993,"Toulouse FC","RC Lens","1-1",1,1,"1",1,2,0,"D"
1993-11-06,1993,"AS Saint-Etienne","AJ Auxerre","1-0",1,0,"1",1,1,1,"H"
1993-11-06,1993,"FC Nantes","FC Martigues","2-1",2,1,"1",1,3,1,"H"
1993-11-06,1993,"Olympique Marseille","SM Caen","2-0",2,0,"1",1,2,2,"H"
1993-11-06,1993,"Lille OSC","Angers SCO","1-1",1,1,"1",1,2,0,"D"
1993-11-06,1993,"Le Havre AC","AS Cannes","3-1",3,1,"1",1,4,2,"H"
1993-11-06,1993,"Girondins Bordeaux","Olympique Lyon","2-0",2,0,"1",1,2,2,"H"
1993-11-06,1993,"RC Strasbourg","FC Sochaux","2-0",2,0,"1",1,2,2,"H"
1993-11-07,1993,"Montpellier HSC","FC Metz","3-2",3,2,"1",1,5,1,"H"
1993-11-09,1993,"Olympique Lyon","Olympique Marseille","1-0",1,0,"1",1,1,1,"H"
1993-11-10,1993,"FC Metz","Lille OSC","1-1",1,1,"1",1,2,0,"D"
1993-11-10,1993,"FC Sochaux","Toulouse FC","0-0",0,0,"1",1,0,0,"D"
1993-11-10,1993,"Paris Saint-Germain","Le Havre AC","0-0",0,0,"1",1,0,0,"D"
1993-11-10,1993,"AJ Auxerre","Girondins Bordeaux","0-1",0,1,"1",1,1,-1,"D"
1993-11-10,1993,"RC Lens","FC Nantes","1-1",1,1,"1",1,2,0,"D"
1993-11-10,1993,"Angers SCO","RC Strasbourg","1-3",1,3,"1",1,4,-2,"D"
1993-11-10,1993,"AS Cannes","AS Monaco","0-2",0,2,"1",1,2,-2,"D"
1993-11-10,1993,"SM Caen","Montpellier HSC","0-0",0,0,"1",1,0,0,"D"
1993-11-10,1993,"FC Martigues","AS Saint-Etienne","2-1",2,1,"1",1,3,1,"H"
1993-11-19,1993,"Girondins Bordeaux","FC Martigues","1-1",1,1,"1",1,2,0,"D"
1993-11-20,1993,"FC Nantes","AS Cannes","0-0",0,0,"1",1,0,0,"D"
1993-11-20,1993,"Toulouse FC","Paris Saint-Germain","1-2",1,2,"1",1,3,-1,"D"
1993-11-20,1993,"AS Saint-Etienne","RC Lens","0-0",0,0,"1",1,0,0,"D"
1993-11-20,1993,"RC Strasbourg","FC Metz","0-0",0,0,"1",1,0,0,"D"
1993-11-20,1993,"AS Monaco","Le Havre AC","1-1",1,1,"1",1,2,0,"D"
1993-11-20,1993,"Olympique Marseille","AJ Auxerre","0-3",0,3,"1",1,3,-3,"D"
1993-11-20,1993,"Lille OSC","Olympique Lyon","2-1",2,1,"1",1,3,1,"H"
1993-11-20,1993,"SM Caen","FC Sochaux","2-1",2,1,"1",1,3,1,"H"
1993-11-20,1993,"Montpellier HSC","Angers SCO","2-1",2,1,"1",1,3,1,"H"
1993-11-27,1993,"AJ Auxerre","Lille OSC","5-0",5,0,"1",1,5,5,"H"
1993-11-27,1993,"FC Sochaux","Montpellier HSC","2-1",2,1,"1",1,3,1,"H"
1993-11-27,1993,"Paris Saint-Germain","AS Saint-Etienne","1-0",1,0,"1",1,1,1,"H"
1993-11-27,1993,"FC Metz","AS Monaco","1-1",1,1,"1",1,2,0,"D"
1993-11-27,1993,"RC Lens","Girondins Bordeaux","1-0",1,0,"1",1,1,1,"H"
1993-11-27,1993,"Le Havre AC","FC Nantes","0-0",0,0,"1",1,0,0,"D"
1993-11-27,1993,"Angers SCO","SM Caen","2-0",2,0,"1",1,2,2,"H"
1993-11-27,1993,"AS Cannes","Toulouse FC","2-1",2,1,"1",1,3,1,"H"
1993-11-27,1993,"Olympique Lyon","RC Strasbourg","2-1",2,1,"1",1,3,1,"H"
1993-11-28,1993,"FC Martigues","Olympique Marseille","0-3",0,3,"1",1,3,-3,"D"
1993-12-02,1993,"AS Saint-Etienne","FC Nantes","1-1",1,1,"1",1,2,0,"D"
1993-12-03,1993,"Olympique Marseille","AS Cannes","3-1",3,1,"1",1,4,2,"H"
1993-12-03,1993,"Toulouse FC","AS Monaco","2-1",2,1,"1",1,3,1,"H"
1993-12-03,1993,"FC Sochaux","FC Martigues","1-0",1,0,"1",1,1,1,"H"
1993-12-03,1993,"Montpellier HSC","AJ Auxerre","1-0",1,0,"1",1,1,1,"H"
1993-12-03,1993,"Lille OSC","Paris Saint-Germain","0-2",0,2,"1",1,2,-2,"D"
1993-12-03,1993,"SM Caen","Olympique Lyon","1-0",1,0,"1",1,1,1,"H"
1993-12-03,1993,"Girondins Bordeaux","Le Havre AC","2-1",2,1,"1",1,3,1,"H"
1993-12-03,1993,"Angers SCO","FC Metz","1-2",1,2,"1",1,3,-1,"D"
1993-12-03,1993,"RC Strasbourg","RC Lens","2-0",2,0,"1",1,2,2,"H"
1993-12-10,1993,"RC Lens","Lille OSC","1-1",1,1,"1",1,2,0,"D"
1993-12-11,1993,"FC Metz","FC Sochaux","1-1",1,1,"1",1,2,0,"D"
1993-12-11,1993,"Paris Saint-Germain","RC Strasbourg","2-0",2,0,"1",1,2,2,"H"
1993-12-11,1993,"FC Nantes","Toulouse FC","4-0",4,0,"1",1,4,4,"H"
1993-12-11,1993,"AS Monaco","AS Saint-Etienne","1-1",1,1,"1",1,2,0,"D"
1993-12-11,1993,"FC Martigues","Montpellier HSC","1-1",1,1,"1",1,2,0,"D"
1993-12-11,1993,"Olympique Lyon","Angers SCO","1-1",1,1,"1",1,2,0,"D"
1993-12-11,1993,"Le Havre AC","Olympique Marseille","1-3",1,3,"1",1,4,-2,"D"
1993-12-11,1993,"AJ Auxerre","SM Caen","1-0",1,0,"1",1,1,1,"H"
1993-12-11,1993,"AS Cannes","Girondins Bordeaux","2-1",2,1,"1",1,3,1,"H"
1993-12-15,1993,"Montpellier HSC","Olympique Marseille","0-2",0,2,"1",1,2,-2,"D"
1993-12-18,1993,"FC Metz","Olympique Lyon","0-1",0,1,"1",1,1,-1,"D"
1993-12-18,1993,"FC Sochaux","Paris Saint-Germain","1-2",1,2,"1",1,3,-1,"D"
1993-12-18,1993,"AS Saint-Etienne","Le Havre AC","0-0",0,0,"1",1,0,0,"D"
1993-12-18,1993,"Montpellier HSC","RC Lens","0-0",0,0,"1",1,0,0,"D"
1993-12-18,1993,"Lille OSC","AS Cannes","1-0",1,0,"1",1,1,1,"H"
1993-12-18,1993,"SM Caen","FC Martigues","4-1",4,1,"1",1,5,3,"H"
1993-12-18,1993,"Angers SCO","AJ Auxerre","2-2",2,2,"1",1,4,0,"D"
1993-12-18,1993,"RC Strasbourg","Toulouse FC","1-0",1,0,"1",1,1,1,"H"
1993-12-18,1993,"Olympique Marseille","FC Nantes","3-1",3,1,"1",1,4,2,"H"
1993-12-19,1993,"Girondins Bordeaux","AS Monaco","1-0",1,0,"1",1,1,1,"H"
1994-01-14,1993,"Paris Saint-Germain","Olympique Marseille","1-1",1,1,"1",1,2,0,"D"
1994-01-15,1993,"RC Lens","SM Caen","2-0",2,0,"1",1,2,2,"H"
1994-01-15,1993,"Toulouse FC","AS Saint-Etienne","1-2",1,2,"1",1,3,-1,"D"
1994-01-15,1993,"FC Nantes","Girondins Bordeaux","4-1",4,1,"1",1,5,3,"H"
1994-01-15,1993,"AS Monaco","Montpellier HSC","1-2",1,2,"1",1,3,-1,"D"
1994-01-15,1993,"Olympique Lyon","FC Sochaux","1-0",1,0,"1",1,1,1,"H"
1994-01-15,1993,"Le Havre AC","Lille OSC","1-0",1,0,"1",1,1,1,"H"
1994-01-15,1993,"AS Cannes","RC Strasbourg","1-1",1,1,"1",1,2,0,"D"
1994-01-15,1993,"AJ Auxerre","FC Metz","2-0",2,0,"1",1,2,2,"H"
1994-01-15,1993,"FC Martigues","Angers SCO","0-0",0,0,"1",1,0,0,"D"
1994-01-28,1993,"Olympique Marseille","AS Monaco","2-1",2,1,"1",1,3,1,"H"
1994-01-29,1993,"Lille OSC","Toulouse FC","3-0",3,0,"1",1,3,3,"H"
1994-01-29,1993,"Olympique Lyon","AJ Auxerre","1-0",1,0,"1",1,1,1,"H"
1994-01-29,1993,"FC Sochaux","AS Cannes","1-1",1,1,"1",1,2,0,"D"
1994-01-29,1993,"RC Strasbourg","Le Havre AC","0-3",0,3,"1",1,3,-3,"D"
1994-01-29,1993,"Montpellier HSC","FC Nantes","1-0",1,0,"1",1,1,1,"H"
1994-01-29,1993,"SM Caen","Paris Saint-Germain","0-2",0,2,"1",1,2,-2,"D"
1994-01-29,1993,"Girondins Bordeaux","AS Saint-Etienne","1-2",1,2,"1",1,3,-1,"D"
1994-01-29,1993,"Angers SCO","RC Lens","1-2",1,2,"1",1,3,-1,"D"
1994-01-29,1993,"FC Metz","FC Martigues","0-0",0,0,"1",1,0,0,"D"
1994-02-04,1993,"Toulouse FC","Girondins Bordeaux","0-0",0,0,"1",1,0,0,"D"
1994-02-05,1993,"RC Lens","FC Metz","2-0",2,0,"1",1,2,2,"H"
1994-02-05,1993,"AS Saint-Etienne","Olympique Marseille","0-0",0,0,"1",1,0,0,"D"
1994-02-05,1993,"Paris Saint-Germain","Angers SCO","3-0",3,0,"1",1,3,3,"H"
1994-02-05,1993,"FC Martigues","Olympique Lyon","0-1",0,1,"1",1,1,-1,"D"
1994-02-05,1993,"AS Monaco","RC Strasbourg","2-1",2,1,"1",1,3,1,"H"
1994-02-05,1993,"Le Havre AC","Montpellier HSC","0-0",0,0,"1",1,0,0,"D"
1994-02-05,1993,"AS Cannes","SM Caen","3-0",3,0,"1",1,3,3,"H"
1994-02-05,1993,"AJ Auxerre","FC Sochaux","1-0",1,0,"1",1,1,1,"H"
1994-02-05,1993,"FC Nantes","Lille OSC","2-0",2,0,"1",1,2,2,"H"
1994-02-08,1993,"SM Caen","Le Havre AC","1-1",1,1,"1",1,2,0,"D"
1994-02-09,1993,"Olympique Marseille","Toulouse FC","5-1",5,1,"1",1,6,4,"H"
1994-02-09,1993,"RC Strasbourg","FC Nantes","0-3",0,3,"1",1,3,-3,"D"
1994-02-09,1993,"FC Sochaux","AS Saint-Etienne","3-2",3,2,"1",1,5,1,"H"
1994-02-09,1993,"Montpellier HSC","Paris Saint-Germain","0-0",0,0,"1",1,0,0,"D"
1994-02-09,1993,"FC Metz","Girondins Bordeaux","1-0",1,0,"1",1,1,1,"H"
1994-02-09,1993,"Lille OSC","AS Monaco","1-1",1,1,"1",1,2,0,"D"
1994-02-09,1993,"AJ Auxerre","FC Martigues","3-0",3,0,"1",1,3,3,"H"
1994-02-09,1993,"Angers SCO","AS Cannes","1-1",1,1,"1",1,2,0,"D"
1994-02-09,1993,"Olympique Lyon","RC Lens","1-2",1,2,"1",1,3,-1,"D"
1994-02-19,1993,"AS Monaco","FC Sochaux","2-0",2,0,"1",1,2,2,"H"
1994-02-19,1993,"Toulouse FC","SM Caen","0-1",0,1,"1",1,1,-1,"D"
1994-02-19,1993,"AS Saint-Etienne","Lille OSC","2-1",2,1,"1",1,3,1,"H"
1994-02-19,1993,"FC Nantes","Angers SCO","2-1",2,1,"1",1,3,1,"H"
1994-02-19,1993,"FC Martigues","RC Strasbourg","0-3",0,3,"1",1,3,-3,"D"
1994-02-19,1993,"RC Lens","AJ Auxerre","1-1",1,1,"1",1,2,0,"D"
1994-02-19,1993,"Le Havre AC","FC Metz","0-1",0,1,"1",1,1,-1,"D"
1994-02-19,1993,"AS Cannes","Montpellier HSC","2-0",2,0,"1",1,2,2,"H"
1994-02-19,1993,"Paris Saint-Germain","Olympique Lyon","0-0",0,0,"1",1,0,0,"D"
1994-02-20,1993,"Girondins Bordeaux","Olympique Marseille","1-0",1,0,"1",1,1,1,"H"
1994-02-24,1993,"AJ Auxerre","Paris Saint-Germain","0-0",0,0,"1",1,0,0,"D"
1994-02-25,1993,"FC Martigues","RC Lens","1-2",1,2,"1",1,3,-1,"D"
1994-02-25,1993,"RC Strasbourg","AS Saint-Etienne","2-0",2,0,"1",1,2,2,"H"
1994-02-25,1993,"FC Sochaux","Le Havre AC","4-2",4,2,"1",1,6,2,"H"
1994-02-25,1993,"Montpellier HSC","Toulouse FC","3-1",3,1,"1",1,4,2,"H"
1994-02-25,1993,"FC Metz","Olympique Marseille","0-0",0,0,"1",1,0,0,"D"
1994-02-25,1993,"Olympique Lyon","AS Cannes","2-2",2,2,"1",1,4,0,"D"
1994-02-25,1993,"Lille OSC","Girondins Bordeaux","1-1",1,1,"1",1,2,0,"D"
1994-02-25,1993,"SM Caen","FC Nantes","0-0",0,0,"1",1,0,0,"D"
1994-02-25,1993,"Angers SCO","AS Monaco","1-1",1,1,"1",1,2,0,"D"
1994-03-05,1993,"Olympique Marseille","Lille OSC","3-2",3,2,"1",1,5,1,"H"
1994-03-05,1993,"AS Monaco","SM Caen","3-0",3,0,"1",1,3,3,"H"
1994-03-05,1993,"Toulouse FC","AJ Auxerre","0-0",0,0,"1",1,0,0,"D"
1994-03-05,1993,"AS Saint-Etienne","Montpellier HSC","2-0",2,0,"1",1,2,2,"H"
1994-03-05,1993,"Girondins Bordeaux","RC Strasbourg","2-0",2,0,"1",1,2,2,"H"
1994-03-05,1993,"RC Lens","FC Sochaux","2-0",2,0,"1",1,2,2,"H"
1994-03-05,1993,"Le Havre AC","Angers SCO","2-1",2,1,"1",1,3,1,"H"
1994-03-05,1993,"AS Cannes","FC Metz","2-0",2,0,"1",1,2,2,"H"
1994-03-05,1993,"FC Nantes","Olympique Lyon","1-0",1,0,"1",1,1,1,"H"
1994-03-06,1993,"Paris Saint-Germain","FC Martigues","2-2",2,2,"1",1,4,0,"D"
1994-03-11,1993,"Olympique Lyon","AS Monaco","1-0",1,0,"1",1,1,1,"H"
1994-03-11,1993,"FC Sochaux","Lille OSC","1-0",1,0,"1",1,1,1,"H"
1994-03-11,1993,"RC Strasbourg","Olympique Marseille","1-1",1,1,"1",1,2,0,"D"
1994-03-11,1993,"FC Martigues","AS Cannes","4-0",4,0,"1",1,4,4,"H"
1994-03-11,1993,"RC Lens","Paris Saint-Germain","1-2",1,2,"1",1,3,-1,"D"
1994-03-11,1993,"SM Caen","AS Saint-Etienne","1-0",1,0,"1",1,1,1,"H"
1994-03-11,1993,"AJ Auxerre","Le Havre AC","3-0",3,0,"1",1,3,3,"H"
1994-03-11,1993,"Angers SCO","Toulouse FC","0-0",0,0,"1",1,0,0,"D"
1994-03-11,1993,"Montpellier HSC","Girondins Bordeaux","1-0",1,0,"1",1,1,1,"H"
1994-03-13,1993,"FC Metz","FC Nantes","2-0",2,0,"1",1,2,2,"H"
1994-03-25,1993,"AS Monaco","AJ Auxerre","0-1",0,1,"1",1,1,-1,"D"
1994-03-26,1993,"Le Havre AC","Olympique Lyon","0-1",0,1,"1",1,1,-1,"D"
1994-03-26,1993,"Lille OSC","RC Strasbourg","1-1",1,1,"1",1,2,0,"D"
1994-03-26,1993,"Toulouse FC","FC Martigues","2-2",2,2,"1",1,4,0,"D"
1994-03-26,1993,"AS Saint-Etienne","Angers SCO","2-0",2,0,"1",1,2,2,"H"
1994-03-26,1993,"FC Nantes","FC Sochaux","2-0",2,0,"1",1,2,2,"H"
1994-03-26,1993,"AS Cannes","RC Lens","3-1",3,1,"1",1,4,2,"H"
1994-03-26,1993,"Girondins Bordeaux","SM Caen","3-0",3,0,"1",1,3,3,"H"
1994-03-26,1993,"Paris Saint-Germain","FC Metz","1-0",1,0,"1",1,1,1,"H"
1994-03-26,1993,"Olympique Marseille","Montpellier HSC","1-1",1,1,"1",1,2,0,"D"
1994-04-01,1993,"AJ Auxerre","FC Nantes","3-1",3,1,"1",1,4,2,"H"
1994-04-02,1993,"Olympique Lyon","Toulouse FC","1-0",1,0,"1",1,1,1,"H"
1994-04-02,1993,"Paris Saint-Germain","AS Cannes","2-1",2,1,"1",1,3,1,"H"
1994-04-02,1993,"Montpellier HSC","Lille OSC","1-3",1,3,"1",1,4,-2,"D"
1994-04-02,1993,"FC Martigues","AS Monaco","1-3",1,3,"1",1,4,-2,"D"
1994-04-02,1993,"FC Sochaux","Olympique Marseille","1-1",1,1,"1",1,2,0,"D"
1994-04-02,1993,"RC Lens","Le Havre AC","5-1",5,1,"1",1,6,4,"H"
1994-04-02,1993,"SM Caen","RC Strasbourg","3-1",3,1,"1",1,4,2,"H"
1994-04-02,1993,"Angers SCO","Girondins Bordeaux","1-3",1,3,"1",1,4,-2,"D"
1994-04-02,1993,"FC Metz","AS Saint-Etienne","0-1",0,1,"1",1,1,-1,"D"
1994-04-05,1993,"AS Monaco","RC Lens","0-0",0,0,"1",1,0,0,"D"
1994-04-05,1993,"Toulouse FC","FC Metz","2-2",2,2,"1",1,4,0,"D"
1994-04-05,1993,"RC Strasbourg","Montpellier HSC","0-1",0,1,"1",1,1,-1,"D"
1994-04-05,1993,"FC Nantes","Paris Saint-Germain","3-0",3,0,"1",1,3,3,"H"
1994-04-05,1993,"Lille OSC","SM Caen","3-1",3,1,"1",1,4,2,"H"
1994-04-05,1993,"Le Havre AC","FC Martigues","2-0",2,0,"1",1,2,2,"H"
1994-04-05,1993,"AS Cannes","AJ Auxerre","2-1",2,1,"1",1,3,1,"H"
1994-04-05,1993,"Girondins Bordeaux","FC Sochaux","4-1",4,1,"1",1,5,3,"H"
1994-04-05,1993,"Olympique Marseille","Angers SCO","2-1",2,1,"1",1,3,1,"H"
1994-04-06,1993,"AS Saint-Etienne","Olympique Lyon","3-0",3,0,"1",1,3,3,"H"
1994-04-09,1993,"RC Lens","Toulouse FC","4-0",4,0,"1",1,4,4,"H"
1994-04-09,1993,"FC Metz","Montpellier HSC","1-1",1,1,"1",1,2,0,"D"
1994-04-09,1993,"Olympique Lyon","Girondins Bordeaux","4-2",4,2,"1",1,6,2,"H"
1994-04-09,1993,"FC Sochaux","RC Strasbourg","1-3",1,3,"1",1,4,-2,"D"
1994-04-09,1993,"AS Cannes","Le Havre AC","1-0",1,0,"1",1,1,1,"H"
1994-04-09,1993,"SM Caen","Olympique Marseille","1-0",1,0,"1",1,1,1,"H"
1994-04-09,1993,"AJ Auxerre","AS Saint-Etienne","3-0",3,0,"1",1,3,3,"H"
1994-04-09,1993,"Angers SCO","Lille OSC","1-2",1,2,"1",1,3,-1,"D"
1994-04-09,1993,"FC Martigues","FC Nantes","1-2",1,2,"1",1,3,-1,"D"
1994-04-17,1993,"Paris Saint-Germain","AS Monaco","1-1",1,1,"1",1,2,0,"D"
1994-04-22,1993,"AS Monaco","AS Cannes","2-0",2,0,"1",1,2,2,"H"
1994-04-26,1993,"Montpellier HSC","SM Caen","0-0",0,0,"1",1,0,0,"D"
1994-04-26,1993,"AS Saint-Etienne","FC Martigues","1-1",1,1,"1",1,2,0,"D"
1994-04-26,1993,"Toulouse FC","FC Sochaux","3-2",3,2,"1",1,5,1,"H"
1994-04-26,1993,"RC Strasbourg","Angers SCO","2-2",2,2,"1",1,4,0,"D"
1994-04-26,1993,"FC Nantes","RC Lens","2-1",2,1,"1",1,3,1,"H"
1994-04-26,1993,"Olympique Marseille","Olympique Lyon","3-0",3,0,"1",1,3,3,"H"
1994-04-26,1993,"Lille OSC","FC Metz","0-4",0,4,"1",1,4,-4,"D"
1994-04-26,1993,"Le Havre AC","Paris Saint-Germain","0-2",0,2,"1",1,2,-2,"D"
1994-04-26,1993,"Girondins Bordeaux","AJ Auxerre","2-0",2,0,"1",1,2,2,"H"
1994-04-29,1993,"AS Cannes","FC Nantes","4-0",4,0,"1",1,4,4,"H"
1994-04-30,1993,"FC Martigues","Girondins Bordeaux","0-0",0,0,"1",1,0,0,"D"
1994-04-30,1993,"Le Havre AC","AS Monaco","1-0",1,0,"1",1,1,1,"H"
1994-04-30,1993,"FC Sochaux","SM Caen","0-0",0,0,"1",1,0,0,"D"
1994-04-30,1993,"Paris Saint-Germain","Toulouse FC","1-0",1,0,"1",1,1,1,"H"
1994-04-30,1993,"FC Metz","RC Strasbourg","2-1",2,1,"1",1,3,1,"H"
1994-04-30,1993,"RC Lens","AS Saint-Etienne","3-1",3,1,"1",1,4,2,"H"
1994-04-30,1993,"AJ Auxerre","Olympique Marseille","2-2",2,2,"1",1,4,0,"D"
1994-04-30,1993,"Angers SCO","Montpellier HSC","2-3",2,3,"1",1,5,-1,"D"
1994-04-30,1993,"Olympique Lyon","Lille OSC","0-0",0,0,"1",1,0,0,"D"
1994-05-07,1993,"Girondins Bordeaux","RC Lens","4-2",4,2,"1",1,6,2,"H"
1994-05-07,1993,"Montpellier HSC","FC Sochaux","1-0",1,0,"1",1,1,1,"H"
1994-05-07,1993,"AS Monaco","FC Metz","1-1",1,1,"1",1,2,0,"D"
1994-05-07,1993,"RC Strasbourg","Olympique Lyon","0-1",0,1,"1",1,1,-1,"D"
1994-05-07,1993,"AS Saint-Etienne","Paris Saint-Germain","1-2",1,2,"1",1,3,-1,"D"
1994-05-07,1993,"FC Nantes","Le Havre AC","3-1",3,1,"1",1,4,2,"H"
1994-05-07,1993,"Toulouse FC","AS Cannes","1-2",1,2,"1",1,3,-1,"D"
1994-05-07,1993,"Lille OSC","AJ Auxerre","1-1",1,1,"1",1,2,0,"D"
1994-05-07,1993,"SM Caen","Angers SCO","2-3",2,3,"1",1,5,-1,"D"
1994-05-07,1993,"Olympique Marseille","FC Martigues","0-0",0,0,"1",1,0,0,"D"
1994-05-21,1993,"AS Monaco","FC Nantes","1-0",1,0,"1",1,1,1,"H"
1994-05-21,1993,"Le Havre AC","Toulouse FC","1-1",1,1,"1",1,2,0,"D"
1994-05-21,1993,"Angers SCO","FC Sochaux","1-2",1,2,"1",1,3,-1,"D"
1994-05-21,1993,"AS Cannes","AS Saint-Etienne","0-0",0,0,"1",1,0,0,"D"
1994-05-21,1993,"AJ Auxerre","RC Strasbourg","2-1",2,1,"1",1,3,1,"H"
1994-05-21,1993,"Olympique Lyon","Montpellier HSC","3-2",3,2,"1",1,5,1,"H"
1994-05-21,1993,"RC Lens","Olympique Marseille","2-3",2,3,"1",1,5,-1,"D"
1994-05-21,1993,"FC Martigues","Lille OSC","2-2",2,2,"1",1,4,0,"D"
1994-05-21,1993,"Paris Saint-Germain","Girondins Bordeaux","4-1",4,1,"1",1,5,3,"H"
1994-05-21,1993,"FC Metz","SM Caen","2-1",2,1,"1",1,3,1,"H"
1995-07-18,1995,"SC Bastia","Paris Saint-Germain","2-2",2,2,"1",1,4,0,"D"
1995-07-19,1995,"EA Guingamp","FC Martigues","2-0",2,0,"1",1,2,2,"H"
1995-07-19,1995,"Montpellier HSC","RC Strasbourg","2-2",2,2,"1",1,4,0,"D"
1995-07-19,1995,"AS Cannes","Olympique Lyon","3-0",3,0,"1",1,3,3,"H"
1995-07-19,1995,"FC Gueugnon","FC Metz","0-0",0,0,"1",1,0,0,"D"
1995-07-19,1995,"RC Lens","Le Havre AC","2-0",2,0,"1",1,2,2,"H"
1995-07-19,1995,"AS Saint-Etienne","OGC Nice","1-1",1,1,"1",1,2,0,"D"
1995-07-19,1995,"Girondins Bordeaux","Lille OSC","1-0",1,0,"1",1,1,1,"H"
1995-07-19,1995,"FC Nantes","AJ Auxerre","1-0",1,0,"1",1,1,1,"H"
1995-07-19,1995,"AS Monaco","Stade Rennes","3-1",3,1,"1",1,4,2,"H"
1995-07-25,1995,"OGC Nice","AS Monaco","1-2",1,2,"1",1,3,-1,"D"
1995-07-26,1995,"FC Martigues","FC Nantes","0-4",0,4,"1",1,4,-4,"D"
1995-07-26,1995,"Olympique Lyon","Montpellier HSC","3-2",3,2,"1",1,5,1,"H"
1995-07-26,1995,"RC Strasbourg","Le Havre AC","3-0",3,0,"1",1,3,3,"H"
1995-07-26,1995,"Stade Rennes","AS Cannes","3-2",3,2,"1",1,5,1,"H"
1995-07-26,1995,"FC Metz","RC Lens","2-0",2,0,"1",1,2,2,"H"
1995-07-26,1995,"Paris Saint-Germain","EA Guingamp","1-1",1,1,"1",1,2,0,"D"
1995-07-26,1995,"Lille OSC","SC Bastia","0-2",0,2,"1",1,2,-2,"D"
1995-07-26,1995,"AJ Auxerre","FC Gueugnon","4-0",4,0,"1",1,4,4,"H"
1995-07-26,1995,"Girondins Bordeaux","AS Saint-Etienne","2-0",2,0,"1",1,2,2,"H"
1995-08-04,1995,"FC Nantes","Paris Saint-Germain","1-2",1,2,"1",1,3,-1,"D"
1995-08-05,1995,"FC Gueugnon","FC Martigues","0-0",0,0,"1",1,0,0,"D"
1995-08-05,1995,"RC Lens","RC Strasbourg","0-0",0,0,"1",1,0,0,"D"
1995-08-05,1995,"Montpellier HSC","Stade Rennes","3-1",3,1,"1",1,4,2,"H"
1995-08-05,1995,"Le Havre AC","Olympique Lyon","2-1",2,1,"1",1,3,1,"H"
1995-08-05,1995,"AS Monaco","AJ Auxerre","2-2",2,2,"1",1,4,0,"D"
1995-08-05,1995,"AS Saint-Etienne","Lille OSC","1-1",1,1,"1",1,2,0,"D"
1995-08-05,1995,"SC Bastia","Girondins Bordeaux","2-0",2,0,"1",1,2,2,"H"
1995-08-05,1995,"AS Cannes","FC Metz","1-2",1,2,"1",1,3,-1,"D"
1995-08-05,1995,"EA Guingamp","OGC Nice","0-0",0,0,"1",1,0,0,"D"
1995-08-09,1995,"Paris Saint-Germain","AS Saint-Etienne","4-0",4,0,"1",1,4,4,"H"
1995-08-09,1995,"Stade Rennes","Le Havre AC","1-0",1,0,"1",1,1,1,"H"
1995-08-09,1995,"FC Metz","Montpellier HSC","1-0",1,0,"1",1,1,1,"H"
1995-08-09,1995,"OGC Nice","FC Gueugnon","3-1",3,1,"1",1,4,2,"H"
1995-08-09,1995,"SC Bastia","AS Monaco","2-1",2,1,"1",1,3,1,"H"
1995-08-09,1995,"Lille OSC","EA Guingamp","0-3",0,3,"1",1,3,-3,"D"
1995-08-09,1995,"AJ Auxerre","RC Lens","0-1",0,1,"1",1,1,-1,"D"
1995-08-09,1995,"FC Martigues","AS Cannes","2-1",2,1,"1",1,3,1,"H"
1995-08-19,1995,"FC Nantes","OGC Nice","1-0",1,0,"1",1,1,1,"H"
1995-08-19,1995,"Le Havre AC","FC Metz","0-0",0,0,"1",1,0,0,"D"
1995-08-19,1995,"Montpellier HSC","AJ Auxerre","3-1",3,1,"1",1,4,2,"H"
1995-08-19,1995,"RC Lens","Olympique Lyon","2-2",2,2,"1",1,4,0,"D"
1995-08-19,1995,"AS Cannes","Lille OSC","2-1",2,1,"1",1,3,1,"H"
1995-08-19,1995,"AS Monaco","FC Martigues","0-1",0,1,"1",1,1,-1,"D"
1995-08-19,1995,"FC Gueugnon","Paris Saint-Germain","1-3",1,3,"1",1,4,-2,"D"
1995-08-19,1995,"AS Saint-Etienne","SC Bastia","3-0",3,0,"1",1,3,3,"H"
1995-08-19,1995,"RC Strasbourg","Stade Rennes","3-1",3,1,"1",1,4,2,"H"
1995-08-20,1995,"EA Guingamp","Girondins Bordeaux","1-0",1,0,"1",1,1,1,"H"
1995-08-25,1995,"Lille OSC","FC Nantes","0-0",0,0,"1",1,0,0,"D"
1995-08-26,1995,"OGC Nice","RC Lens","1-1",1,1,"1",1,2,0,"D"
1995-08-26,1995,"Stade Rennes","Olympique Lyon","1-0",1,0,"1",1,1,1,"H"
1995-08-26,1995,"FC Metz","RC Strasbourg","3-2",3,2,"1",1,5,1,"H"
1995-08-26,1995,"AS Saint-Etienne","EA Guingamp","4-0",4,0,"1",1,4,4,"H"
1995-08-26,1995,"Paris Saint-Germain","Le Havre AC","2-0",2,0,"1",1,2,2,"H"
1995-08-26,1995,"SC Bastia","FC Gueugnon","1-2",1,2,"1",1,3,-1,"D"
1995-08-26,1995,"Girondins Bordeaux","AS Monaco","2-4",2,4,"1",1,6,-2,"D"
1995-08-26,1995,"AJ Auxerre","AS Cannes","5-1",5,1,"1",1,6,4,"H"
1995-08-26,1995,"FC Martigues","Montpellier HSC","0-1",0,1,"1",1,1,-1,"D"
1995-08-29,1995,"Montpellier HSC","OGC Nice","0-1",0,1,"1",1,1,-1,"D"
1995-08-29,1995,"AS Monaco","Lille OSC","2-1",2,1,"1",1,3,1,"H"
1995-08-29,1995,"Le Havre AC","AJ Auxerre","0-4",0,4,"1",1,4,-4,"D"
1995-08-29,1995,"RC Lens","Stade Rennes","1-0",1,0,"1",1,1,1,"H"
1995-08-29,1995,"Olympique Lyon","FC Metz","1-1",1,1,"1",1,2,0,"D"
1995-08-29,1995,"FC Gueugnon","Girondins Bordeaux","2-2",2,2,"1",1,4,0,"D"
1995-08-29,1995,"FC Nantes","AS Saint-Etienne","2-2",2,2,"1",1,4,0,"D"
1995-08-29,1995,"AS Cannes","Paris Saint-Germain","0-2",0,2,"1",1,2,-2,"D"
1995-08-29,1995,"RC Strasbourg","FC Martigues","2-0",2,0,"1",1,2,2,"H"
1995-08-30,1995,"EA Guingamp","SC Bastia","1-0",1,0,"1",1,1,1,"H"
1995-09-01,1995,"Girondins Bordeaux","FC Nantes","3-0",3,0,"1",1,3,3,"H"
1995-09-01,1995,"Olympique Lyon","RC Strasbourg","1-1",1,1,"1",1,2,0,"D"
1995-09-09,1995,"Paris Saint-Germain","AS Monaco","2-1",2,1,"1",1,3,1,"H"
1995-09-09,1995,"FC Martigues","Olympique Lyon","1-2",1,2,"1",1,3,-1,"D"
1995-09-09,1995,"EA Guingamp","Montpellier HSC","0-0",0,0,"1",1,0,0,"D"
1995-09-09,1995,"AS Saint-Etienne","FC Gueugnon","2-0",2,0,"1",1,2,2,"H"
1995-09-09,1995,"SC Bastia","FC Nantes","4-1",4,1,"1",1,5,3,"H"
1995-09-09,1995,"Lille OSC","RC Lens","1-3",1,3,"1",1,4,-2,"D"
1995-09-09,1995,"Girondins Bordeaux","AS Cannes","2-1",2,1,"1",1,3,1,"H"
1995-09-09,1995,"AJ Auxerre","RC Strasbourg","1-0",1,0,"1",1,1,1,"H"
1995-09-09,1995,"OGC Nice","Le Havre AC","1-2",1,2,"1",1,3,-1,"D"
1995-09-10,1995,"FC Metz","Stade Rennes","0-0",0,0,"1",1,0,0,"D"
1995-09-16,1995,"Olympique Lyon","AJ Auxerre","0-1",0,1,"1",1,1,-1,"D"
1995-09-16,1995,"RC Strasbourg","OGC Nice","1-1",1,1,"1",1,2,0,"D"
1995-09-16,1995,"AS Cannes","AS Saint-Etienne","2-0",2,0,"1",1,2,2,"H"
1995-09-16,1995,"Stade Rennes","FC Martigues","1-3",1,3,"1",1,4,-2,"D"
1995-09-16,1995,"AS Monaco","FC Metz","0-1",0,1,"1",1,1,-1,"D"
1995-09-16,1995,"FC Nantes","EA Guingamp","0-0",0,0,"1",1,0,0,"D"
1995-09-16,1995,"FC Gueugnon","Lille OSC","3-1",3,1,"1",1,4,2,"H"
1995-09-17,1995,"RC Lens","SC Bastia","3-1",3,1,"1",1,4,2,"H"
1995-09-17,1995,"Le Havre AC","Girondins Bordeaux","1-0",1,0,"1",1,1,1,"H"
1995-09-17,1995,"Montpellier HSC","Paris Saint-Germain","1-0",1,0,"1",1,1,1,"H"
1995-09-21,1995,"AS Saint-Etienne","AS Monaco","2-4",2,4,"1",1,6,-2,"D"
1995-09-22,1995,"Lille OSC","Le Havre AC","2-0",2,0,"1",1,2,2,"H"
1995-09-22,1995,"FC Martigues","FC Metz","0-1",0,1,"1",1,1,-1,"D"
1995-09-22,1995,"EA Guingamp","FC Gueugnon","0-0",0,0,"1",1,0,0,"D"
1995-09-22,1995,"OGC Nice","Olympique Lyon","1-0",1,0,"1",1,1,1,"H"
1995-09-22,1995,"SC Bastia","AS Cannes","2-1",2,1,"1",1,3,1,"H"
1995-09-22,1995,"Girondins Bordeaux","Montpellier HSC","3-0",3,0,"1",1,3,3,"H"
1995-09-22,1995,"AJ Auxerre","Stade Rennes","2-1",2,1,"1",1,3,1,"H"
1995-09-22,1995,"FC Nantes","RC Lens","1-1",1,1,"1",1,2,0,"D"
1995-09-22,1995,"Paris Saint-Germain","RC Strasbourg","2-0",2,0,"1",1,2,2,"H"
1995-09-30,1995,"AS Cannes","OGC Nice","1-3",1,3,"1",1,4,-2,"D"
1995-09-30,1995,"Le Havre AC","FC Martigues","1-0",1,0,"1",1,1,1,"H"
1995-09-30,1995,"Olympique Lyon","AS Saint-Etienne","2-1",2,1,"1",1,3,1,"H"
1995-09-30,1995,"Stade Rennes","SC Bastia","2-0",2,0,"1",1,2,2,"H"
1995-09-30,1995,"AS Monaco","EA Guingamp","1-0",1,0,"1",1,1,1,"H"
1995-09-30,1995,"FC Metz","AJ Auxerre","3-1",3,1,"1",1,4,2,"H"
1995-09-30,1995,"FC Gueugnon","FC Nantes","0-1",0,1,"1",1,1,-1,"D"
1995-09-30,1995,"Montpellier HSC","Lille OSC","0-0",0,0,"1",1,0,0,"D"
1995-10-01,1995,"RC Lens","Paris Saint-Germain","3-1",3,1,"1",1,4,2,"H"
1995-10-01,1995,"RC Strasbourg","Girondins Bordeaux","3-0",3,0,"1",1,3,3,"H"
1995-10-03,1995,"FC Nantes","AS Monaco","2-2",2,2,"1",1,4,0,"D"
1995-10-04,1995,"Paris Saint-Germain","Stade Rennes","1-1",1,1,"1",1,2,0,"D"
1995-10-04,1995,"AS Saint-Etienne","Montpellier HSC","0-2",0,2,"1",1,2,-2,"D"
1995-10-04,1995,"FC Gueugnon","RC Lens","0-1",0,1,"1",1,1,-1,"D"
1995-10-04,1995,"FC Martigues","AJ Auxerre","1-2",1,2,"1",1,3,-1,"D"
1995-10-04,1995,"EA Guingamp","AS Cannes","2-0",2,0,"1",1,2,2,"H"
1995-10-04,1995,"SC Bastia","Le Havre AC","1-0",1,0,"1",1,1,1,"H"
1995-10-04,1995,"Lille OSC","RC Strasbourg","2-0",2,0,"1",1,2,2,"H"
1995-10-04,1995,"Girondins Bordeaux","Olympique Lyon","1-1",1,1,"1",1,2,0,"D"
1995-10-04,1995,"OGC Nice","FC Metz","0-1",0,1,"1",1,1,-1,"D"
1995-10-13,1995,"RC Lens","FC Martigues","1-0",1,0,"1",1,1,1,"H"
1995-10-14,1995,"Stade Rennes","Lille OSC","3-1",3,1,"1",1,4,2,"H"
1995-10-14,1995,"RC Strasbourg","EA Guingamp","0-0",0,0,"1",1,0,0,"D"
1995-10-14,1995,"Montpellier HSC","SC Bastia","4-3",4,3,"1",1,7,1,"H"
1995-10-14,1995,"AS Cannes","FC Nantes","0-2",0,2,"1",1,2,-2,"D"
1995-10-14,1995,"AS Monaco","FC Gueugnon","0-0",0,0,"1",1,0,0,"D"
1995-10-14,1995,"FC Metz","Girondins Bordeaux","2-0",2,0,"1",1,2,2,"H"
1995-10-14,1995,"AJ Auxerre","OGC Nice","2-1",2,1,"1",1,3,1,"H"
1995-10-14,1995,"Olympique Lyon","Paris Saint-Germain","0-0",0,0,"1",1,0,0,"D"
1995-10-15,1995,"Le Havre AC","AS Saint-Etienne","2-2",2,2,"1",1,4,0,"D"
1995-10-21,1995,"OGC Nice","FC Martigues","1-0",1,0,"1",1,1,1,"H"
1995-10-21,1995,"AS Monaco","Montpellier HSC","3-1",3,1,"1",1,4,2,"H"
1995-10-21,1995,"FC Gueugnon","AS Cannes","1-1",1,1,"1",1,2,0,"D"
1995-10-21,1995,"EA Guingamp","Le Havre AC","2-2",2,2,"1",1,4,0,"D"
1995-10-21,1995,"SC Bastia","RC Strasbourg","1-1",1,1,"1",1,2,0,"D"
1995-10-21,1995,"Lille OSC","FC Metz","0-0",0,0,"1",1,0,0,"D"
1995-10-21,1995,"Girondins Bordeaux","Stade Rennes","0-0",0,0,"1",1,0,0,"D"
1995-10-21,1995,"FC Nantes","Olympique Lyon","0-0",0,0,"1",1,0,0,"D"
1995-10-21,1995,"AS Saint-Etienne","RC Lens","1-1",1,1,"1",1,2,0,"D"
1995-10-22,1995,"Paris Saint-Germain","AJ Auxerre","3-1",3,1,"1",1,4,2,"H"
1995-10-26,1995,"FC Metz","Paris Saint-Germain","0-3",0,3,"1",1,3,-3,"D"
1995-10-27,1995,"AS Cannes","AS Monaco","1-1",1,1,"1",1,2,0,"D"
1995-10-27,1995,"RC Lens","EA Guingamp","0-1",0,1,"1",1,1,-1,"D"
1995-10-27,1995,"RC Strasbourg","AS Saint-Etienne","3-1",3,1,"1",1,4,2,"H"
1995-10-27,1995,"Olympique Lyon","SC Bastia","1-1",1,1,"1",1,2,0,"D"
1995-10-27,1995,"Le Havre AC","FC Nantes","0-1",0,1,"1",1,1,-1,"D"
1995-10-27,1995,"Stade Rennes","OGC Nice","1-0",1,0,"1",1,1,1,"H"
1995-10-27,1995,"FC Martigues","Girondins Bordeaux","3-1",3,1,"1",1,4,2,"H"
1995-10-27,1995,"AJ Auxerre","Lille OSC","1-2",1,2,"1",1,3,-1,"D"
1995-10-27,1995,"Montpellier HSC","FC Gueugnon","2-2",2,2,"1",1,4,0,"D"
1995-11-04,1995,"FC Gueugnon","Le Havre AC","0-1",0,1,"1",1,1,-1,"D"
1995-11-04,1995,"AS Monaco","RC Lens","1-1",1,1,"1",1,2,0,"D"
1995-11-04,1995,"AS Saint-Etienne","Stade Rennes","0-0",0,0,"1",1,0,0,"D"
1995-11-04,1995,"EA Guingamp","Olympique Lyon","1-0",1,0,"1",1,1,1,"H"
1995-11-04,1995,"SC Bastia","FC Metz","1-0",1,0,"1",1,1,1,"H"
1995-11-04,1995,"Lille OSC","FC Martigues","0-0",0,0,"1",1,0,0,"D"
1995-11-04,1995,"FC Nantes","Montpellier HSC","1-0",1,0,"1",1,1,1,"H"
1995-11-04,1995,"Girondins Bordeaux","AJ Auxerre","0-1",0,1,"1",1,1,-1,"D"
1995-11-05,1995,"Paris Saint-Germain","OGC Nice","3-2",3,2,"1",1,5,1,"H"
1995-11-05,1995,"AS Cannes","RC Strasbourg","0-3",0,3,"1",1,3,-3,"D"
1995-11-07,1995,"Stade Rennes","EA Guingamp","3-0",3,0,"1",1,3,3,"H"
1995-11-08,1995,"Montpellier HSC","AS Cannes","3-1",3,1,"1",1,4,2,"H"
1995-11-08,1995,"FC Martigues","Paris Saint-Germain","2-4",2,4,"1",1,6,-2,"D"
1995-11-08,1995,"Le Havre AC","AS Monaco","2-1",2,1,"1",1,3,1,"H"
1995-11-08,1995,"RC Lens","Girondins Bordeaux","0-0",0,0,"1",1,0,0,"D"
1995-11-08,1995,"RC Strasbourg","FC Nantes","1-1",1,1,"1",1,2,0,"D"
1995-11-08,1995,"FC Metz","AS Saint-Etienne","1-2",1,2,"1",1,3,-1,"D"
1995-11-08,1995,"OGC Nice","Lille OSC","2-1",2,1,"1",1,3,1,"H"
1995-11-08,1995,"AJ Auxerre","SC Bastia","3-0",3,0,"1",1,3,3,"H"
1995-11-08,1995,"Olympique Lyon","FC Gueugnon","0-0",0,0,"1",1,0,0,"D"
1995-11-18,1995,"SC Bastia","FC Martigues","2-0",2,0,"1",1,2,2,"H"
1995-11-18,1995,"AS Cannes","Le Havre AC","0-0",0,0,"1",1,0,0,"D"
1995-11-18,1995,"AS Monaco","Olympique Lyon","0-2",0,2,"1",1,2,-2,"D"
1995-11-18,1995,"EA Guingamp","FC Metz","0-0",0,0,"1",1,0,0,"D"
1995-11-18,1995,"Lille OSC","Paris Saint-Germain","0-0",0,0,"1",1,0,0,"D"
1995-11-18,1995,"Girondins Bordeaux","OGC Nice","4-1",4,1,"1",1,5,3,"H"
1995-11-18,1995,"FC Nantes","Stade Rennes","2-2",2,2,"1",1,4,0,"D"
1995-11-18,1995,"Montpellier HSC","RC Lens","0-0",0,0,"1",1,0,0,"D"
1995-11-18,1995,"FC Gueugnon","RC Strasbourg","0-1",0,1,"1",1,1,-1,"D"
1995-11-19,1995,"AS Saint-Etienne","AJ Auxerre","0-5",0,5,"1",1,5,-5,"D"
1995-11-24,1995,"RC Strasbourg","AS Monaco","2-0",2,0,"1",1,2,2,"H"
1995-11-25,1995,"FC Metz","FC Nantes","0-0",0,0,"1",1,0,0,"D"
1995-11-25,1995,"Le Havre AC","Montpellier HSC","2-2",2,2,"1",1,4,0,"D"
1995-11-25,1995,"RC Lens","AS Cannes","1-1",1,1,"1",1,2,0,"D"
1995-11-25,1995,"Olympique Lyon","Lille OSC","1-1",1,1,"1",1,2,0,"D"
1995-11-25,1995,"Stade Rennes","FC Gueugnon","2-1",2,1,"1",1,3,1,"H"
1995-11-25,1995,"FC Martigues","AS Saint-Etienne","1-1",1,1,"1",1,2,0,"D"
1995-11-25,1995,"OGC Nice","SC Bastia","3-1",3,1,"1",1,4,2,"H"
1995-11-25,1995,"Paris Saint-Germain","Girondins Bordeaux","3-0",3,0,"1",1,3,3,"H"
1995-11-25,1995,"AJ Auxerre","EA Guingamp","1-2",1,2,"1",1,3,-1,"D"
1995-11-30,1995,"FC Gueugnon","AJ Auxerre","0-0",0,0,"1",1,0,0,"D"
1995-12-01,1995,"AS Monaco","OGC Nice","1-0",1,0,"1",1,1,1,"H"
1995-12-01,1995,"RC Lens","FC Metz","2-0",2,0,"1",1,2,2,"H"
1995-12-01,1995,"Le Havre AC","RC Strasbourg","2-0",2,0,"1",1,2,2,"H"
1995-12-01,1995,"Montpellier HSC","Olympique Lyon","2-1",2,1,"1",1,3,1,"H"
1995-12-01,1995,"AS Cannes","Stade Rennes","3-0",3,0,"1",1,3,3,"H"
1995-12-01,1995,"AS Saint-Etienne","Girondins Bordeaux","2-0",2,0,"1",1,2,2,"H"
1995-12-01,1995,"SC Bastia","Lille OSC","4-0",4,0,"1",1,4,4,"H"
1995-12-01,1995,"EA Guingamp","Paris Saint-Germain","0-0",0,0,"1",1,0,0,"D"
1995-12-01,1995,"FC Nantes","FC Martigues","3-0",3,0,"1",1,3,3,"H"
1995-12-09,1995,"OGC Nice","EA Guingamp","2-1",2,1,"1",1,3,1,"H"
1995-12-09,1995,"Olympique Lyon","Le Havre AC","3-2",3,2,"1",1,5,1,"H"
1995-12-09,1995,"Stade Rennes","Montpellier HSC","1-1",1,1,"1",1,2,0,"D"
1995-12-09,1995,"AJ Auxerre","AS Monaco","1-2",1,2,"1",1,3,-1,"D"
1995-12-09,1995,"FC Martigues","FC Gueugnon","3-0",3,0,"1",1,3,3,"H"
1995-12-09,1995,"Paris Saint-Germain","FC Nantes","5-0",5,0,"1",1,5,5,"H"
1995-12-09,1995,"Lille OSC","AS Saint-Etienne","1-1",1,1,"1",1,2,0,"D"
1995-12-09,1995,"Girondins Bordeaux","SC Bastia","1-3",1,3,"1",1,4,-2,"D"
1995-12-09,1995,"FC Metz","AS Cannes","0-0",0,0,"1",1,0,0,"D"
1995-12-10,1995,"RC Strasbourg","RC Lens","1-2",1,2,"1",1,3,-1,"D"
1995-12-16,1995,"FC Gueugnon","OGC Nice","1-0",1,0,"1",1,1,1,"H"
1995-12-16,1995,"Le Havre AC","Stade Rennes","0-0",0,0,"1",1,0,0,"D"
1995-12-16,1995,"RC Lens","AJ Auxerre","0-0",0,0,"1",1,0,0,"D"
1995-12-16,1995,"RC Strasbourg","Olympique Lyon","2-2",2,2,"1",1,4,0,"D"
1995-12-16,1995,"EA Guingamp","Lille OSC","0-1",0,1,"1",1,1,-1,"D"
1995-12-16,1995,"AS Saint-Etienne","Paris Saint-Germain","1-1",1,1,"1",1,2,0,"D"
1995-12-16,1995,"FC Nantes","Girondins Bordeaux","2-0",2,0,"1",1,2,2,"H"
1995-12-16,1995,"AS Monaco","SC Bastia","0-0",0,0,"1",1,0,0,"D"
1995-12-16,1995,"AS Cannes","FC Martigues","2-1",2,1,"1",1,3,1,"H"
1996-01-03,1995,"Montpellier HSC","FC Metz","1-2",1,2,"1",1,3,-1,"D"
1996-01-09,1995,"FC Martigues","AS Monaco","0-4",0,4,"1",1,4,-4,"D"
1996-01-10,1995,"Lille OSC","AS Cannes","0-2",0,2,"1",1,2,-2,"D"
1996-01-10,1995,"OGC Nice","FC Nantes","1-0",1,0,"1",1,1,1,"H"
1996-01-10,1995,"Olympique Lyon","RC Lens","0-0",0,0,"1",1,0,0,"D"
1996-01-10,1995,"Stade Rennes","RC Strasbourg","0-0",0,0,"1",1,0,0,"D"
1996-01-10,1995,"FC Metz","Le Havre AC","2-1",2,1,"1",1,3,1,"H"
1996-01-10,1995,"SC Bastia","AS Saint-Etienne","0-0",0,0,"1",1,0,0,"D"
1996-01-10,1995,"Girondins Bordeaux","EA Guingamp","2-0",2,0,"1",1,2,2,"H"
1996-01-10,1995,"AJ Auxerre","Montpellier HSC","1-0",1,0,"1",1,1,1,"H"
1996-01-10,1995,"Paris Saint-Germain","FC Gueugnon","1-1",1,1,"1",1,2,0,"D"
1996-01-19,1995,"Le Havre AC","Paris Saint-Germain","1-1",1,1,"1",1,2,0,"D"
1996-01-20,1995,"AS Cannes","AJ Auxerre","0-1",0,1,"1",1,1,-1,"D"
1996-01-20,1995,"RC Lens","OGC Nice","0-0",0,0,"1",1,0,0,"D"
1996-01-20,1995,"Olympique Lyon","Stade Rennes","2-2",2,2,"1",1,4,0,"D"
1996-01-20,1995,"Montpellier HSC","FC Martigues","2-0",2,0,"1",1,2,2,"H"
1996-01-20,1995,"FC Gueugnon","SC Bastia","1-0",1,0,"1",1,1,1,"H"
1996-01-20,1995,"RC Strasbourg","FC Metz","1-2",1,2,"1",1,3,-1,"D"
1996-01-20,1995,"EA Guingamp","AS Saint-Etienne","3-0",3,0,"1",1,3,3,"H"
1996-01-20,1995,"FC Nantes","Lille OSC","1-2",1,2,"1",1,3,-1,"D"
1996-01-20,1995,"AS Monaco","Girondins Bordeaux","2-0",2,0,"1",1,2,2,"H"
1996-01-27,1995,"SC Bastia","EA Guingamp","0-1",0,1,"1",1,1,-1,"D"
1996-01-27,1995,"Stade Rennes","RC Lens","2-1",2,1,"1",1,3,1,"H"
1996-01-27,1995,"FC Martigues","RC Strasbourg","2-0",2,0,"1",1,2,2,"H"
1996-01-27,1995,"Paris Saint-Germain","AS Cannes","2-1",2,1,"1",1,3,1,"H"
1996-01-27,1995,"Lille OSC","AS Monaco","0-0",0,0,"1",1,0,0,"D"
1996-01-27,1995,"Girondins Bordeaux","FC Gueugnon","3-1",3,1,"1",1,4,2,"H"
1996-01-27,1995,"AJ Auxerre","Le Havre AC","1-0",1,0,"1",1,1,1,"H"
1996-01-27,1995,"OGC Nice","Montpellier HSC","1-2",1,2,"1",1,3,-1,"D"
1996-01-28,1995,"AS Saint-Etienne","FC Nantes","0-0",0,0,"1",1,0,0,"D"
1996-02-06,1995,"RC Lens","Lille OSC","1-1",1,1,"1",1,2,0,"D"
1996-02-07,1995,"Le Havre AC","OGC Nice","0-0",0,0,"1",1,0,0,"D"
1996-02-07,1995,"FC Nantes","SC Bastia","3-1",3,1,"1",1,4,2,"H"
1996-02-07,1995,"Olympique Lyon","FC Martigues","5-1",5,1,"1",1,6,4,"H"
1996-02-07,1995,"AS Cannes","Girondins Bordeaux","1-1",1,1,"1",1,2,0,"D"
1996-02-07,1995,"AS Monaco","Paris Saint-Germain","1-0",1,0,"1",1,1,1,"H"
1996-02-10,1995,"AJ Auxerre","Olympique Lyon","2-0",2,0,"1",1,2,2,"H"
1996-02-10,1995,"FC Martigues","Stade Rennes","1-2",1,2,"1",1,3,-1,"D"
1996-02-10,1995,"SC Bastia","RC Lens","3-2",3,2,"1",1,5,1,"H"
1996-02-10,1995,"Lille OSC","FC Gueugnon","2-0",2,0,"1",1,2,2,"H"
1996-02-10,1995,"Girondins Bordeaux","Le Havre AC","3-1",3,1,"1",1,4,2,"H"
1996-02-10,1995,"EA Guingamp","FC Nantes","3-1",3,1,"1",1,4,2,"H"
1996-02-10,1995,"OGC Nice","RC Strasbourg","2-2",2,2,"1",1,4,0,"D"
1996-02-11,1995,"Paris Saint-Germain","Montpellier HSC","2-3",2,3,"1",1,5,-1,"D"
1996-02-17,1995,"Le Havre AC","Lille OSC","4-1",4,1,"1",1,5,3,"H"
1996-02-17,1995,"RC Strasbourg","Paris Saint-Germain","1-0",1,0,"1",1,1,1,"H"
1996-02-17,1995,"Montpellier HSC","Girondins Bordeaux","3-0",3,0,"1",1,3,3,"H"
1996-02-17,1995,"Olympique Lyon","OGC Nice","1-0",1,0,"1",1,1,1,"H"
1996-02-17,1995,"AS Cannes","SC Bastia","1-0",1,0,"1",1,1,1,"H"
1996-02-17,1995,"Stade Rennes","AJ Auxerre","2-1",2,1,"1",1,3,1,"H"
1996-02-17,1995,"FC Gueugnon","EA Guingamp","2-2",2,2,"1",1,4,0,"D"
1996-02-17,1995,"FC Metz","FC Martigues","2-0",2,0,"1",1,2,2,"H"
1996-02-17,1995,"RC Lens","FC Nantes","2-1",2,1,"1",1,3,1,"H"
1996-02-17,1995,"AS Monaco","AS Saint-Etienne","2-0",2,0,"1",1,2,2,"H"
1996-02-23,1995,"FC Gueugnon","AS Saint-Etienne","1-0",1,0,"1",1,1,1,"H"
1996-02-26,1995,"OGC Nice","AS Cannes","1-2",1,2,"1",1,3,-1,"D"
1996-02-27,1995,"EA Guingamp","AS Monaco","0-0",0,0,"1",1,0,0,"D"
1996-02-27,1995,"Lille OSC","Montpellier HSC","1-1",1,1,"1",1,2,0,"D"
1996-02-27,1995,"AS Saint-Etienne","Olympique Lyon","1-1",1,1,"1",1,2,0,"D"
1996-02-27,1995,"Paris Saint-Germain","RC Lens","1-0",1,0,"1",1,1,1,"H"
1996-02-27,1995,"FC Martigues","Le Havre AC","0-1",0,1,"1",1,1,-1,"D"
1996-02-27,1995,"FC Nantes","FC Gueugnon","1-0",1,0,"1",1,1,1,"H"
1996-02-27,1995,"AJ Auxerre","FC Metz","0-0",0,0,"1",1,0,0,"D"
1996-02-27,1995,"Girondins Bordeaux","RC Strasbourg","1-1",1,1,"1",1,2,0,"D"
1996-03-01,1995,"Olympique Lyon","Girondins Bordeaux","1-0",1,0,"1",1,1,1,"H"
1996-03-01,1995,"AS Monaco","FC Nantes","4-1",4,1,"1",1,5,3,"H"
1996-03-02,1995,"Montpellier HSC","AS Saint-Etienne","1-0",1,0,"1",1,1,1,"H"
1996-03-02,1995,"Le Havre AC","SC Bastia","1-0",1,0,"1",1,1,1,"H"
1996-03-02,1995,"RC Strasbourg","Lille OSC","2-0",2,0,"1",1,2,2,"H"
1996-03-02,1995,"Stade Rennes","Paris Saint-Germain","0-1",0,1,"1",1,1,-1,"D"
1996-03-02,1995,"RC Lens","FC Gueugnon","2-0",2,0,"1",1,2,2,"H"
1996-03-02,1995,"AJ Auxerre","FC Martigues","4-0",4,0,"1",1,4,4,"H"
1996-03-02,1995,"AS Cannes","EA Guingamp","3-0",3,0,"1",1,3,3,"H"
1996-03-02,1995,"FC Metz","OGC Nice","4-0",4,0,"1",1,4,4,"H"
1996-03-05,1995,"FC Metz","Olympique Lyon","0-1",0,1,"1",1,1,-1,"D"
1996-03-05,1995,"RC Strasbourg","AJ Auxerre","1-0",1,0,"1",1,1,1,"H"
1996-03-09,1995,"FC Martigues","RC Lens","0-1",0,1,"1",1,1,-1,"D"
1996-03-09,1995,"FC Gueugnon","AS Monaco","2-2",2,2,"1",1,4,0,"D"
1996-03-09,1995,"SC Bastia","Montpellier HSC","1-0",1,0,"1",1,1,1,"H"
1996-03-09,1995,"AS Saint-Etienne","Le Havre AC","1-1",1,1,"1",1,2,0,"D"
1996-03-09,1995,"OGC Nice","AJ Auxerre","1-3",1,3,"1",1,4,-2,"D"
1996-03-09,1995,"EA Guingamp","RC Strasbourg","3-0",3,0,"1",1,3,3,"H"
1996-03-09,1995,"Lille OSC","Stade Rennes","0-0",0,0,"1",1,0,0,"D"
1996-03-09,1995,"FC Nantes","AS Cannes","2-0",2,0,"1",1,2,2,"H"
1996-03-09,1995,"Girondins Bordeaux","FC Metz","4-0",4,0,"1",1,4,4,"H"
1996-03-10,1995,"Paris Saint-Germain","Olympique Lyon","2-0",2,0,"1",1,2,2,"H"
1996-03-16,1995,"Stade Rennes","FC Metz","0-0",0,0,"1",1,0,0,"D"
1996-03-16,1995,"AS Saint-Etienne","AS Cannes","2-2",2,2,"1",1,4,0,"D"
1996-03-23,1995,"Stade Rennes","Girondins Bordeaux","4-3",4,3,"1",1,7,1,"H"
1996-03-23,1995,"Montpellier HSC","AS Monaco","0-0",0,0,"1",1,0,0,"D"
1996-03-23,1995,"Le Havre AC","EA Guingamp","1-0",1,0,"1",1,1,1,"H"
1996-03-23,1995,"RC Strasbourg","SC Bastia","4-3",4,3,"1",1,7,1,"H"
1996-03-23,1995,"Olympique Lyon","FC Nantes","1-1",1,1,"1",1,2,0,"D"
1996-03-23,1995,"FC Metz","Lille OSC","2-0",2,0,"1",1,2,2,"H"
1996-03-23,1995,"RC Lens","AS Saint-Etienne","3-0",3,0,"1",1,3,3,"H"
1996-03-23,1995,"AS Cannes","FC Gueugnon","2-0",2,0,"1",1,2,2,"H"
1996-03-23,1995,"FC Martigues","OGC Nice","0-0",0,0,"1",1,0,0,"D"
1996-03-24,1995,"AJ Auxerre","Paris Saint-Germain","3-0",3,0,"1",1,3,3,"H"
1996-03-30,1995,"OGC Nice","Stade Rennes","0-0",0,0,"1",1,0,0,"D"
1996-03-30,1995,"AS Monaco","AS Cannes","1-0",1,0,"1",1,1,1,"H"
1996-03-30,1995,"AS Saint-Etienne","RC Strasbourg","2-0",2,0,"1",1,2,2,"H"
1996-03-30,1995,"FC Gueugnon","Montpellier HSC","0-2",0,2,"1",1,2,-2,"D"
1996-03-30,1995,"Paris Saint-Germain","FC Metz","2-3",2,3,"1",1,5,-1,"D"
1996-03-30,1995,"SC Bastia","Olympique Lyon","0-0",0,0,"1",1,0,0,"D"
1996-03-30,1995,"Lille OSC","AJ Auxerre","0-4",0,4,"1",1,4,-4,"D"
1996-03-30,1995,"FC Nantes","Le Havre AC","1-1",1,1,"1",1,2,0,"D"
1996-03-31,1995,"EA Guingamp","RC Lens","1-0",1,0,"1",1,1,1,"H"
1996-04-05,1995,"Montpellier HSC","EA Guingamp","2-1",2,1,"1",1,3,1,"H"
1996-04-05,1995,"SC Bastia","Stade Rennes","0-0",0,0,"1",1,0,0,"D"
1996-04-08,1995,"RC Lens","AS Monaco","2-1",2,1,"1",1,3,1,"H"
1996-04-09,1995,"Montpellier HSC","FC Nantes","1-0",1,0,"1",1,1,1,"H"
1996-04-09,1995,"Le Havre AC","FC Gueugnon","0-2",0,2,"1",1,2,-2,"D"
1996-04-09,1995,"AJ Auxerre","Girondins Bordeaux","2-0",2,0,"1",1,2,2,"H"
1996-04-09,1995,"RC Strasbourg","AS Cannes","1-0",1,0,"1",1,1,1,"H"
1996-04-09,1995,"Stade Rennes","AS Saint-Etienne","3-0",3,0,"1",1,3,3,"H"
1996-04-09,1995,"OGC Nice","Paris Saint-Germain","1-2",1,2,"1",1,3,-1,"D"
1996-04-09,1995,"FC Martigues","Lille OSC","1-0",1,0,"1",1,1,1,"H"
1996-04-10,1995,"Olympique Lyon","EA Guingamp","1-1",1,1,"1",1,2,0,"D"
1996-04-10,1995,"FC Metz","SC Bastia","2-0",2,0,"1",1,2,2,"H"
1996-04-14,1995,"FC Metz","AS Monaco","0-3",0,3,"1",1,3,-3,"D"
1996-04-20,1995,"SC Bastia","AJ Auxerre","1-1",1,1,"1",1,2,0,"D"
1996-04-20,1995,"AS Cannes","Montpellier HSC","2-1",2,1,"1",1,3,1,"H"
1996-04-20,1995,"FC Gueugnon","Olympique Lyon","0-0",0,0,"1",1,0,0,"D"
1996-04-20,1995,"AS Monaco","Le Havre AC","2-1",2,1,"1",1,3,1,"H"
1996-04-20,1995,"AS Saint-Etienne","FC Metz","1-1",1,1,"1",1,2,0,"D"
1996-04-20,1995,"Lille OSC","OGC Nice","1-0",1,0,"1",1,1,1,"H"
1996-04-20,1995,"Girondins Bordeaux","RC Lens","0-0",0,0,"1",1,0,0,"D"
1996-04-20,1995,"FC Nantes","RC Strasbourg","2-0",2,0,"1",1,2,2,"H"
1996-04-20,1995,"EA Guingamp","Stade Rennes","0-0",0,0,"1",1,0,0,"D"
1996-04-23,1995,"Paris Saint-Germain","FC Martigues","0-0",0,0,"1",1,0,0,"D"
1996-04-26,1995,"OGC Nice","Girondins Bordeaux","1-0",1,0,"1",1,1,1,"H"
1996-04-26,1995,"AJ Auxerre","AS Saint-Etienne","2-0",2,0,"1",1,2,2,"H"
1996-04-27,1995,"Stade Rennes","FC Nantes","2-2",2,2,"1",1,4,0,"D"
1996-04-27,1995,"Le Havre AC","AS Cannes","0-0",0,0,"1",1,0,0,"D"
1996-04-27,1995,"RC Lens","Montpellier HSC","2-1",2,1,"1",1,3,1,"H"
1996-04-27,1995,"Olympique Lyon","AS Monaco","3-3",3,3,"1",1,6,0,"D"
1996-04-27,1995,"FC Metz","EA Guingamp","3-0",3,0,"1",1,3,3,"H"
1996-04-27,1995,"FC Martigues","SC Bastia","3-1",3,1,"1",1,4,2,"H"
1996-04-27,1995,"Paris Saint-Germain","Lille OSC","0-1",0,1,"1",1,1,-1,"D"
1996-04-27,1995,"RC Strasbourg","FC Gueugnon","0-0",0,0,"1",1,0,0,"D"
1996-05-05,1995,"Girondins Bordeaux","FC Martigues","1-1",1,1,"1",1,2,0,"D"
1996-05-11,1995,"FC Gueugnon","Stade Rennes","1-0",1,0,"1",1,1,1,"H"
1996-05-11,1995,"Girondins Bordeaux","Paris Saint-Germain","2-2",2,2,"1",1,4,0,"D"
1996-05-11,1995,"AS Cannes","RC Lens","5-2",5,2,"1",1,7,3,"H"
1996-05-11,1995,"AS Monaco","RC Strasbourg","5-1",5,1,"1",1,6,4,"H"
1996-05-11,1995,"Montpellier HSC","Le Havre AC","2-0",2,0,"1",1,2,2,"H"
1996-05-11,1995,"EA Guingamp","AJ Auxerre","1-1",1,1,"1",1,2,0,"D"
1996-05-11,1995,"AS Saint-Etienne","FC Martigues","2-2",2,2,"1",1,4,0,"D"
1996-05-11,1995,"Lille OSC","Olympique Lyon","2-1",2,1,"1",1,3,1,"H"
1996-05-11,1995,"FC Nantes","FC Metz","1-0",1,0,"1",1,1,1,"H"
1996-05-11,1995,"SC Bastia","OGC Nice","1-2",1,2,"1",1,3,-1,"D"
1996-05-18,1995,"Le Havre AC","RC Lens","1-1",1,1,"1",1,2,0,"D"
1996-05-18,1995,"AJ Auxerre","FC Nantes","2-1",2,1,"1",1,3,1,"H"
1996-05-18,1995,"Lille OSC","Girondins Bordeaux","0-2",0,2,"1",1,2,-2,"D"
1996-05-18,1995,"Paris Saint-Germain","SC Bastia","5-1",5,1,"1",1,6,4,"H"
1996-05-18,1995,"OGC Nice","AS Saint-Etienne","2-0",2,0,"1",1,2,2,"H"
1996-05-18,1995,"FC Martigues","EA Guingamp","2-1",2,1,"1",1,3,1,"H"
1996-05-18,1995,"FC Metz","FC Gueugnon","1-2",1,2,"1",1,3,-1,"D"
1996-05-18,1995,"Stade Rennes","AS Monaco","2-3",2,3,"1",1,5,-1,"D"
1996-05-18,1995,"Olympique Lyon","AS Cannes","1-0",1,0,"1",1,1,1,"H"
1996-05-18,1995,"RC Strasbourg","Montpellier HSC","1-0",1,0,"1",1,1,1,"H"
1996-08-11,1996,"SC Bastia","Stade Rennes","2-0",2,0,"1",1,2,2,"H"
1996-08-11,1996,"OGC Nice","AJ Auxerre","0-1",0,1,"1",1,1,-1,"D"
1996-08-11,1996,"Lille OSC","FC Metz","1-0",1,0,"1",1,1,1,"H"
1996-08-11,1996,"Girondins Bordeaux","Le Havre AC","1-0",1,0,"1",1,1,1,"H"
1996-08-11,1996,"RC Strasbourg","Paris Saint-Germain","0-1",0,1,"1",1,1,-1,"D"
1996-08-11,1996,"SM Caen","RC Lens","0-2",0,2,"1",1,2,-2,"D"
1996-08-11,1996,"AS Nancy","AS Cannes","1-2",1,2,"1",1,3,-1,"D"
1996-08-11,1996,"EA Guingamp","Montpellier HSC","0-0",0,0,"1",1,0,0,"D"
1996-08-11,1996,"Olympique Marseille","Olympique Lyon","3-1",3,1,"1",1,4,2,"H"
1996-08-11,1996,"FC Nantes","AS Monaco","1-3",1,3,"1",1,4,-2,"D"
1996-08-17,1996,"AS Monaco","Montpellier HSC","1-1",1,1,"1",1,2,0,"D"
1996-08-17,1996,"Stade Rennes","OGC Nice","3-1",3,1,"1",1,4,2,"H"
1996-08-17,1996,"AJ Auxerre","Lille OSC","2-0",2,0,"1",1,2,2,"H"
1996-08-17,1996,"FC Metz","Girondins Bordeaux","1-1",1,1,"1",1,2,0,"D"
1996-08-17,1996,"Le Havre AC","Olympique Marseille","1-1",1,1,"1",1,2,0,"D"
1996-08-17,1996,"Olympique Lyon","RC Strasbourg","2-0",2,0,"1",1,2,2,"H"
1996-08-17,1996,"Paris Saint-Germain","SM Caen","2-0",2,0,"1",1,2,2,"H"
1996-08-17,1996,"AS Cannes","FC Nantes","1-1",1,1,"1",1,2,0,"D"
1996-08-17,1996,"SC Bastia","EA Guingamp","1-0",1,0,"1",1,1,1,"H"
1996-08-17,1996,"RC Lens","AS Nancy","3-1",3,1,"1",1,4,2,"H"
1996-08-23,1996,"AS Nancy","Paris Saint-Germain","0-0",0,0,"1",1,0,0,"D"
1996-08-24,1996,"RC Strasbourg","Le Havre AC","1-0",1,0,"1",1,1,1,"H"
1996-08-24,1996,"Montpellier HSC","AS Cannes","0-1",0,1,"1",1,1,-1,"D"
1996-08-24,1996,"EA Guingamp","AS Monaco","2-1",2,1,"1",1,3,1,"H"
1996-08-24,1996,"FC Nantes","RC Lens","0-1",0,1,"1",1,1,-1,"D"
1996-08-24,1996,"SM Caen","Olympique Lyon","1-1",1,1,"1",1,2,0,"D"
1996-08-24,1996,"Girondins Bordeaux","AJ Auxerre","0-0",0,0,"1",1,0,0,"D"
1996-08-24,1996,"OGC Nice","SC Bastia","1-1",1,1,"1",1,2,0,"D"
1996-08-24,1996,"Olympique Marseille","FC Metz","1-2",1,2,"1",1,3,-1,"D"
1996-08-24,1996,"Lille OSC","Stade Rennes","3-1",3,1,"1",1,4,2,"H"
1996-08-27,1996,"AJ Auxerre","Olympique Marseille","0-0",0,0,"1",1,0,0,"D"
1996-08-28,1996,"AS Cannes","AS Monaco","0-2",0,2,"1",1,2,-2,"D"
1996-08-28,1996,"Stade Rennes","Girondins Bordeaux","1-1",1,1,"1",1,2,0,"D"
1996-08-28,1996,"FC Metz","RC Strasbourg","3-1",3,1,"1",1,4,2,"H"
1996-08-28,1996,"Le Havre AC","SM Caen","1-1",1,1,"1",1,2,0,"D"
1996-08-28,1996,"Olympique Lyon","AS Nancy","2-0",2,0,"1",1,2,2,"H"
1996-08-28,1996,"RC Lens","Montpellier HSC","3-2",3,2,"1",1,5,1,"H"
1996-08-28,1996,"OGC Nice","EA Guingamp","1-2",1,2,"1",1,3,-1,"D"
1996-08-28,1996,"SC Bastia","Lille OSC","0-0",0,0,"1",1,0,0,"D"
1996-08-28,1996,"Paris Saint-Germain","FC Nantes","1-0",1,0,"1",1,1,1,"H"
1996-09-02,1996,"FC Nantes","Olympique Lyon","2-2",2,2,"1",1,4,0,"D"
1996-09-03,1996,"RC Strasbourg","AJ Auxerre","2-1",2,1,"1",1,3,1,"H"
1996-09-03,1996,"Olympique Marseille","Stade Rennes","3-1",3,1,"1",1,4,2,"H"
1996-09-03,1996,"EA Guingamp","AS Cannes","0-1",0,1,"1",1,1,-1,"D"
1996-09-03,1996,"SM Caen","FC Metz","0-0",0,0,"1",1,0,0,"D"
1996-09-03,1996,"Lille OSC","OGC Nice","3-2",3,2,"1",1,5,1,"H"
1996-09-03,1996,"AS Monaco","RC Lens","5-1",5,1,"1",1,6,4,"H"
1996-09-03,1996,"AS Nancy","Le Havre AC","0-1",0,1,"1",1,1,-1,"D"
1996-09-03,1996,"Montpellier HSC","Paris Saint-Germain","0-3",0,3,"1",1,3,-3,"D"
1996-09-03,1996,"Girondins Bordeaux","SC Bastia","3-1",3,1,"1",1,4,2,"H"
1996-09-06,1996,"Olympique Lyon","Montpellier HSC","1-1",1,1,"1",1,2,0,"D"
1996-09-06,1996,"Stade Rennes","RC Strasbourg","2-0",2,0,"1",1,2,2,"H"
1996-09-06,1996,"AJ Auxerre","SM Caen","2-0",2,0,"1",1,2,2,"H"
1996-09-06,1996,"Le Havre AC","FC Nantes","3-1",3,1,"1",1,4,2,"H"
1996-09-06,1996,"Paris Saint-Germain","AS Monaco","0-0",0,0,"1",1,0,0,"D"
1996-09-06,1996,"RC Lens","AS Cannes","0-0",0,0,"1",1,0,0,"D"
1996-09-06,1996,"Lille OSC","EA Guingamp","1-1",1,1,"1",1,2,0,"D"
1996-09-06,1996,"FC Metz","AS Nancy","1-0",1,0,"1",1,1,1,"H"
1996-09-08,1996,"SC Bastia","Olympique Marseille","2-0",2,0,"1",1,2,2,"H"
1996-09-09,1996,"OGC Nice","Girondins Bordeaux","0-1",0,1,"1",1,1,-1,"D"
1996-09-14,1996,"SM Caen","Stade Rennes","0-0",0,0,"1",1,0,0,"D"
1996-09-14,1996,"EA Guingamp","RC Lens","1-0",1,0,"1",1,1,1,"H"
1996-09-14,1996,"FC Nantes","FC Metz","0-1",0,1,"1",1,1,-1,"D"
1996-09-14,1996,"AS Nancy","AJ Auxerre","0-0",0,0,"1",1,0,0,"D"
1996-09-14,1996,"Olympique Marseille","OGC Nice","1-0",1,0,"1",1,1,1,"H"
1996-09-14,1996,"Girondins Bordeaux","Lille OSC","3-0",3,0,"1",1,3,3,"H"
1996-09-14,1996,"AS Monaco","Olympique Lyon","0-0",0,0,"1",1,0,0,"D"
1996-09-14,1996,"Montpellier HSC","Le Havre AC","2-1",2,1,"1",1,3,1,"H"
1996-09-14,1996,"RC Strasbourg","SC Bastia","1-3",1,3,"1",1,4,-2,"D"
1996-09-15,1996,"AS Cannes","Paris Saint-Germain","0-1",0,1,"1",1,1,-1,"D"
1996-09-19,1996,"AJ Auxerre","FC Nantes","2-2",2,2,"1",1,4,0,"D"
1996-09-20,1996,"Girondins Bordeaux","EA Guingamp","0-0",0,0,"1",1,0,0,"D"
1996-09-20,1996,"FC Metz","Montpellier HSC","1-1",1,1,"1",1,2,0,"D"
1996-09-20,1996,"Le Havre AC","AS Monaco","1-2",1,2,"1",1,3,-1,"D"
1996-09-20,1996,"Paris Saint-Germain","RC Lens","4-0",4,0,"1",1,4,4,"H"
1996-09-20,1996,"Stade Rennes","AS Nancy","1-0",1,0,"1",1,1,1,"H"
1996-09-20,1996,"Lille OSC","Olympique Marseille","1-1",1,1,"1",1,2,0,"D"
1996-09-20,1996,"OGC Nice","RC Strasbourg","1-1",1,1,"1",1,2,0,"D"
1996-09-20,1996,"SC Bastia","SM Caen","4-2",4,2,"1",1,6,2,"H"
1996-09-20,1996,"Olympique Lyon","AS Cannes","3-1",3,1,"1",1,4,2,"H"
1996-09-28,1996,"RC Strasbourg","Lille OSC","3-0",3,0,"1",1,3,3,"H"
1996-09-28,1996,"FC Nantes","Stade Rennes","3-3",3,3,"1",1,6,0,"D"
1996-09-28,1996,"AS Nancy","SC Bastia","2-2",2,2,"1",1,4,0,"D"
1996-09-28,1996,"SM Caen","OGC Nice","1-2",1,2,"1",1,3,-1,"D"
1996-09-28,1996,"Olympique Marseille","Girondins Bordeaux","0-0",0,0,"1",1,0,0,"D"
1996-09-28,1996,"RC Lens","Olympique Lyon","0-1",0,1,"1",1,1,-1,"D"
1996-09-28,1996,"AS Cannes","Le Havre AC","2-0",2,0,"1",1,2,2,"H"
1996-09-28,1996,"Montpellier HSC","AJ Auxerre","0-0",0,0,"1",1,0,0,"D"
1996-09-28,1996,"AS Monaco","FC Metz","1-1",1,1,"1",1,2,0,"D"
1996-09-29,1996,"EA Guingamp","Paris Saint-Germain","2-2",2,2,"1",1,4,0,"D"
1996-10-01,1996,"Le Havre AC","RC Lens","0-0",0,0,"1",1,0,0,"D"
1996-10-02,1996,"Olympique Marseille","EA Guingamp","2-1",2,1,"1",1,3,1,"H"
1996-10-02,1996,"Girondins Bordeaux","RC Strasbourg","1-2",1,2,"1",1,3,-1,"D"
1996-10-02,1996,"Stade Rennes","Montpellier HSC","2-0",2,0,"1",1,2,2,"H"
1996-10-02,1996,"AJ Auxerre","AS Monaco","2-0",2,0,"1",1,2,2,"H"
1996-10-02,1996,"FC Metz","AS Cannes","0-0",0,0,"1",1,0,0,"D"
1996-10-02,1996,"Lille OSC","SM Caen","1-0",1,0,"1",1,1,1,"H"
1996-10-02,1996,"OGC Nice","AS Nancy","1-0",1,0,"1",1,1,1,"H"
1996-10-02,1996,"SC Bastia","FC Nantes","0-0",0,0,"1",1,0,0,"D"
1996-10-02,1996,"Olympique Lyon","Paris Saint-Germain","1-1",1,1,"1",1,2,0,"D"
1996-10-05,1996,"RC Lens","FC Metz","2-2",2,2,"1",1,4,0,"D"
1996-10-05,1996,"EA Guingamp","Olympique Lyon","1-0",1,0,"1",1,1,1,"H"
1996-10-05,1996,"FC Nantes","OGC Nice","7-0",7,0,"1",1,7,7,"H"
1996-10-05,1996,"AS Nancy","Lille OSC","2-2",2,2,"1",1,4,0,"D"
1996-10-05,1996,"Paris Saint-Germain","Le Havre AC","2-0",2,0,"1",1,2,2,"H"
1996-10-05,1996,"RC Strasbourg","Olympique Marseille","2-1",2,1,"1",1,3,1,"H"
1996-10-05,1996,"AS Cannes","AJ Auxerre","1-1",1,1,"1",1,2,0,"D"
1996-10-05,1996,"AS Monaco","Stade Rennes","3-1",3,1,"1",1,4,2,"H"
1996-10-05,1996,"Montpellier HSC","SC Bastia","3-1",3,1,"1",1,4,2,"H"
1996-10-05,1996,"SM Caen","Girondins Bordeaux","0-0",0,0,"1",1,0,0,"D"
1996-10-12,1996,"RC Strasbourg","EA Guingamp","2-1",2,1,"1",1,3,1,"H"
1996-10-12,1996,"AJ Auxerre","RC Lens","1-0",1,0,"1",1,1,1,"H"
1996-10-12,1996,"FC Metz","Paris Saint-Germain","0-1",0,1,"1",1,1,-1,"D"
1996-10-12,1996,"Le Havre AC","Olympique Lyon","4-1",4,1,"1",1,5,3,"H"
1996-10-12,1996,"Olympique Marseille","SM Caen","0-1",0,1,"1",1,1,-1,"D"
1996-10-12,1996,"Girondins Bordeaux","AS Nancy","0-1",0,1,"1",1,1,-1,"D"
1996-10-12,1996,"Lille OSC","FC Nantes","3-3",3,3,"1",1,6,0,"D"
1996-10-12,1996,"SC Bastia","AS Monaco","0-0",0,0,"1",1,0,0,"D"
1996-10-12,1996,"OGC Nice","Montpellier HSC","1-1",1,1,"1",1,2,0,"D"
1996-10-13,1996,"Stade Rennes","AS Cannes","3-0",3,0,"1",1,3,3,"H"
1996-10-19,1996,"Olympique Lyon","FC Metz","0-0",0,0,"1",1,0,0,"D"
1996-10-19,1996,"EA Guingamp","Le Havre AC","2-2",2,2,"1",1,4,0,"D"
1996-10-19,1996,"FC Nantes","Girondins Bordeaux","3-1",3,1,"1",1,4,2,"H"
1996-10-19,1996,"AS Nancy","Olympique Marseille","0-0",0,0,"1",1,0,0,"D"
1996-10-19,1996,"SM Caen","RC Strasbourg","3-0",3,0,"1",1,3,3,"H"
1996-10-19,1996,"RC Lens","Stade Rennes","2-0",2,0,"1",1,2,2,"H"
1996-10-19,1996,"AS Cannes","SC Bastia","1-1",1,1,"1",1,2,0,"D"
1996-10-19,1996,"Montpellier HSC","Lille OSC","0-1",0,1,"1",1,1,-1,"D"
1996-10-19,1996,"AS Monaco","OGC Nice","4-1",4,1,"1",1,5,3,"H"
1996-10-19,1996,"Paris Saint-Germain","AJ Auxerre","1-1",1,1,"1",1,2,0,"D"
1996-10-25,1996,"Girondins Bordeaux","Montpellier HSC","3-1",3,1,"1",1,4,2,"H"
1996-10-26,1996,"Olympique Marseille","FC Nantes","0-1",0,1,"1",1,1,-1,"D"
1996-10-26,1996,"Stade Rennes","Paris Saint-Germain","2-1",2,1,"1",1,3,1,"H"
1996-10-26,1996,"AJ Auxerre","Olympique Lyon","7-0",7,0,"1",1,7,7,"H"
1996-10-26,1996,"FC Metz","Le Havre AC","1-2",1,2,"1",1,3,-1,"D"
1996-10-26,1996,"RC Strasbourg","AS Nancy","3-1",3,1,"1",1,4,2,"H"
1996-10-26,1996,"Lille OSC","AS Monaco","1-4",1,4,"1",1,5,-3,"D"
1996-10-26,1996,"OGC Nice","AS Cannes","0-0",0,0,"1",1,0,0,"D"
1996-10-26,1996,"SC Bastia","RC Lens","0-1",0,1,"1",1,1,-1,"D"
1996-10-26,1996,"SM Caen","EA Guingamp","0-1",0,1,"1",1,1,-1,"D"
1996-11-02,1996,"AS Nancy","SM Caen","1-2",1,2,"1",1,3,-1,"D"
1996-11-02,1996,"EA Guingamp","FC Metz","0-1",0,1,"1",1,1,-1,"D"
1996-11-02,1996,"FC Nantes","RC Strasbourg","3-0",3,0,"1",1,3,3,"H"
1996-11-02,1996,"AS Monaco","Girondins Bordeaux","3-1",3,1,"1",1,4,2,"H"
1996-11-02,1996,"Olympique Lyon","Stade Rennes","2-0",2,0,"1",1,2,2,"H"
1996-11-02,1996,"AS Cannes","Lille OSC","0-1",0,1,"1",1,1,-1,"D"
1996-11-02,1996,"Le Havre AC","AJ Auxerre","0-2",0,2,"1",1,2,-2,"D"
1996-11-02,1996,"Montpellier HSC","Olympique Marseille","2-0",2,0,"1",1,2,2,"H"
1996-11-02,1996,"RC Lens","OGC Nice","3-2",3,2,"1",1,5,1,"H"
1996-11-03,1996,"Paris Saint-Germain","SC Bastia","3-0",3,0,"1",1,3,3,"H"
1996-11-05,1996,"Olympique Marseille","AS Monaco","3-1",3,1,"1",1,4,2,"H"
1996-11-06,1996,"Lille OSC","RC Lens","2-1",2,1,"1",1,3,1,"H"
1996-11-06,1996,"Stade Rennes","Le Havre AC","1-1",1,1,"1",1,2,0,"D"
1996-11-06,1996,"AJ Auxerre","FC Metz","2-3",2,3,"1",1,5,-1,"D"
1996-11-06,1996,"AS Nancy","EA Guingamp","2-0",2,0,"1",1,2,2,"H"
1996-11-06,1996,"SM Caen","FC Nantes","0-0",0,0,"1",1,0,0,"D"
1996-11-06,1996,"Girondins Bordeaux","AS Cannes","1-0",1,0,"1",1,1,1,"H"
1996-11-06,1996,"OGC Nice","Paris Saint-Germain","0-1",0,1,"1",1,1,-1,"D"
1996-11-06,1996,"SC Bastia","Olympique Lyon","3-1",3,1,"1",1,4,2,"H"
1996-11-06,1996,"RC Strasbourg","Montpellier HSC","2-1",2,1,"1",1,3,1,"H"
1996-11-12,1996,"FC Nantes","AS Nancy","2-0",2,0,"1",1,2,2,"H"
1996-11-13,1996,"Paris Saint-Germain","Lille OSC","3-1",3,1,"1",1,4,2,"H"
1996-11-13,1996,"Olympique Lyon","OGC Nice","3-1",3,1,"1",1,4,2,"H"
1996-11-13,1996,"Le Havre AC","SC Bastia","0-1",0,1,"1",1,1,-1,"D"
1996-11-13,1996,"EA Guingamp","AJ Auxerre","0-0",0,0,"1",1,0,0,"D"
1996-11-13,1996,"AS Cannes","Olympique Marseille","0-0",0,0,"1",1,0,0,"D"
1996-11-13,1996,"AS Monaco","RC Strasbourg","2-0",2,0,"1",1,2,2,"H"
1996-11-13,1996,"Montpellier HSC","SM Caen","0-0",0,0,"1",1,0,0,"D"
1996-11-13,1996,"FC Metz","Stade Rennes","2-0",2,0,"1",1,2,2,"H"
1996-11-13,1996,"RC Lens","Girondins Bordeaux","3-4",3,4,"1",1,7,-1,"D"
1996-11-16,1996,"AS Nancy","Montpellier HSC","0-0",0,0,"1",1,0,0,"D"
1996-11-16,1996,"FC Nantes","EA Guingamp","1-1",1,1,"1",1,2,0,"D"
1996-11-16,1996,"SM Caen","AS Monaco","0-1",0,1,"1",1,1,-1,"D"
1996-11-16,1996,"Olympique Marseille","RC Lens","2-1",2,1,"1",1,3,1,"H"
1996-11-16,1996,"Girondins Bordeaux","Paris Saint-Germain","5-3",5,3,"1",1,8,2,"H"
1996-11-16,1996,"OGC Nice","Le Havre AC","0-3",0,3,"1",1,3,-3,"D"
1996-11-16,1996,"SC Bastia","FC Metz","2-1",2,1,"1",1,3,1,"H"
1996-11-16,1996,"RC Strasbourg","AS Cannes","2-0",2,0,"1",1,2,2,"H"
1996-11-16,1996,"Stade Rennes","AJ Auxerre","1-0",1,0,"1",1,1,1,"H"
1996-11-17,1996,"Lille OSC","Olympique Lyon","1-1",1,1,"1",1,2,0,"D"
1996-11-22,1996,"Paris Saint-Germain","Olympique Marseille","0-0",0,0,"1",1,0,0,"D"
1996-11-23,1996,"Montpellier HSC","FC Nantes","2-2",2,2,"1",1,4,0,"D"
1996-11-23,1996,"AJ Auxerre","SC Bastia","1-2",1,2,"1",1,3,-1,"D"
1996-11-23,1996,"FC Metz","OGC Nice","1-0",1,0,"1",1,1,1,"H"
1996-11-23,1996,"Le Havre AC","Lille OSC","0-0",0,0,"1",1,0,0,"D"
1996-11-23,1996,"Olympique Lyon","Girondins Bordeaux","2-2",2,2,"1",1,4,0,"D"
1996-11-23,1996,"RC Lens","RC Strasbourg","1-2",1,2,"1",1,3,-1,"D"
1996-11-23,1996,"AS Monaco","AS Nancy","2-0",2,0,"1",1,2,2,"H"
1996-11-23,1996,"EA Guingamp","Stade Rennes","1-0",1,0,"1",1,1,1,"H"
1996-11-23,1996,"AS Cannes","SM Caen","2-0",2,0,"1",1,2,2,"H"
1996-11-28,1996,"Montpellier HSC","AS Monaco","0-1",0,1,"1",1,1,-1,"D"
1996-11-28,1996,"Girondins Bordeaux","FC Metz","1-0",1,0,"1",1,1,1,"H"
1996-11-29,1996,"EA Guingamp","SC Bastia","2-1",2,1,"1",1,3,1,"H"
1996-11-29,1996,"FC Nantes","AS Cannes","5-1",5,1,"1",1,6,4,"H"
1996-11-29,1996,"AS Nancy","RC Lens","1-1",1,1,"1",1,2,0,"D"
1996-11-29,1996,"SM Caen","Paris Saint-Germain","1-3",1,3,"1",1,4,-2,"D"
1996-11-29,1996,"RC Strasbourg","Olympique Lyon","3-0",3,0,"1",1,3,3,"H"
1996-11-29,1996,"Olympique Marseille","Le Havre AC","0-0",0,0,"1",1,0,0,"D"
1996-11-29,1996,"Lille OSC","AJ Auxerre","0-1",0,1,"1",1,1,-1,"D"
1996-11-29,1996,"OGC Nice","Stade Rennes","3-1",3,1,"1",1,4,2,"H"
1996-12-06,1996,"RC Lens","FC Nantes","0-4",0,4,"1",1,4,-4,"D"
1996-12-06,1996,"Paris Saint-Germain","AS Nancy","1-2",1,2,"1",1,3,-1,"D"
1996-12-07,1996,"AS Monaco","EA Guingamp","0-0",0,0,"1",1,0,0,"D"
1996-12-07,1996,"Olympique Lyon","SM Caen","3-0",3,0,"1",1,3,3,"H"
1996-12-07,1996,"Le Havre AC","RC Strasbourg","2-0",2,0,"1",1,2,2,"H"
1996-12-07,1996,"FC Metz","Olympique Marseille","1-1",1,1,"1",1,2,0,"D"
1996-12-07,1996,"AJ Auxerre","Girondins Bordeaux","2-1",2,1,"1",1,3,1,"H"
1996-12-07,1996,"Stade Rennes","Lille OSC","2-0",2,0,"1",1,2,2,"H"
1996-12-07,1996,"AS Cannes","Montpellier HSC","1-0",1,0,"1",1,1,1,"H"
1996-12-07,1996,"SC Bastia","OGC Nice","1-0",1,0,"1",1,1,1,"H"
1996-12-14,1996,"SM Caen","Le Havre AC","4-0",4,0,"1",1,4,4,"H"
1996-12-14,1996,"EA Guingamp","OGC Nice","0-1",0,1,"1",1,1,-1,"D"
1996-12-14,1996,"Girondins Bordeaux","Stade Rennes","2-0",2,0,"1",1,2,2,"H"
1996-12-14,1996,"RC Strasbourg","FC Metz","0-1",0,1,"1",1,1,-1,"D"
1996-12-14,1996,"FC Nantes","Paris Saint-Germain","0-0",0,0,"1",1,0,0,"D"
1996-12-14,1996,"Lille OSC","SC Bastia","1-2",1,2,"1",1,3,-1,"D"
1996-12-14,1996,"AS Monaco","AS Cannes","1-0",1,0,"1",1,1,1,"H"
1996-12-14,1996,"AS Nancy","Olympique Lyon","2-3",2,3,"1",1,5,-1,"D"
1996-12-14,1996,"Montpellier HSC","RC Lens","1-0",1,0,"1",1,1,1,"H"
1996-12-15,1996,"Olympique Marseille","AJ Auxerre","3-0",3,0,"1",1,3,3,"H"
1996-12-19,1996,"SC Bastia","Girondins Bordeaux","3-1",3,1,"1",1,4,2,"H"
1996-12-20,1996,"OGC Nice","Lille OSC","1-1",1,1,"1",1,2,0,"D"
1996-12-20,1996,"AS Cannes","EA Guingamp","1-0",1,0,"1",1,1,1,"H"
1996-12-20,1996,"Olympique Lyon","FC Nantes","0-1",0,1,"1",1,1,-1,"D"
1996-12-20,1996,"Le Havre AC","AS Nancy","1-3",1,3,"1",1,4,-2,"D"
1996-12-20,1996,"FC Metz","SM Caen","2-2",2,2,"1",1,4,0,"D"
1996-12-20,1996,"Stade Rennes","Olympique Marseille","4-2",4,2,"1",1,6,2,"H"
1996-12-20,1996,"RC Lens","AS Monaco","1-3",1,3,"1",1,4,-2,"D"
1996-12-20,1996,"Paris Saint-Germain","Montpellier HSC","1-1",1,1,"1",1,2,0,"D"
1996-12-20,1996,"AJ Auxerre","RC Strasbourg","0-1",0,1,"1",1,1,-1,"D"
1997-01-25,1996,"AS Nancy","FC Metz","2-3",2,3,"1",1,5,-1,"D"
1997-01-25,1996,"FC Nantes","Le Havre AC","1-1",1,1,"1",1,2,0,"D"
1997-01-25,1996,"RC Strasbourg","Stade Rennes","3-0",3,0,"1",1,3,3,"H"
1997-01-25,1996,"AS Cannes","RC Lens","0-0",0,0,"1",1,0,0,"D"
1997-01-25,1996,"Olympique Marseille","SC Bastia","1-0",1,0,"1",1,1,1,"H"
1997-01-25,1996,"EA Guingamp","Lille OSC","1-0",1,0,"1",1,1,1,"H"
1997-01-25,1996,"Girondins Bordeaux","OGC Nice","4-1",4,1,"1",1,5,3,"H"
1997-01-25,1996,"Montpellier HSC","Olympique Lyon","2-1",2,1,"1",1,3,1,"H"
1997-01-26,1996,"AS Monaco","Paris Saint-Germain","2-0",2,0,"1",1,2,2,"H"
1997-01-26,1996,"SM Caen","AJ Auxerre","2-3",2,3,"1",1,5,-1,"D"
1997-02-01,1996,"OGC Nice","Olympique Marseille","0-0",0,0,"1",1,0,0,"D"
1997-02-01,1996,"RC Lens","EA Guingamp","2-1",2,1,"1",1,3,1,"H"
1997-02-01,1996,"FC Metz","FC Nantes","0-1",0,1,"1",1,1,-1,"D"
1997-02-01,1996,"Stade Rennes","SM Caen","1-1",1,1,"1",1,2,0,"D"
1997-02-01,1996,"Lille OSC","Girondins Bordeaux","0-0",0,0,"1",1,0,0,"D"
1997-02-01,1996,"Paris Saint-Germain","AS Cannes","1-1",1,1,"1",1,2,0,"D"
1997-02-01,1996,"Le Havre AC","Montpellier HSC","0-0",0,0,"1",1,0,0,"D"
1997-02-01,1996,"AJ Auxerre","AS Nancy","1-0",1,0,"1",1,1,1,"H"
1997-02-02,1996,"SC Bastia","RC Strasbourg","3-1",3,1,"1",1,4,2,"H"
1997-02-02,1996,"Olympique Lyon","AS Monaco","3-3",3,3,"1",1,6,0,"D"
1997-02-11,1996,"SM Caen","SC Bastia","2-2",2,2,"1",1,4,0,"D"
1997-02-13,1996,"RC Lens","Paris Saint-Germain","1-2",1,2,"1",1,3,-1,"D"
1997-02-13,1996,"FC Nantes","AJ Auxerre","0-0",0,0,"1",1,0,0,"D"
1997-02-14,1996,"AS Cannes","Olympique Lyon","0-1",0,1,"1",1,1,-1,"D"
1997-02-14,1996,"AS Nancy","Stade Rennes","1-0",1,0,"1",1,1,1,"H"
1997-02-14,1996,"Montpellier HSC","FC Metz","1-0",1,0,"1",1,1,1,"H"
1997-02-14,1996,"AS Monaco","Le Havre AC","3-0",3,0,"1",1,3,3,"H"
1997-02-14,1996,"Olympique Marseille","Lille OSC","5-1",5,1,"1",1,6,4,"H"
1997-02-14,1996,"RC Strasbourg","OGC Nice","3-1",3,1,"1",1,4,2,"H"
1997-02-14,1996,"EA Guingamp","Girondins Bordeaux","2-2",2,2,"1",1,4,0,"D"
1997-02-21,1996,"Olympique Lyon","RC Lens","0-0",0,0,"1",1,0,0,"D"
1997-02-21,1996,"Stade Rennes","FC Nantes","0-1",0,1,"1",1,1,-1,"D"
1997-02-22,1996,"Girondins Bordeaux","Olympique Marseille","4-0",4,0,"1",1,4,4,"H"
1997-02-22,1996,"Paris Saint-Germain","EA Guingamp","1-1",1,1,"1",1,2,0,"D"
1997-02-22,1996,"SC Bastia","AS Nancy","2-0",2,0,"1",1,2,2,"H"
1997-02-22,1996,"Lille OSC","RC Strasbourg","2-4",2,4,"1",1,6,-2,"D"
1997-02-22,1996,"Le Havre AC","AS Cannes","0-0",0,0,"1",1,0,0,"D"
1997-02-22,1996,"FC Metz","AS Monaco","2-0",2,0,"1",1,2,2,"H"
1997-02-22,1996,"AJ Auxerre","Montpellier HSC","0-2",0,2,"1",1,2,-2,"D"
1997-02-22,1996,"OGC Nice","SM Caen","1-1",1,1,"1",1,2,0,"D"
1997-03-08,1996,"RC Strasbourg","Girondins Bordeaux","1-1",1,1,"1",1,2,0,"D"
1997-03-08,1996,"Montpellier HSC","Stade Rennes","0-0",0,0,"1",1,0,0,"D"
1997-03-08,1996,"FC Nantes","SC Bastia","3-0",3,0,"1",1,3,3,"H"
1997-03-08,1996,"AS Cannes","FC Metz","0-0",0,0,"1",1,0,0,"D"
1997-03-08,1996,"RC Lens","Le Havre AC","0-1",0,1,"1",1,1,-1,"D"
1997-03-08,1996,"EA Guingamp","Olympique Marseille","3-1",3,1,"1",1,4,2,"H"
1997-03-08,1996,"AS Nancy","OGC Nice","1-0",1,0,"1",1,1,1,"H"
1997-03-08,1996,"SM Caen","Lille OSC","1-0",1,0,"1",1,1,1,"H"
1997-03-09,1996,"AS Monaco","AJ Auxerre","0-0",0,0,"1",1,0,0,"D"
1997-03-09,1996,"Paris Saint-Germain","Olympique Lyon","3-1",3,1,"1",1,4,2,"H"
1997-03-14,1996,"Olympique Marseille","RC Strasbourg","0-1",0,1,"1",1,1,-1,"D"
1997-03-14,1996,"Lille OSC","AS Nancy","2-0",2,0,"1",1,2,2,"H"
1997-03-14,1996,"OGC Nice","FC Nantes","1-2",1,2,"1",1,3,-1,"D"
1997-03-14,1996,"Le Havre AC","Paris Saint-Germain","1-0",1,0,"1",1,1,1,"H"
1997-03-14,1996,"AJ Auxerre","AS Cannes","3-1",3,1,"1",1,4,2,"H"
1997-03-14,1996,"Stade Rennes","AS Monaco","0-3",0,3,"1",1,3,-3,"D"
1997-03-14,1996,"SC Bastia","Montpellier HSC","2-2",2,2,"1",1,4,0,"D"
1997-03-15,1996,"Olympique Lyon","EA Guingamp","2-1",2,1,"1",1,3,1,"H"
1997-03-15,1996,"Girondins Bordeaux","SM Caen","3-1",3,1,"1",1,4,2,"H"
1997-03-15,1996,"FC Metz","RC Lens","2-0",2,0,"1",1,2,2,"H"
1997-03-22,1996,"AS Nancy","Girondins Bordeaux","1-1",1,1,"1",1,2,0,"D"
1997-03-22,1996,"EA Guingamp","RC Strasbourg","2-1",2,1,"1",1,3,1,"H"
1997-03-22,1996,"AS Cannes","Stade Rennes","1-0",1,0,"1",1,1,1,"H"
1997-03-22,1996,"Olympique Lyon","Le Havre AC","2-1",2,1,"1",1,3,1,"H"
1997-03-22,1996,"FC Nantes","Lille OSC","1-0",1,0,"1",1,1,1,"H"
1997-03-22,1996,"Montpellier HSC","OGC Nice","2-1",2,1,"1",1,3,1,"H"
1997-03-22,1996,"AS Monaco","SC Bastia","3-1",3,1,"1",1,4,2,"H"
1997-03-22,1996,"RC Lens","AJ Auxerre","2-1",2,1,"1",1,3,1,"H"
1997-03-23,1996,"SM Caen","Olympique Marseille","1-0",1,0,"1",1,1,1,"H"
1997-03-23,1996,"Paris Saint-Germain","FC Metz","2-0",2,0,"1",1,2,2,"H"
1997-03-25,1996,"Lille OSC","Montpellier HSC","0-4",0,4,"1",1,4,-4,"D"
1997-03-25,1996,"Girondins Bordeaux","FC Nantes","0-0",0,0,"1",1,0,0,"D"
1997-03-26,1996,"FC Metz","Olympique Lyon","0-1",0,1,"1",1,1,-1,"D"
1997-03-26,1996,"Le Havre AC","EA Guingamp","0-1",0,1,"1",1,1,-1,"D"
1997-03-26,1996,"Olympique Marseille","AS Nancy","4-1",4,1,"1",1,5,3,"H"
1997-03-26,1996,"RC Strasbourg","SM Caen","2-0",2,0,"1",1,2,2,"H"
1997-03-26,1996,"AJ Auxerre","Paris Saint-Germain","2-1",2,1,"1",1,3,1,"H"
1997-03-26,1996,"Stade Rennes","RC Lens","2-2",2,2,"1",1,4,0,"D"
1997-03-26,1996,"SC Bastia","AS Cannes","1-0",1,0,"1",1,1,1,"H"
1997-03-26,1996,"OGC Nice","AS Monaco","0-2",0,2,"1",1,2,-2,"D"
1997-04-04,1996,"AS Monaco","Lille OSC","2-0",2,0,"1",1,2,2,"H"
1997-04-05,1996,"Olympique Lyon","AJ Auxerre","2-0",2,0,"1",1,2,2,"H"
1997-04-05,1996,"Paris Saint-Germain","Stade Rennes","1-1",1,1,"1",1,2,0,"D"
1997-04-05,1996,"AS Nancy","RC Strasbourg","2-0",2,0,"1",1,2,2,"H"
1997-04-05,1996,"FC Nantes","Olympique Marseille","1-1",1,1,"1",1,2,0,"D"
1997-04-05,1996,"AS Cannes","OGC Nice","1-1",1,1,"1",1,2,0,"D"
1997-04-05,1996,"Montpellier HSC","Girondins Bordeaux","2-0",2,0,"1",1,2,2,"H"
1997-04-05,1996,"Le Havre AC","FC Metz","0-0",0,0,"1",1,0,0,"D"
1997-04-06,1996,"EA Guingamp","SM Caen","1-1",1,1,"1",1,2,0,"D"
1997-04-06,1996,"RC Lens","SC Bastia","1-1",1,1,"1",1,2,0,"D"
1997-04-15,1996,"SC Bastia","Paris Saint-Germain","1-1",1,1,"1",1,2,0,"D"
1997-04-16,1996,"Stade Rennes","Olympique Lyon","2-1",2,1,"1",1,3,1,"H"
1997-04-16,1996,"FC Metz","EA Guingamp","2-0",2,0,"1",1,2,2,"H"
1997-04-16,1996,"RC Strasbourg","FC Nantes","0-1",0,1,"1",1,1,-1,"D"
1997-04-16,1996,"AJ Auxerre","Le Havre AC","2-0",2,0,"1",1,2,2,"H"
1997-04-16,1996,"OGC Nice","RC Lens","1-2",1,2,"1",1,3,-1,"D"
1997-04-16,1996,"Girondins Bordeaux","AS Monaco","2-1",2,1,"1",1,3,1,"H"
1997-04-16,1996,"Olympique Marseille","Montpellier HSC","2-2",2,2,"1",1,4,0,"D"
1997-04-16,1996,"SM Caen","AS Nancy","1-1",1,1,"1",1,2,0,"D"
1997-04-17,1996,"Lille OSC","AS Cannes","1-2",1,2,"1",1,3,-1,"D"
1997-04-26,1996,"EA Guingamp","AS Nancy","0-1",0,1,"1",1,1,-1,"D"
1997-04-26,1996,"Le Havre AC","Stade Rennes","1-1",1,1,"1",1,2,0,"D"
1997-04-26,1996,"FC Metz","AJ Auxerre","1-0",1,0,"1",1,1,1,"H"
1997-04-26,1996,"RC Lens","Lille OSC","1-0",1,0,"1",1,1,1,"H"
1997-04-26,1996,"Montpellier HSC","RC Strasbourg","1-4",1,4,"1",1,5,-3,"D"
1997-04-26,1996,"AS Cannes","Girondins Bordeaux","1-1",1,1,"1",1,2,0,"D"
1997-04-26,1996,"FC Nantes","SM Caen","1-1",1,1,"1",1,2,0,"D"
1997-04-26,1996,"Olympique Lyon","SC Bastia","4-2",4,2,"1",1,6,2,"H"
1997-04-26,1996,"AS Monaco","Olympique Marseille","1-1",1,1,"1",1,2,0,"D"
1997-04-27,1996,"Paris Saint-Germain","OGC Nice","5-0",5,0,"1",1,5,5,"H"
1997-04-29,1996,"RC Strasbourg","AS Monaco","0-2",0,2,"1",1,2,-2,"D"
1997-04-29,1996,"SM Caen","Montpellier HSC","0-1",0,1,"1",1,1,-1,"D"
1997-04-30,1996,"Girondins Bordeaux","RC Lens","2-1",2,1,"1",1,3,1,"H"
1997-04-30,1996,"AJ Auxerre","EA Guingamp","1-0",1,0,"1",1,1,1,"H"
1997-04-30,1996,"AS Nancy","FC Nantes","1-3",1,3,"1",1,4,-2,"D"
1997-04-30,1996,"Stade Rennes","FC Metz","1-3",1,3,"1",1,4,-2,"D"
1997-04-30,1996,"SC Bastia","Le Havre AC","1-2",1,2,"1",1,3,-1,"D"
1997-04-30,1996,"Lille OSC","Paris Saint-Germain","0-1",0,1,"1",1,1,-1,"D"
1997-04-30,1996,"Olympique Marseille","AS Cannes","3-1",3,1,"1",1,4,2,"H"
1997-04-30,1996,"OGC Nice","Olympique Lyon","0-1",0,1,"1",1,1,-1,"D"
1997-05-03,1996,"Montpellier HSC","AS Nancy","1-1",1,1,"1",1,2,0,"D"
1997-05-03,1996,"EA Guingamp","FC Nantes","0-0",0,0,"1",1,0,0,"D"
1997-05-03,1996,"AJ Auxerre","Stade Rennes","4-1",4,1,"1",1,5,3,"H"
1997-05-03,1996,"Paris Saint-Germain","Girondins Bordeaux","2-2",2,2,"1",1,4,0,"D"
1997-05-03,1996,"Olympique Lyon","Lille OSC","0-0",0,0,"1",1,0,0,"D"
1997-05-03,1996,"Le Havre AC","OGC Nice","1-0",1,0,"1",1,1,1,"H"
1997-05-03,1996,"FC Metz","SC Bastia","1-0",1,0,"1",1,1,1,"H"
1997-05-03,1996,"RC Lens","Olympique Marseille","2-0",2,0,"1",1,2,2,"H"
1997-05-04,1996,"AS Monaco","SM Caen","2-2",2,2,"1",1,4,0,"D"
1997-05-04,1996,"AS Cannes","RC Strasbourg","2-2",2,2,"1",1,4,0,"D"
1997-05-17,1996,"Lille OSC","Le Havre AC","2-2",2,2,"1",1,4,0,"D"
1997-05-17,1996,"Stade Rennes","EA Guingamp","1-1",1,1,"1",1,2,0,"D"
1997-05-17,1996,"OGC Nice","FC Metz","3-0",3,0,"1",1,3,3,"H"
1997-05-17,1996,"Girondins Bordeaux","Olympique Lyon","2-2",2,2,"1",1,4,0,"D"
1997-05-17,1996,"RC Strasbourg","RC Lens","1-0",1,0,"1",1,1,1,"H"
1997-05-17,1996,"SM Caen","AS Cannes","3-0",3,0,"1",1,3,3,"H"
1997-05-17,1996,"AS Nancy","AS Monaco","1-3",1,3,"1",1,4,-2,"D"
1997-05-17,1996,"FC Nantes","Montpellier HSC","3-0",3,0,"1",1,3,3,"H"
1997-05-17,1996,"Olympique Marseille","Paris Saint-Germain","1-0",1,0,"1",1,1,1,"H"
1997-05-17,1996,"SC Bastia","AJ Auxerre","2-1",2,1,"1",1,3,1,"H"
1997-05-24,1996,"AJ Auxerre","OGC Nice","3-1",3,1,"1",1,4,2,"H"
1997-05-24,1996,"AS Monaco","FC Nantes","2-1",2,1,"1",1,3,1,"H"
1997-05-24,1996,"AS Cannes","AS Nancy","0-1",0,1,"1",1,1,-1,"D"
1997-05-24,1996,"RC Lens","SM Caen","0-0",0,0,"1",1,0,0,"D"
1997-05-24,1996,"Paris Saint-Germain","RC Strasbourg","2-1",2,1,"1",1,3,1,"H"
1997-05-24,1996,"Olympique Lyon","Olympique Marseille","8-0",8,0,"1",1,8,8,"H"
1997-05-24,1996,"FC Metz","Lille OSC","1-0",1,0,"1",1,1,1,"H"
1997-05-24,1996,"Stade Rennes","SC Bastia","1-3",1,3,"1",1,4,-2,"D"
1997-05-24,1996,"Montpellier HSC","EA Guingamp","1-0",1,0,"1",1,1,1,"H"
1997-05-24,1996,"Le Havre AC","Girondins Bordeaux","1-2",1,2,"1",1,3,-1,"D"
1997-08-01,1997,"Toulouse FC","Stade Rennes","1-0",1,0,"1",1,1,1,"H"
1997-08-01,1997,"Girondins Bordeaux","AS Monaco","1-0",1,0,"1",1,1,1,"H"
1997-08-02,1997,"FC Nantes","SC Bastia","0-1",0,1,"1",1,1,-1,"D"
1997-08-02,1997,"EA Guingamp","AS Cannes","3-1",3,1,"1",1,4,2,"H"
1997-08-02,1997,"RC Lens","AJ Auxerre","3-0",3,0,"1",1,3,3,"H"
1997-08-02,1997,"Olympique Lyon","FC Metz","0-1",0,1,"1",1,1,-1,"D"
1997-08-02,1997,"Olympique Marseille","Le Havre AC","3-1",3,1,"1",1,4,2,"H"
1997-08-02,1997,"Montpellier HSC","RC Strasbourg","1-1",1,1,"1",1,2,0,"D"
1997-08-02,1997,"Paris Saint-Germain","LB Chateauroux","2-0",2,0,"1",1,2,2,"H"
1997-08-08,1997,"Stade Rennes","Olympique Lyon","0-3",0,3,"1",1,3,-3,"D"
1997-08-08,1997,"AJ Auxerre","Paris Saint-Germain","2-3",2,3,"1",1,5,-1,"D"
1997-08-09,1997,"SC Bastia","EA Guingamp","1-0",1,0,"1",1,1,1,"H"
1997-08-09,1997,"AS Monaco","LB Chateauroux","2-2",2,2,"1",1,4,0,"D"
1997-08-09,1997,"AS Cannes","Toulouse FC","0-1",0,1,"1",1,1,-1,"D"
1997-08-09,1997,"FC Metz","Girondins Bordeaux","4-1",4,1,"1",1,5,3,"H"
1997-08-09,1997,"Olympique Marseille","FC Nantes","1-0",1,0,"1",1,1,1,"H"
1997-08-09,1997,"Le Havre AC","Montpellier HSC","4-0",4,0,"1",1,4,4,"H"
1997-08-09,1997,"RC Strasbourg","RC Lens","2-1",2,1,"1",1,3,1,"H"
1997-08-15,1997,"RC Lens","Le Havre AC","0-0",0,0,"1",1,0,0,"D"
1997-08-15,1997,"LB Chateauroux","FC Metz","1-2",1,2,"1",1,3,-1,"D"
1997-08-16,1997,"FC Nantes","AJ Auxerre","0-2",0,2,"1",1,2,-2,"D"
1997-08-16,1997,"Girondins Bordeaux","Stade Rennes","2-2",2,2,"1",1,4,0,"D"
1997-08-16,1997,"EA Guingamp","RC Strasbourg","0-0",0,0,"1",1,0,0,"D"
1997-08-16,1997,"Olympique Lyon","AS Monaco","0-3",0,3,"1",1,3,-3,"D"
1997-08-16,1997,"Montpellier HSC","Olympique Marseille","0-0",0,0,"1",1,0,0,"D"
1997-08-16,1997,"Paris Saint-Germain","AS Cannes","3-1",3,1,"1",1,4,2,"H"
1997-08-16,1997,"Toulouse FC","SC Bastia","1-1",1,1,"1",1,2,0,"D"
1997-08-21,1997,"AS Cannes","Girondins Bordeaux","0-2",0,2,"1",1,2,-2,"D"
1997-08-21,1997,"RC Strasbourg","FC Nantes","1-2",1,2,"1",1,3,-1,"D"
1997-08-22,1997,"AJ Auxerre","EA Guingamp","1-0",1,0,"1",1,1,1,"H"
1997-08-22,1997,"FC Metz","Paris Saint-Germain","2-1",2,1,"1",1,3,1,"H"
1997-08-22,1997,"Olympique Marseille","RC Lens","2-3",2,3,"1",1,5,-1,"D"
1997-08-22,1997,"Le Havre AC","Olympique Lyon","1-3",1,3,"1",1,4,-2,"D"
1997-08-22,1997,"Montpellier HSC","Toulouse FC","4-0",4,0,"1",1,4,4,"H"
1997-08-22,1997,"Stade Rennes","AS Monaco","2-1",2,1,"1",1,3,1,"H"
1997-08-22,1997,"SC Bastia","LB Chateauroux","1-1",1,1,"1",1,2,0,"D"
1997-08-29,1997,"AS Monaco","FC Metz","1-2",1,2,"1",1,3,-1,"D"
1997-08-29,1997,"EA Guingamp","Olympique Marseille","1-1",1,1,"1",1,2,0,"D"
1997-08-30,1997,"FC Nantes","Le Havre AC","2-0",2,0,"1",1,2,2,"H"
1997-08-30,1997,"Girondins Bordeaux","AJ Auxerre","3-2",3,2,"1",1,5,1,"H"
1997-08-30,1997,"RC Lens","Montpellier HSC","0-0",0,0,"1",1,0,0,"D"
1997-08-30,1997,"Olympique Lyon","SC Bastia","0-2",0,2,"1",1,2,-2,"D"
1997-08-30,1997,"Paris Saint-Germain","Stade Rennes","4-1",4,1,"1",1,5,3,"H"
1997-08-30,1997,"LB Chateauroux","AS Cannes","1-2",1,2,"1",1,3,-1,"D"
1997-08-30,1997,"Toulouse FC","RC Strasbourg","1-1",1,1,"1",1,2,0,"D"
1997-09-04,1997,"Olympique Marseille","Olympique Lyon","1-0",1,0,"1",1,1,1,"H"
1997-09-04,1997,"Le Havre AC","Toulouse FC","1-1",1,1,"1",1,2,0,"D"
1997-09-05,1997,"SC Bastia","Girondins Bordeaux","4-1",4,1,"1",1,5,3,"H"
1997-09-05,1997,"AS Cannes","AS Monaco","1-2",1,2,"1",1,3,-1,"D"
1997-09-05,1997,"RC Lens","FC Nantes","0-0",0,0,"1",1,0,0,"D"
1997-09-05,1997,"AJ Auxerre","LB Chateauroux","5-0",5,0,"1",1,5,5,"H"
1997-09-05,1997,"Montpellier HSC","EA Guingamp","2-3",2,3,"1",1,5,-1,"D"
1997-09-05,1997,"RC Strasbourg","Paris Saint-Germain","0-3",0,3,"1",1,3,-3,"D"
1997-09-05,1997,"Stade Rennes","FC Metz","2-2",2,2,"1",1,4,0,"D"
1997-09-11,1997,"LB Chateauroux","Stade Rennes","1-0",1,0,"1",1,1,1,"H"
1997-09-11,1997,"EA Guingamp","RC Lens","2-1",2,1,"1",1,3,1,"H"
1997-09-12,1997,"FC Nantes","Montpellier HSC","1-1",1,1,"1",1,2,0,"D"
1997-09-12,1997,"Girondins Bordeaux","Le Havre AC","2-1",2,1,"1",1,3,1,"H"
1997-09-12,1997,"AS Monaco","Olympique Marseille","2-0",2,0,"1",1,2,2,"H"
1997-09-12,1997,"Olympique Lyon","RC Strasbourg","3-1",3,1,"1",1,4,2,"H"
1997-09-12,1997,"FC Metz","AS Cannes","2-0",2,0,"1",1,2,2,"H"
1997-09-12,1997,"Paris Saint-Germain","SC Bastia","2-0",2,0,"1",1,2,2,"H"
1997-09-12,1997,"Toulouse FC","AJ Auxerre","2-1",2,1,"1",1,3,1,"H"
1997-09-20,1997,"EA Guingamp","FC Nantes","1-0",1,0,"1",1,1,1,"H"
1997-09-20,1997,"AS Cannes","Stade Rennes","1-1",1,1,"1",1,2,0,"D"
1997-09-20,1997,"RC Lens","Toulouse FC","2-0",2,0,"1",1,2,2,"H"
1997-09-20,1997,"AJ Auxerre","Olympique Lyon","1-2",1,2,"1",1,3,-1,"D"
1997-09-20,1997,"Olympique Marseille","LB Chateauroux","2-0",2,0,"1",1,2,2,"H"
1997-09-20,1997,"Le Havre AC","Paris Saint-Germain","1-1",1,1,"1",1,2,0,"D"
1997-09-20,1997,"RC Strasbourg","Girondins Bordeaux","0-0",0,0,"1",1,0,0,"D"
1997-09-21,1997,"SC Bastia","FC Metz","0-0",0,0,"1",1,0,0,"D"
1997-09-21,1997,"Montpellier HSC","AS Monaco","0-2",0,2,"1",1,2,-2,"D"
1997-09-25,1997,"Olympique Lyon","RC Lens","1-3",1,3,"1",1,4,-2,"D"
1997-09-25,1997,"Girondins Bordeaux","Olympique Marseille","2-0",2,0,"1",1,2,2,"H"
1997-09-26,1997,"FC Nantes","AS Cannes","1-2",1,2,"1",1,3,-1,"D"
1997-09-26,1997,"AS Monaco","RC Strasbourg","3-2",3,2,"1",1,5,1,"H"
1997-09-26,1997,"FC Metz","AJ Auxerre","3-0",3,0,"1",1,3,3,"H"
1997-09-26,1997,"Paris Saint-Germain","Montpellier HSC","1-1",1,1,"1",1,2,0,"D"
1997-09-26,1997,"Toulouse FC","EA Guingamp","3-0",3,0,"1",1,3,3,"H"
1997-09-26,1997,"Stade Rennes","SC Bastia","2-0",2,0,"1",1,2,2,"H"
1997-09-26,1997,"LB Chateauroux","Le Havre AC","2-1",2,1,"1",1,3,1,"H"
1997-10-04,1997,"SC Bastia","AS Cannes","5-1",5,1,"1",1,6,4,"H"
1997-10-04,1997,"EA Guingamp","Olympique Lyon","0-1",0,1,"1",1,1,-1,"D"
1997-10-04,1997,"RC Lens","LB Chateauroux","1-0",1,0,"1",1,1,1,"H"
1997-10-04,1997,"AJ Auxerre","Stade Rennes","4-0",4,0,"1",1,4,4,"H"
1997-10-04,1997,"Le Havre AC","AS Monaco","1-1",1,1,"1",1,2,0,"D"
1997-10-04,1997,"Montpellier HSC","Girondins Bordeaux","0-1",0,1,"1",1,1,-1,"D"
1997-10-04,1997,"Olympique Marseille","Toulouse FC","2-0",2,0,"1",1,2,2,"H"
1997-10-05,1997,"FC Nantes","Paris Saint-Germain","0-0",0,0,"1",1,0,0,"D"
1997-10-05,1997,"RC Strasbourg","FC Metz","2-0",2,0,"1",1,2,2,"H"
1997-10-07,1997,"AS Cannes","AJ Auxerre","2-3",2,3,"1",1,5,-1,"D"
1997-10-07,1997,"AS Monaco","SC Bastia","1-0",1,0,"1",1,1,1,"H"
1997-10-08,1997,"Girondins Bordeaux","RC Lens","3-0",3,0,"1",1,3,3,"H"
1997-10-08,1997,"Olympique Lyon","Montpellier HSC","1-2",1,2,"1",1,3,-1,"D"
1997-10-08,1997,"FC Metz","Le Havre AC","2-0",2,0,"1",1,2,2,"H"
1997-10-08,1997,"Paris Saint-Germain","EA Guingamp","4-2",4,2,"1",1,6,2,"H"
1997-10-08,1997,"LB Chateauroux","RC Strasbourg","2-0",2,0,"1",1,2,2,"H"
1997-10-08,1997,"Toulouse FC","FC Nantes","1-0",1,0,"1",1,1,1,"H"
1997-10-08,1997,"Stade Rennes","Olympique Marseille","0-2",0,2,"1",1,2,-2,"D"
1997-10-16,1997,"EA Guingamp","Girondins Bordeaux","0-1",0,1,"1",1,1,-1,"D"
1997-10-16,1997,"Olympique Marseille","FC Metz","2-0",2,0,"1",1,2,2,"H"
1997-10-17,1997,"FC Nantes","Olympique Lyon","3-2",3,2,"1",1,5,1,"H"
1997-10-17,1997,"RC Lens","AS Monaco","1-0",1,0,"1",1,1,1,"H"
1997-10-17,1997,"AJ Auxerre","SC Bastia","2-0",2,0,"1",1,2,2,"H"
1997-10-17,1997,"Le Havre AC","Stade Rennes","1-1",1,1,"1",1,2,0,"D"
1997-10-17,1997,"Montpellier HSC","LB Chateauroux","1-0",1,0,"1",1,1,1,"H"
1997-10-17,1997,"RC Strasbourg","AS Cannes","2-0",2,0,"1",1,2,2,"H"
1997-10-17,1997,"Toulouse FC","Paris Saint-Germain","0-2",0,2,"1",1,2,-2,"D"
1997-10-25,1997,"SC Bastia","Olympique Marseille","1-1",1,1,"1",1,2,0,"D"
1997-10-25,1997,"AS Cannes","Le Havre AC","1-1",1,1,"1",1,2,0,"D"
1997-10-25,1997,"Olympique Lyon","Toulouse FC","0-0",0,0,"1",1,0,0,"D"
1997-10-25,1997,"FC Metz","Montpellier HSC","0-1",0,1,"1",1,1,-1,"D"
1997-10-25,1997,"Paris Saint-Germain","RC Lens","2-0",2,0,"1",1,2,2,"H"
1997-10-25,1997,"LB Chateauroux","EA Guingamp","2-2",2,2,"1",1,4,0,"D"
1997-10-25,1997,"Stade Rennes","RC Strasbourg","3-1",3,1,"1",1,4,2,"H"
1997-10-26,1997,"Girondins Bordeaux","FC Nantes","1-1",1,1,"1",1,2,0,"D"
1997-10-26,1997,"AS Monaco","AJ Auxerre","0-1",0,1,"1",1,1,-1,"D"
1997-10-31,1997,"FC Nantes","LB Chateauroux","3-1",3,1,"1",1,4,2,"H"
1997-10-31,1997,"EA Guingamp","AS Monaco","1-2",1,2,"1",1,3,-1,"D"
1997-10-31,1997,"RC Lens","FC Metz","1-1",1,1,"1",1,2,0,"D"
1997-10-31,1997,"Olympique Lyon","Paris Saint-Germain","1-0",1,0,"1",1,1,1,"H"
1997-10-31,1997,"Olympique Marseille","AS Cannes","2-0",2,0,"1",1,2,2,"H"
1997-10-31,1997,"Le Havre AC","SC Bastia","2-1",2,1,"1",1,3,1,"H"
1997-10-31,1997,"RC Strasbourg","AJ Auxerre","1-1",1,1,"1",1,2,0,"D"
1997-11-02,1997,"Montpellier HSC","Stade Rennes","2-0",2,0,"1",1,2,2,"H"
1997-11-02,1997,"Toulouse FC","Girondins Bordeaux","2-2",2,2,"1",1,4,0,"D"
1997-11-08,1997,"Girondins Bordeaux","Olympique Lyon","0-0",0,0,"1",1,0,0,"D"
1997-11-08,1997,"AS Cannes","Montpellier HSC","1-0",1,0,"1",1,1,1,"H"
1997-11-08,1997,"AJ Auxerre","Le Havre AC","0-0",0,0,"1",1,0,0,"D"
1997-11-08,1997,"FC Metz","EA Guingamp","2-1",2,1,"1",1,3,1,"H"
1997-11-08,1997,"LB Chateauroux","Toulouse FC","2-1",2,1,"1",1,3,1,"H"
1997-11-08,1997,"Stade Rennes","RC Lens","2-3",2,3,"1",1,5,-1,"D"
1997-11-08,1997,"SC Bastia","RC Strasbourg","2-0",2,0,"1",1,2,2,"H"
1997-11-09,1997,"AS Monaco","FC Nantes","3-2",3,2,"1",1,5,1,"H"
1997-11-09,1997,"Paris Saint-Germain","Olympique Marseille","1-2",1,2,"1",1,3,-1,"D"
1997-11-14,1997,"Olympique Lyon","LB Chateauroux","2-1",2,1,"1",1,3,1,"H"
1997-11-15,1997,"FC Nantes","FC Metz","1-1",1,1,"1",1,2,0,"D"
1997-11-15,1997,"Girondins Bordeaux","Paris Saint-Germain","0-0",0,0,"1",1,0,0,"D"
1997-11-15,1997,"Olympique Marseille","AJ Auxerre","4-0",4,0,"1",1,4,4,"H"
1997-11-15,1997,"Montpellier HSC","SC Bastia","1-1",1,1,"1",1,2,0,"D"
1997-11-15,1997,"Toulouse FC","AS Monaco","1-3",1,3,"1",1,4,-2,"D"
1997-11-15,1997,"RC Lens","AS Cannes","5-4",5,4,"1",1,9,1,"H"
1997-11-16,1997,"Le Havre AC","RC Strasbourg","1-1",1,1,"1",1,2,0,"D"
1997-11-16,1997,"EA Guingamp","Stade Rennes","1-0",1,0,"1",1,1,1,"H"
1997-11-20,1997,"AJ Auxerre","Montpellier HSC","3-1",3,1,"1",1,4,2,"H"
1997-11-20,1997,"RC Strasbourg","Olympique Marseille","2-0",2,0,"1",1,2,2,"H"
1997-11-20,1997,"AS Monaco","Paris Saint-Germain","3-0",3,0,"1",1,3,3,"H"
1997-11-21,1997,"SC Bastia","RC Lens","1-0",1,0,"1",1,1,1,"H"
1997-11-21,1997,"AS Cannes","Olympique Lyon","1-0",1,0,"1",1,1,1,"H"
1997-11-21,1997,"FC Metz","Toulouse FC","2-1",2,1,"1",1,3,1,"H"
1997-11-21,1997,"Le Havre AC","EA Guingamp","0-0",0,0,"1",1,0,0,"D"
1997-11-21,1997,"LB Chateauroux","Girondins Bordeaux","1-0",1,0,"1",1,1,1,"H"
1997-11-21,1997,"Stade Rennes","FC Nantes","3-0",3,0,"1",1,3,3,"H"
1997-11-29,1997,"FC Nantes","Olympique Marseille","1-0",1,0,"1",1,1,1,"H"
1997-11-29,1997,"EA Guingamp","SC Bastia","0-0",0,0,"1",1,0,0,"D"
1997-11-29,1997,"RC Lens","RC Strasbourg","3-2",3,2,"1",1,5,1,"H"
1997-11-29,1997,"Olympique Lyon","Stade Rennes","3-1",3,1,"1",1,4,2,"H"
1997-11-29,1997,"Montpellier HSC","Le Havre AC","1-1",1,1,"1",1,2,0,"D"
1997-11-29,1997,"LB Chateauroux","AS Monaco","0-2",0,2,"1",1,2,-2,"D"
1997-11-29,1997,"Toulouse FC","AS Cannes","1-0",1,0,"1",1,1,1,"H"
1997-11-30,1997,"Paris Saint-Germain","AJ Auxerre","1-0",1,0,"1",1,1,1,"H"
1997-11-30,1997,"Girondins Bordeaux","FC Metz","2-2",2,2,"1",1,4,0,"D"
1997-12-04,1997,"AJ Auxerre","FC Nantes","3-1",3,1,"1",1,4,2,"H"
1997-12-05,1997,"AS Monaco","Olympique Lyon","2-1",2,1,"1",1,3,1,"H"
1997-12-05,1997,"AS Cannes","Paris Saint-Germain","0-1",0,1,"1",1,1,-1,"D"
1997-12-05,1997,"FC Metz","LB Chateauroux","2-0",2,0,"1",1,2,2,"H"
1997-12-06,1997,"Le Havre AC","RC Lens","0-1",0,1,"1",1,1,-1,"D"
1997-12-06,1997,"RC Strasbourg","EA Guingamp","0-1",0,1,"1",1,1,-1,"D"
1997-12-06,1997,"Stade Rennes","Girondins Bordeaux","0-0",0,0,"1",1,0,0,"D"
1997-12-07,1997,"SC Bastia","Toulouse FC","0-0",0,0,"1",1,0,0,"D"
1997-12-07,1997,"Olympique Marseille","Montpellier HSC","0-0",0,0,"1",1,0,0,"D"
1997-12-13,1997,"RC Lens","Olympique Marseille","0-1",0,1,"1",1,1,-1,"D"
1997-12-13,1997,"FC Nantes","RC Strasbourg","2-1",2,1,"1",1,3,1,"H"
1997-12-13,1997,"Girondins Bordeaux","AS Cannes","0-1",0,1,"1",1,1,-1,"D"
1997-12-13,1997,"EA Guingamp","AJ Auxerre","1-1",1,1,"1",1,2,0,"D"
1997-12-13,1997,"Olympique Lyon","Le Havre AC","0-1",0,1,"1",1,1,-1,"D"
1997-12-13,1997,"Toulouse FC","Montpellier HSC","1-1",1,1,"1",1,2,0,"D"
1997-12-13,1997,"LB Chateauroux","SC Bastia","1-1",1,1,"1",1,2,0,"D"
1997-12-14,1997,"AS Monaco","Stade Rennes","1-0",1,0,"1",1,1,1,"H"
1997-12-14,1997,"Paris Saint-Germain","FC Metz","1-1",1,1,"1",1,2,0,"D"
1997-12-19,1997,"SC Bastia","Olympique Lyon","0-1",0,1,"1",1,1,-1,"D"
1997-12-19,1997,"AJ Auxerre","Girondins Bordeaux","4-2",4,2,"1",1,6,2,"H"
1997-12-19,1997,"FC Metz","AS Monaco","3-0",3,0,"1",1,3,3,"H"
1997-12-19,1997,"Le Havre AC","FC Nantes","1-0",1,0,"1",1,1,1,"H"
1997-12-19,1997,"Montpellier HSC","RC Lens","1-2",1,2,"1",1,3,-1,"D"
1997-12-19,1997,"RC Strasbourg","Toulouse FC","2-0",2,0,"1",1,2,2,"H"
1997-12-19,1997,"Stade Rennes","Paris Saint-Germain","1-2",1,2,"1",1,3,-1,"D"
1997-12-19,1997,"AS Cannes","LB Chateauroux","2-2",2,2,"1",1,4,0,"D"
1998-01-10,1997,"Girondins Bordeaux","SC Bastia","2-0",2,0,"1",1,2,2,"H"
1998-01-10,1997,"AS Monaco","AS Cannes","0-1",0,1,"1",1,1,-1,"D"
1998-01-10,1997,"EA Guingamp","Montpellier HSC","1-2",1,2,"1",1,3,-1,"D"
1998-01-10,1997,"Olympique Lyon","Olympique Marseille","2-1",2,1,"1",1,3,1,"H"
1998-01-10,1997,"FC Metz","Stade Rennes","1-0",1,0,"1",1,1,1,"H"
1998-01-10,1997,"LB Chateauroux","AJ Auxerre","3-2",3,2,"1",1,5,1,"H"
1998-01-10,1997,"Toulouse FC","Le Havre AC","1-0",1,0,"1",1,1,1,"H"
1998-01-11,1997,"FC Nantes","RC Lens","1-0",1,0,"1",1,1,1,"H"
1998-01-11,1997,"Paris Saint-Germain","RC Strasbourg","2-1",2,1,"1",1,3,1,"H"
1998-01-14,1997,"Olympique Marseille","EA Guingamp","3-0",3,0,"1",1,3,3,"H"
1998-01-20,1997,"AS Cannes","FC Metz","1-1",1,1,"1",1,2,0,"D"
1998-01-20,1997,"Olympique Marseille","AS Monaco","1-1",1,1,"1",1,2,0,"D"
1998-01-21,1997,"SC Bastia","Paris Saint-Germain","2-0",2,0,"1",1,2,2,"H"
1998-01-21,1997,"RC Lens","EA Guingamp","1-0",1,0,"1",1,1,1,"H"
1998-01-21,1997,"AJ Auxerre","Toulouse FC","3-1",3,1,"1",1,4,2,"H"
1998-01-21,1997,"Le Havre AC","Girondins Bordeaux","0-0",0,0,"1",1,0,0,"D"
1998-01-21,1997,"Montpellier HSC","FC Nantes","2-0",2,0,"1",1,2,2,"H"
1998-01-21,1997,"RC Strasbourg","Olympique Lyon","1-2",1,2,"1",1,3,-1,"D"
1998-01-21,1997,"Stade Rennes","LB Chateauroux","3-0",3,0,"1",1,3,3,"H"
1998-01-24,1997,"FC Nantes","EA Guingamp","2-0",2,0,"1",1,2,2,"H"
1998-01-24,1997,"Girondins Bordeaux","RC Strasbourg","4-4",4,4,"1",1,8,0,"D"
1998-01-24,1997,"AS Monaco","Montpellier HSC","4-0",4,0,"1",1,4,4,"H"
1998-01-24,1997,"Olympique Lyon","AJ Auxerre","1-0",1,0,"1",1,1,1,"H"
1998-01-24,1997,"FC Metz","SC Bastia","0-1",0,1,"1",1,1,-1,"D"
1998-01-24,1997,"Paris Saint-Germain","Le Havre AC","0-2",0,2,"1",1,2,-2,"D"
1998-01-24,1997,"LB Chateauroux","Olympique Marseille","0-3",0,3,"1",1,3,-3,"D"
1998-01-24,1997,"Toulouse FC","RC Lens","1-2",1,2,"1",1,3,-1,"D"
1998-01-24,1997,"Stade Rennes","AS Cannes","2-0",2,0,"1",1,2,2,"H"
1998-02-03,1997,"SC Bastia","Stade Rennes","0-0",0,0,"1",1,0,0,"D"
1998-02-03,1997,"RC Strasbourg","AS Monaco","0-0",0,0,"1",1,0,0,"D"
1998-02-04,1997,"EA Guingamp","Toulouse FC","2-0",2,0,"1",1,2,2,"H"
1998-02-04,1997,"RC Lens","Olympique Lyon","3-0",3,0,"1",1,3,3,"H"
1998-02-04,1997,"AJ Auxerre","FC Metz","0-0",0,0,"1",1,0,0,"D"
1998-02-04,1997,"Olympique Marseille","Girondins Bordeaux","1-0",1,0,"1",1,1,1,"H"
1998-02-04,1997,"Montpellier HSC","Paris Saint-Germain","2-1",2,1,"1",1,3,1,"H"
1998-02-05,1997,"AS Cannes","FC Nantes","2-3",2,3,"1",1,5,-1,"D"
1998-02-05,1997,"Le Havre AC","LB Chateauroux","5-0",5,0,"1",1,5,5,"H"
1998-02-12,1997,"LB Chateauroux","RC Lens","2-1",2,1,"1",1,3,1,"H"
1998-02-12,1997,"Stade Rennes","AJ Auxerre","1-1",1,1,"1",1,2,0,"D"
1998-02-13,1997,"Girondins Bordeaux","Montpellier HSC","3-1",3,1,"1",1,4,2,"H"
1998-02-13,1997,"AS Monaco","Le Havre AC","2-0",2,0,"1",1,2,2,"H"
1998-02-13,1997,"AS Cannes","SC Bastia","1-1",1,1,"1",1,2,0,"D"
1998-02-13,1997,"Olympique Lyon","EA Guingamp","1-0",1,0,"1",1,1,1,"H"
1998-02-13,1997,"FC Metz","RC Strasbourg","1-0",1,0,"1",1,1,1,"H"
1998-02-13,1997,"Paris Saint-Germain","FC Nantes","0-1",0,1,"1",1,1,-1,"D"
1998-02-13,1997,"Toulouse FC","Olympique Marseille","0-4",0,4,"1",1,4,-4,"D"
1998-02-20,1997,"SC Bastia","AS Monaco","1-0",1,0,"1",1,1,1,"H"
1998-02-20,1997,"RC Strasbourg","LB Chateauroux","2-0",2,0,"1",1,2,2,"H"
1998-02-21,1997,"FC Nantes","Toulouse FC","0-1",0,1,"1",1,1,-1,"D"
1998-02-21,1997,"EA Guingamp","Paris Saint-Germain","0-0",0,0,"1",1,0,0,"D"
1998-02-21,1997,"AJ Auxerre","AS Cannes","1-1",1,1,"1",1,2,0,"D"
1998-02-21,1997,"Olympique Marseille","Stade Rennes","0-1",0,1,"1",1,1,-1,"D"
1998-02-21,1997,"Montpellier HSC","Olympique Lyon","1-1",1,1,"1",1,2,0,"D"
1998-02-21,1997,"RC Lens","Girondins Bordeaux","1-0",1,0,"1",1,1,1,"H"
1998-02-21,1997,"Le Havre AC","FC Metz","2-1",2,1,"1",1,3,1,"H"
1998-03-07,1997,"SC Bastia","AJ Auxerre","1-2",1,2,"1",1,3,-1,"D"
1998-03-07,1997,"Girondins Bordeaux","EA Guingamp","4-2",4,2,"1",1,6,2,"H"
1998-03-07,1997,"AS Monaco","RC Lens","0-1",0,1,"1",1,1,-1,"D"
1998-03-07,1997,"AS Cannes","RC Strasbourg","1-0",1,0,"1",1,1,1,"H"
1998-03-07,1997,"Olympique Lyon","FC Nantes","0-0",0,0,"1",1,0,0,"D"
1998-03-07,1997,"FC Metz","Olympique Marseille","3-2",3,2,"1",1,5,1,"H"
1998-03-07,1997,"Paris Saint-Germain","Toulouse FC","1-1",1,1,"1",1,2,0,"D"
1998-03-07,1997,"LB Chateauroux","Montpellier HSC","0-1",0,1,"1",1,1,-1,"D"
1998-03-07,1997,"Stade Rennes","Le Havre AC","2-2",2,2,"1",1,4,0,"D"
1998-03-13,1997,"FC Nantes","Girondins Bordeaux","1-2",1,2,"1",1,3,-1,"D"
1998-03-13,1997,"EA Guingamp","LB Chateauroux","0-0",0,0,"1",1,0,0,"D"
1998-03-13,1997,"AJ Auxerre","AS Monaco","3-1",3,1,"1",1,4,2,"H"
1998-03-13,1997,"Le Havre AC","AS Cannes","2-0",2,0,"1",1,2,2,"H"
1998-03-13,1997,"Montpellier HSC","FC Metz","0-1",0,1,"1",1,1,-1,"D"
1998-03-13,1997,"RC Strasbourg","Stade Rennes","3-1",3,1,"1",1,4,2,"H"
1998-03-13,1997,"Toulouse FC","Olympique Lyon","0-2",0,2,"1",1,2,-2,"D"
1998-03-15,1997,"RC Lens","Paris Saint-Germain","3-0",3,0,"1",1,3,3,"H"
1998-03-15,1997,"Olympique Marseille","SC Bastia","1-0",1,0,"1",1,1,1,"H"
1998-03-28,1997,"SC Bastia","Le Havre AC","2-0",2,0,"1",1,2,2,"H"
1998-03-28,1997,"Girondins Bordeaux","Toulouse FC","3-1",3,1,"1",1,4,2,"H"
1998-03-28,1997,"AS Monaco","EA Guingamp","1-0",1,0,"1",1,1,1,"H"
1998-03-28,1997,"Paris Saint-Germain","Olympique Lyon","3-0",3,0,"1",1,3,3,"H"
1998-03-28,1997,"LB Chateauroux","FC Nantes","1-2",1,2,"1",1,3,-1,"D"
1998-03-28,1997,"Stade Rennes","Montpellier HSC","2-0",2,0,"1",1,2,2,"H"
1998-03-28,1997,"AJ Auxerre","RC Strasbourg","1-2",1,2,"1",1,3,-1,"D"
1998-03-29,1997,"AS Cannes","Olympique Marseille","3-3",3,3,"1",1,6,0,"D"
1998-03-29,1997,"FC Metz","RC Lens","0-2",0,2,"1",1,2,-2,"D"
1998-04-07,1997,"FC Nantes","AS Monaco","1-1",1,1,"1",1,2,0,"D"
1998-04-07,1997,"RC Lens","Stade Rennes","3-0",3,0,"1",1,3,3,"H"
1998-04-07,1997,"Olympique Lyon","Girondins Bordeaux","1-1",1,1,"1",1,2,0,"D"
1998-04-07,1997,"Le Havre AC","AJ Auxerre","2-2",2,2,"1",1,4,0,"D"
1998-04-07,1997,"Montpellier HSC","AS Cannes","1-0",1,0,"1",1,1,1,"H"
1998-04-07,1997,"RC Strasbourg","SC Bastia","1-1",1,1,"1",1,2,0,"D"
1998-04-07,1997,"Toulouse FC","LB Chateauroux","1-1",1,1,"1",1,2,0,"D"
1998-04-08,1997,"Olympique Marseille","Paris Saint-Germain","0-0",0,0,"1",1,0,0,"D"
1998-04-08,1997,"EA Guingamp","FC Metz","0-1",0,1,"1",1,1,-1,"D"
1998-04-17,1997,"FC Metz","FC Nantes","3-2",3,2,"1",1,5,1,"H"
1998-04-17,1997,"AS Cannes","RC Lens","0-2",0,2,"1",1,2,-2,"D"
1998-04-18,1997,"AS Monaco","Toulouse FC","0-1",0,1,"1",1,1,-1,"D"
1998-04-18,1997,"AJ Auxerre","Olympique Marseille","2-1",2,1,"1",1,3,1,"H"
1998-04-18,1997,"RC Strasbourg","Le Havre AC","0-1",0,1,"1",1,1,-1,"D"
1998-04-18,1997,"Paris Saint-Germain","Girondins Bordeaux","0-1",0,1,"1",1,1,-1,"D"
1998-04-18,1997,"LB Chateauroux","Olympique Lyon","2-3",2,3,"1",1,5,-1,"D"
1998-04-18,1997,"Stade Rennes","EA Guingamp","1-2",1,2,"1",1,3,-1,"D"
1998-04-18,1997,"SC Bastia","Montpellier HSC","2-1",2,1,"1",1,3,1,"H"
1998-04-25,1997,"FC Nantes","Stade Rennes","1-1",1,1,"1",1,2,0,"D"
1998-04-25,1997,"Girondins Bordeaux","LB Chateauroux","1-0",1,0,"1",1,1,1,"H"
1998-04-25,1997,"EA Guingamp","Le Havre AC","1-2",1,2,"1",1,3,-1,"D"
1998-04-25,1997,"RC Lens","SC Bastia","5-1",5,1,"1",1,6,4,"H"
1998-04-25,1997,"Olympique Lyon","AS Cannes","2-0",2,0,"1",1,2,2,"H"
1998-04-25,1997,"Olympique Marseille","RC Strasbourg","0-0",0,0,"1",1,0,0,"D"
1998-04-25,1997,"Montpellier HSC","AJ Auxerre","1-1",1,1,"1",1,2,0,"D"
1998-04-25,1997,"Paris Saint-Germain","AS Monaco","1-2",1,2,"1",1,3,-1,"D"
1998-04-25,1997,"Toulouse FC","FC Metz","0-1",0,1,"1",1,1,-1,"D"
1998-05-09,1997,"SC Bastia","FC Nantes","2-1",2,1,"1",1,3,1,"H"
1998-05-09,1997,"AS Monaco","Girondins Bordeaux","5-2",5,2,"1",1,7,3,"H"
1998-05-09,1997,"AS Cannes","EA Guingamp","1-3",1,3,"1",1,4,-2,"D"
1998-05-09,1997,"AJ Auxerre","RC Lens","1-1",1,1,"1",1,2,0,"D"
1998-05-09,1997,"FC Metz","Olympique Lyon","1-0",1,0,"1",1,1,1,"H"
1998-05-09,1997,"Le Havre AC","Olympique Marseille","1-1",1,1,"1",1,2,0,"D"
1998-05-09,1997,"RC Strasbourg","Montpellier HSC","3-0",3,0,"1",1,3,3,"H"
1998-05-09,1997,"LB Chateauroux","Paris Saint-Germain","2-1",2,1,"1",1,3,1,"H"
1998-05-09,1997,"Stade Rennes","Toulouse FC","1-0",1,0,"1",1,1,1,"H"
1998-08-07,1998,"Le Havre AC","FC Metz","0-0",0,0,"1",1,0,0,"D"
1998-08-07,1998,"Stade Rennes","AJ Auxerre","1-0",1,0,"1",1,1,1,"H"
1998-08-07,1998,"FC Lorient","AS Monaco","1-2",1,2,"1",1,3,-1,"D"
1998-08-08,1998,"Olympique Marseille","FC Nantes","2-0",2,0,"1",1,2,2,"H"
1998-08-08,1998,"SC Bastia","Montpellier HSC","2-2",2,2,"1",1,4,0,"D"
1998-08-08,1998,"Girondins Bordeaux","Paris Saint-Germain","3-1",3,1,"1",1,4,2,"H"
1998-08-08,1998,"RC Strasbourg","Olympique Lyon","0-0",0,0,"1",1,0,0,"D"
1998-08-08,1998,"Toulouse FC","RC Lens","3-2",3,2,"1",1,5,1,"H"
1998-08-08,1998,"AS Nancy","FC Sochaux","1-1",1,1,"1",1,2,0,"D"
1998-08-14,1998,"RC Lens","FC Lorient","1-1",1,1,"1",1,2,0,"D"
1998-08-14,1998,"Olympique Lyon","Toulouse FC","6-1",6,1,"1",1,7,5,"H"
1998-08-15,1998,"Le Havre AC","Girondins Bordeaux","2-3",2,3,"1",1,5,-1,"D"
1998-08-15,1998,"AS Monaco","FC Sochaux","4-1",4,1,"1",1,5,3,"H"
1998-08-15,1998,"Paris Saint-Germain","SC Bastia","2-0",2,0,"1",1,2,2,"H"
1998-08-15,1998,"FC Nantes","RC Strasbourg","1-0",1,0,"1",1,1,1,"H"
1998-08-15,1998,"AJ Auxerre","AS Nancy","3-2",3,2,"1",1,5,1,"H"
1998-08-15,1998,"Montpellier HSC","Stade Rennes","3-1",3,1,"1",1,4,2,"H"
1998-08-15,1998,"FC Metz","Olympique Marseille","0-1",0,1,"1",1,1,-1,"D"
1998-08-22,1998,"Stade Rennes","Le Havre AC","2-1",2,1,"1",1,3,1,"H"
1998-08-22,1998,"Olympique Marseille","Montpellier HSC","5-4",5,4,"1",1,9,1,"H"
1998-08-22,1998,"Girondins Bordeaux","AJ Auxerre","1-0",1,0,"1",1,1,1,"H"
1998-08-22,1998,"RC Strasbourg","Paris Saint-Germain","0-1",0,1,"1",1,1,-1,"D"
1998-08-22,1998,"Toulouse FC","AS Monaco","0-0",0,0,"1",1,0,0,"D"
1998-08-22,1998,"FC Lorient","Olympique Lyon","0-1",0,1,"1",1,1,-1,"D"
1998-08-22,1998,"SC Bastia","FC Metz","3-0",3,0,"1",1,3,3,"H"
1998-08-23,1998,"FC Sochaux","RC Lens","0-4",0,4,"1",1,4,-4,"D"
1998-08-23,1998,"AS Nancy","FC Nantes","1-0",1,0,"1",1,1,1,"H"
1998-08-29,1998,"Le Havre AC","Olympique Marseille","0-0",0,0,"1",1,0,0,"D"
1998-08-29,1998,"RC Lens","AS Nancy","2-1",2,1,"1",1,3,1,"H"
1998-08-29,1998,"Olympique Lyon","AS Monaco","1-1",1,1,"1",1,2,0,"D"
1998-08-29,1998,"Paris Saint-Germain","FC Lorient","1-2",1,2,"1",1,3,-1,"D"
1998-08-29,1998,"FC Nantes","FC Sochaux","2-0",2,0,"1",1,2,2,"H"
1998-08-29,1998,"Montpellier HSC","Toulouse FC","3-0",3,0,"1",1,3,3,"H"
1998-08-29,1998,"FC Metz","Girondins Bordeaux","0-2",0,2,"1",1,2,-2,"D"
1998-08-30,1998,"Stade Rennes","RC Strasbourg","1-1",1,1,"1",1,2,0,"D"
1998-08-30,1998,"AJ Auxerre","SC Bastia","1-0",1,0,"1",1,1,1,"H"
1998-09-10,1998,"AS Monaco","RC Lens","2-0",2,0,"1",1,2,2,"H"
1998-09-10,1998,"FC Lorient","AJ Auxerre","1-1",1,1,"1",1,2,0,"D"
1998-09-11,1998,"FC Sochaux","Olympique Lyon","1-2",1,2,"1",1,3,-1,"D"
1998-09-11,1998,"Olympique Marseille","Stade Rennes","1-1",1,1,"1",1,2,0,"D"
1998-09-11,1998,"SC Bastia","Le Havre AC","2-0",2,0,"1",1,2,2,"H"
1998-09-11,1998,"Girondins Bordeaux","Montpellier HSC","3-1",3,1,"1",1,4,2,"H"
1998-09-11,1998,"RC Strasbourg","FC Metz","0-0",0,0,"1",1,0,0,"D"
1998-09-11,1998,"Toulouse FC","FC Nantes","2-3",2,3,"1",1,5,-1,"D"
1998-09-11,1998,"AS Nancy","Paris Saint-Germain","0-0",0,0,"1",1,0,0,"D"
1998-09-19,1998,"Le Havre AC","RC Strasbourg","0-1",0,1,"1",1,1,-1,"D"
1998-09-19,1998,"Stade Rennes","SC Bastia","2-0",2,0,"1",1,2,2,"H"
1998-09-19,1998,"Olympique Lyon","RC Lens","3-1",3,1,"1",1,4,2,"H"
1998-09-19,1998,"FC Nantes","FC Lorient","1-1",1,1,"1",1,2,0,"D"
1998-09-19,1998,"AJ Auxerre","FC Sochaux","3-1",3,1,"1",1,4,2,"H"
1998-09-19,1998,"Montpellier HSC","AS Nancy","1-1",1,1,"1",1,2,0,"D"
1998-09-19,1998,"FC Metz","Toulouse FC","0-0",0,0,"1",1,0,0,"D"
1998-09-20,1998,"Olympique Marseille","Girondins Bordeaux","2-2",2,2,"1",1,4,0,"D"
1998-09-20,1998,"Paris Saint-Germain","AS Monaco","1-0",1,0,"1",1,1,1,"H"
1998-09-24,1998,"SC Bastia","Olympique Marseille","0-2",0,2,"1",1,2,-2,"D"
1998-09-24,1998,"Toulouse FC","AJ Auxerre","0-0",0,0,"1",1,0,0,"D"
1998-09-25,1998,"FC Sochaux","Paris Saint-Germain","1-0",1,0,"1",1,1,1,"H"
1998-09-25,1998,"AS Monaco","Le Havre AC","3-0",3,0,"1",1,3,3,"H"
1998-09-25,1998,"RC Lens","FC Nantes","2-4",2,4,"1",1,6,-2,"D"
1998-09-25,1998,"Girondins Bordeaux","Stade Rennes","4-0",4,0,"1",1,4,4,"H"
1998-09-25,1998,"RC Strasbourg","Montpellier HSC","2-1",2,1,"1",1,3,1,"H"
1998-09-25,1998,"FC Lorient","FC Metz","1-1",1,1,"1",1,2,0,"D"
1998-09-25,1998,"AS Nancy","Olympique Lyon","0-0",0,0,"1",1,0,0,"D"
1998-10-03,1998,"Le Havre AC","FC Sochaux","3-0",3,0,"1",1,3,3,"H"
1998-10-03,1998,"Stade Rennes","AS Monaco","2-1",2,1,"1",1,3,1,"H"
1998-10-03,1998,"Olympique Marseille","Toulouse FC","2-0",2,0,"1",1,2,2,"H"
1998-10-03,1998,"SC Bastia","Girondins Bordeaux","2-0",2,0,"1",1,2,2,"H"
1998-10-03,1998,"FC Nantes","Olympique Lyon","2-0",2,0,"1",1,2,2,"H"
1998-10-03,1998,"AJ Auxerre","RC Strasbourg","3-1",3,1,"1",1,4,2,"H"
1998-10-03,1998,"Montpellier HSC","FC Lorient","5-1",5,1,"1",1,6,4,"H"
1998-10-04,1998,"Paris Saint-Germain","RC Lens","0-1",0,1,"1",1,1,-1,"D"
1998-10-04,1998,"FC Metz","AS Nancy","2-3",2,3,"1",1,5,-1,"D"
1998-10-16,1998,"Olympique Lyon","Paris Saint-Germain","1-1",1,1,"1",1,2,0,"D"
1998-10-16,1998,"Girondins Bordeaux","FC Nantes","2-0",2,0,"1",1,2,2,"H"
1998-10-16,1998,"RC Strasbourg","Olympique Marseille","0-2",0,2,"1",1,2,-2,"D"
1998-10-17,1998,"FC Sochaux","FC Metz","1-1",1,1,"1",1,2,0,"D"
1998-10-17,1998,"AS Monaco","Montpellier HSC","2-0",2,0,"1",1,2,2,"H"
1998-10-17,1998,"RC Lens","AJ Auxerre","2-2",2,2,"1",1,4,0,"D"
1998-10-17,1998,"FC Lorient","Le Havre AC","0-0",0,0,"1",1,0,0,"D"
1998-10-17,1998,"AS Nancy","Stade Rennes","0-1",0,1,"1",1,1,-1,"D"
1998-10-18,1998,"Toulouse FC","SC Bastia","2-1",2,1,"1",1,3,1,"H"
1998-10-24,1998,"Le Havre AC","Toulouse FC","0-0",0,0,"1",1,0,0,"D"
1998-10-24,1998,"Stade Rennes","FC Lorient","1-0",1,0,"1",1,1,1,"H"
1998-10-24,1998,"Olympique Marseille","FC Sochaux","4-0",4,0,"1",1,4,4,"H"
1998-10-24,1998,"SC Bastia","RC Strasbourg","0-0",0,0,"1",1,0,0,"D"
1998-10-24,1998,"FC Nantes","Paris Saint-Germain","0-0",0,0,"1",1,0,0,"D"
1998-10-24,1998,"AJ Auxerre","Olympique Lyon","1-0",1,0,"1",1,1,1,"H"
1998-10-24,1998,"FC Metz","AS Monaco","1-0",1,0,"1",1,1,1,"H"
1998-10-25,1998,"Girondins Bordeaux","AS Nancy","2-0",2,0,"1",1,2,2,"H"
1998-10-25,1998,"Montpellier HSC","RC Lens","1-0",1,0,"1",1,1,1,"H"
1998-10-29,1998,"AS Monaco","FC Nantes","3-1",3,1,"1",1,4,2,"H"
1998-10-29,1998,"Olympique Lyon","Le Havre AC","0-0",0,0,"1",1,0,0,"D"
1998-10-29,1998,"FC Lorient","Olympique Marseille","1-3",1,3,"1",1,4,-2,"D"
1998-10-30,1998,"RC Lens","FC Metz","2-0",2,0,"1",1,2,2,"H"
1998-10-30,1998,"Paris Saint-Germain","AJ Auxerre","2-0",2,0,"1",1,2,2,"H"
1998-10-30,1998,"RC Strasbourg","Girondins Bordeaux","3-2",3,2,"1",1,5,1,"H"
1998-10-30,1998,"Toulouse FC","Stade Rennes","0-1",0,1,"1",1,1,-1,"D"
1998-10-30,1998,"AS Nancy","SC Bastia","1-2",1,2,"1",1,3,-1,"D"
1998-10-31,1998,"FC Sochaux","Montpellier HSC","4-0",4,0,"1",1,4,4,"H"
1998-11-06,1998,"Olympique Marseille","AS Monaco","1-0",1,0,"1",1,1,1,"H"
1998-11-06,1998,"SC Bastia","FC Lorient","2-1",2,1,"1",1,3,1,"H"
1998-11-07,1998,"Le Havre AC","RC Lens","3-1",3,1,"1",1,4,2,"H"
1998-11-07,1998,"Stade Rennes","FC Sochaux","4-0",4,0,"1",1,4,4,"H"
1998-11-07,1998,"Girondins Bordeaux","Toulouse FC","3-1",3,1,"1",1,4,2,"H"
1998-11-07,1998,"RC Strasbourg","AS Nancy","1-2",1,2,"1",1,3,-1,"D"
1998-11-07,1998,"AJ Auxerre","FC Nantes","1-1",1,1,"1",1,2,0,"D"
1998-11-07,1998,"Montpellier HSC","Paris Saint-Germain","2-1",2,1,"1",1,3,1,"H"
1998-11-07,1998,"FC Metz","Olympique Lyon","3-2",3,2,"1",1,5,1,"H"
1998-11-10,1998,"FC Nantes","Le Havre AC","1-1",1,1,"1",1,2,0,"D"
1998-11-10,1998,"AS Nancy","Olympique Marseille","2-3",2,3,"1",1,5,-1,"D"
1998-11-11,1998,"FC Sochaux","SC Bastia","2-1",2,1,"1",1,3,1,"H"
1998-11-11,1998,"AS Monaco","AJ Auxerre","3-2",3,2,"1",1,5,1,"H"
1998-11-11,1998,"RC Lens","Stade Rennes","3-1",3,1,"1",1,4,2,"H"
1998-11-11,1998,"Olympique Lyon","Montpellier HSC","2-0",2,0,"1",1,2,2,"H"
1998-11-11,1998,"Paris Saint-Germain","FC Metz","2-2",2,2,"1",1,4,0,"D"
1998-11-11,1998,"Toulouse FC","RC Strasbourg","0-1",0,1,"1",1,1,-1,"D"
1998-11-11,1998,"FC Lorient","Girondins Bordeaux","0-2",0,2,"1",1,2,-2,"D"
1998-11-14,1998,"Stade Rennes","Olympique Lyon","0-0",0,0,"1",1,0,0,"D"
1998-11-14,1998,"Olympique Marseille","RC Lens","1-0",1,0,"1",1,1,1,"H"
1998-11-14,1998,"SC Bastia","AS Monaco","3-1",3,1,"1",1,4,2,"H"
1998-11-14,1998,"Girondins Bordeaux","FC Sochaux","0-0",0,0,"1",1,0,0,"D"
1998-11-14,1998,"Toulouse FC","AS Nancy","1-1",1,1,"1",1,2,0,"D"
1998-11-14,1998,"Montpellier HSC","AJ Auxerre","3-0",3,0,"1",1,3,3,"H"
1998-11-14,1998,"FC Metz","FC Nantes","1-0",1,0,"1",1,1,1,"H"
1998-11-15,1998,"Le Havre AC","Paris Saint-Germain","0-4",0,4,"1",1,4,-4,"D"
1998-11-15,1998,"RC Strasbourg","FC Lorient","2-0",2,0,"1",1,2,2,"H"
1998-11-19,1998,"AS Monaco","Girondins Bordeaux","0-2",0,2,"1",1,2,-2,"D"
1998-11-19,1998,"Olympique Lyon","Olympique Marseille","2-1",2,1,"1",1,3,1,"H"
1998-11-20,1998,"FC Sochaux","RC Strasbourg","1-1",1,1,"1",1,2,0,"D"
1998-11-20,1998,"RC Lens","SC Bastia","1-0",1,0,"1",1,1,1,"H"
1998-11-20,1998,"Paris Saint-Germain","Stade Rennes","2-1",2,1,"1",1,3,1,"H"
1998-11-20,1998,"FC Nantes","Montpellier HSC","1-1",1,1,"1",1,2,0,"D"
1998-11-20,1998,"AJ Auxerre","FC Metz","1-0",1,0,"1",1,1,1,"H"
1998-11-20,1998,"FC Lorient","Toulouse FC","1-0",1,0,"1",1,1,1,"H"
1998-11-20,1998,"AS Nancy","Le Havre AC","1-0",1,0,"1",1,1,1,"H"
1998-11-28,1998,"Le Havre AC","AJ Auxerre","2-1",2,1,"1",1,3,1,"H"
1998-11-28,1998,"Stade Rennes","FC Nantes","2-3",2,3,"1",1,5,-1,"D"
1998-11-28,1998,"SC Bastia","Olympique Lyon","4-1",4,1,"1",1,5,3,"H"
1998-11-28,1998,"RC Strasbourg","AS Monaco","1-1",1,1,"1",1,2,0,"D"
1998-11-28,1998,"Toulouse FC","FC Sochaux","1-1",1,1,"1",1,2,0,"D"
1998-11-28,1998,"FC Lorient","AS Nancy","0-1",0,1,"1",1,1,-1,"D"
1998-11-28,1998,"FC Metz","Montpellier HSC","3-1",3,1,"1",1,4,2,"H"
1998-11-29,1998,"Olympique Marseille","Paris Saint-Germain","0-0",0,0,"1",1,0,0,"D"
1998-11-29,1998,"Girondins Bordeaux","RC Lens","1-0",1,0,"1",1,1,1,"H"
1998-12-03,1998,"AS Monaco","AS Nancy","3-0",3,0,"1",1,3,3,"H"
1998-12-03,1998,"Olympique Lyon","Girondins Bordeaux","2-1",2,1,"1",1,3,1,"H"
1998-12-03,1998,"AJ Auxerre","Olympique Marseille","1-1",1,1,"1",1,2,0,"D"
1998-12-04,1998,"FC Sochaux","FC Lorient","0-1",0,1,"1",1,1,-1,"D"
1998-12-04,1998,"RC Lens","RC Strasbourg","3-0",3,0,"1",1,3,3,"H"
1998-12-04,1998,"Paris Saint-Germain","Toulouse FC","0-0",0,0,"1",1,0,0,"D"
1998-12-04,1998,"FC Nantes","SC Bastia","2-0",2,0,"1",1,2,2,"H"
1998-12-04,1998,"Montpellier HSC","Le Havre AC","2-0",2,0,"1",1,2,2,"H"
1998-12-04,1998,"FC Metz","Stade Rennes","0-0",0,0,"1",1,0,0,"D"
1998-12-11,1998,"Stade Rennes","Montpellier HSC","3-2",3,2,"1",1,5,1,"H"
1998-12-11,1998,"RC Strasbourg","FC Nantes","2-2",2,2,"1",1,4,0,"D"
1998-12-12,1998,"Olympique Marseille","FC Metz","3-0",3,0,"1",1,3,3,"H"
1998-12-12,1998,"SC Bastia","Paris Saint-Germain","2-0",2,0,"1",1,2,2,"H"
1998-12-12,1998,"Girondins Bordeaux","Le Havre AC","3-0",3,0,"1",1,3,3,"H"
1998-12-12,1998,"Toulouse FC","Olympique Lyon","0-0",0,0,"1",1,0,0,"D"
1998-12-12,1998,"FC Lorient","RC Lens","1-1",1,1,"1",1,2,0,"D"
1998-12-12,1998,"AS Nancy","AJ Auxerre","1-1",1,1,"1",1,2,0,"D"
1998-12-15,1998,"AJ Auxerre","Girondins Bordeaux","3-1",3,1,"1",1,4,2,"H"
1998-12-15,1998,"FC Metz","SC Bastia","4-0",4,0,"1",1,4,4,"H"
1998-12-16,1998,"Le Havre AC","Stade Rennes","2-0",2,0,"1",1,2,2,"H"
1998-12-16,1998,"AS Monaco","Toulouse FC","1-1",1,1,"1",1,2,0,"D"
1998-12-16,1998,"RC Lens","FC Sochaux","1-1",1,1,"1",1,2,0,"D"
1998-12-16,1998,"Olympique Lyon","FC Lorient","2-2",2,2,"1",1,4,0,"D"
1998-12-16,1998,"Paris Saint-Germain","RC Strasbourg","0-0",0,0,"1",1,0,0,"D"
1998-12-16,1998,"FC Nantes","AS Nancy","2-0",2,0,"1",1,2,2,"H"
1998-12-16,1998,"Montpellier HSC","Olympique Marseille","0-1",0,1,"1",1,1,-1,"D"
1998-12-19,1998,"FC Sochaux","FC Nantes","1-1",1,1,"1",1,2,0,"D"
1998-12-19,1998,"AS Monaco","Olympique Lyon","0-1",0,1,"1",1,1,-1,"D"
1998-12-19,1998,"Olympique Marseille","Le Havre AC","2-0",2,0,"1",1,2,2,"H"
1998-12-19,1998,"SC Bastia","AJ Auxerre","2-0",2,0,"1",1,2,2,"H"
1998-12-19,1998,"Girondins Bordeaux","FC Metz","6-0",6,0,"1",1,6,6,"H"
1998-12-19,1998,"RC Strasbourg","Stade Rennes","1-1",1,1,"1",1,2,0,"D"
1998-12-19,1998,"Toulouse FC","Montpellier HSC","2-5",2,5,"1",1,7,-3,"D"
1998-12-19,1998,"FC Lorient","Paris Saint-Germain","2-0",2,0,"1",1,2,2,"H"
1998-12-19,1998,"AS Nancy","RC Lens","0-1",0,1,"1",1,1,-1,"D"
1999-01-16,1998,"Le Havre AC","SC Bastia","1-1",1,1,"1",1,2,0,"D"
1999-01-16,1998,"Stade Rennes","Olympique Marseille","1-1",1,1,"1",1,2,0,"D"
1999-01-16,1998,"RC Lens","AS Monaco","1-1",1,1,"1",1,2,0,"D"
1999-01-16,1998,"FC Nantes","Toulouse FC","2-0",2,0,"1",1,2,2,"H"
1999-01-16,1998,"AJ Auxerre","FC Lorient","5-0",5,0,"1",1,5,5,"H"
1999-01-16,1998,"Montpellier HSC","Girondins Bordeaux","1-1",1,1,"1",1,2,0,"D"
1999-01-17,1998,"Paris Saint-Germain","AS Nancy","1-2",1,2,"1",1,3,-1,"D"
1999-01-17,1998,"FC Metz","RC Strasbourg","1-0",1,0,"1",1,1,1,"H"
1999-01-29,1998,"AS Monaco","Paris Saint-Germain","2-1",2,1,"1",1,3,1,"H"
1999-01-29,1998,"SC Bastia","Stade Rennes","0-1",0,1,"1",1,1,-1,"D"
1999-01-29,1998,"Girondins Bordeaux","Olympique Marseille","4-1",4,1,"1",1,5,3,"H"
1999-01-30,1998,"FC Sochaux","AJ Auxerre","1-1",1,1,"1",1,2,0,"D"
1999-01-30,1998,"RC Lens","Olympique Lyon","0-3",0,3,"1",1,3,-3,"D"
1999-01-30,1998,"RC Strasbourg","Le Havre AC","0-1",0,1,"1",1,1,-1,"D"
1999-01-30,1998,"Toulouse FC","FC Metz","1-0",1,0,"1",1,1,1,"H"
1999-01-30,1998,"FC Lorient","FC Nantes","1-1",1,1,"1",1,2,0,"D"
1999-01-30,1998,"AS Nancy","Montpellier HSC","0-1",0,1,"1",1,1,-1,"D"
1999-02-06,1998,"Le Havre AC","AS Monaco","1-2",1,2,"1",1,3,-1,"D"
1999-02-06,1998,"Stade Rennes","Girondins Bordeaux","1-1",1,1,"1",1,2,0,"D"
1999-02-06,1998,"Olympique Marseille","SC Bastia","3-1",3,1,"1",1,4,2,"H"
1999-02-06,1998,"Olympique Lyon","AS Nancy","2-1",2,1,"1",1,3,1,"H"
1999-02-06,1998,"Paris Saint-Germain","FC Sochaux","2-1",2,1,"1",1,3,1,"H"
1999-02-06,1998,"FC Nantes","RC Lens","2-0",2,0,"1",1,2,2,"H"
1999-02-06,1998,"FC Metz","FC Lorient","3-0",3,0,"1",1,3,3,"H"
1999-02-07,1998,"AJ Auxerre","Toulouse FC","1-2",1,2,"1",1,3,-1,"D"
1999-02-07,1998,"Montpellier HSC","RC Strasbourg","1-1",1,1,"1",1,2,0,"D"
1999-02-13,1998,"AS Monaco","Stade Rennes","4-2",4,2,"1",1,6,2,"H"
1999-02-13,1998,"RC Lens","Paris Saint-Germain","2-1",2,1,"1",1,3,1,"H"
1999-02-13,1998,"Olympique Lyon","FC Nantes","2-1",2,1,"1",1,3,1,"H"
1999-02-13,1998,"Girondins Bordeaux","SC Bastia","2-0",2,0,"1",1,2,2,"H"
1999-02-13,1998,"FC Lorient","Montpellier HSC","1-1",1,1,"1",1,2,0,"D"
1999-02-14,1998,"Toulouse FC","Olympique Marseille","1-0",1,0,"1",1,1,1,"H"
1999-02-25,1998,"Olympique Marseille","RC Strasbourg","1-0",1,0,"1",1,1,1,"H"
1999-02-25,1998,"Paris Saint-Germain","Olympique Lyon","0-1",0,1,"1",1,1,-1,"D"
1999-02-25,1998,"FC Nantes","Girondins Bordeaux","0-0",0,0,"1",1,0,0,"D"
1999-02-25,1998,"Montpellier HSC","AS Monaco","2-3",2,3,"1",1,5,-1,"D"
1999-02-26,1998,"Le Havre AC","FC Lorient","0-1",0,1,"1",1,1,-1,"D"
1999-02-26,1998,"Stade Rennes","AS Nancy","2-1",2,1,"1",1,3,1,"H"
1999-02-26,1998,"SC Bastia","Toulouse FC","1-1",1,1,"1",1,2,0,"D"
1999-02-26,1998,"AJ Auxerre","RC Lens","1-2",1,2,"1",1,3,-1,"D"
1999-02-26,1998,"FC Metz","FC Sochaux","1-1",1,1,"1",1,2,0,"D"
1999-03-09,1998,"FC Sochaux","Olympique Marseille","0-0",0,0,"1",1,0,0,"D"
1999-03-09,1998,"AS Nancy","Girondins Bordeaux","2-3",2,3,"1",1,5,-1,"D"
1999-03-10,1998,"AS Monaco","FC Metz","0-0",0,0,"1",1,0,0,"D"
1999-03-10,1998,"RC Lens","Montpellier HSC","1-0",1,0,"1",1,1,1,"H"
1999-03-10,1998,"Olympique Lyon","AJ Auxerre","2-1",2,1,"1",1,3,1,"H"
1999-03-10,1998,"Paris Saint-Germain","FC Nantes","0-0",0,0,"1",1,0,0,"D"
1999-03-10,1998,"RC Strasbourg","SC Bastia","1-1",1,1,"1",1,2,0,"D"
1999-03-10,1998,"Toulouse FC","Le Havre AC","0-0",0,0,"1",1,0,0,"D"
1999-03-10,1998,"FC Lorient","Stade Rennes","1-1",1,1,"1",1,2,0,"D"
1999-03-14,1998,"FC Sochaux","AS Monaco","1-1",1,1,"1",1,2,0,"D"
1999-03-14,1998,"RC Strasbourg","AJ Auxerre","2-1",2,1,"1",1,3,1,"H"
1999-03-19,1998,"SC Bastia","AS Nancy","1-2",1,2,"1",1,3,-1,"D"
1999-03-19,1998,"FC Nantes","AS Monaco","0-1",0,1,"1",1,1,-1,"D"
1999-03-20,1998,"Le Havre AC","Olympique Lyon","1-0",1,0,"1",1,1,1,"H"
1999-03-20,1998,"Stade Rennes","Toulouse FC","1-0",1,0,"1",1,1,1,"H"
1999-03-20,1998,"Olympique Marseille","FC Lorient","4-1",4,1,"1",1,5,3,"H"
1999-03-20,1998,"Girondins Bordeaux","RC Strasbourg","1-0",1,0,"1",1,1,1,"H"
1999-03-20,1998,"AJ Auxerre","Paris Saint-Germain","0-1",0,1,"1",1,1,-1,"D"
1999-03-20,1998,"Montpellier HSC","FC Sochaux","0-0",0,0,"1",1,0,0,"D"
1999-03-20,1998,"FC Metz","RC Lens","0-1",0,1,"1",1,1,-1,"D"
1999-04-02,1998,"FC Sochaux","Stade Rennes","0-3",0,3,"1",1,3,-3,"D"
1999-04-02,1998,"AS Monaco","Olympique Marseille","1-2",1,2,"1",1,3,-1,"D"
1999-04-03,1998,"RC Lens","Le Havre AC","0-1",0,1,"1",1,1,-1,"D"
1999-04-03,1998,"Olympique Lyon","FC Metz","2-0",2,0,"1",1,2,2,"H"
1999-04-03,1998,"Paris Saint-Germain","Montpellier HSC","0-1",0,1,"1",1,1,-1,"D"
1999-04-03,1998,"FC Nantes","AJ Auxerre","2-2",2,2,"1",1,4,0,"D"
1999-04-03,1998,"Toulouse FC","Girondins Bordeaux","0-3",0,3,"1",1,3,-3,"D"
1999-04-03,1998,"FC Lorient","SC Bastia","3-1",3,1,"1",1,4,2,"H"
1999-04-03,1998,"AS Nancy","RC Strasbourg","1-1",1,1,"1",1,2,0,"D"
1999-04-08,1998,"Olympique Lyon","FC Sochaux","4-1",4,1,"1",1,5,3,"H"
1999-04-09,1998,"AS Nancy","FC Metz","1-0",1,0,"1",1,1,1,"H"
1999-04-13,1998,"Stade Rennes","RC Lens","2-0",2,0,"1",1,2,2,"H"
1999-04-13,1998,"SC Bastia","FC Sochaux","1-1",1,1,"1",1,2,0,"D"
1999-04-14,1998,"Le Havre AC","FC Nantes","2-1",2,1,"1",1,3,1,"H"
1999-04-14,1998,"Girondins Bordeaux","FC Lorient","0-0",0,0,"1",1,0,0,"D"
1999-04-14,1998,"RC Strasbourg","Toulouse FC","2-0",2,0,"1",1,2,2,"H"
1999-04-14,1998,"AJ Auxerre","AS Monaco","0-3",0,3,"1",1,3,-3,"D"
1999-04-14,1998,"Montpellier HSC","Olympique Lyon","1-3",1,3,"1",1,4,-2,"D"
1999-04-14,1998,"FC Metz","Paris Saint-Germain","1-1",1,1,"1",1,2,0,"D"
1999-04-15,1998,"Olympique Marseille","AS Nancy","4-0",4,0,"1",1,4,4,"H"
1999-04-24,1998,"FC Sochaux","Girondins Bordeaux","2-0",2,0,"1",1,2,2,"H"
1999-04-24,1998,"AS Monaco","SC Bastia","1-1",1,1,"1",1,2,0,"D"
1999-04-24,1998,"RC Lens","Olympique Marseille","4-0",4,0,"1",1,4,4,"H"
1999-04-24,1998,"FC Nantes","FC Metz","0-0",0,0,"1",1,0,0,"D"
1999-04-24,1998,"AJ Auxerre","Montpellier HSC","2-2",2,2,"1",1,4,0,"D"
1999-04-24,1998,"FC Lorient","RC Strasbourg","0-1",0,1,"1",1,1,-1,"D"
1999-04-24,1998,"AS Nancy","Toulouse FC","2-0",2,0,"1",1,2,2,"H"
1999-04-25,1998,"Olympique Lyon","Stade Rennes","1-2",1,2,"1",1,3,-1,"D"
1999-04-25,1998,"Paris Saint-Germain","Le Havre AC","3-0",3,0,"1",1,3,3,"H"
1999-04-30,1998,"Olympique Marseille","Olympique Lyon","0-0",0,0,"1",1,0,0,"D"
1999-04-30,1998,"Girondins Bordeaux","AS Monaco","0-1",0,1,"1",1,1,-1,"D"
1999-04-30,1998,"Toulouse FC","FC Lorient","1-4",1,4,"1",1,5,-3,"D"
1999-05-01,1998,"Le Havre AC","AS Nancy","1-1",1,1,"1",1,2,0,"D"
1999-05-01,1998,"Stade Rennes","Paris Saint-Germain","2-1",2,1,"1",1,3,1,"H"
1999-05-01,1998,"SC Bastia","RC Lens","1-1",1,1,"1",1,2,0,"D"
1999-05-01,1998,"RC Strasbourg","FC Sochaux","1-1",1,1,"1",1,2,0,"D"
1999-05-01,1998,"Montpellier HSC","FC Nantes","1-2",1,2,"1",1,3,-1,"D"
1999-05-01,1998,"FC Metz","AJ Auxerre","2-0",2,0,"1",1,2,2,"H"
1999-05-04,1998,"RC Lens","Girondins Bordeaux","2-4",2,4,"1",1,6,-2,"D"
1999-05-04,1998,"Paris Saint-Germain","Olympique Marseille","2-1",2,1,"1",1,3,1,"H"
1999-05-04,1998,"Montpellier HSC","FC Metz","1-1",1,1,"1",1,2,0,"D"
1999-05-05,1998,"FC Sochaux","Toulouse FC","2-1",2,1,"1",1,3,1,"H"
1999-05-05,1998,"AS Monaco","RC Strasbourg","2-1",2,1,"1",1,3,1,"H"
1999-05-05,1998,"Olympique Lyon","SC Bastia","2-1",2,1,"1",1,3,1,"H"
1999-05-05,1998,"FC Nantes","Stade Rennes","2-1",2,1,"1",1,3,1,"H"
1999-05-05,1998,"AJ Auxerre","Le Havre AC","0-0",0,0,"1",1,0,0,"D"
1999-05-05,1998,"AS Nancy","FC Lorient","2-0",2,0,"1",1,2,2,"H"
1999-05-14,1998,"FC Sochaux","Le Havre AC","1-0",1,0,"1",1,1,1,"H"
1999-05-22,1998,"Le Havre AC","Montpellier HSC","1-1",1,1,"1",1,2,0,"D"
1999-05-22,1998,"Stade Rennes","FC Metz","1-0",1,0,"1",1,1,1,"H"
1999-05-22,1998,"Olympique Marseille","AJ Auxerre","1-0",1,0,"1",1,1,1,"H"
1999-05-22,1998,"SC Bastia","FC Nantes","1-0",1,0,"1",1,1,1,"H"
1999-05-22,1998,"Girondins Bordeaux","Olympique Lyon","1-0",1,0,"1",1,1,1,"H"
1999-05-22,1998,"RC Strasbourg","RC Lens","1-1",1,1,"1",1,2,0,"D"
1999-05-22,1998,"Toulouse FC","Paris Saint-Germain","2-1",2,1,"1",1,3,1,"H"
1999-05-22,1998,"FC Lorient","FC Sochaux","4-1",4,1,"1",1,5,3,"H"
1999-05-22,1998,"AS Nancy","AS Monaco","1-2",1,2,"1",1,3,-1,"D"
1999-05-29,1998,"FC Sochaux","AS Nancy","1-1",1,1,"1",1,2,0,"D"
1999-05-29,1998,"AS Monaco","FC Lorient","1-0",1,0,"1",1,1,1,"H"
1999-05-29,1998,"RC Lens","Toulouse FC","3-1",3,1,"1",1,4,2,"H"
1999-05-29,1998,"Olympique Lyon","RC Strasbourg","3-2",3,2,"1",1,5,1,"H"
1999-05-29,1998,"Paris Saint-Germain","Girondins Bordeaux","2-3",2,3,"1",1,5,-1,"D"
1999-05-29,1998,"FC Nantes","Olympique Marseille","0-1",0,1,"1",1,1,-1,"D"
1999-05-29,1998,"AJ Auxerre","Stade Rennes","2-0",2,0,"1",1,2,2,"H"
1999-05-29,1998,"Montpellier HSC","SC Bastia","3-0",3,0,"1",1,3,3,"H"
1999-05-29,1998,"FC Metz","Le Havre AC","1-0",1,0,"1",1,1,1,"H"
1999-07-30,1999,"Girondins Bordeaux","SC Bastia","3-2",3,2,"1",1,5,1,"H"
1999-07-31,1999,"FC Metz","Stade Rennes","0-0",0,0,"1",1,0,0,"D"
1999-07-31,1999,"Paris Saint-Germain","ATAC Troyes","1-0",1,0,"1",1,1,1,"H"
1999-07-31,1999,"FC Nantes","Le Havre AC","1-0",1,0,"1",1,1,1,"H"
1999-07-31,1999,"Olympique Marseille","CS Sedan","3-0",3,0,"1",1,3,3,"H"
1999-07-31,1999,"AJ Auxerre","AS Nancy","2-1",2,1,"1",1,3,1,"H"
1999-07-31,1999,"Olympique Lyon","Montpellier HSC","1-2",1,2,"1",1,3,-1,"D"
1999-07-31,1999,"RC Strasbourg","RC Lens","1-0",1,0,"1",1,1,1,"H"
1999-07-31,1999,"AS Monaco","AS Saint-Etienne","2-2",2,2,"1",1,4,0,"D"
1999-08-06,1999,"RC Lens","AS Monaco","1-0",1,0,"1",1,1,1,"H"
1999-08-06,1999,"SC Bastia","RC Strasbourg","3-0",3,0,"1",1,3,3,"H"
1999-08-06,1999,"ATAC Troyes","Olympique Lyon","1-2",1,2,"1",1,3,-1,"D"
1999-08-06,1999,"CS Sedan","AS Nancy","3-1",3,1,"1",1,4,2,"H"
1999-08-06,1999,"Le Havre AC","Olympique Marseille","0-0",0,0,"1",1,0,0,"D"
1999-08-06,1999,"AS Saint-Etienne","FC Nantes","0-2",0,2,"1",1,2,-2,"D"
1999-08-08,1999,"FC Metz","AJ Auxerre","3-0",3,0,"1",1,3,3,"H"
1999-08-08,1999,"Montpellier HSC","Girondins Bordeaux","2-2",2,2,"1",1,4,0,"D"
1999-08-08,1999,"Stade Rennes","Paris Saint-Germain","1-3",1,3,"1",1,4,-2,"D"
1999-08-14,1999,"RC Strasbourg","Montpellier HSC","2-0",2,0,"1",1,2,2,"H"
1999-08-14,1999,"AS Monaco","SC Bastia","4-0",4,0,"1",1,4,4,"H"
1999-08-14,1999,"FC Nantes","RC Lens","0-1",0,1,"1",1,1,-1,"D"
1999-08-14,1999,"AS Nancy","Le Havre AC","3-0",3,0,"1",1,3,3,"H"
1999-08-14,1999,"Paris Saint-Germain","FC Metz","2-1",2,1,"1",1,3,1,"H"
1999-08-14,1999,"Girondins Bordeaux","ATAC Troyes","4-0",4,0,"1",1,4,4,"H"
1999-08-14,1999,"AJ Auxerre","CS Sedan","3-1",3,1,"1",1,4,2,"H"
1999-08-15,1999,"Olympique Lyon","Stade Rennes","2-2",2,2,"1",1,4,0,"D"
1999-08-15,1999,"Olympique Marseille","AS Saint-Etienne","3-3",3,3,"1",1,6,0,"D"
1999-08-20,1999,"AS Saint-Etienne","AS Nancy","2-1",2,1,"1",1,3,1,"H"
1999-08-20,1999,"Montpellier HSC","AS Monaco","2-3",2,3,"1",1,5,-1,"D"
1999-08-20,1999,"ATAC Troyes","RC Strasbourg","2-1",2,1,"1",1,3,1,"H"
1999-08-20,1999,"FC Metz","Olympique Lyon","0-1",0,1,"1",1,1,-1,"D"
1999-08-20,1999,"Paris Saint-Germain","AJ Auxerre","1-1",1,1,"1",1,2,0,"D"
1999-08-20,1999,"Le Havre AC","CS Sedan","2-1",2,1,"1",1,3,1,"H"
1999-08-20,1999,"Stade Rennes","Girondins Bordeaux","2-1",2,1,"1",1,3,1,"H"
1999-08-22,1999,"RC Lens","Olympique Marseille","0-0",0,0,"1",1,0,0,"D"
1999-08-22,1999,"SC Bastia","FC Nantes","2-1",2,1,"1",1,3,1,"H"
1999-08-28,1999,"RC Strasbourg","Stade Rennes","2-1",2,1,"1",1,3,1,"H"
1999-08-28,1999,"FC Nantes","Montpellier HSC","3-0",3,0,"1",1,3,3,"H"
1999-08-28,1999,"Olympique Marseille","SC Bastia","1-1",1,1,"1",1,2,0,"D"
1999-08-28,1999,"AS Nancy","RC Lens","2-1",2,1,"1",1,3,1,"H"
1999-08-28,1999,"CS Sedan","AS Saint-Etienne","3-2",3,2,"1",1,5,1,"H"
1999-08-28,1999,"Girondins Bordeaux","FC Metz","0-0",0,0,"1",1,0,0,"D"
1999-08-28,1999,"AJ Auxerre","Le Havre AC","2-1",2,1,"1",1,3,1,"H"
1999-08-29,1999,"Olympique Lyon","Paris Saint-Germain","1-0",1,0,"1",1,1,1,"H"
1999-08-29,1999,"AS Monaco","ATAC Troyes","3-0",3,0,"1",1,3,3,"H"
1999-09-11,1999,"RC Lens","CS Sedan","0-3",0,3,"1",1,3,-3,"D"
1999-09-11,1999,"SC Bastia","AS Nancy","1-1",1,1,"1",1,2,0,"D"
1999-09-11,1999,"Montpellier HSC","Olympique Marseille","3-1",3,1,"1",1,4,2,"H"
1999-09-11,1999,"FC Metz","RC Strasbourg","0-0",0,0,"1",1,0,0,"D"
1999-09-11,1999,"Olympique Lyon","AJ Auxerre","0-0",0,0,"1",1,0,0,"D"
1999-09-11,1999,"AS Saint-Etienne","Le Havre AC","3-3",3,3,"1",1,6,0,"D"
1999-09-11,1999,"ATAC Troyes","FC Nantes","1-0",1,0,"1",1,1,1,"H"
1999-09-12,1999,"Paris Saint-Germain","Girondins Bordeaux","2-1",2,1,"1",1,3,1,"H"
1999-09-12,1999,"Stade Rennes","AS Monaco","2-1",2,1,"1",1,3,1,"H"
1999-09-18,1999,"Girondins Bordeaux","Olympique Lyon","1-3",1,3,"1",1,4,-2,"D"
1999-09-18,1999,"AJ Auxerre","AS Saint-Etienne","2-1",2,1,"1",1,3,1,"H"
1999-09-19,1999,"AS Nancy","Montpellier HSC","1-2",1,2,"1",1,3,-1,"D"
1999-09-19,1999,"AS Monaco","FC Metz","2-2",2,2,"1",1,4,0,"D"
1999-09-19,1999,"FC Nantes","Stade Rennes","3-0",3,0,"1",1,3,3,"H"
1999-09-19,1999,"Olympique Marseille","ATAC Troyes","1-0",1,0,"1",1,1,1,"H"
1999-09-19,1999,"CS Sedan","SC Bastia","2-0",2,0,"1",1,2,2,"H"
1999-09-19,1999,"Le Havre AC","RC Lens","1-1",1,1,"1",1,2,0,"D"
1999-09-19,1999,"RC Strasbourg","Paris Saint-Germain","1-1",1,1,"1",1,2,0,"D"
1999-09-25,1999,"Girondins Bordeaux","AJ Auxerre","1-0",1,0,"1",1,1,1,"H"
1999-09-25,1999,"SC Bastia","Le Havre AC","1-1",1,1,"1",1,2,0,"D"
1999-09-25,1999,"Montpellier HSC","CS Sedan","1-1",1,1,"1",1,2,0,"D"
1999-09-25,1999,"FC Metz","FC Nantes","2-1",2,1,"1",1,3,1,"H"
1999-09-25,1999,"Paris Saint-Germain","AS Monaco","0-3",0,3,"1",1,3,-3,"D"
1999-09-25,1999,"Olympique Lyon","RC Strasbourg","0-0",0,0,"1",1,0,0,"D"
1999-09-25,1999,"ATAC Troyes","AS Nancy","2-0",2,0,"1",1,2,2,"H"
1999-09-26,1999,"RC Lens","AS Saint-Etienne","0-2",0,2,"1",1,2,-2,"D"
1999-09-26,1999,"Stade Rennes","Olympique Marseille","1-2",1,2,"1",1,3,-1,"D"
1999-10-02,1999,"CS Sedan","ATAC Troyes","2-1",2,1,"1",1,3,1,"H"
1999-10-02,1999,"Le Havre AC","Montpellier HSC","2-1",2,1,"1",1,3,1,"H"
1999-10-02,1999,"AS Saint-Etienne","SC Bastia","1-1",1,1,"1",1,2,0,"D"
1999-10-02,1999,"AS Nancy","Stade Rennes","3-0",3,0,"1",1,3,3,"H"
1999-10-02,1999,"RC Strasbourg","Girondins Bordeaux","2-2",2,2,"1",1,4,0,"D"
1999-10-02,1999,"Olympique Marseille","FC Metz","1-1",1,1,"1",1,2,0,"D"
1999-10-03,1999,"AS Monaco","Olympique Lyon","1-0",1,0,"1",1,1,1,"H"
1999-10-03,1999,"FC Nantes","Paris Saint-Germain","0-4",0,4,"1",1,4,-4,"D"
1999-10-03,1999,"AJ Auxerre","RC Lens","3-2",3,2,"1",1,5,1,"H"
1999-10-12,1999,"Paris Saint-Germain","Olympique Marseille","0-2",0,2,"1",1,2,-2,"D"
1999-10-12,1999,"Olympique Lyon","FC Nantes","2-0",2,0,"1",1,2,2,"H"
1999-10-13,1999,"FC Metz","AS Nancy","2-2",2,2,"1",1,4,0,"D"
1999-10-13,1999,"Montpellier HSC","AS Saint-Etienne","0-1",0,1,"1",1,1,-1,"D"
1999-10-13,1999,"ATAC Troyes","Le Havre AC","3-1",3,1,"1",1,4,2,"H"
1999-10-13,1999,"Stade Rennes","CS Sedan","5-0",5,0,"1",1,5,5,"H"
1999-10-13,1999,"Girondins Bordeaux","AS Monaco","3-2",3,2,"1",1,5,1,"H"
1999-10-13,1999,"RC Strasbourg","AJ Auxerre","1-3",1,3,"1",1,4,-2,"D"
1999-10-13,1999,"SC Bastia","RC Lens","2-0",2,0,"1",1,2,2,"H"
1999-10-15,1999,"Olympique Marseille","Olympique Lyon","0-1",0,1,"1",1,1,-1,"D"
1999-10-16,1999,"AS Nancy","Paris Saint-Germain","1-1",1,1,"1",1,2,0,"D"
1999-10-16,1999,"Le Havre AC","Stade Rennes","0-1",0,1,"1",1,1,-1,"D"
1999-10-16,1999,"FC Nantes","Girondins Bordeaux","0-1",0,1,"1",1,1,-1,"D"
1999-10-16,1999,"AJ Auxerre","SC Bastia","3-1",3,1,"1",1,4,2,"H"
1999-10-16,1999,"AS Saint-Etienne","ATAC Troyes","1-0",1,0,"1",1,1,1,"H"
1999-10-16,1999,"RC Lens","Montpellier HSC","1-0",1,0,"1",1,1,1,"H"
1999-10-16,1999,"AS Monaco","RC Strasbourg","3-0",3,0,"1",1,3,3,"H"
1999-10-17,1999,"CS Sedan","FC Metz","0-2",0,2,"1",1,2,-2,"D"
1999-10-23,1999,"Girondins Bordeaux","Olympique Marseille","2-1",2,1,"1",1,3,1,"H"
1999-10-23,1999,"Stade Rennes","AS Saint-Etienne","4-1",4,1,"1",1,5,3,"H"
1999-10-24,1999,"FC Metz","Le Havre AC","3-0",3,0,"1",1,3,3,"H"
1999-10-24,1999,"Montpellier HSC","SC Bastia","1-1",1,1,"1",1,2,0,"D"
1999-10-24,1999,"ATAC Troyes","RC Lens","0-1",0,1,"1",1,1,-1,"D"
1999-10-24,1999,"Paris Saint-Germain","CS Sedan","3-2",3,2,"1",1,5,1,"H"
1999-10-24,1999,"Olympique Lyon","AS Nancy","2-1",2,1,"1",1,3,1,"H"
1999-10-24,1999,"RC Strasbourg","FC Nantes","3-2",3,2,"1",1,5,1,"H"
1999-10-29,1999,"CS Sedan","Olympique Lyon","2-0",2,0,"1",1,2,2,"H"
1999-10-29,1999,"FC Nantes","AS Monaco","0-3",0,3,"1",1,3,-3,"D"
1999-10-30,1999,"AS Nancy","Girondins Bordeaux","2-2",2,2,"1",1,4,0,"D"
1999-10-30,1999,"Olympique Marseille","RC Strasbourg","4-1",4,1,"1",1,5,3,"H"
1999-10-30,1999,"AJ Auxerre","Montpellier HSC","2-1",2,1,"1",1,3,1,"H"
1999-10-30,1999,"Le Havre AC","Paris Saint-Germain","3-1",3,1,"1",1,4,2,"H"
1999-10-30,1999,"AS Saint-Etienne","FC Metz","2-0",2,0,"1",1,2,2,"H"
1999-10-30,1999,"SC Bastia","ATAC Troyes","5-0",5,0,"1",1,5,5,"H"
1999-10-31,1999,"RC Lens","Stade Rennes","1-1",1,1,"1",1,2,0,"D"
1999-11-06,1999,"Stade Rennes","SC Bastia","0-0",0,0,"1",1,0,0,"D"
1999-11-06,1999,"Paris Saint-Germain","AS Saint-Etienne","2-0",2,0,"1",1,2,2,"H"
1999-11-06,1999,"Girondins Bordeaux","CS Sedan","1-1",1,1,"1",1,2,0,"D"
1999-11-06,1999,"RC Strasbourg","AS Nancy","0-2",0,2,"1",1,2,-2,"D"
1999-11-07,1999,"FC Metz","RC Lens","0-0",0,0,"1",1,0,0,"D"
1999-11-07,1999,"Olympique Lyon","Le Havre AC","3-0",3,0,"1",1,3,3,"H"
1999-11-07,1999,"AS Monaco","Olympique Marseille","1-1",1,1,"1",1,2,0,"D"
1999-11-07,1999,"FC Nantes","AJ Auxerre","3-1",3,1,"1",1,4,2,"H"
1999-11-07,1999,"ATAC Troyes","Montpellier HSC","2-1",2,1,"1",1,3,1,"H"
1999-11-09,1999,"CS Sedan","RC Strasbourg","2-1",2,1,"1",1,3,1,"H"
1999-11-10,1999,"AS Nancy","AS Monaco","1-2",1,2,"1",1,3,-1,"D"
1999-11-10,1999,"Le Havre AC","Girondins Bordeaux","3-0",3,0,"1",1,3,3,"H"
1999-11-10,1999,"Montpellier HSC","Stade Rennes","1-2",1,2,"1",1,3,-1,"D"
1999-11-10,1999,"Olympique Marseille","FC Nantes","1-1",1,1,"1",1,2,0,"D"
1999-11-10,1999,"AJ Auxerre","ATAC Troyes","0-1",0,1,"1",1,1,-1,"D"
1999-11-10,1999,"AS Saint-Etienne","Olympique Lyon","1-1",1,1,"1",1,2,0,"D"
1999-11-10,1999,"RC Lens","Paris Saint-Germain","3-2",3,2,"1",1,5,1,"H"
1999-11-10,1999,"SC Bastia","FC Metz","0-0",0,0,"1",1,0,0,"D"
1999-11-19,1999,"RC Strasbourg","Le Havre AC","0-1",0,1,"1",1,1,-1,"D"
1999-11-19,1999,"Stade Rennes","ATAC Troyes","2-2",2,2,"1",1,4,0,"D"
1999-11-19,1999,"FC Metz","Montpellier HSC","2-2",2,2,"1",1,4,0,"D"
1999-11-19,1999,"Paris Saint-Germain","SC Bastia","2-0",2,0,"1",1,2,2,"H"
1999-11-19,1999,"Girondins Bordeaux","AS Saint-Etienne","1-2",1,2,"1",1,3,-1,"D"
1999-11-20,1999,"Olympique Lyon","RC Lens","1-0",1,0,"1",1,1,1,"H"
1999-11-20,1999,"AS Monaco","CS Sedan","2-1",2,1,"1",1,3,1,"H"
1999-11-20,1999,"FC Nantes","AS Nancy","2-0",2,0,"1",1,2,2,"H"
1999-11-20,1999,"Olympique Marseille","AJ Auxerre","0-1",0,1,"1",1,1,-1,"D"
1999-11-27,1999,"Montpellier HSC","Paris Saint-Germain","0-1",0,1,"1",1,1,-1,"D"
1999-11-27,1999,"ATAC Troyes","FC Metz","2-2",2,2,"1",1,4,0,"D"
1999-11-27,1999,"Stade Rennes","AJ Auxerre","1-0",1,0,"1",1,1,1,"H"
1999-11-27,1999,"AS Nancy","Olympique Marseille","2-2",2,2,"1",1,4,0,"D"
1999-11-27,1999,"Le Havre AC","AS Monaco","1-4",1,4,"1",1,5,-3,"D"
1999-11-27,1999,"AS Saint-Etienne","RC Strasbourg","0-1",0,1,"1",1,1,-1,"D"
1999-11-28,1999,"CS Sedan","FC Nantes","0-0",0,0,"1",1,0,0,"D"
1999-11-28,1999,"RC Lens","Girondins Bordeaux","3-3",3,3,"1",1,6,0,"D"
1999-11-28,1999,"SC Bastia","Olympique Lyon","3-0",3,0,"1",1,3,3,"H"
1999-12-01,1999,"AS Monaco","AJ Auxerre","2-0",2,0,"1",1,2,2,"H"
1999-12-03,1999,"RC Strasbourg","SC Bastia","2-0",2,0,"1",1,2,2,"H"
1999-12-03,1999,"FC Nantes","AS Saint-Etienne","0-1",0,1,"1",1,1,-1,"D"
1999-12-03,1999,"Olympique Marseille","Le Havre AC","2-0",2,0,"1",1,2,2,"H"
1999-12-03,1999,"AS Nancy","CS Sedan","0-2",0,2,"1",1,2,-2,"D"
1999-12-03,1999,"Olympique Lyon","ATAC Troyes","1-3",1,3,"1",1,4,-2,"D"
1999-12-03,1999,"Girondins Bordeaux","Montpellier HSC","2-0",2,0,"1",1,2,2,"H"
1999-12-05,1999,"Paris Saint-Germain","Stade Rennes","1-0",1,0,"1",1,1,1,"H"
1999-12-05,1999,"AS Monaco","RC Lens","2-0",2,0,"1",1,2,2,"H"
1999-12-05,1999,"AJ Auxerre","FC Metz","1-1",1,1,"1",1,2,0,"D"
1999-12-11,1999,"ATAC Troyes","Girondins Bordeaux","2-0",2,0,"1",1,2,2,"H"
1999-12-11,1999,"Stade Rennes","Olympique Lyon","1-2",1,2,"1",1,3,-1,"D"
1999-12-11,1999,"CS Sedan","AJ Auxerre","1-1",1,1,"1",1,2,0,"D"
1999-12-11,1999,"Le Havre AC","AS Nancy","0-1",0,1,"1",1,1,-1,"D"
1999-12-11,1999,"Montpellier HSC","RC Strasbourg","1-1",1,1,"1",1,2,0,"D"
1999-12-12,1999,"FC Metz","Paris Saint-Germain","1-3",1,3,"1",1,4,-2,"D"
1999-12-12,1999,"AS Saint-Etienne","Olympique Marseille","5-1",5,1,"1",1,6,4,"H"
1999-12-12,1999,"SC Bastia","AS Monaco","1-0",1,0,"1",1,1,1,"H"
1999-12-14,1999,"RC Lens","FC Nantes","1-2",1,2,"1",1,3,-1,"D"
1999-12-17,1999,"Olympique Lyon","FC Metz","2-0",2,0,"1",1,2,2,"H"
1999-12-17,1999,"Girondins Bordeaux","Stade Rennes","1-0",1,0,"1",1,1,1,"H"
1999-12-17,1999,"AJ Auxerre","Paris Saint-Germain","1-0",1,0,"1",1,1,1,"H"
1999-12-18,1999,"Olympique Marseille","RC Lens","1-2",1,2,"1",1,3,-1,"D"
1999-12-18,1999,"AS Nancy","AS Saint-Etienne","1-0",1,0,"1",1,1,1,"H"
1999-12-18,1999,"AS Monaco","Montpellier HSC","1-0",1,0,"1",1,1,1,"H"
1999-12-18,1999,"FC Nantes","SC Bastia","1-1",1,1,"1",1,2,0,"D"
2000-01-11,1999,"FC Metz","Girondins Bordeaux","2-1",2,1,"1",1,3,1,"H"
2000-01-11,1999,"Paris Saint-Germain","Olympique Lyon","2-2",2,2,"1",1,4,0,"D"
2000-01-12,1999,"Le Havre AC","AJ Auxerre","0-0",0,0,"1",1,0,0,"D"
2000-01-12,1999,"Montpellier HSC","FC Nantes","3-0",3,0,"1",1,3,3,"H"
2000-01-12,1999,"ATAC Troyes","AS Monaco","1-4",1,4,"1",1,5,-3,"D"
2000-01-12,1999,"Stade Rennes","RC Strasbourg","2-1",2,1,"1",1,3,1,"H"
2000-01-12,1999,"AS Saint-Etienne","CS Sedan","2-3",2,3,"1",1,5,-1,"D"
2000-01-12,1999,"RC Lens","AS Nancy","0-1",0,1,"1",1,1,-1,"D"
2000-01-12,1999,"SC Bastia","Olympique Marseille","0-0",0,0,"1",1,0,0,"D"
2000-01-19,1999,"FC Nantes","ATAC Troyes","3-0",3,0,"1",1,3,3,"H"
2000-01-19,1999,"Olympique Marseille","Montpellier HSC","0-0",0,0,"1",1,0,0,"D"
2000-01-19,1999,"AJ Auxerre","Olympique Lyon","2-0",2,0,"1",1,2,2,"H"
2000-01-19,1999,"Girondins Bordeaux","Paris Saint-Germain","1-1",1,1,"1",1,2,0,"D"
2000-01-19,1999,"RC Strasbourg","FC Metz","1-1",1,1,"1",1,2,0,"D"
2000-01-19,1999,"AS Monaco","Stade Rennes","3-1",3,1,"1",1,4,2,"H"
2000-01-19,1999,"AS Nancy","SC Bastia","1-0",1,0,"1",1,1,1,"H"
2000-01-19,1999,"CS Sedan","RC Lens","0-0",0,0,"1",1,0,0,"D"
2000-01-19,1999,"Le Havre AC","AS Saint-Etienne","1-0",1,0,"1",1,1,1,"H"
2000-01-20,1999,"CS Sedan","Le Havre AC","0-1",0,1,"1",1,1,-1,"D"
2000-01-20,1999,"RC Strasbourg","ATAC Troyes","2-0",2,0,"1",1,2,2,"H"
2000-01-25,1999,"FC Metz","AS Monaco","1-1",1,1,"1",1,2,0,"D"
2000-01-25,1999,"ATAC Troyes","Olympique Marseille","1-2",1,2,"1",1,3,-1,"D"
2000-01-26,1999,"Paris Saint-Germain","RC Strasbourg","4-2",4,2,"1",1,6,2,"H"
2000-01-26,1999,"SC Bastia","CS Sedan","1-0",1,0,"1",1,1,1,"H"
2000-01-26,1999,"Montpellier HSC","AS Nancy","1-0",1,0,"1",1,1,1,"H"
2000-01-26,1999,"Stade Rennes","FC Nantes","0-0",0,0,"1",1,0,0,"D"
2000-01-26,1999,"Olympique Lyon","Girondins Bordeaux","1-1",1,1,"1",1,2,0,"D"
2000-01-26,1999,"AS Saint-Etienne","AJ Auxerre","0-0",0,0,"1",1,0,0,"D"
2000-01-26,1999,"RC Lens","Le Havre AC","4-0",4,0,"1",1,4,4,"H"
2000-02-01,1999,"AS Monaco","Paris Saint-Germain","1-0",1,0,"1",1,1,1,"H"
2000-02-01,1999,"AJ Auxerre","Girondins Bordeaux","1-0",1,0,"1",1,1,1,"H"
2000-02-02,1999,"AS Nancy","ATAC Troyes","1-2",1,2,"1",1,3,-1,"D"
2000-02-02,1999,"RC Strasbourg","Olympique Lyon","4-2",4,2,"1",1,6,2,"H"
2000-02-02,1999,"FC Nantes","FC Metz","1-3",1,3,"1",1,4,-2,"D"
2000-02-02,1999,"Olympique Marseille","Stade Rennes","1-1",1,1,"1",1,2,0,"D"
2000-02-02,1999,"CS Sedan","Montpellier HSC","2-1",2,1,"1",1,3,1,"H"
2000-02-02,1999,"Le Havre AC","SC Bastia","2-2",2,2,"1",1,4,0,"D"
2000-02-02,1999,"AS Saint-Etienne","RC Lens","0-2",0,2,"1",1,2,-2,"D"
2000-02-05,1999,"Montpellier HSC","Le Havre AC","0-0",0,0,"1",1,0,0,"D"
2000-02-05,1999,"ATAC Troyes","CS Sedan","0-2",0,2,"1",1,2,-2,"D"
2000-02-05,1999,"Stade Rennes","AS Nancy","3-1",3,1,"1",1,4,2,"H"
2000-02-05,1999,"Girondins Bordeaux","RC Strasbourg","3-0",3,0,"1",1,3,3,"H"
2000-02-05,1999,"RC Lens","AJ Auxerre","2-1",2,1,"1",1,3,1,"H"
2000-02-05,1999,"SC Bastia","AS Saint-Etienne","4-0",4,0,"1",1,4,4,"H"
2000-02-05,1999,"FC Metz","Olympique Marseille","2-0",2,0,"1",1,2,2,"H"
2000-02-05,1999,"Paris Saint-Germain","FC Nantes","0-0",0,0,"1",1,0,0,"D"
2000-02-05,1999,"Olympique Lyon","AS Monaco","2-1",2,1,"1",1,3,1,"H"
2000-02-15,1999,"FC Nantes","Olympique Lyon","6-1",6,1,"1",1,7,5,"H"
2000-02-15,1999,"Olympique Marseille","Paris Saint-Germain","4-1",4,1,"1",1,5,3,"H"
2000-02-16,1999,"AS Nancy","FC Metz","0-0",0,0,"1",1,0,0,"D"
2000-02-16,1999,"RC Lens","SC Bastia","4-0",4,0,"1",1,4,4,"H"
2000-02-16,1999,"AS Monaco","Girondins Bordeaux","1-0",1,0,"1",1,1,1,"H"
2000-02-16,1999,"AJ Auxerre","RC Strasbourg","0-1",0,1,"1",1,1,-1,"D"
2000-02-16,1999,"CS Sedan","Stade Rennes","2-1",2,1,"1",1,3,1,"H"
2000-02-16,1999,"Le Havre AC","ATAC Troyes","2-0",2,0,"1",1,2,2,"H"
2000-02-16,1999,"AS Saint-Etienne","Montpellier HSC","5-4",5,4,"1",1,9,1,"H"
2000-02-26,1999,"Girondins Bordeaux","FC Nantes","3-0",3,0,"1",1,3,3,"H"
2000-02-26,1999,"SC Bastia","AJ Auxerre","2-0",2,0,"1",1,2,2,"H"
2000-02-26,1999,"Montpellier HSC","RC Lens","1-1",1,1,"1",1,2,0,"D"
2000-02-26,1999,"FC Metz","CS Sedan","1-1",1,1,"1",1,2,0,"D"
2000-02-26,1999,"Paris Saint-Germain","AS Nancy","1-1",1,1,"1",1,2,0,"D"
2000-02-26,1999,"Olympique Lyon","Olympique Marseille","2-0",2,0,"1",1,2,2,"H"
2000-02-26,1999,"ATAC Troyes","AS Saint-Etienne","0-1",0,1,"1",1,1,-1,"D"
2000-02-26,1999,"Stade Rennes","Le Havre AC","2-1",2,1,"1",1,3,1,"H"
2000-02-27,1999,"RC Strasbourg","AS Monaco","3-2",3,2,"1",1,5,1,"H"
2000-03-11,1999,"SC Bastia","Montpellier HSC","1-0",1,0,"1",1,1,1,"H"
2000-03-11,1999,"FC Nantes","RC Strasbourg","3-1",3,1,"1",1,4,2,"H"
2000-03-11,1999,"Olympique Marseille","Girondins Bordeaux","0-2",0,2,"1",1,2,-2,"D"
2000-03-11,1999,"CS Sedan","Paris Saint-Germain","1-1",1,1,"1",1,2,0,"D"
2000-03-11,1999,"Le Havre AC","FC Metz","1-0",1,0,"1",1,1,1,"H"
2000-03-11,1999,"AS Saint-Etienne","Stade Rennes","1-0",1,0,"1",1,1,1,"H"
2000-03-12,1999,"AS Nancy","Olympique Lyon","1-0",1,0,"1",1,1,1,"H"
2000-03-12,1999,"RC Lens","ATAC Troyes","0-1",0,1,"1",1,1,-1,"D"
2000-03-12,1999,"AJ Auxerre","AS Monaco","0-2",0,2,"1",1,2,-2,"D"
2000-03-25,1999,"RC Strasbourg","Olympique Marseille","3-1",3,1,"1",1,4,2,"H"
2000-03-25,1999,"Montpellier HSC","AJ Auxerre","2-0",2,0,"1",1,2,2,"H"
2000-03-25,1999,"ATAC Troyes","SC Bastia","1-0",1,0,"1",1,1,1,"H"
2000-03-25,1999,"FC Metz","AS Saint-Etienne","1-1",1,1,"1",1,2,0,"D"
2000-03-25,1999,"Paris Saint-Germain","Le Havre AC","2-1",2,1,"1",1,3,1,"H"
2000-03-25,1999,"Girondins Bordeaux","AS Nancy","2-1",2,1,"1",1,3,1,"H"
2000-03-25,1999,"Stade Rennes","RC Lens","3-0",3,0,"1",1,3,3,"H"
2000-03-26,1999,"Olympique Lyon","CS Sedan","2-0",2,0,"1",1,2,2,"H"
2000-03-26,1999,"AS Monaco","FC Nantes","2-0",2,0,"1",1,2,2,"H"
2000-04-07,1999,"CS Sedan","Girondins Bordeaux","0-1",0,1,"1",1,1,-1,"D"
2000-04-07,1999,"Olympique Marseille","AS Monaco","4-2",4,2,"1",1,6,2,"H"
2000-04-08,1999,"AS Nancy","RC Strasbourg","2-3",2,3,"1",1,5,-1,"D"
2000-04-08,1999,"Montpellier HSC","ATAC Troyes","2-2",2,2,"1",1,4,0,"D"
2000-04-08,1999,"AJ Auxerre","FC Nantes","1-1",1,1,"1",1,2,0,"D"
2000-04-08,1999,"Le Havre AC","Olympique Lyon","0-1",0,1,"1",1,1,-1,"D"
2000-04-08,1999,"AS Saint-Etienne","Paris Saint-Germain","1-1",1,1,"1",1,2,0,"D"
2000-04-08,1999,"SC Bastia","Stade Rennes","4-2",4,2,"1",1,6,2,"H"
2000-04-09,1999,"RC Lens","FC Metz","1-0",1,0,"1",1,1,1,"H"
2000-04-14,1999,"Paris Saint-Germain","RC Lens","4-1",4,1,"1",1,5,3,"H"
2000-04-14,1999,"Olympique Lyon","AS Saint-Etienne","0-0",0,0,"1",1,0,0,"D"
2000-04-15,1999,"FC Metz","SC Bastia","1-1",1,1,"1",1,2,0,"D"
2000-04-15,1999,"FC Nantes","Olympique Marseille","0-0",0,0,"1",1,0,0,"D"
2000-04-15,1999,"ATAC Troyes","AJ Auxerre","2-0",2,0,"1",1,2,2,"H"
2000-04-15,1999,"Stade Rennes","Montpellier HSC","1-3",1,3,"1",1,4,-2,"D"
2000-04-15,1999,"Girondins Bordeaux","Le Havre AC","3-0",3,0,"1",1,3,3,"H"
2000-04-15,1999,"RC Strasbourg","CS Sedan","1-1",1,1,"1",1,2,0,"D"
2000-04-15,1999,"AS Monaco","AS Nancy","2-2",2,2,"1",1,4,0,"D"
2000-04-29,1999,"AS Saint-Etienne","Girondins Bordeaux","1-2",1,2,"1",1,3,-1,"D"
2000-04-29,1999,"RC Lens","Olympique Lyon","4-3",4,3,"1",1,7,1,"H"
2000-04-29,1999,"Montpellier HSC","FC Metz","0-1",0,1,"1",1,1,-1,"D"
2000-04-29,1999,"AS Nancy","FC Nantes","2-1",2,1,"1",1,3,1,"H"
2000-04-29,1999,"CS Sedan","AS Monaco","2-1",2,1,"1",1,3,1,"H"
2000-04-29,1999,"Le Havre AC","RC Strasbourg","0-1",0,1,"1",1,1,-1,"D"
2000-04-29,1999,"ATAC Troyes","Stade Rennes","1-0",1,0,"1",1,1,1,"H"
2000-04-30,1999,"SC Bastia","Paris Saint-Germain","1-2",1,2,"1",1,3,-1,"D"
2000-04-30,1999,"AJ Auxerre","Olympique Marseille","2-2",2,2,"1",1,4,0,"D"
2000-05-04,1999,"FC Nantes","CS Sedan","1-0",1,0,"1",1,1,1,"H"
2000-05-04,1999,"Olympique Marseille","AS Nancy","2-2",2,2,"1",1,4,0,"D"
2000-05-04,1999,"AJ Auxerre","Stade Rennes","4-0",4,0,"1",1,4,4,"H"
2000-05-04,1999,"Girondins Bordeaux","RC Lens","1-2",1,2,"1",1,3,-1,"D"
2000-05-04,1999,"RC Strasbourg","AS Saint-Etienne","0-1",0,1,"1",1,1,-1,"D"
2000-05-04,1999,"AS Monaco","Le Havre AC","5-2",5,2,"1",1,7,3,"H"
2000-05-04,1999,"FC Metz","ATAC Troyes","3-1",3,1,"1",1,4,2,"H"
2000-05-04,1999,"Paris Saint-Germain","Montpellier HSC","3-0",3,0,"1",1,3,3,"H"
2000-05-04,1999,"Olympique Lyon","SC Bastia","2-1",2,1,"1",1,3,1,"H"
2000-05-13,1999,"Montpellier HSC","Olympique Lyon","2-2",2,2,"1",1,4,0,"D"
2000-05-13,1999,"ATAC Troyes","Paris Saint-Germain","2-2",2,2,"1",1,4,0,"D"
2000-05-13,1999,"Stade Rennes","FC Metz","2-0",2,0,"1",1,2,2,"H"
2000-05-13,1999,"AS Saint-Etienne","AS Monaco","3-1",3,1,"1",1,4,2,"H"
2000-05-13,1999,"RC Lens","RC Strasbourg","3-0",3,0,"1",1,3,3,"H"
2000-05-13,1999,"SC Bastia","Girondins Bordeaux","1-1",1,1,"1",1,2,0,"D"
2000-05-13,1999,"AS Nancy","AJ Auxerre","2-0",2,0,"1",1,2,2,"H"
2000-05-13,1999,"CS Sedan","Olympique Marseille","2-2",2,2,"1",1,4,0,"D"
2000-05-13,1999,"Le Havre AC","FC Nantes","0-1",0,1,"1",1,1,-1,"D"
2000-07-28,2000,"Olympique Marseille","ESTAC Troyes","3-1",3,1,"1",1,4,2,"H"
2000-07-28,2000,"Paris Saint-Germain","RC Strasbourg","3-1",3,1,"1",1,4,2,"H"
2000-07-29,2000,"AJ Auxerre","CS Sedan","0-1",0,1,"1",1,1,-1,"D"
2000-07-29,2000,"Girondins Bordeaux","FC Metz","1-1",1,1,"1",1,2,0,"D"
2000-07-29,2000,"EA Guingamp","AS Saint-Etienne","2-2",2,2,"1",1,4,0,"D"
2000-07-29,2000,"Lille OSC","AS Monaco","1-1",1,1,"1",1,2,0,"D"
2000-07-29,2000,"Olympique Lyon","Stade Rennes","2-2",2,2,"1",1,4,0,"D"
2000-07-29,2000,"FC Nantes","RC Lens","0-2",0,2,"1",1,2,-2,"D"
2000-07-29,2000,"Toulouse FC","SC Bastia","0-1",0,1,"1",1,1,-1,"D"
2000-08-03,2000,"CS Sedan","Olympique Lyon","1-1",1,1,"1",1,2,0,"D"
2000-08-04,2000,"AS Monaco","FC Nantes","2-5",2,5,"1",1,7,-3,"D"
2000-08-04,2000,"AS Saint-Etienne","Olympique Marseille","3-0",3,0,"1",1,3,3,"H"
2000-08-05,2000,"SC Bastia","Girondins Bordeaux","2-0",2,0,"1",1,2,2,"H"
2000-08-05,2000,"RC Lens","EA Guingamp","3-2",3,2,"1",1,5,1,"H"
2000-08-05,2000,"FC Metz","AJ Auxerre","1-2",1,2,"1",1,3,-1,"D"
2000-08-05,2000,"Stade Rennes","Paris Saint-Germain","1-1",1,1,"1",1,2,0,"D"
2000-08-05,2000,"RC Strasbourg","Lille OSC","0-4",0,4,"1",1,4,-4,"D"
2000-08-05,2000,"ESTAC Troyes","Toulouse FC","1-1",1,1,"1",1,2,0,"D"
2000-08-12,2000,"AJ Auxerre","SC Bastia","1-0",1,0,"1",1,1,1,"H"
2000-08-12,2000,"Girondins Bordeaux","ESTAC Troyes","2-2",2,2,"1",1,4,0,"D"
2000-08-12,2000,"EA Guingamp","FC Nantes","0-1",0,1,"1",1,1,-1,"D"
2000-08-12,2000,"Lille OSC","Stade Rennes","1-0",1,0,"1",1,1,1,"H"
2000-08-12,2000,"Olympique Lyon","FC Metz","0-0",0,0,"1",1,0,0,"D"
2000-08-12,2000,"RC Strasbourg","AS Monaco","1-3",1,3,"1",1,4,-2,"D"
2000-08-12,2000,"Toulouse FC","AS Saint-Etienne","1-1",1,1,"1",1,2,0,"D"
2000-08-13,2000,"Paris Saint-Germain","CS Sedan","2-1",2,1,"1",1,3,1,"H"
2000-08-13,2000,"Olympique Marseille","RC Lens","0-0",0,0,"1",1,0,0,"D"
2000-08-18,2000,"SC Bastia","Olympique Lyon","2-0",2,0,"1",1,2,2,"H"
2000-08-19,2000,"AS Saint-Etienne","Girondins Bordeaux","1-0",1,0,"1",1,1,1,"H"
2000-08-19,2000,"RC Lens","Toulouse FC","2-1",2,1,"1",1,3,1,"H"
2000-08-19,2000,"FC Metz","Paris Saint-Germain","1-0",1,0,"1",1,1,1,"H"
2000-08-19,2000,"FC Nantes","Olympique Marseille","3-2",3,2,"1",1,5,1,"H"
2000-08-19,2000,"Stade Rennes","RC Strasbourg","3-0",3,0,"1",1,3,3,"H"
2000-08-19,2000,"CS Sedan","Lille OSC","1-0",1,0,"1",1,1,1,"H"
2000-08-19,2000,"ESTAC Troyes","AJ Auxerre","1-0",1,0,"1",1,1,1,"H"
2000-08-20,2000,"AS Monaco","EA Guingamp","1-0",1,0,"1",1,1,1,"H"
2000-08-26,2000,"Girondins Bordeaux","RC Lens","1-1",1,1,"1",1,2,0,"D"
2000-08-26,2000,"Lille OSC","FC Metz","2-1",2,1,"1",1,3,1,"H"
2000-08-26,2000,"Olympique Lyon","ESTAC Troyes","1-0",1,0,"1",1,1,1,"H"
2000-08-26,2000,"Olympique Marseille","EA Guingamp","3-1",3,1,"1",1,4,2,"H"
2000-08-26,2000,"Stade Rennes","AS Monaco","1-1",1,1,"1",1,2,0,"D"
2000-08-26,2000,"RC Strasbourg","CS Sedan","3-2",3,2,"1",1,5,1,"H"
2000-08-26,2000,"Toulouse FC","FC Nantes","1-1",1,1,"1",1,2,0,"D"
2000-08-27,2000,"AJ Auxerre","AS Saint-Etienne","4-3",4,3,"1",1,7,1,"H"
2000-08-27,2000,"Paris Saint-Germain","SC Bastia","3-1",3,1,"1",1,4,2,"H"
2000-09-05,2000,"AS Monaco","Olympique Marseille","0-2",0,2,"1",1,2,-2,"D"
2000-09-06,2000,"FC Nantes","Girondins Bordeaux","0-5",0,5,"1",1,5,-5,"D"
2000-09-06,2000,"AS Saint-Etienne","Olympique Lyon","2-2",2,2,"1",1,4,0,"D"
2000-09-06,2000,"SC Bastia","Lille OSC","1-0",1,0,"1",1,1,1,"H"
2000-09-06,2000,"EA Guingamp","Toulouse FC","2-1",2,1,"1",1,3,1,"H"
2000-09-06,2000,"RC Lens","AJ Auxerre","1-0",1,0,"1",1,1,1,"H"
2000-09-06,2000,"FC Metz","RC Strasbourg","1-0",1,0,"1",1,1,1,"H"
2000-09-06,2000,"ESTAC Troyes","Paris Saint-Germain","5-3",5,3,"1",1,8,2,"H"
2000-09-09,2000,"CS Sedan","AS Monaco","1-0",1,0,"1",1,1,1,"H"
2000-09-09,2000,"Paris Saint-Germain","AS Saint-Etienne","5-1",5,1,"1",1,6,4,"H"
2000-09-09,2000,"Stade Rennes","FC Metz","0-1",0,1,"1",1,1,-1,"D"
2000-09-09,2000,"RC Strasbourg","SC Bastia","1-4",1,4,"1",1,5,-3,"D"
2000-09-09,2000,"AJ Auxerre","FC Nantes","2-2",2,2,"1",1,4,0,"D"
2000-09-09,2000,"Girondins Bordeaux","EA Guingamp","0-2",0,2,"1",1,2,-2,"D"
2000-09-09,2000,"Lille OSC","ESTAC Troyes","1-2",1,2,"1",1,3,-1,"D"
2000-09-09,2000,"Olympique Lyon","RC Lens","3-0",3,0,"1",1,3,3,"H"
2000-09-10,2000,"Toulouse FC","Olympique Marseille","2-0",2,0,"1",1,2,2,"H"
2000-09-16,2000,"RC Lens","Paris Saint-Germain","1-1",1,1,"1",1,2,0,"D"
2000-09-16,2000,"Olympique Marseille","Girondins Bordeaux","0-1",0,1,"1",1,1,-1,"D"
2000-09-16,2000,"FC Metz","CS Sedan","1-0",1,0,"1",1,1,1,"H"
2000-09-16,2000,"AS Monaco","Toulouse FC","3-0",3,0,"1",1,3,3,"H"
2000-09-16,2000,"SC Bastia","Stade Rennes","0-2",0,2,"1",1,2,-2,"D"
2000-09-16,2000,"EA Guingamp","AJ Auxerre","1-0",1,0,"1",1,1,1,"H"
2000-09-16,2000,"ESTAC Troyes","RC Strasbourg","0-1",0,1,"1",1,1,-1,"D"
2000-09-17,2000,"FC Nantes","Olympique Lyon","0-1",0,1,"1",1,1,-1,"D"
2000-09-17,2000,"AS Saint-Etienne","Lille OSC","1-1",1,1,"1",1,2,0,"D"
2000-09-23,2000,"AJ Auxerre","Olympique Marseille","0-1",0,1,"1",1,1,-1,"D"
2000-09-23,2000,"Girondins Bordeaux","Toulouse FC","2-1",2,1,"1",1,3,1,"H"
2000-09-23,2000,"Olympique Lyon","EA Guingamp","0-1",0,1,"1",1,1,-1,"D"
2000-09-23,2000,"FC Metz","AS Monaco","1-3",1,3,"1",1,4,-2,"D"
2000-09-23,2000,"Paris Saint-Germain","FC Nantes","2-1",2,1,"1",1,3,1,"H"
2000-09-23,2000,"Stade Rennes","ESTAC Troyes","0-2",0,2,"1",1,2,-2,"D"
2000-09-23,2000,"CS Sedan","SC Bastia","3-3",3,3,"1",1,6,0,"D"
2000-09-23,2000,"RC Strasbourg","AS Saint-Etienne","3-2",3,2,"1",1,5,1,"H"
2000-09-24,2000,"Lille OSC","RC Lens","2-1",2,1,"1",1,3,1,"H"
2000-09-30,2000,"EA Guingamp","Paris Saint-Germain","1-1",1,1,"1",1,2,0,"D"
2000-09-30,2000,"RC Lens","RC Strasbourg","0-0",0,0,"1",1,0,0,"D"
2000-09-30,2000,"AS Monaco","Girondins Bordeaux","2-2",2,2,"1",1,4,0,"D"
2000-09-30,2000,"AS Saint-Etienne","Stade Rennes","0-2",0,2,"1",1,2,-2,"D"
2000-09-30,2000,"Toulouse FC","AJ Auxerre","0-1",0,1,"1",1,1,-1,"D"
2000-09-30,2000,"ESTAC Troyes","CS Sedan","1-1",1,1,"1",1,2,0,"D"
2000-09-30,2000,"SC Bastia","FC Metz","1-0",1,0,"1",1,1,1,"H"
2000-10-01,2000,"FC Nantes","Lille OSC","0-0",0,0,"1",1,0,0,"D"
2000-10-01,2000,"Olympique Marseille","Olympique Lyon","1-1",1,1,"1",1,2,0,"D"
2000-10-10,2000,"CS Sedan","Stade Rennes","2-1",2,1,"1",1,3,1,"H"
2000-10-13,2000,"SC Bastia","AS Monaco","0-2",0,2,"1",1,2,-2,"D"
2000-10-13,2000,"Paris Saint-Germain","Olympique Marseille","2-0",2,0,"1",1,2,2,"H"
2000-10-14,2000,"Stade Rennes","RC Lens","1-0",1,0,"1",1,1,1,"H"
2000-10-14,2000,"CS Sedan","AS Saint-Etienne","2-1",2,1,"1",1,3,1,"H"
2000-10-14,2000,"RC Strasbourg","FC Nantes","0-5",0,5,"1",1,5,-5,"D"
2000-10-14,2000,"Lille OSC","EA Guingamp","1-1",1,1,"1",1,2,0,"D"
2000-10-14,2000,"FC Metz","ESTAC Troyes","2-2",2,2,"1",1,4,0,"D"
2000-10-15,2000,"AJ Auxerre","Girondins Bordeaux","0-2",0,2,"1",1,2,-2,"D"
2000-10-21,2000,"Toulouse FC","Paris Saint-Germain","2-3",2,3,"1",1,5,-1,"D"
2000-10-21,2000,"ESTAC Troyes","SC Bastia","0-0",0,0,"1",1,0,0,"D"
2000-10-21,2000,"AS Monaco","AJ Auxerre","1-1",1,1,"1",1,2,0,"D"
2000-10-21,2000,"FC Nantes","Stade Rennes","1-0",1,0,"1",1,1,1,"H"
2000-10-21,2000,"AS Saint-Etienne","FC Metz","2-0",2,0,"1",1,2,2,"H"
2000-10-21,2000,"Girondins Bordeaux","Olympique Lyon","1-1",1,1,"1",1,2,0,"D"
2000-10-21,2000,"EA Guingamp","RC Strasbourg","2-1",2,1,"1",1,3,1,"H"
2000-10-21,2000,"RC Lens","CS Sedan","1-1",1,1,"1",1,2,0,"D"
2000-10-22,2000,"Olympique Marseille","Lille OSC","0-1",0,1,"1",1,1,-1,"D"
2000-10-28,2000,"RC Strasbourg","Olympique Marseille","1-1",1,1,"1",1,2,0,"D"
2000-10-29,2000,"ESTAC Troyes","AS Monaco","1-0",1,0,"1",1,1,1,"H"
2000-10-29,2000,"SC Bastia","AS Saint-Etienne","0-0",0,0,"1",1,0,0,"D"
2000-10-29,2000,"Lille OSC","Toulouse FC","1-0",1,0,"1",1,1,1,"H"
2000-10-29,2000,"Olympique Lyon","AJ Auxerre","2-2",2,2,"1",1,4,0,"D"
2000-10-29,2000,"FC Metz","RC Lens","2-1",2,1,"1",1,3,1,"H"
2000-10-29,2000,"Paris Saint-Germain","Girondins Bordeaux","1-2",1,2,"1",1,3,-1,"D"
2000-10-29,2000,"Stade Rennes","EA Guingamp","1-2",1,2,"1",1,3,-1,"D"
2000-10-29,2000,"CS Sedan","FC Nantes","2-0",2,0,"1",1,2,2,"H"
2000-11-03,2000,"AS Monaco","Olympique Lyon","0-2",0,2,"1",1,2,-2,"D"
2000-11-04,2000,"AJ Auxerre","Paris Saint-Germain","1-0",1,0,"1",1,1,1,"H"
2000-11-04,2000,"Girondins Bordeaux","Lille OSC","1-0",1,0,"1",1,1,1,"H"
2000-11-04,2000,"EA Guingamp","CS Sedan","0-3",0,3,"1",1,3,-3,"D"
2000-11-04,2000,"RC Lens","SC Bastia","4-0",4,0,"1",1,4,4,"H"
2000-11-04,2000,"Olympique Marseille","Stade Rennes","0-1",0,1,"1",1,1,-1,"D"
2000-11-04,2000,"FC Nantes","FC Metz","2-0",2,0,"1",1,2,2,"H"
2000-11-04,2000,"AS Saint-Etienne","ESTAC Troyes","4-1",4,1,"1",1,5,3,"H"
2000-11-04,2000,"Toulouse FC","RC Strasbourg","0-0",0,0,"1",1,0,0,"D"
2000-11-10,2000,"AS Saint-Etienne","AS Monaco","1-0",1,0,"1",1,1,1,"H"
2000-11-11,2000,"Paris Saint-Germain","Olympique Lyon","1-1",1,1,"1",1,2,0,"D"
2000-11-11,2000,"Stade Rennes","Toulouse FC","1-1",1,1,"1",1,2,0,"D"
2000-11-11,2000,"Lille OSC","AJ Auxerre","1-1",1,1,"1",1,2,0,"D"
2000-11-11,2000,"FC Metz","EA Guingamp","1-1",1,1,"1",1,2,0,"D"
2000-11-11,2000,"CS Sedan","Olympique Marseille","2-0",2,0,"1",1,2,2,"H"
2000-11-11,2000,"ESTAC Troyes","RC Lens","1-0",1,0,"1",1,1,1,"H"
2000-11-12,2000,"RC Strasbourg","Girondins Bordeaux","0-2",0,2,"1",1,2,-2,"D"
2000-11-17,2000,"Olympique Marseille","FC Metz","4-1",4,1,"1",1,5,3,"H"
2000-11-18,2000,"AS Monaco","Paris Saint-Germain","2-0",2,0,"1",1,2,2,"H"
2000-11-18,2000,"FC Nantes","ESTAC Troyes","4-0",4,0,"1",1,4,4,"H"
2000-11-18,2000,"Toulouse FC","CS Sedan","2-0",2,0,"1",1,2,2,"H"
2000-11-18,2000,"EA Guingamp","SC Bastia","1-0",1,0,"1",1,1,1,"H"
2000-11-18,2000,"RC Lens","AS Saint-Etienne","0-0",0,0,"1",1,0,0,"D"
2000-11-18,2000,"Olympique Lyon","Lille OSC","0-1",0,1,"1",1,1,-1,"D"
2000-11-19,2000,"AJ Auxerre","RC Strasbourg","1-2",1,2,"1",1,3,-1,"D"
2000-11-19,2000,"Girondins Bordeaux","Stade Rennes","3-0",3,0,"1",1,3,3,"H"
2000-11-25,2000,"SC Bastia","Olympique Marseille","3-0",3,0,"1",1,3,3,"H"
2000-11-25,2000,"RC Lens","AS Monaco","4-3",4,3,"1",1,7,1,"H"
2000-11-25,2000,"RC Strasbourg","Olympique Lyon","0-3",0,3,"1",1,3,-3,"D"
2000-11-25,2000,"ESTAC Troyes","EA Guingamp","0-1",0,1,"1",1,1,-1,"D"
2000-11-25,2000,"FC Metz","Toulouse FC","1-1",1,1,"1",1,2,0,"D"
2000-11-25,2000,"Stade Rennes","AJ Auxerre","0-1",0,1,"1",1,1,-1,"D"
2000-11-26,2000,"AS Saint-Etienne","FC Nantes","0-2",0,2,"1",1,2,-2,"D"
2000-11-26,2000,"CS Sedan","Girondins Bordeaux","0-0",0,0,"1",1,0,0,"D"
2000-11-28,2000,"EA Guingamp","RC Lens","0-1",0,1,"1",1,1,-1,"D"
2000-11-28,2000,"Paris Saint-Germain","Stade Rennes","0-1",0,1,"1",1,1,-1,"D"
2000-11-29,2000,"Toulouse FC","ESTAC Troyes","2-1",2,1,"1",1,3,1,"H"
2000-11-29,2000,"AJ Auxerre","FC Metz","1-0",1,0,"1",1,1,1,"H"
2000-11-29,2000,"Girondins Bordeaux","SC Bastia","0-0",0,0,"1",1,0,0,"D"
2000-11-29,2000,"Lille OSC","RC Strasbourg","1-1",1,1,"1",1,2,0,"D"
2000-11-29,2000,"Olympique Lyon","CS Sedan","2-2",2,2,"1",1,4,0,"D"
2000-11-29,2000,"Olympique Marseille","AS Saint-Etienne","2-1",2,1,"1",1,3,1,"H"
2000-11-29,2000,"FC Nantes","AS Monaco","3-1",3,1,"1",1,4,2,"H"
2000-12-02,2000,"FC Metz","Olympique Lyon","0-0",0,0,"1",1,0,0,"D"
2000-12-02,2000,"AS Monaco","RC Strasbourg","1-0",1,0,"1",1,1,1,"H"
2000-12-02,2000,"FC Nantes","EA Guingamp","2-1",2,1,"1",1,3,1,"H"
2000-12-02,2000,"Stade Rennes","Lille OSC","2-0",2,0,"1",1,2,2,"H"
2000-12-02,2000,"AS Saint-Etienne","Toulouse FC","1-0",1,0,"1",1,1,1,"H"
2000-12-02,2000,"CS Sedan","Paris Saint-Germain","5-1",5,1,"1",1,6,4,"H"
2000-12-02,2000,"ESTAC Troyes","Girondins Bordeaux","1-0",1,0,"1",1,1,1,"H"
2000-12-02,2000,"SC Bastia","AJ Auxerre","3-1",3,1,"1",1,4,2,"H"
2000-12-03,2000,"RC Lens","Olympique Marseille","1-0",1,0,"1",1,1,1,"H"
2000-12-09,2000,"Paris Saint-Germain","FC Metz","1-0",1,0,"1",1,1,1,"H"
2000-12-09,2000,"RC Strasbourg","Stade Rennes","1-1",1,1,"1",1,2,0,"D"
2000-12-09,2000,"Toulouse FC","RC Lens","1-0",1,0,"1",1,1,1,"H"
2000-12-09,2000,"AJ Auxerre","ESTAC Troyes","2-2",2,2,"1",1,4,0,"D"
2000-12-09,2000,"EA Guingamp","AS Monaco","2-2",2,2,"1",1,4,0,"D"
2000-12-09,2000,"Lille OSC","CS Sedan","2-0",2,0,"1",1,2,2,"H"
2000-12-09,2000,"Olympique Lyon","SC Bastia","1-0",1,0,"1",1,1,1,"H"
2000-12-10,2000,"Olympique Marseille","FC Nantes","2-0",2,0,"1",1,2,2,"H"
2000-12-10,2000,"Girondins Bordeaux","AS Saint-Etienne","2-1",2,1,"1",1,3,1,"H"
2000-12-13,2000,"Olympique Lyon","Toulouse FC","4-1",4,1,"1",1,5,3,"H"
2000-12-13,2000,"SC Bastia","FC Nantes","3-1",3,1,"1",1,4,2,"H"
2000-12-13,2000,"Lille OSC","Paris Saint-Germain","2-0",2,0,"1",1,2,2,"H"
2000-12-16,2000,"EA Guingamp","Olympique Marseille","1-0",1,0,"1",1,1,1,"H"
2000-12-16,2000,"RC Lens","Girondins Bordeaux","2-2",2,2,"1",1,4,0,"D"
2000-12-16,2000,"FC Metz","Lille OSC","1-1",1,1,"1",1,2,0,"D"
2000-12-16,2000,"AS Monaco","Stade Rennes","1-2",1,2,"1",1,3,-1,"D"
2000-12-16,2000,"AS Saint-Etienne","AJ Auxerre","2-0",2,0,"1",1,2,2,"H"
2000-12-16,2000,"CS Sedan","RC Strasbourg","1-0",1,0,"1",1,1,1,"H"
2000-12-16,2000,"ESTAC Troyes","Olympique Lyon","1-0",1,0,"1",1,1,1,"H"
2000-12-17,2000,"FC Nantes","Toulouse FC","3-2",3,2,"1",1,5,1,"H"
2000-12-17,2000,"SC Bastia","Paris Saint-Germain","1-1",1,1,"1",1,2,0,"D"
2000-12-20,2000,"Olympique Marseille","AS Monaco","2-1",2,1,"1",1,3,1,"H"
2000-12-21,2000,"Girondins Bordeaux","FC Nantes","0-2",0,2,"1",1,2,-2,"D"
2000-12-21,2000,"Lille OSC","SC Bastia","1-0",1,0,"1",1,1,1,"H"
2000-12-21,2000,"Olympique Lyon","AS Saint-Etienne","2-1",2,1,"1",1,3,1,"H"
2000-12-21,2000,"AJ Auxerre","RC Lens","3-2",3,2,"1",1,5,1,"H"
2000-12-21,2000,"Toulouse FC","EA Guingamp","1-1",1,1,"1",1,2,0,"D"
2000-12-21,2000,"Paris Saint-Germain","ESTAC Troyes","0-0",0,0,"1",1,0,0,"D"
2000-12-21,2000,"Stade Rennes","CS Sedan","2-0",2,0,"1",1,2,2,"H"
2001-01-12,2000,"RC Lens","Olympique Lyon","0-0",0,0,"1",1,0,0,"D"
2001-01-13,2000,"FC Nantes","AJ Auxerre","1-1",1,1,"1",1,2,0,"D"
2001-01-13,2000,"AS Saint-Etienne","Paris Saint-Germain","1-0",1,0,"1",1,1,1,"H"
2001-01-13,2000,"ESTAC Troyes","Lille OSC","2-1",2,1,"1",1,3,1,"H"
2001-01-13,2000,"SC Bastia","RC Strasbourg","3-1",3,1,"1",1,4,2,"H"
2001-01-13,2000,"EA Guingamp","Girondins Bordeaux","1-1",1,1,"1",1,2,0,"D"
2001-01-13,2000,"Olympique Marseille","Toulouse FC","1-1",1,1,"1",1,2,0,"D"
2001-01-13,2000,"FC Metz","Stade Rennes","2-2",2,2,"1",1,4,0,"D"
2001-01-13,2000,"AS Monaco","CS Sedan","1-0",1,0,"1",1,1,1,"H"
2001-01-26,2000,"Girondins Bordeaux","Olympique Marseille","3-0",3,0,"1",1,3,3,"H"
2001-01-27,2000,"Olympique Lyon","FC Nantes","3-1",3,1,"1",1,4,2,"H"
2001-01-27,2000,"Paris Saint-Germain","RC Lens","1-0",1,0,"1",1,1,1,"H"
2001-01-27,2000,"Stade Rennes","SC Bastia","1-2",1,2,"1",1,3,-1,"D"
2001-01-27,2000,"CS Sedan","FC Metz","0-0",0,0,"1",1,0,0,"D"
2001-01-27,2000,"RC Strasbourg","ESTAC Troyes","3-3",3,3,"1",1,6,0,"D"
2001-01-27,2000,"Toulouse FC","AS Monaco","2-1",2,1,"1",1,3,1,"H"
2001-01-27,2000,"Lille OSC","AS Saint-Etienne","4-1",4,1,"1",1,5,3,"H"
2001-01-27,2000,"AJ Auxerre","EA Guingamp","1-1",1,1,"1",1,2,0,"D"
2001-02-03,2000,"FC Nantes","Paris Saint-Germain","1-0",1,0,"1",1,1,1,"H"
2001-02-03,2000,"AS Saint-Etienne","RC Strasbourg","3-3",3,3,"1",1,6,0,"D"
2001-02-03,2000,"Toulouse FC","Girondins Bordeaux","1-1",1,1,"1",1,2,0,"D"
2001-02-03,2000,"SC Bastia","CS Sedan","0-1",0,1,"1",1,1,-1,"D"
2001-02-03,2000,"EA Guingamp","Olympique Lyon","2-3",2,3,"1",1,5,-1,"D"
2001-02-03,2000,"Olympique Marseille","AJ Auxerre","0-1",0,1,"1",1,1,-1,"D"
2001-02-03,2000,"AS Monaco","FC Metz","6-1",6,1,"1",1,7,5,"H"
2001-02-04,2000,"RC Lens","Lille OSC","0-1",0,1,"1",1,1,-1,"D"
2001-02-06,2000,"Stade Rennes","AS Saint-Etienne","3-0",3,0,"1",1,3,3,"H"
2001-02-06,2000,"Paris Saint-Germain","EA Guingamp","1-3",1,3,"1",1,4,-2,"D"
2001-02-06,2000,"Olympique Lyon","Olympique Marseille","1-1",1,1,"1",1,2,0,"D"
2001-02-07,2000,"FC Metz","SC Bastia","3-2",3,2,"1",1,5,1,"H"
2001-02-07,2000,"AJ Auxerre","Toulouse FC","2-0",2,0,"1",1,2,2,"H"
2001-02-07,2000,"Girondins Bordeaux","AS Monaco","2-1",2,1,"1",1,3,1,"H"
2001-02-07,2000,"Lille OSC","FC Nantes","1-1",1,1,"1",1,2,0,"D"
2001-02-07,2000,"CS Sedan","ESTAC Troyes","2-1",2,1,"1",1,3,1,"H"
2001-02-07,2000,"RC Strasbourg","RC Lens","1-0",1,0,"1",1,1,1,"H"
2001-02-17,2000,"Olympique Marseille","Paris Saint-Germain","1-0",1,0,"1",1,1,1,"H"
2001-02-17,2000,"AS Monaco","SC Bastia","2-1",2,1,"1",1,3,1,"H"
2001-02-17,2000,"EA Guingamp","Lille OSC","0-1",0,1,"1",1,1,-1,"D"
2001-02-17,2000,"RC Lens","Stade Rennes","1-2",1,2,"1",1,3,-1,"D"
2001-02-17,2000,"AS Saint-Etienne","CS Sedan","0-2",0,2,"1",1,2,-2,"D"
2001-02-17,2000,"Toulouse FC","Olympique Lyon","1-1",1,1,"1",1,2,0,"D"
2001-02-17,2000,"ESTAC Troyes","FC Metz","3-2",3,2,"1",1,5,1,"H"
2001-02-18,2000,"FC Nantes","RC Strasbourg","1-0",1,0,"1",1,1,1,"H"
2001-02-18,2000,"Girondins Bordeaux","AJ Auxerre","1-0",1,0,"1",1,1,1,"H"
2001-02-23,2000,"ESTAC Troyes","Stade Rennes","3-1",3,1,"1",1,4,2,"H"
2001-03-03,2000,"Olympique Lyon","Girondins Bordeaux","2-1",2,1,"1",1,3,1,"H"
2001-03-03,2000,"FC Metz","AS Saint-Etienne","3-0",3,0,"1",1,3,3,"H"
2001-03-03,2000,"Paris Saint-Germain","Toulouse FC","3-0",3,0,"1",1,3,3,"H"
2001-03-03,2000,"AJ Auxerre","AS Monaco","1-0",1,0,"1",1,1,1,"H"
2001-03-03,2000,"SC Bastia","ESTAC Troyes","2-2",2,2,"1",1,4,0,"D"
2001-03-03,2000,"Lille OSC","Olympique Marseille","1-0",1,0,"1",1,1,1,"H"
2001-03-03,2000,"CS Sedan","RC Lens","2-2",2,2,"1",1,4,0,"D"
2001-03-03,2000,"RC Strasbourg","EA Guingamp","0-1",0,1,"1",1,1,-1,"D"
2001-03-04,2000,"Stade Rennes","FC Nantes","0-2",0,2,"1",1,2,-2,"D"
2001-03-17,2000,"Toulouse FC","Lille OSC","0-2",0,2,"1",1,2,-2,"D"
2001-03-17,2000,"AJ Auxerre","Olympique Lyon","0-3",0,3,"1",1,3,-3,"D"
2001-03-17,2000,"EA Guingamp","Stade Rennes","1-6",1,6,"1",1,7,-5,"D"
2001-03-17,2000,"RC Lens","FC Metz","1-1",1,1,"1",1,2,0,"D"
2001-03-17,2000,"Olympique Marseille","RC Strasbourg","0-0",0,0,"1",1,0,0,"D"
2001-03-17,2000,"AS Monaco","ESTAC Troyes","4-3",4,3,"1",1,7,1,"H"
2001-03-17,2000,"FC Nantes","CS Sedan","4-1",4,1,"1",1,5,3,"H"
2001-03-17,2000,"AS Saint-Etienne","SC Bastia","2-1",2,1,"1",1,3,1,"H"
2001-03-18,2000,"Girondins Bordeaux","Paris Saint-Germain","2-0",2,0,"1",1,2,2,"H"
2001-04-06,2000,"Lille OSC","Girondins Bordeaux","2-2",2,2,"1",1,4,0,"D"
2001-04-07,2000,"Olympique Lyon","AS Monaco","2-1",2,1,"1",1,3,1,"H"
2001-04-07,2000,"FC Metz","FC Nantes","1-2",1,2,"1",1,3,-1,"D"
2001-04-07,2000,"Paris Saint-Germain","AJ Auxerre","3-0",3,0,"1",1,3,3,"H"
2001-04-07,2000,"Stade Rennes","Olympique Marseille","2-0",2,0,"1",1,2,2,"H"
2001-04-07,2000,"CS Sedan","EA Guingamp","2-2",2,2,"1",1,4,0,"D"
2001-04-07,2000,"RC Strasbourg","Toulouse FC","1-0",1,0,"1",1,1,1,"H"
2001-04-07,2000,"ESTAC Troyes","AS Saint-Etienne","0-0",0,0,"1",1,0,0,"D"
2001-04-07,2000,"SC Bastia","RC Lens","1-3",1,3,"1",1,4,-2,"D"
2001-04-11,2000,"RC Strasbourg","FC Metz","0-1",0,1,"1",1,1,-1,"D"
2001-04-14,2000,"FC Nantes","SC Bastia","1-0",1,0,"1",1,1,1,"H"
2001-04-14,2000,"Toulouse FC","Stade Rennes","2-0",2,0,"1",1,2,2,"H"
2001-04-14,2000,"Olympique Marseille","CS Sedan","2-1",2,1,"1",1,3,1,"H"
2001-04-14,2000,"AS Monaco","AS Saint-Etienne","5-3",5,3,"1",1,8,2,"H"
2001-04-14,2000,"AJ Auxerre","Lille OSC","1-1",1,1,"1",1,2,0,"D"
2001-04-14,2000,"Girondins Bordeaux","RC Strasbourg","2-1",2,1,"1",1,3,1,"H"
2001-04-14,2000,"EA Guingamp","FC Metz","1-3",1,3,"1",1,4,-2,"D"
2001-04-15,2000,"Olympique Lyon","Paris Saint-Germain","2-0",2,0,"1",1,2,2,"H"
2001-04-28,2000,"FC Metz","Olympique Marseille","1-0",1,0,"1",1,1,1,"H"
2001-04-28,2000,"Paris Saint-Germain","AS Monaco","1-1",1,1,"1",1,2,0,"D"
2001-04-28,2000,"Stade Rennes","Girondins Bordeaux","1-2",1,2,"1",1,3,-1,"D"
2001-04-28,2000,"AS Saint-Etienne","RC Lens","1-1",1,1,"1",1,2,0,"D"
2001-04-28,2000,"CS Sedan","Toulouse FC","2-3",2,3,"1",1,5,-1,"D"
2001-04-28,2000,"RC Strasbourg","AJ Auxerre","1-0",1,0,"1",1,1,1,"H"
2001-04-28,2000,"SC Bastia","EA Guingamp","2-0",2,0,"1",1,2,2,"H"
2001-04-28,2000,"Lille OSC","Olympique Lyon","1-2",1,2,"1",1,3,-1,"D"
2001-04-29,2000,"ESTAC Troyes","FC Nantes","0-1",0,1,"1",1,1,-1,"D"
2001-05-04,2000,"RC Lens","ESTAC Troyes","1-1",1,1,"1",1,2,0,"D"
2001-05-12,2000,"AJ Auxerre","Stade Rennes","0-1",0,1,"1",1,1,-1,"D"
2001-05-12,2000,"Girondins Bordeaux","CS Sedan","2-2",2,2,"1",1,4,0,"D"
2001-05-12,2000,"EA Guingamp","ESTAC Troyes","1-1",1,1,"1",1,2,0,"D"
2001-05-12,2000,"Olympique Lyon","RC Strasbourg","5-0",5,0,"1",1,5,5,"H"
2001-05-12,2000,"Olympique Marseille","SC Bastia","2-1",2,1,"1",1,3,1,"H"
2001-05-12,2000,"AS Monaco","RC Lens","0-0",0,0,"1",1,0,0,"D"
2001-05-12,2000,"FC Nantes","AS Saint-Etienne","1-0",1,0,"1",1,1,1,"H"
2001-05-12,2000,"Paris Saint-Germain","Lille OSC","2-2",2,2,"1",1,4,0,"D"
2001-05-12,2000,"Toulouse FC","FC Metz","2-1",2,1,"1",1,3,1,"H"
2001-05-19,2000,"SC Bastia","Toulouse FC","5-1",5,1,"1",1,6,4,"H"
2001-05-19,2000,"RC Lens","FC Nantes","1-4",1,4,"1",1,5,-3,"D"
2001-05-19,2000,"FC Metz","Girondins Bordeaux","2-0",2,0,"1",1,2,2,"H"
2001-05-19,2000,"AS Monaco","Lille OSC","1-2",1,2,"1",1,3,-1,"D"
2001-05-19,2000,"Stade Rennes","Olympique Lyon","3-4",3,4,"1",1,7,-1,"D"
2001-05-19,2000,"AS Saint-Etienne","EA Guingamp","2-2",2,2,"1",1,4,0,"D"
2001-05-19,2000,"CS Sedan","AJ Auxerre","1-0",1,0,"1",1,1,1,"H"
2001-05-19,2000,"RC Strasbourg","Paris Saint-Germain","1-2",1,2,"1",1,3,-1,"D"
2001-05-19,2000,"ESTAC Troyes","Olympique Marseille","1-1",1,1,"1",1,2,0,"D"
2001-07-27,2001,"Girondins Bordeaux","FC Nantes","2-0",2,0,"1",1,2,2,"H"
2001-07-28,2001,"Paris Saint-Germain","Lille OSC","0-0",0,0,"1",1,0,0,"D"
2001-07-28,2001,"AS Monaco","FC Sochaux","0-1",0,1,"1",1,1,-1,"D"
2001-07-28,2001,"SC Bastia","CS Sedan","1-1",1,1,"1",1,2,0,"D"
2001-07-28,2001,"RC Lens","Olympique Lyon","2-0",2,0,"1",1,2,2,"H"
2001-07-28,2001,"Stade Rennes","AJ Auxerre","0-5",0,5,"1",1,5,-5,"D"
2001-07-28,2001,"Montpellier HSC","Olympique Marseille","1-1",1,1,"1",1,2,0,"D"
2001-07-28,2001,"ESTAC Troyes","EA Guingamp","3-0",3,0,"1",1,3,3,"H"
2001-07-28,2001,"FC Lorient","FC Metz","1-0",1,0,"1",1,1,1,"H"
2001-08-03,2001,"Olympique Marseille","Girondins Bordeaux","0-0",0,0,"1",1,0,0,"D"
2001-08-04,2001,"FC Nantes","RC Lens","1-2",1,2,"1",1,3,-1,"D"
2001-08-04,2001,"EA Guingamp","SC Bastia","1-0",1,0,"1",1,1,1,"H"
2001-08-04,2001,"FC Sochaux","Stade Rennes","4-3",4,3,"1",1,7,1,"H"
2001-08-04,2001,"Olympique Lyon","CS Sedan","2-0",2,0,"1",1,2,2,"H"
2001-08-04,2001,"FC Metz","ESTAC Troyes","2-1",2,1,"1",1,3,1,"H"
2001-08-04,2001,"AJ Auxerre","Paris Saint-Germain","1-1",1,1,"1",1,2,0,"D"
2001-08-04,2001,"AS Monaco","Montpellier HSC","0-0",0,0,"1",1,0,0,"D"
2001-08-04,2001,"Lille OSC","FC Lorient","3-1",3,1,"1",1,4,2,"H"
2001-08-11,2001,"Stade Rennes","AS Monaco","3-0",3,0,"1",1,3,3,"H"
2001-08-11,2001,"Paris Saint-Germain","FC Sochaux","1-0",1,0,"1",1,1,1,"H"
2001-08-11,2001,"Girondins Bordeaux","Lille OSC","0-0",0,0,"1",1,0,0,"D"
2001-08-11,2001,"RC Lens","Olympique Marseille","2-0",2,0,"1",1,2,2,"H"
2001-08-11,2001,"Montpellier HSC","FC Metz","3-0",3,0,"1",1,3,3,"H"
2001-08-11,2001,"CS Sedan","EA Guingamp","1-1",1,1,"1",1,2,0,"D"
2001-08-11,2001,"ESTAC Troyes","FC Nantes","0-0",0,0,"1",1,0,0,"D"
2001-08-12,2001,"FC Lorient","AJ Auxerre","0-1",0,1,"1",1,1,-1,"D"
2001-08-12,2001,"SC Bastia","Olympique Lyon","1-2",1,2,"1",1,3,-1,"D"
2001-08-18,2001,"AS Monaco","Paris Saint-Germain","2-2",2,2,"1",1,4,0,"D"
2001-08-18,2001,"Lille OSC","Montpellier HSC","2-1",2,1,"1",1,3,1,"H"
2001-08-18,2001,"FC Metz","RC Lens","0-1",0,1,"1",1,1,-1,"D"
2001-08-18,2001,"Olympique Lyon","EA Guingamp","3-0",3,0,"1",1,3,3,"H"
2001-08-18,2001,"FC Nantes","SC Bastia","1-2",1,2,"1",1,3,-1,"D"
2001-08-18,2001,"Olympique Marseille","ESTAC Troyes","0-1",0,1,"1",1,1,-1,"D"
2001-08-18,2001,"Stade Rennes","Girondins Bordeaux","1-0",1,0,"1",1,1,1,"H"
2001-08-18,2001,"FC Sochaux","FC Lorient","2-2",2,2,"1",1,4,0,"D"
2001-08-19,2001,"AJ Auxerre","CS Sedan","2-1",2,1,"1",1,3,1,"H"
2001-08-25,2001,"Girondins Bordeaux","AJ Auxerre","1-1",1,1,"1",1,2,0,"D"
2001-08-25,2001,"Paris Saint-Germain","Stade Rennes","3-0",3,0,"1",1,3,3,"H"
2001-08-25,2001,"SC Bastia","Olympique Marseille","1-0",1,0,"1",1,1,1,"H"
2001-08-25,2001,"Montpellier HSC","FC Sochaux","0-0",0,0,"1",1,0,0,"D"
2001-08-25,2001,"CS Sedan","FC Metz","2-0",2,0,"1",1,2,2,"H"
2001-08-25,2001,"ESTAC Troyes","Olympique Lyon","0-2",0,2,"1",1,2,-2,"D"
2001-08-25,2001,"FC Lorient","AS Monaco","2-0",2,0,"1",1,2,2,"H"
2001-08-25,2001,"EA Guingamp","FC Nantes","1-0",1,0,"1",1,1,1,"H"
2001-08-26,2001,"RC Lens","Lille OSC","1-1",1,1,"1",1,2,0,"D"
2001-09-08,2001,"Olympique Marseille","Olympique Lyon","0-0",0,0,"1",1,0,0,"D"
2001-09-08,2001,"Paris Saint-Germain","RC Lens","2-2",2,2,"1",1,4,0,"D"
2001-09-08,2001,"AS Monaco","ESTAC Troyes","2-0",2,0,"1",1,2,2,"H"
2001-09-08,2001,"AJ Auxerre","Montpellier HSC","1-0",1,0,"1",1,1,1,"H"
2001-09-08,2001,"FC Metz","SC Bastia","0-1",0,1,"1",1,1,-1,"D"
2001-09-08,2001,"FC Nantes","CS Sedan","1-1",1,1,"1",1,2,0,"D"
2001-09-08,2001,"Stade Rennes","FC Lorient","1-1",1,1,"1",1,2,0,"D"
2001-09-08,2001,"Lille OSC","EA Guingamp","1-0",1,0,"1",1,1,1,"H"
2001-09-09,2001,"FC Sochaux","Girondins Bordeaux","2-0",2,0,"1",1,2,2,"H"
2001-09-15,2001,"Olympique Lyon","FC Nantes","4-1",4,1,"1",1,5,3,"H"
2001-09-15,2001,"SC Bastia","AJ Auxerre","0-1",0,1,"1",1,1,-1,"D"
2001-09-15,2001,"RC Lens","FC Sochaux","3-0",3,0,"1",1,3,3,"H"
2001-09-15,2001,"Montpellier HSC","Stade Rennes","0-0",0,0,"1",1,0,0,"D"
2001-09-15,2001,"ESTAC Troyes","Lille OSC","0-1",0,1,"1",1,1,-1,"D"
2001-09-15,2001,"FC Lorient","Paris Saint-Germain","1-1",1,1,"1",1,2,0,"D"
2001-09-15,2001,"EA Guingamp","FC Metz","0-2",0,2,"1",1,2,-2,"D"
2001-09-16,2001,"Girondins Bordeaux","AS Monaco","0-0",0,0,"1",1,0,0,"D"
2001-09-16,2001,"CS Sedan","Olympique Marseille","1-1",1,1,"1",1,2,0,"D"
2001-09-21,2001,"Paris Saint-Germain","Montpellier HSC","0-0",0,0,"1",1,0,0,"D"
2001-09-22,2001,"AS Monaco","RC Lens","3-0",3,0,"1",1,3,3,"H"
2001-09-22,2001,"AJ Auxerre","EA Guingamp","2-2",2,2,"1",1,4,0,"D"
2001-09-22,2001,"FC Metz","Olympique Lyon","2-0",2,0,"1",1,2,2,"H"
2001-09-22,2001,"Olympique Marseille","FC Nantes","2-0",2,0,"1",1,2,2,"H"
2001-09-22,2001,"Stade Rennes","ESTAC Troyes","0-1",0,1,"1",1,1,-1,"D"
2001-09-22,2001,"Lille OSC","SC Bastia","2-1",2,1,"1",1,3,1,"H"
2001-09-23,2001,"FC Lorient","Girondins Bordeaux","0-2",0,2,"1",1,2,-2,"D"
2001-09-23,2001,"FC Sochaux","CS Sedan","3-0",3,0,"1",1,3,3,"H"
2001-09-29,2001,"EA Guingamp","Olympique Marseille","1-0",1,0,"1",1,1,1,"H"
2001-09-29,2001,"Olympique Lyon","Stade Rennes","4-0",4,0,"1",1,4,4,"H"
2001-09-29,2001,"SC Bastia","AS Monaco","1-0",1,0,"1",1,1,1,"H"
2001-09-29,2001,"FC Nantes","FC Metz","0-0",0,0,"1",1,0,0,"D"
2001-09-29,2001,"RC Lens","AJ Auxerre","1-1",1,1,"1",1,2,0,"D"
2001-09-29,2001,"Montpellier HSC","FC Lorient","1-3",1,3,"1",1,4,-2,"D"
2001-09-30,2001,"CS Sedan","Lille OSC","1-1",1,1,"1",1,2,0,"D"
2001-09-30,2001,"ESTAC Troyes","FC Sochaux","2-2",2,2,"1",1,4,0,"D"
2001-09-30,2001,"Girondins Bordeaux","Paris Saint-Germain","1-0",1,0,"1",1,1,1,"H"
2001-10-13,2001,"FC Metz","Olympique Marseille","0-2",0,2,"1",1,2,-2,"D"
2001-10-13,2001,"AS Monaco","CS Sedan","2-0",2,0,"1",1,2,2,"H"
2001-10-13,2001,"AJ Auxerre","ESTAC Troyes","1-3",1,3,"1",1,4,-2,"D"
2001-10-13,2001,"Stade Rennes","EA Guingamp","2-1",2,1,"1",1,3,1,"H"
2001-10-13,2001,"Montpellier HSC","Girondins Bordeaux","0-0",0,0,"1",1,0,0,"D"
2001-10-13,2001,"FC Lorient","RC Lens","2-3",2,3,"1",1,5,-1,"D"
2001-10-13,2001,"FC Sochaux","SC Bastia","4-1",4,1,"1",1,5,3,"H"
2001-10-13,2001,"Lille OSC","FC Nantes","1-0",1,0,"1",1,1,1,"H"
2001-10-14,2001,"Paris Saint-Germain","Olympique Lyon","2-2",2,2,"1",1,4,0,"D"
2001-10-20,2001,"Olympique Lyon","FC Sochaux","1-1",1,1,"1",1,2,0,"D"
2001-10-20,2001,"SC Bastia","Stade Rennes","1-2",1,2,"1",1,3,-1,"D"
2001-10-20,2001,"FC Nantes","AJ Auxerre","2-2",2,2,"1",1,4,0,"D"
2001-10-20,2001,"Olympique Marseille","Lille OSC","0-0",0,0,"1",1,0,0,"D"
2001-10-20,2001,"RC Lens","Montpellier HSC","2-0",2,0,"1",1,2,2,"H"
2001-10-20,2001,"EA Guingamp","AS Monaco","2-1",2,1,"1",1,3,1,"H"
2001-10-21,2001,"Girondins Bordeaux","FC Metz","1-0",1,0,"1",1,1,1,"H"
2001-10-21,2001,"ESTAC Troyes","FC Lorient","4-2",4,2,"1",1,6,2,"H"
2001-10-21,2001,"CS Sedan","Paris Saint-Germain","1-2",1,2,"1",1,3,-1,"D"
2001-10-26,2001,"AJ Auxerre","Olympique Marseille","2-0",2,0,"1",1,2,2,"H"
2001-10-27,2001,"Stade Rennes","RC Lens","1-2",1,2,"1",1,3,-1,"D"
2001-10-27,2001,"Paris Saint-Germain","SC Bastia","1-0",1,0,"1",1,1,1,"H"
2001-10-27,2001,"AS Monaco","Olympique Lyon","2-1",2,1,"1",1,3,1,"H"
2001-10-27,2001,"Girondins Bordeaux","CS Sedan","2-1",2,1,"1",1,3,1,"H"
2001-10-27,2001,"Montpellier HSC","ESTAC Troyes","2-0",2,0,"1",1,2,2,"H"
2001-10-27,2001,"FC Lorient","EA Guingamp","6-2",6,2,"1",1,8,4,"H"
2001-10-27,2001,"FC Sochaux","FC Nantes","0-1",0,1,"1",1,1,-1,"D"
2001-10-27,2001,"Lille OSC","FC Metz","2-0",2,0,"1",1,2,2,"H"
2001-11-03,2001,"FC Nantes","AS Monaco","2-1",2,1,"1",1,3,1,"H"
2001-11-03,2001,"SC Bastia","FC Lorient","3-1",3,1,"1",1,4,2,"H"
2001-11-03,2001,"Olympique Marseille","Stade Rennes","2-1",2,1,"1",1,3,1,"H"
2001-11-03,2001,"CS Sedan","Montpellier HSC","2-0",2,0,"1",1,2,2,"H"
2001-11-03,2001,"EA Guingamp","FC Sochaux","0-0",0,0,"1",1,0,0,"D"
2001-11-04,2001,"FC Metz","AJ Auxerre","2-0",2,0,"1",1,2,2,"H"
2001-11-04,2001,"ESTAC Troyes","Paris Saint-Germain","1-0",1,0,"1",1,1,1,"H"
2001-11-04,2001,"RC Lens","Girondins Bordeaux","0-0",0,0,"1",1,0,0,"D"
2001-11-04,2001,"Olympique Lyon","Lille OSC","4-2",4,2,"1",1,6,2,"H"
2001-11-16,2001,"AS Monaco","Olympique Marseille","1-1",1,1,"1",1,2,0,"D"
2001-11-17,2001,"Stade Rennes","FC Nantes","2-0",2,0,"1",1,2,2,"H"
2001-11-17,2001,"Paris Saint-Germain","EA Guingamp","1-1",1,1,"1",1,2,0,"D"
2001-11-17,2001,"AJ Auxerre","Lille OSC","2-1",2,1,"1",1,3,1,"H"
2001-11-17,2001,"Girondins Bordeaux","ESTAC Troyes","2-3",2,3,"1",1,5,-1,"D"
2001-11-17,2001,"RC Lens","CS Sedan","1-0",1,0,"1",1,1,1,"H"
2001-11-17,2001,"Montpellier HSC","SC Bastia","2-1",2,1,"1",1,3,1,"H"
2001-11-17,2001,"FC Lorient","Olympique Lyon","0-3",0,3,"1",1,3,-3,"D"
2001-11-17,2001,"FC Sochaux","FC Metz","2-0",2,0,"1",1,2,2,"H"
2001-11-24,2001,"Olympique Marseille","FC Sochaux","4-2",4,2,"1",1,6,2,"H"
2001-11-24,2001,"FC Metz","AS Monaco","1-0",1,0,"1",1,1,1,"H"
2001-11-24,2001,"SC Bastia","Girondins Bordeaux","1-2",1,2,"1",1,3,-1,"D"
2001-11-24,2001,"CS Sedan","FC Lorient","5-0",5,0,"1",1,5,5,"H"
2001-11-24,2001,"ESTAC Troyes","RC Lens","1-1",1,1,"1",1,2,0,"D"
2001-11-24,2001,"EA Guingamp","Montpellier HSC","2-2",2,2,"1",1,4,0,"D"
2001-11-25,2001,"Olympique Lyon","AJ Auxerre","3-0",3,0,"1",1,3,3,"H"
2001-11-25,2001,"Lille OSC","Stade Rennes","1-0",1,0,"1",1,1,1,"H"
2001-11-25,2001,"FC Nantes","Paris Saint-Germain","1-2",1,2,"1",1,3,-1,"D"
2001-11-28,2001,"Montpellier HSC","Olympique Lyon","3-0",3,0,"1",1,3,3,"H"
2001-11-28,2001,"AS Monaco","Lille OSC","2-2",2,2,"1",1,4,0,"D"
2001-11-28,2001,"Girondins Bordeaux","EA Guingamp","2-0",2,0,"1",1,2,2,"H"
2001-11-28,2001,"RC Lens","SC Bastia","7-0",7,0,"1",1,7,7,"H"
2001-11-28,2001,"Stade Rennes","FC Metz","0-0",0,0,"1",1,0,0,"D"
2001-11-28,2001,"ESTAC Troyes","CS Sedan","1-1",1,1,"1",1,2,0,"D"
2001-11-28,2001,"FC Lorient","FC Nantes","1-2",1,2,"1",1,3,-1,"D"
2001-11-28,2001,"FC Sochaux","AJ Auxerre","1-2",1,2,"1",1,3,-1,"D"
2001-11-29,2001,"Paris Saint-Germain","Olympique Marseille","0-0",0,0,"1",1,0,0,"D"
2001-12-08,2001,"AJ Auxerre","AS Monaco","2-0",2,0,"1",1,2,2,"H"
2001-12-08,2001,"SC Bastia","ESTAC Troyes","2-0",2,0,"1",1,2,2,"H"
2001-12-08,2001,"FC Nantes","Montpellier HSC","1-2",1,2,"1",1,3,-1,"D"
2001-12-08,2001,"Olympique Marseille","FC Lorient","3-2",3,2,"1",1,5,1,"H"
2001-12-08,2001,"CS Sedan","Stade Rennes","0-0",0,0,"1",1,0,0,"D"
2001-12-08,2001,"EA Guingamp","RC Lens","1-0",1,0,"1",1,1,1,"H"
2001-12-09,2001,"FC Metz","Paris Saint-Germain","0-2",0,2,"1",1,2,-2,"D"
2001-12-09,2001,"Lille OSC","FC Sochaux","1-2",1,2,"1",1,3,-1,"D"
2001-12-09,2001,"Olympique Lyon","Girondins Bordeaux","1-0",1,0,"1",1,1,1,"H"
2001-12-18,2001,"RC Lens","FC Nantes","3-0",3,0,"1",1,3,3,"H"
2001-12-18,2001,"Girondins Bordeaux","Olympique Marseille","0-0",0,0,"1",1,0,0,"D"
2001-12-19,2001,"Paris Saint-Germain","AJ Auxerre","0-0",0,0,"1",1,0,0,"D"
2001-12-19,2001,"SC Bastia","EA Guingamp","3-0",3,0,"1",1,3,3,"H"
2001-12-19,2001,"Stade Rennes","FC Sochaux","1-1",1,1,"1",1,2,0,"D"
2001-12-19,2001,"CS Sedan","Olympique Lyon","2-1",2,1,"1",1,3,1,"H"
2001-12-19,2001,"FC Lorient","Lille OSC","2-4",2,4,"1",1,6,-2,"D"
2001-12-21,2001,"Olympique Marseille","RC Lens","1-2",1,2,"1",1,3,-1,"D"
2001-12-22,2001,"FC Sochaux","Paris Saint-Germain","0-2",0,2,"1",1,2,-2,"D"
2001-12-22,2001,"AS Monaco","Stade Rennes","3-1",3,1,"1",1,4,2,"H"
2001-12-22,2001,"FC Nantes","ESTAC Troyes","1-0",1,0,"1",1,1,1,"H"
2001-12-22,2001,"EA Guingamp","CS Sedan","1-2",1,2,"1",1,3,-1,"D"
2002-01-05,2001,"Paris Saint-Germain","AS Monaco","1-2",1,2,"1",1,3,-1,"D"
2002-01-05,2001,"Girondins Bordeaux","Stade Rennes","2-1",2,1,"1",1,3,1,"H"
2002-01-05,2001,"SC Bastia","FC Nantes","0-2",0,2,"1",1,2,-2,"D"
2002-01-05,2001,"Montpellier HSC","Lille OSC","2-0",2,0,"1",1,2,2,"H"
2002-01-05,2001,"FC Lorient","FC Sochaux","1-1",1,1,"1",1,2,0,"D"
2002-01-05,2001,"EA Guingamp","Olympique Lyon","2-4",2,4,"1",1,6,-2,"D"
2002-01-11,2001,"Lille OSC","RC Lens","0-1",0,1,"1",1,1,-1,"D"
2002-01-12,2001,"Stade Rennes","Paris Saint-Germain","1-2",1,2,"1",1,3,-1,"D"
2002-01-12,2001,"AS Monaco","FC Lorient","1-0",1,0,"1",1,1,1,"H"
2002-01-12,2001,"FC Nantes","EA Guingamp","2-0",2,0,"1",1,2,2,"H"
2002-01-12,2001,"Olympique Marseille","SC Bastia","2-2",2,2,"1",1,4,0,"D"
2002-01-12,2001,"FC Sochaux","Montpellier HSC","0-1",0,1,"1",1,1,-1,"D"
2002-01-16,2001,"Montpellier HSC","AS Monaco","1-1",1,1,"1",1,2,0,"D"
2002-01-16,2001,"ESTAC Troyes","FC Metz","2-0",2,0,"1",1,2,2,"H"
2002-01-16,2001,"AJ Auxerre","FC Lorient","2-2",2,2,"1",1,4,0,"D"
2002-01-16,2001,"Olympique Lyon","SC Bastia","0-0",0,0,"1",1,0,0,"D"
2002-01-16,2001,"Lille OSC","Girondins Bordeaux","2-2",2,2,"1",1,4,0,"D"
2002-01-23,2001,"Girondins Bordeaux","FC Sochaux","0-1",0,1,"1",1,1,-1,"D"
2002-01-23,2001,"Olympique Lyon","Olympique Marseille","4-0",4,0,"1",1,4,4,"H"
2002-01-23,2001,"SC Bastia","FC Metz","1-2",1,2,"1",1,3,-1,"D"
2002-01-23,2001,"Montpellier HSC","AJ Auxerre","0-0",0,0,"1",1,0,0,"D"
2002-01-23,2001,"CS Sedan","FC Nantes","0-0",0,0,"1",1,0,0,"D"
2002-01-23,2001,"ESTAC Troyes","AS Monaco","3-0",3,0,"1",1,3,3,"H"
2002-01-23,2001,"FC Lorient","Stade Rennes","2-0",2,0,"1",1,2,2,"H"
2002-01-23,2001,"EA Guingamp","Lille OSC","0-0",0,0,"1",1,0,0,"D"
2002-01-24,2001,"RC Lens","Paris Saint-Germain","1-1",1,1,"1",1,2,0,"D"
2002-01-26,2001,"ESTAC Troyes","Olympique Marseille","1-0",1,0,"1",1,1,1,"H"
2002-01-29,2001,"FC Nantes","Olympique Lyon","3-0",3,0,"1",1,3,3,"H"
2002-01-30,2001,"AS Monaco","Girondins Bordeaux","3-1",3,1,"1",1,4,2,"H"
2002-01-30,2001,"Paris Saint-Germain","FC Lorient","5-0",5,0,"1",1,5,5,"H"
2002-01-30,2001,"AJ Auxerre","SC Bastia","1-0",1,0,"1",1,1,1,"H"
2002-01-30,2001,"FC Metz","EA Guingamp","2-4",2,4,"1",1,6,-2,"D"
2002-01-30,2001,"Olympique Marseille","CS Sedan","2-1",2,1,"1",1,3,1,"H"
2002-01-30,2001,"Stade Rennes","Montpellier HSC","2-0",2,0,"1",1,2,2,"H"
2002-01-30,2001,"FC Sochaux","RC Lens","0-2",0,2,"1",1,2,-2,"D"
2002-02-02,2001,"Montpellier HSC","Paris Saint-Germain","0-0",0,0,"1",1,0,0,"D"
2002-02-02,2001,"Girondins Bordeaux","FC Lorient","2-1",2,1,"1",1,3,1,"H"
2002-02-02,2001,"Olympique Lyon","FC Metz","4-1",4,1,"1",1,5,3,"H"
2002-02-02,2001,"SC Bastia","Lille OSC","1-0",1,0,"1",1,1,1,"H"
2002-02-02,2001,"RC Lens","AS Monaco","1-0",1,0,"1",1,1,1,"H"
2002-02-02,2001,"CS Sedan","FC Sochaux","2-1",2,1,"1",1,3,1,"H"
2002-02-02,2001,"ESTAC Troyes","Stade Rennes","1-1",1,1,"1",1,2,0,"D"
2002-02-02,2001,"EA Guingamp","AJ Auxerre","0-0",0,0,"1",1,0,0,"D"
2002-02-03,2001,"FC Nantes","Olympique Marseille","3-1",3,1,"1",1,4,2,"H"
2002-02-06,2001,"Stade Rennes","Olympique Lyon","2-2",2,2,"1",1,4,0,"D"
2002-02-06,2001,"AS Monaco","SC Bastia","1-1",1,1,"1",1,2,0,"D"
2002-02-06,2001,"AJ Auxerre","RC Lens","1-0",1,0,"1",1,1,1,"H"
2002-02-06,2001,"FC Metz","FC Nantes","2-0",2,0,"1",1,2,2,"H"
2002-02-06,2001,"Olympique Marseille","EA Guingamp","2-1",2,1,"1",1,3,1,"H"
2002-02-06,2001,"FC Lorient","Montpellier HSC","1-0",1,0,"1",1,1,1,"H"
2002-02-06,2001,"FC Sochaux","ESTAC Troyes","2-2",2,2,"1",1,4,0,"D"
2002-02-06,2001,"Lille OSC","CS Sedan","1-1",1,1,"1",1,2,0,"D"
2002-02-07,2001,"Paris Saint-Germain","Girondins Bordeaux","1-0",1,0,"1",1,1,1,"H"
2002-02-09,2001,"FC Metz","Montpellier HSC","0-0",0,0,"1",1,0,0,"D"
2002-02-09,2001,"Olympique Lyon","ESTAC Troyes","3-1",3,1,"1",1,4,2,"H"
2002-02-16,2001,"FC Nantes","Lille OSC","0-1",0,1,"1",1,1,-1,"D"
2002-02-16,2001,"Girondins Bordeaux","Montpellier HSC","3-1",3,1,"1",1,4,2,"H"
2002-02-16,2001,"SC Bastia","FC Sochaux","3-0",3,0,"1",1,3,3,"H"
2002-02-16,2001,"RC Lens","FC Lorient","1-1",1,1,"1",1,2,0,"D"
2002-02-16,2001,"CS Sedan","AS Monaco","0-0",0,0,"1",1,0,0,"D"
2002-02-16,2001,"ESTAC Troyes","AJ Auxerre","1-2",1,2,"1",1,3,-1,"D"
2002-02-16,2001,"EA Guingamp","Stade Rennes","1-1",1,1,"1",1,2,0,"D"
2002-02-17,2001,"Olympique Marseille","FC Metz","1-0",1,0,"1",1,1,1,"H"
2002-02-17,2001,"Olympique Lyon","Paris Saint-Germain","3-0",3,0,"1",1,3,3,"H"
2002-02-23,2001,"Montpellier HSC","RC Lens","1-2",1,2,"1",1,3,-1,"D"
2002-02-23,2001,"Paris Saint-Germain","CS Sedan","3-0",3,0,"1",1,3,3,"H"
2002-02-23,2001,"AS Monaco","EA Guingamp","3-1",3,1,"1",1,4,2,"H"
2002-02-23,2001,"AJ Auxerre","FC Nantes","2-1",2,1,"1",1,3,1,"H"
2002-02-23,2001,"FC Metz","Girondins Bordeaux","1-2",1,2,"1",1,3,-1,"D"
2002-02-23,2001,"Stade Rennes","SC Bastia","2-1",2,1,"1",1,3,1,"H"
2002-02-23,2001,"FC Lorient","ESTAC Troyes","1-0",1,0,"1",1,1,1,"H"
2002-02-24,2001,"FC Sochaux","Olympique Lyon","2-1",2,1,"1",1,3,1,"H"
2002-02-24,2001,"Lille OSC","Olympique Marseille","2-0",2,0,"1",1,2,2,"H"
2002-03-02,2001,"RC Lens","FC Metz","2-2",2,2,"1",1,4,0,"D"
2002-03-03,2001,"Lille OSC","ESTAC Troyes","1-0",1,0,"1",1,1,1,"H"
2002-03-06,2001,"SC Bastia","Paris Saint-Germain","0-1",0,1,"1",1,1,-1,"D"
2002-03-06,2001,"FC Metz","Lille OSC","0-1",0,1,"1",1,1,-1,"D"
2002-03-06,2001,"Olympique Lyon","AS Monaco","1-0",1,0,"1",1,1,1,"H"
2002-03-06,2001,"FC Nantes","FC Sochaux","0-0",0,0,"1",1,0,0,"D"
2002-03-06,2001,"RC Lens","Stade Rennes","2-0",2,0,"1",1,2,2,"H"
2002-03-06,2001,"CS Sedan","Girondins Bordeaux","1-0",1,0,"1",1,1,1,"H"
2002-03-06,2001,"ESTAC Troyes","Montpellier HSC","2-0",2,0,"1",1,2,2,"H"
2002-03-06,2001,"EA Guingamp","FC Lorient","4-3",4,3,"1",1,7,1,"H"
2002-03-10,2001,"AJ Auxerre","Girondins Bordeaux","0-1",0,1,"1",1,1,-1,"D"
2002-03-16,2001,"Stade Rennes","Olympique Marseille","2-1",2,1,"1",1,3,1,"H"
2002-03-16,2001,"Paris Saint-Germain","ESTAC Troyes","3-1",3,1,"1",1,4,2,"H"
2002-03-16,2001,"AS Monaco","FC Nantes","1-2",1,2,"1",1,3,-1,"D"
2002-03-16,2001,"AJ Auxerre","FC Metz","3-2",3,2,"1",1,5,1,"H"
2002-03-16,2001,"Montpellier HSC","CS Sedan","0-0",0,0,"1",1,0,0,"D"
2002-03-16,2001,"FC Lorient","SC Bastia","0-0",0,0,"1",1,0,0,"D"
2002-03-16,2001,"FC Sochaux","EA Guingamp","1-0",1,0,"1",1,1,1,"H"
2002-03-16,2001,"Lille OSC","Olympique Lyon","2-0",2,0,"1",1,2,2,"H"
2002-03-17,2001,"Girondins Bordeaux","RC Lens","2-1",2,1,"1",1,3,1,"H"
2002-03-23,2001,"EA Guingamp","Paris Saint-Germain","0-1",0,1,"1",1,1,-1,"D"
2002-03-23,2001,"FC Metz","FC Sochaux","2-0",2,0,"1",1,2,2,"H"
2002-03-23,2001,"Olympique Lyon","FC Lorient","2-0",2,0,"1",1,2,2,"H"
2002-03-23,2001,"SC Bastia","Montpellier HSC","3-0",3,0,"1",1,3,3,"H"
2002-03-23,2001,"FC Nantes","Stade Rennes","3-1",3,1,"1",1,4,2,"H"
2002-03-23,2001,"CS Sedan","RC Lens","1-1",1,1,"1",1,2,0,"D"
2002-03-23,2001,"ESTAC Troyes","Girondins Bordeaux","2-0",2,0,"1",1,2,2,"H"
2002-03-23,2001,"Lille OSC","AJ Auxerre","2-3",2,3,"1",1,5,-1,"D"
2002-03-24,2001,"Olympique Marseille","AS Monaco","1-1",1,1,"1",1,2,0,"D"
2002-04-01,2001,"Olympique Marseille","AJ Auxerre","3-0",3,0,"1",1,3,3,"H"
2002-04-06,2001,"RC Lens","ESTAC Troyes","0-0",0,0,"1",1,0,0,"D"
2002-04-06,2001,"Paris Saint-Germain","FC Nantes","1-1",1,1,"1",1,2,0,"D"
2002-04-06,2001,"AS Monaco","FC Metz","2-2",2,2,"1",1,4,0,"D"
2002-04-06,2001,"Girondins Bordeaux","SC Bastia","2-1",2,1,"1",1,3,1,"H"
2002-04-06,2001,"Stade Rennes","Lille OSC","4-0",4,0,"1",1,4,4,"H"
2002-04-06,2001,"Montpellier HSC","EA Guingamp","2-1",2,1,"1",1,3,1,"H"
2002-04-06,2001,"FC Lorient","CS Sedan","1-1",1,1,"1",1,2,0,"D"
2002-04-06,2001,"FC Sochaux","Olympique Marseille","3-0",3,0,"1",1,3,3,"H"
2002-04-07,2001,"AJ Auxerre","Olympique Lyon","0-1",0,1,"1",1,1,-1,"D"
2002-04-09,2001,"FC Metz","CS Sedan","2-3",2,3,"1",1,5,-1,"D"
2002-04-12,2001,"Olympique Marseille","Paris Saint-Germain","1-0",1,0,"1",1,1,1,"H"
2002-04-13,2001,"AJ Auxerre","FC Sochaux","2-0",2,0,"1",1,2,2,"H"
2002-04-13,2001,"FC Metz","Stade Rennes","3-1",3,1,"1",1,4,2,"H"
2002-04-13,2001,"Olympique Lyon","Montpellier HSC","0-0",0,0,"1",1,0,0,"D"
2002-04-13,2001,"SC Bastia","RC Lens","3-1",3,1,"1",1,4,2,"H"
2002-04-13,2001,"FC Nantes","FC Lorient","2-0",2,0,"1",1,2,2,"H"
2002-04-13,2001,"CS Sedan","ESTAC Troyes","0-0",0,0,"1",1,0,0,"D"
2002-04-13,2001,"EA Guingamp","Girondins Bordeaux","2-1",2,1,"1",1,3,1,"H"
2002-04-13,2001,"Lille OSC","AS Monaco","1-1",1,1,"1",1,2,0,"D"
2002-04-21,2001,"CS Sedan","AJ Auxerre","3-3",3,3,"1",1,6,0,"D"
2002-04-27,2001,"Paris Saint-Germain","FC Metz","2-0",2,0,"1",1,2,2,"H"
2002-04-27,2001,"AS Monaco","AJ Auxerre","1-1",1,1,"1",1,2,0,"D"
2002-04-27,2001,"Girondins Bordeaux","Olympique Lyon","0-1",0,1,"1",1,1,-1,"D"
2002-04-27,2001,"RC Lens","EA Guingamp","4-1",4,1,"1",1,5,3,"H"
2002-04-27,2001,"Stade Rennes","CS Sedan","1-0",1,0,"1",1,1,1,"H"
2002-04-27,2001,"Montpellier HSC","FC Nantes","3-0",3,0,"1",1,3,3,"H"
2002-04-27,2001,"ESTAC Troyes","SC Bastia","3-0",3,0,"1",1,3,3,"H"
2002-04-27,2001,"FC Lorient","Olympique Marseille","2-2",2,2,"1",1,4,0,"D"
2002-04-27,2001,"FC Sochaux","Lille OSC","0-0",0,0,"1",1,0,0,"D"
2002-05-04,2001,"AJ Auxerre","Stade Rennes","2-3",2,3,"1",1,5,-1,"D"
2002-05-04,2001,"FC Metz","FC Lorient","1-1",1,1,"1",1,2,0,"D"
2002-05-04,2001,"Olympique Lyon","RC Lens","3-1",3,1,"1",1,4,2,"H"
2002-05-04,2001,"FC Nantes","Girondins Bordeaux","2-1",2,1,"1",1,3,1,"H"
2002-05-04,2001,"Olympique Marseille","Montpellier HSC","1-0",1,0,"1",1,1,1,"H"
2002-05-04,2001,"CS Sedan","SC Bastia","0-2",0,2,"1",1,2,-2,"D"
2002-05-04,2001,"FC Sochaux","AS Monaco","3-0",3,0,"1",1,3,3,"H"
2002-05-04,2001,"EA Guingamp","ESTAC Troyes","1-0",1,0,"1",1,1,1,"H"
2002-05-04,2001,"Lille OSC","Paris Saint-Germain","1-0",1,0,"1",1,1,1,"H"
2002-08-02,2002,"EA Guingamp","Olympique Lyon","3-3",3,3,"1",1,6,0,"D"
2002-08-03,2002,"Olympique Marseille","FC Nantes","0-2",0,2,"1",1,2,-2,"D"
2002-08-03,2002,"ESTAC Troyes","AS Monaco","0-4",0,4,"1",1,4,-4,"D"
2002-08-03,2002,"Paris Saint-Germain","AJ Auxerre","1-0",1,0,"1",1,1,1,"H"
2002-08-03,2002,"CS Sedan","FC Sochaux","0-0",0,0,"1",1,0,0,"D"
2002-08-03,2002,"RC Strasbourg","AC Ajaccio","1-1",1,1,"1",1,2,0,"D"
2002-08-03,2002,"Montpellier HSC","Stade Rennes","1-0",1,0,"1",1,1,1,"H"
2002-08-03,2002,"OGC Nice","Le Havre AC","1-2",1,2,"1",1,3,-1,"D"
2002-08-03,2002,"SC Bastia","RC Lens","1-1",1,1,"1",1,2,0,"D"
2002-08-03,2002,"Lille OSC","Girondins Bordeaux","0-3",0,3,"1",1,3,-3,"D"
2002-08-08,2002,"AJ Auxerre","Montpellier HSC","2-0",2,0,"1",1,2,2,"H"
2002-08-09,2002,"Girondins Bordeaux","Paris Saint-Germain","0-0",0,0,"1",1,0,0,"D"
2002-08-10,2002,"RC Lens","FC Sochaux","1-1",1,1,"1",1,2,0,"D"
2002-08-10,2002,"AS Monaco","Olympique Marseille","0-1",0,1,"1",1,1,-1,"D"
2002-08-10,2002,"OGC Nice","RC Strasbourg","4-0",4,0,"1",1,4,4,"H"
2002-08-10,2002,"Olympique Lyon","CS Sedan","6-1",6,1,"1",1,7,5,"H"
2002-08-10,2002,"FC Nantes","SC Bastia","1-0",1,0,"1",1,1,1,"H"
2002-08-10,2002,"AC Ajaccio","EA Guingamp","0-2",0,2,"1",1,2,-2,"D"
2002-08-10,2002,"Stade Rennes","ESTAC Troyes","0-0",0,0,"1",1,0,0,"D"
2002-08-10,2002,"Le Havre AC","Lille OSC","0-0",0,0,"1",1,0,0,"D"
2002-08-16,2002,"Olympique Marseille","Olympique Lyon","1-1",1,1,"1",1,2,0,"D"
2002-08-17,2002,"Montpellier HSC","Girondins Bordeaux","0-1",0,1,"1",1,1,-1,"D"
2002-08-17,2002,"SC Bastia","AS Monaco","1-0",1,0,"1",1,1,1,"H"
2002-08-17,2002,"CS Sedan","RC Lens","0-1",0,1,"1",1,1,-1,"D"
2002-08-17,2002,"Paris Saint-Germain","AC Ajaccio","2-2",2,2,"1",1,4,0,"D"
2002-08-17,2002,"RC Strasbourg","Le Havre AC","1-1",1,1,"1",1,2,0,"D"
2002-08-17,2002,"EA Guingamp","Stade Rennes","3-0",3,0,"1",1,3,3,"H"
2002-08-17,2002,"Lille OSC","OGC Nice","0-3",0,3,"1",1,3,-3,"D"
2002-08-17,2002,"ESTAC Troyes","AJ Auxerre","1-2",1,2,"1",1,3,-1,"D"
2002-08-17,2002,"FC Sochaux","FC Nantes","4-2",4,2,"1",1,6,2,"H"
2002-08-23,2002,"Lille OSC","ESTAC Troyes","0-0",0,0,"1",1,0,0,"D"
2002-08-24,2002,"FC Nantes","RC Lens","2-2",2,2,"1",1,4,0,"D"
2002-08-24,2002,"Girondins Bordeaux","RC Strasbourg","1-2",1,2,"1",1,3,-1,"D"
2002-08-24,2002,"Stade Rennes","Olympique Marseille","1-3",1,3,"1",1,4,-2,"D"
2002-08-24,2002,"AS Monaco","FC Sochaux","1-0",1,0,"1",1,1,1,"H"
2002-08-24,2002,"AJ Auxerre","EA Guingamp","2-1",2,1,"1",1,3,1,"H"
2002-08-24,2002,"Olympique Lyon","SC Bastia","4-1",4,1,"1",1,5,3,"H"
2002-08-24,2002,"AC Ajaccio","CS Sedan","1-0",1,0,"1",1,1,1,"H"
2002-08-24,2002,"OGC Nice","Montpellier HSC","2-1",2,1,"1",1,3,1,"H"
2002-08-25,2002,"Le Havre AC","Paris Saint-Germain","0-1",0,1,"1",1,1,-1,"D"
2002-08-31,2002,"RC Lens","AS Monaco","1-0",1,0,"1",1,1,1,"H"
2002-08-31,2002,"SC Bastia","Stade Rennes","3-1",3,1,"1",1,4,2,"H"
2002-08-31,2002,"Montpellier HSC","Le Havre AC","0-0",0,0,"1",1,0,0,"D"
2002-08-31,2002,"Paris Saint-Germain","OGC Nice","1-1",1,1,"1",1,2,0,"D"
2002-08-31,2002,"RC Strasbourg","Lille OSC","2-2",2,2,"1",1,4,0,"D"
2002-08-31,2002,"FC Sochaux","Olympique Lyon","2-1",2,1,"1",1,3,1,"H"
2002-08-31,2002,"EA Guingamp","Girondins Bordeaux","0-0",0,0,"1",1,0,0,"D"
2002-08-31,2002,"CS Sedan","FC Nantes","1-0",1,0,"1",1,1,1,"H"
2002-08-31,2002,"ESTAC Troyes","AC Ajaccio","1-0",1,0,"1",1,1,1,"H"
2002-09-01,2002,"Olympique Marseille","AJ Auxerre","0-0",0,0,"1",1,0,0,"D"
2002-09-10,2002,"Olympique Lyon","RC Lens","1-0",1,0,"1",1,1,1,"H"
2002-09-11,2002,"OGC Nice","Olympique Marseille","2-0",2,0,"1",1,2,2,"H"
2002-09-11,2002,"Girondins Bordeaux","ESTAC Troyes","1-0",1,0,"1",1,1,1,"H"
2002-09-11,2002,"Stade Rennes","FC Sochaux","2-2",2,2,"1",1,4,0,"D"
2002-09-11,2002,"AS Monaco","FC Nantes","2-1",2,1,"1",1,3,1,"H"
2002-09-11,2002,"AJ Auxerre","SC Bastia","1-0",1,0,"1",1,1,1,"H"
2002-09-11,2002,"Lille OSC","Paris Saint-Germain","2-1",2,1,"1",1,3,1,"H"
2002-09-11,2002,"RC Strasbourg","CS Sedan","1-1",1,1,"1",1,2,0,"D"
2002-09-11,2002,"AC Ajaccio","Montpellier HSC","0-0",0,0,"1",1,0,0,"D"
2002-09-11,2002,"Le Havre AC","EA Guingamp","1-2",1,2,"1",1,3,-1,"D"
2002-09-14,2002,"Olympique Marseille","Girondins Bordeaux","2-1",2,1,"1",1,3,1,"H"
2002-09-14,2002,"FC Nantes","Olympique Lyon","1-0",1,0,"1",1,1,1,"H"
2002-09-14,2002,"Montpellier HSC","Lille OSC","1-0",1,0,"1",1,1,1,"H"
2002-09-14,2002,"Paris Saint-Germain","RC Strasbourg","3-0",3,0,"1",1,3,3,"H"
2002-09-14,2002,"FC Sochaux","AJ Auxerre","1-1",1,1,"1",1,2,0,"D"
2002-09-14,2002,"RC Lens","Stade Rennes","1-0",1,0,"1",1,1,1,"H"
2002-09-14,2002,"EA Guingamp","OGC Nice","0-0",0,0,"1",1,0,0,"D"
2002-09-14,2002,"CS Sedan","AS Monaco","2-2",2,2,"1",1,4,0,"D"
2002-09-14,2002,"ESTAC Troyes","Le Havre AC","1-1",1,1,"1",1,2,0,"D"
2002-09-15,2002,"SC Bastia","AC Ajaccio","1-2",1,2,"1",1,3,-1,"D"
2002-09-21,2002,"Olympique Lyon","AS Monaco","1-3",1,3,"1",1,4,-2,"D"
2002-09-21,2002,"Girondins Bordeaux","RC Lens","1-0",1,0,"1",1,1,1,"H"
2002-09-21,2002,"Stade Rennes","FC Nantes","1-0",1,0,"1",1,1,1,"H"
2002-09-21,2002,"Lille OSC","EA Guingamp","2-1",2,1,"1",1,3,1,"H"
2002-09-21,2002,"RC Strasbourg","Montpellier HSC","3-2",3,2,"1",1,5,1,"H"
2002-09-21,2002,"AC Ajaccio","FC Sochaux","0-1",0,1,"1",1,1,-1,"D"
2002-09-21,2002,"Le Havre AC","Olympique Marseille","1-3",1,3,"1",1,4,-2,"D"
2002-09-21,2002,"OGC Nice","ESTAC Troyes","1-0",1,0,"1",1,1,1,"H"
2002-09-22,2002,"Paris Saint-Germain","SC Bastia","1-1",1,1,"1",1,2,0,"D"
2002-09-27,2002,"Olympique Marseille","AC Ajaccio","3-1",3,1,"1",1,4,2,"H"
2002-09-28,2002,"FC Nantes","AJ Auxerre","1-4",1,4,"1",1,5,-3,"D"
2002-09-28,2002,"Montpellier HSC","Paris Saint-Germain","1-1",1,1,"1",1,2,0,"D"
2002-09-28,2002,"AS Monaco","Stade Rennes","2-1",2,1,"1",1,3,1,"H"
2002-09-28,2002,"SC Bastia","Girondins Bordeaux","2-1",2,1,"1",1,3,1,"H"
2002-09-28,2002,"FC Sochaux","OGC Nice","1-0",1,0,"1",1,1,1,"H"
2002-09-28,2002,"RC Lens","Lille OSC","0-0",0,0,"1",1,0,0,"D"
2002-09-28,2002,"EA Guingamp","RC Strasbourg","2-3",2,3,"1",1,5,-1,"D"
2002-09-28,2002,"CS Sedan","Le Havre AC","4-0",4,0,"1",1,4,4,"H"
2002-09-28,2002,"ESTAC Troyes","Olympique Lyon","1-1",1,1,"1",1,2,0,"D"
2002-10-05,2002,"Le Havre AC","FC Sochaux","1-0",1,0,"1",1,1,1,"H"
2002-10-05,2002,"Lille OSC","Olympique Marseille","3-0",3,0,"1",1,3,3,"H"
2002-10-05,2002,"RC Strasbourg","ESTAC Troyes","2-1",2,1,"1",1,3,1,"H"
2002-10-05,2002,"Stade Rennes","Olympique Lyon","0-1",0,1,"1",1,1,-1,"D"
2002-10-05,2002,"AC Ajaccio","FC Nantes","1-0",1,0,"1",1,1,1,"H"
2002-10-05,2002,"Montpellier HSC","RC Lens","0-2",0,2,"1",1,2,-2,"D"
2002-10-05,2002,"OGC Nice","SC Bastia","2-0",2,0,"1",1,2,2,"H"
2002-10-06,2002,"Girondins Bordeaux","CS Sedan","2-2",2,2,"1",1,4,0,"D"
2002-10-06,2002,"AJ Auxerre","AS Monaco","1-1",1,1,"1",1,2,0,"D"
2002-10-06,2002,"Paris Saint-Germain","EA Guingamp","5-0",5,0,"1",1,5,5,"H"
2002-10-19,2002,"Olympique Lyon","AJ Auxerre","3-0",3,0,"1",1,3,3,"H"
2002-10-19,2002,"SC Bastia","Le Havre AC","3-1",3,1,"1",1,4,2,"H"
2002-10-19,2002,"RC Lens","AC Ajaccio","1-1",1,1,"1",1,2,0,"D"
2002-10-19,2002,"AS Monaco","Lille OSC","1-1",1,1,"1",1,2,0,"D"
2002-10-19,2002,"FC Sochaux","Girondins Bordeaux","2-0",2,0,"1",1,2,2,"H"
2002-10-19,2002,"FC Nantes","OGC Nice","0-0",0,0,"1",1,0,0,"D"
2002-10-19,2002,"EA Guingamp","Montpellier HSC","3-1",3,1,"1",1,4,2,"H"
2002-10-19,2002,"CS Sedan","Stade Rennes","1-3",1,3,"1",1,4,-2,"D"
2002-10-19,2002,"ESTAC Troyes","Paris Saint-Germain","1-2",1,2,"1",1,3,-1,"D"
2002-10-20,2002,"Olympique Marseille","RC Strasbourg","1-0",1,0,"1",1,1,1,"H"
2002-10-25,2002,"Girondins Bordeaux","AS Monaco","2-2",2,2,"1",1,4,0,"D"
2002-10-26,2002,"Paris Saint-Germain","Olympique Marseille","3-0",3,0,"1",1,3,3,"H"
2002-10-26,2002,"Montpellier HSC","ESTAC Troyes","2-2",2,2,"1",1,4,0,"D"
2002-10-26,2002,"AJ Auxerre","Stade Rennes","1-0",1,0,"1",1,1,1,"H"
2002-10-26,2002,"Lille OSC","FC Sochaux","1-0",1,0,"1",1,1,1,"H"
2002-10-26,2002,"RC Strasbourg","SC Bastia","2-0",2,0,"1",1,2,2,"H"
2002-10-26,2002,"Le Havre AC","FC Nantes","1-1",1,1,"1",1,2,0,"D"
2002-10-26,2002,"AC Ajaccio","Olympique Lyon","0-1",0,1,"1",1,1,-1,"D"
2002-10-26,2002,"EA Guingamp","CS Sedan","0-1",0,1,"1",1,1,-1,"D"
2002-10-26,2002,"OGC Nice","RC Lens","0-0",0,0,"1",1,0,0,"D"
2002-11-02,2002,"Olympique Lyon","OGC Nice","2-2",2,2,"1",1,4,0,"D"
2002-11-02,2002,"SC Bastia","Lille OSC","1-0",1,0,"1",1,1,1,"H"
2002-11-02,2002,"RC Lens","AJ Auxerre","3-1",3,1,"1",1,4,2,"H"
2002-11-02,2002,"AS Monaco","Le Havre AC","1-1",1,1,"1",1,2,0,"D"
2002-11-02,2002,"ESTAC Troyes","EA Guingamp","0-2",0,2,"1",1,2,-2,"D"
2002-11-02,2002,"Olympique Marseille","Montpellier HSC","2-0",2,0,"1",1,2,2,"H"
2002-11-02,2002,"FC Sochaux","RC Strasbourg","2-0",2,0,"1",1,2,2,"H"
2002-11-02,2002,"Stade Rennes","AC Ajaccio","0-0",0,0,"1",1,0,0,"D"
2002-11-03,2002,"CS Sedan","Paris Saint-Germain","3-1",3,1,"1",1,4,2,"H"
2002-11-03,2002,"FC Nantes","Girondins Bordeaux","0-0",0,0,"1",1,0,0,"D"
2002-11-07,2002,"Le Havre AC","Olympique Lyon","1-2",1,2,"1",1,3,-1,"D"
2002-11-07,2002,"AC Ajaccio","AJ Auxerre","1-0",1,0,"1",1,1,1,"H"
2002-11-08,2002,"OGC Nice","AS Monaco","1-0",1,0,"1",1,1,1,"H"
2002-11-09,2002,"Girondins Bordeaux","Stade Rennes","2-0",2,0,"1",1,2,2,"H"
2002-11-09,2002,"RC Strasbourg","RC Lens","2-0",2,0,"1",1,2,2,"H"
2002-11-09,2002,"ESTAC Troyes","SC Bastia","3-0",3,0,"1",1,3,3,"H"
2002-11-09,2002,"Paris Saint-Germain","FC Sochaux","1-1",1,1,"1",1,2,0,"D"
2002-11-09,2002,"Lille OSC","FC Nantes","0-1",0,1,"1",1,1,-1,"D"
2002-11-09,2002,"Montpellier HSC","CS Sedan","2-0",2,0,"1",1,2,2,"H"
2002-11-09,2002,"EA Guingamp","Olympique Marseille","0-0",0,0,"1",1,0,0,"D"
2002-11-14,2002,"AS Monaco","AC Ajaccio","3-2",3,2,"1",1,5,1,"H"
2002-11-16,2002,"AJ Auxerre","OGC Nice","0-2",0,2,"1",1,2,-2,"D"
2002-11-16,2002,"Olympique Lyon","Girondins Bordeaux","4-2",4,2,"1",1,6,2,"H"
2002-11-16,2002,"Olympique Marseille","ESTAC Troyes","0-0",0,0,"1",1,0,0,"D"
2002-11-16,2002,"CS Sedan","Lille OSC","0-1",0,1,"1",1,1,-1,"D"
2002-11-16,2002,"SC Bastia","EA Guingamp","0-2",0,2,"1",1,2,-2,"D"
2002-11-16,2002,"FC Nantes","RC Strasbourg","4-1",4,1,"1",1,5,3,"H"
2002-11-16,2002,"FC Sochaux","Montpellier HSC","0-0",0,0,"1",1,0,0,"D"
2002-11-16,2002,"Stade Rennes","Le Havre AC","0-0",0,0,"1",1,0,0,"D"
2002-11-17,2002,"RC Lens","Paris Saint-Germain","3-2",3,2,"1",1,5,1,"H"
2002-11-22,2002,"Paris Saint-Germain","FC Nantes","0-1",0,1,"1",1,1,-1,"D"
2002-11-23,2002,"Olympique Marseille","RC Lens","1-0",1,0,"1",1,1,1,"H"
2002-11-23,2002,"Montpellier HSC","SC Bastia","2-2",2,2,"1",1,4,0,"D"
2002-11-23,2002,"Girondins Bordeaux","AC Ajaccio","1-0",1,0,"1",1,1,1,"H"
2002-11-23,2002,"OGC Nice","Stade Rennes","0-0",0,0,"1",1,0,0,"D"
2002-11-23,2002,"Le Havre AC","AJ Auxerre","0-1",0,1,"1",1,1,-1,"D"
2002-11-23,2002,"Lille OSC","Olympique Lyon","2-1",2,1,"1",1,3,1,"H"
2002-11-23,2002,"ESTAC Troyes","CS Sedan","2-0",2,0,"1",1,2,2,"H"
2002-11-23,2002,"EA Guingamp","FC Sochaux","2-0",2,0,"1",1,2,2,"H"
2002-11-24,2002,"RC Strasbourg","AS Monaco","1-0",1,0,"1",1,1,1,"H"
2002-11-30,2002,"AS Monaco","Paris Saint-Germain","3-1",3,1,"1",1,4,2,"H"
2002-11-30,2002,"FC Sochaux","ESTAC Troyes","1-0",1,0,"1",1,1,1,"H"
2002-11-30,2002,"SC Bastia","Olympique Marseille","2-0",2,0,"1",1,2,2,"H"
2002-11-30,2002,"FC Nantes","Montpellier HSC","3-1",3,1,"1",1,4,2,"H"
2002-11-30,2002,"AC Ajaccio","Le Havre AC","1-2",1,2,"1",1,3,-1,"D"
2002-11-30,2002,"Stade Rennes","Lille OSC","5-1",5,1,"1",1,6,4,"H"
2002-11-30,2002,"CS Sedan","OGC Nice","3-0",3,0,"1",1,3,3,"H"
2002-12-01,2002,"Olympique Lyon","RC Strasbourg","2-1",2,1,"1",1,3,1,"H"
2002-12-01,2002,"RC Lens","EA Guingamp","1-3",1,3,"1",1,4,-2,"D"
2002-12-01,2002,"AJ Auxerre","Girondins Bordeaux","1-0",1,0,"1",1,1,1,"H"
2002-12-03,2002,"OGC Nice","AC Ajaccio","3-0",3,0,"1",1,3,3,"H"
2002-12-04,2002,"Paris Saint-Germain","Olympique Lyon","2-0",2,0,"1",1,2,2,"H"
2002-12-04,2002,"SC Bastia","CS Sedan","0-1",0,1,"1",1,1,-1,"D"
2002-12-04,2002,"Montpellier HSC","AS Monaco","1-2",1,2,"1",1,3,-1,"D"
2002-12-04,2002,"RC Strasbourg","Stade Rennes","1-3",1,3,"1",1,4,-2,"D"
2002-12-04,2002,"Olympique Marseille","FC Sochaux","1-0",1,0,"1",1,1,1,"H"
2002-12-04,2002,"Le Havre AC","Girondins Bordeaux","1-0",1,0,"1",1,1,1,"H"
2002-12-04,2002,"Lille OSC","AJ Auxerre","2-2",2,2,"1",1,4,0,"D"
2002-12-04,2002,"ESTAC Troyes","RC Lens","0-0",0,0,"1",1,0,0,"D"
2002-12-04,2002,"EA Guingamp","FC Nantes","2-0",2,0,"1",1,2,2,"H"
2002-12-14,2002,"FC Sochaux","SC Bastia","2-0",2,0,"1",1,2,2,"H"
2002-12-14,2002,"CS Sedan","Olympique Marseille","1-2",1,2,"1",1,3,-1,"D"
2002-12-15,2002,"Girondins Bordeaux","OGC Nice","4-0",4,0,"1",1,4,4,"H"
2002-12-15,2002,"RC Lens","Le Havre AC","1-0",1,0,"1",1,1,1,"H"
2002-12-15,2002,"AS Monaco","EA Guingamp","4-0",4,0,"1",1,4,4,"H"
2002-12-15,2002,"AJ Auxerre","RC Strasbourg","0-0",0,0,"1",1,0,0,"D"
2002-12-15,2002,"Olympique Lyon","Montpellier HSC","1-1",1,1,"1",1,2,0,"D"
2002-12-15,2002,"FC Nantes","ESTAC Troyes","2-1",2,1,"1",1,3,1,"H"
2002-12-15,2002,"AC Ajaccio","Lille OSC","2-2",2,2,"1",1,4,0,"D"
2002-12-15,2002,"Stade Rennes","Paris Saint-Germain","1-0",1,0,"1",1,1,1,"H"
2002-12-19,2002,"Paris Saint-Germain","Girondins Bordeaux","1-1",1,1,"1",1,2,0,"D"
2002-12-20,2002,"FC Sochaux","RC Lens","3-0",3,0,"1",1,3,3,"H"
2002-12-20,2002,"SC Bastia","FC Nantes","3-1",3,1,"1",1,4,2,"H"
2002-12-20,2002,"CS Sedan","Olympique Lyon","1-1",1,1,"1",1,2,0,"D"
2002-12-20,2002,"RC Strasbourg","OGC Nice","0-0",0,0,"1",1,0,0,"D"
2002-12-20,2002,"EA Guingamp","AC Ajaccio","3-1",3,1,"1",1,4,2,"H"
2002-12-20,2002,"Olympique Marseille","AS Monaco","1-1",1,1,"1",1,2,0,"D"
2002-12-20,2002,"Lille OSC","Le Havre AC","1-0",1,0,"1",1,1,1,"H"
2002-12-20,2002,"ESTAC Troyes","Stade Rennes","0-1",0,1,"1",1,1,-1,"D"
2003-01-10,2002,"Olympique Lyon","Olympique Marseille","1-0",1,0,"1",1,1,1,"H"
2003-01-11,2002,"Stade Rennes","EA Guingamp","2-1",2,1,"1",1,3,1,"H"
2003-01-11,2002,"AJ Auxerre","ESTAC Troyes","1-0",1,0,"1",1,1,1,"H"
2003-01-11,2002,"Girondins Bordeaux","Montpellier HSC","3-1",3,1,"1",1,4,2,"H"
2003-01-11,2002,"AS Monaco","SC Bastia","0-0",0,0,"1",1,0,0,"D"
2003-01-11,2002,"OGC Nice","Lille OSC","2-0",2,0,"1",1,2,2,"H"
2003-01-11,2002,"AC Ajaccio","Paris Saint-Germain","0-0",0,0,"1",1,0,0,"D"
2003-01-14,2002,"Olympique Marseille","Stade Rennes","2-0",2,0,"1",1,2,2,"H"
2003-01-15,2002,"FC Sochaux","AS Monaco","0-0",0,0,"1",1,0,0,"D"
2003-01-15,2002,"SC Bastia","Olympique Lyon","2-0",2,0,"1",1,2,2,"H"
2003-01-15,2002,"EA Guingamp","AJ Auxerre","0-2",0,2,"1",1,2,-2,"D"
2003-01-15,2002,"Montpellier HSC","OGC Nice","2-2",2,2,"1",1,4,0,"D"
2003-01-15,2002,"Paris Saint-Germain","Le Havre AC","1-0",1,0,"1",1,1,1,"H"
2003-01-15,2002,"CS Sedan","AC Ajaccio","1-1",1,1,"1",1,2,0,"D"
2003-01-18,2002,"Montpellier HSC","AJ Auxerre","0-0",0,0,"1",1,0,0,"D"
2003-01-18,2002,"Le Havre AC","RC Strasbourg","1-1",1,1,"1",1,2,0,"D"
2003-01-18,2002,"RC Lens","CS Sedan","4-0",4,0,"1",1,4,4,"H"
2003-01-21,2002,"AJ Auxerre","Olympique Marseille","0-0",0,0,"1",1,0,0,"D"
2003-01-22,2002,"Olympique Lyon","FC Sochaux","4-1",4,1,"1",1,5,3,"H"
2003-01-22,2002,"AC Ajaccio","ESTAC Troyes","1-0",1,0,"1",1,1,1,"H"
2003-01-22,2002,"Girondins Bordeaux","EA Guingamp","4-2",4,2,"1",1,6,2,"H"
2003-01-22,2002,"Le Havre AC","Montpellier HSC","1-0",1,0,"1",1,1,1,"H"
2003-01-22,2002,"Lille OSC","RC Strasbourg","0-1",0,1,"1",1,1,-1,"D"
2003-01-22,2002,"AS Monaco","RC Lens","1-1",1,1,"1",1,2,0,"D"
2003-01-22,2002,"FC Nantes","CS Sedan","4-1",4,1,"1",1,5,3,"H"
2003-01-22,2002,"OGC Nice","Paris Saint-Germain","0-0",0,0,"1",1,0,0,"D"
2003-01-22,2002,"Stade Rennes","SC Bastia","0-1",0,1,"1",1,1,-1,"D"
2003-01-28,2002,"Olympique Marseille","OGC Nice","2-0",2,0,"1",1,2,2,"H"
2003-01-29,2002,"FC Nantes","AS Monaco","0-2",0,2,"1",1,2,-2,"D"
2003-01-29,2002,"SC Bastia","AJ Auxerre","2-0",2,0,"1",1,2,2,"H"
2003-01-29,2002,"EA Guingamp","Le Havre AC","1-2",1,2,"1",1,3,-1,"D"
2003-01-29,2002,"RC Lens","Olympique Lyon","2-2",2,2,"1",1,4,0,"D"
2003-01-29,2002,"Montpellier HSC","AC Ajaccio","0-1",0,1,"1",1,1,-1,"D"
2003-01-29,2002,"Paris Saint-Germain","Lille OSC","1-0",1,0,"1",1,1,1,"H"
2003-01-29,2002,"CS Sedan","RC Strasbourg","2-1",2,1,"1",1,3,1,"H"
2003-01-29,2002,"FC Sochaux","Stade Rennes","1-0",1,0,"1",1,1,1,"H"
2003-01-29,2002,"ESTAC Troyes","Girondins Bordeaux","0-1",0,1,"1",1,1,-1,"D"
2003-02-01,2002,"AJ Auxerre","FC Sochaux","2-0",2,0,"1",1,2,2,"H"
2003-02-01,2002,"AC Ajaccio","SC Bastia","1-1",1,1,"1",1,2,0,"D"
2003-02-01,2002,"Le Havre AC","ESTAC Troyes","1-0",1,0,"1",1,1,1,"H"
2003-02-01,2002,"Olympique Lyon","FC Nantes","0-0",0,0,"1",1,0,0,"D"
2003-02-01,2002,"AS Monaco","CS Sedan","3-0",3,0,"1",1,3,3,"H"
2003-02-01,2002,"OGC Nice","EA Guingamp","1-0",1,0,"1",1,1,1,"H"
2003-02-01,2002,"Stade Rennes","RC Lens","1-1",1,1,"1",1,2,0,"D"
2003-02-01,2002,"RC Strasbourg","Paris Saint-Germain","0-1",0,1,"1",1,1,-1,"D"
2003-02-02,2002,"Girondins Bordeaux","Olympique Marseille","3-1",3,1,"1",1,4,2,"H"
2003-02-04,2002,"AS Monaco","Olympique Lyon","2-0",2,0,"1",1,2,2,"H"
2003-02-05,2002,"CS Sedan","AJ Auxerre","1-2",1,2,"1",1,3,-1,"D"
2003-02-05,2002,"SC Bastia","Paris Saint-Germain","1-0",1,0,"1",1,1,1,"H"
2003-02-05,2002,"RC Lens","Girondins Bordeaux","3-3",3,3,"1",1,6,0,"D"
2003-02-05,2002,"Olympique Marseille","Le Havre AC","2-0",2,0,"1",1,2,2,"H"
2003-02-05,2002,"Montpellier HSC","RC Strasbourg","2-1",2,1,"1",1,3,1,"H"
2003-02-05,2002,"FC Nantes","Stade Rennes","1-0",1,0,"1",1,1,1,"H"
2003-02-05,2002,"ESTAC Troyes","OGC Nice","1-0",1,0,"1",1,1,1,"H"
2003-02-08,2002,"AC Ajaccio","Olympique Marseille","0-2",0,2,"1",1,2,-2,"D"
2003-02-08,2002,"Girondins Bordeaux","SC Bastia","0-2",0,2,"1",1,2,-2,"D"
2003-02-08,2002,"Le Havre AC","CS Sedan","2-1",2,1,"1",1,3,1,"H"
2003-02-08,2002,"Lille OSC","RC Lens","0-2",0,2,"1",1,2,-2,"D"
2003-02-08,2002,"Olympique Lyon","ESTAC Troyes","0-0",0,0,"1",1,0,0,"D"
2003-02-08,2002,"OGC Nice","FC Sochaux","2-2",2,2,"1",1,4,0,"D"
2003-02-08,2002,"Paris Saint-Germain","Montpellier HSC","1-3",1,3,"1",1,4,-2,"D"
2003-02-08,2002,"Stade Rennes","AS Monaco","0-0",0,0,"1",1,0,0,"D"
2003-02-08,2002,"RC Strasbourg","EA Guingamp","3-1",3,1,"1",1,4,2,"H"
2003-02-09,2002,"AJ Auxerre","FC Nantes","0-1",0,1,"1",1,1,-1,"D"
2003-02-15,2002,"FC Nantes","FC Sochaux","0-1",0,1,"1",1,1,-1,"D"
2003-02-19,2002,"ESTAC Troyes","Lille OSC","2-0",2,0,"1",1,2,2,"H"
2003-02-22,2002,"EA Guingamp","Paris Saint-Germain","3-2",3,2,"1",1,5,1,"H"
2003-02-22,2002,"SC Bastia","OGC Nice","1-1",1,1,"1",1,2,0,"D"
2003-02-22,2002,"RC Lens","Montpellier HSC","4-0",4,0,"1",1,4,4,"H"
2003-02-22,2002,"Olympique Lyon","Stade Rennes","4-1",4,1,"1",1,5,3,"H"
2003-02-22,2002,"Olympique Marseille","Lille OSC","2-0",2,0,"1",1,2,2,"H"
2003-02-22,2002,"FC Nantes","AC Ajaccio","1-0",1,0,"1",1,1,1,"H"
2003-02-22,2002,"CS Sedan","Girondins Bordeaux","0-1",0,1,"1",1,1,-1,"D"
2003-02-22,2002,"FC Sochaux","Le Havre AC","1-0",1,0,"1",1,1,1,"H"
2003-02-22,2002,"ESTAC Troyes","RC Strasbourg","1-0",1,0,"1",1,1,1,"H"
2003-02-23,2002,"AS Monaco","AJ Auxerre","3-1",3,1,"1",1,4,2,"H"
2003-02-28,2002,"OGC Nice","FC Nantes","1-1",1,1,"1",1,2,0,"D"
2003-03-01,2002,"Girondins Bordeaux","FC Sochaux","2-0",2,0,"1",1,2,2,"H"
2003-03-01,2002,"AC Ajaccio","RC Lens","0-0",0,0,"1",1,0,0,"D"
2003-03-01,2002,"Le Havre AC","SC Bastia","2-0",2,0,"1",1,2,2,"H"
2003-03-01,2002,"Lille OSC","AS Monaco","1-3",1,3,"1",1,4,-2,"D"
2003-03-01,2002,"Montpellier HSC","EA Guingamp","2-0",2,0,"1",1,2,2,"H"
2003-03-01,2002,"Paris Saint-Germain","ESTAC Troyes","4-2",4,2,"1",1,6,2,"H"
2003-03-01,2002,"Stade Rennes","CS Sedan","1-0",1,0,"1",1,1,1,"H"
2003-03-01,2002,"RC Strasbourg","Olympique Marseille","0-0",0,0,"1",1,0,0,"D"
2003-03-02,2002,"AJ Auxerre","Olympique Lyon","1-2",1,2,"1",1,3,-1,"D"
2003-03-08,2002,"Stade Rennes","AJ Auxerre","0-0",0,0,"1",1,0,0,"D"
2003-03-08,2002,"SC Bastia","RC Strasbourg","1-1",1,1,"1",1,2,0,"D"
2003-03-08,2002,"RC Lens","OGC Nice","0-0",0,0,"1",1,0,0,"D"
2003-03-08,2002,"Olympique Lyon","AC Ajaccio","3-1",3,1,"1",1,4,2,"H"
2003-03-08,2002,"AS Monaco","Girondins Bordeaux","0-1",0,1,"1",1,1,-1,"D"
2003-03-08,2002,"FC Nantes","Le Havre AC","2-0",2,0,"1",1,2,2,"H"
2003-03-08,2002,"CS Sedan","EA Guingamp","2-0",2,0,"1",1,2,2,"H"
2003-03-08,2002,"FC Sochaux","Lille OSC","2-2",2,2,"1",1,4,0,"D"
2003-03-08,2002,"ESTAC Troyes","Montpellier HSC","0-2",0,2,"1",1,2,-2,"D"
2003-03-09,2002,"Olympique Marseille","Paris Saint-Germain","0-3",0,3,"1",1,3,-3,"D"
2003-03-14,2002,"RC Lens","FC Nantes","0-1",0,1,"1",1,1,-1,"D"
2003-03-14,2002,"Lille OSC","Montpellier HSC","2-0",2,0,"1",1,2,2,"H"
2003-03-14,2002,"FC Sochaux","AC Ajaccio","1-1",1,1,"1",1,2,0,"D"
2003-03-18,2002,"EA Guingamp","Lille OSC","1-0",1,0,"1",1,1,1,"H"
2003-03-19,2002,"RC Strasbourg","Girondins Bordeaux","1-1",1,1,"1",1,2,0,"D"
2003-03-22,2002,"Montpellier HSC","Olympique Marseille","1-2",1,2,"1",1,3,-1,"D"
2003-03-22,2002,"AC Ajaccio","Stade Rennes","1-0",1,0,"1",1,1,1,"H"
2003-03-22,2002,"AJ Auxerre","RC Lens","0-0",0,0,"1",1,0,0,"D"
2003-03-22,2002,"Girondins Bordeaux","FC Nantes","0-0",0,0,"1",1,0,0,"D"
2003-03-22,2002,"EA Guingamp","ESTAC Troyes","2-0",2,0,"1",1,2,2,"H"
2003-03-22,2002,"Le Havre AC","AS Monaco","0-3",0,3,"1",1,3,-3,"D"
2003-03-22,2002,"Lille OSC","SC Bastia","1-1",1,1,"1",1,2,0,"D"
2003-03-22,2002,"Paris Saint-Germain","CS Sedan","2-0",2,0,"1",1,2,2,"H"
2003-03-22,2002,"RC Strasbourg","FC Sochaux","1-3",1,3,"1",1,4,-2,"D"
2003-03-23,2002,"OGC Nice","Olympique Lyon","0-1",0,1,"1",1,1,-1,"D"
2003-04-05,2002,"Olympique Lyon","Le Havre AC","2-1",2,1,"1",1,3,1,"H"
2003-04-05,2002,"AJ Auxerre","AC Ajaccio","1-0",1,0,"1",1,1,1,"H"
2003-04-05,2002,"SC Bastia","ESTAC Troyes","1-1",1,1,"1",1,2,0,"D"
2003-04-05,2002,"RC Lens","RC Strasbourg","1-1",1,1,"1",1,2,0,"D"
2003-04-05,2002,"Olympique Marseille","EA Guingamp","0-2",0,2,"1",1,2,-2,"D"
2003-04-05,2002,"FC Nantes","Lille OSC","1-0",1,0,"1",1,1,1,"H"
2003-04-05,2002,"Stade Rennes","Girondins Bordeaux","3-4",3,4,"1",1,7,-1,"D"
2003-04-05,2002,"CS Sedan","Montpellier HSC","1-2",1,2,"1",1,3,-1,"D"
2003-04-05,2002,"FC Sochaux","Paris Saint-Germain","0-0",0,0,"1",1,0,0,"D"
2003-04-06,2002,"AS Monaco","OGC Nice","0-1",0,1,"1",1,1,-1,"D"
2003-04-08,2002,"AJ Auxerre","CS Sedan","3-1",3,1,"1",1,4,2,"H"
2003-04-11,2002,"Girondins Bordeaux","Olympique Lyon","0-1",0,1,"1",1,1,-1,"D"
2003-04-12,2002,"ESTAC Troyes","Olympique Marseille","0-0",0,0,"1",1,0,0,"D"
2003-04-12,2002,"AC Ajaccio","AS Monaco","2-4",2,4,"1",1,6,-2,"D"
2003-04-12,2002,"EA Guingamp","SC Bastia","3-0",3,0,"1",1,3,3,"H"
2003-04-12,2002,"Le Havre AC","Stade Rennes","0-1",0,1,"1",1,1,-1,"D"
2003-04-12,2002,"Lille OSC","CS Sedan","0-0",0,0,"1",1,0,0,"D"
2003-04-12,2002,"Montpellier HSC","FC Sochaux","0-2",0,2,"1",1,2,-2,"D"
2003-04-12,2002,"OGC Nice","AJ Auxerre","1-0",1,0,"1",1,1,1,"H"
2003-04-12,2002,"Paris Saint-Germain","RC Lens","0-1",0,1,"1",1,1,-1,"D"
2003-04-12,2002,"RC Strasbourg","FC Nantes","2-0",2,0,"1",1,2,2,"H"
2003-04-19,2002,"AC Ajaccio","Girondins Bordeaux","1-6",1,6,"1",1,7,-5,"D"
2003-04-19,2002,"AJ Auxerre","Le Havre AC","1-0",1,0,"1",1,1,1,"H"
2003-04-19,2002,"SC Bastia","Montpellier HSC","1-2",1,2,"1",1,3,-1,"D"
2003-04-19,2002,"Olympique Lyon","Lille OSC","0-0",0,0,"1",1,0,0,"D"
2003-04-19,2002,"FC Nantes","Paris Saint-Germain","1-1",1,1,"1",1,2,0,"D"
2003-04-19,2002,"Stade Rennes","OGC Nice","2-2",2,2,"1",1,4,0,"D"
2003-04-19,2002,"CS Sedan","ESTAC Troyes","4-0",4,0,"1",1,4,4,"H"
2003-04-19,2002,"FC Sochaux","EA Guingamp","0-0",0,0,"1",1,0,0,"D"
2003-04-20,2002,"AS Monaco","RC Strasbourg","2-0",2,0,"1",1,2,2,"H"
2003-04-20,2002,"RC Lens","Olympique Marseille","0-1",0,1,"1",1,1,-1,"D"
2003-05-03,2002,"Olympique Marseille","SC Bastia","2-1",2,1,"1",1,3,1,"H"
2003-05-03,2002,"Girondins Bordeaux","AJ Auxerre","0-1",0,1,"1",1,1,-1,"D"
2003-05-03,2002,"EA Guingamp","RC Lens","1-0",1,0,"1",1,1,1,"H"
2003-05-03,2002,"Le Havre AC","AC Ajaccio","0-1",0,1,"1",1,1,-1,"D"
2003-05-03,2002,"Lille OSC","Stade Rennes","1-0",1,0,"1",1,1,1,"H"
2003-05-03,2002,"Montpellier HSC","FC Nantes","1-0",1,0,"1",1,1,1,"H"
2003-05-03,2002,"OGC Nice","CS Sedan","0-0",0,0,"1",1,0,0,"D"
2003-05-03,2002,"RC Strasbourg","Olympique Lyon","0-4",0,4,"1",1,4,-4,"D"
2003-05-03,2002,"ESTAC Troyes","FC Sochaux","0-2",0,2,"1",1,2,-2,"D"
2003-05-04,2002,"Paris Saint-Germain","AS Monaco","2-1",2,1,"1",1,3,1,"H"
2003-05-10,2002,"AC Ajaccio","OGC Nice","2-0",2,0,"1",1,2,2,"H"
2003-05-10,2002,"AJ Auxerre","Lille OSC","0-0",0,0,"1",1,0,0,"D"
2003-05-10,2002,"Girondins Bordeaux","Le Havre AC","2-0",2,0,"1",1,2,2,"H"
2003-05-10,2002,"RC Lens","ESTAC Troyes","1-0",1,0,"1",1,1,1,"H"
2003-05-10,2002,"AS Monaco","Montpellier HSC","3-1",3,1,"1",1,4,2,"H"
2003-05-10,2002,"FC Nantes","EA Guingamp","0-4",0,4,"1",1,4,-4,"D"
2003-05-10,2002,"Stade Rennes","RC Strasbourg","2-3",2,3,"1",1,5,-1,"D"
2003-05-10,2002,"CS Sedan","SC Bastia","2-2",2,2,"1",1,4,0,"D"
2003-05-10,2002,"FC Sochaux","Olympique Marseille","3-0",3,0,"1",1,3,3,"H"
2003-05-11,2002,"Olympique Lyon","Paris Saint-Germain","1-0",1,0,"1",1,1,1,"H"
2003-05-20,2002,"SC Bastia","FC Sochaux","2-2",2,2,"1",1,4,0,"D"
2003-05-20,2002,"EA Guingamp","AS Monaco","3-1",3,1,"1",1,4,2,"H"
2003-05-20,2002,"Le Havre AC","RC Lens","1-3",1,3,"1",1,4,-2,"D"
2003-05-20,2002,"Lille OSC","AC Ajaccio","2-0",2,0,"1",1,2,2,"H"
2003-05-20,2002,"Olympique Marseille","CS Sedan","4-2",4,2,"1",1,6,2,"H"
2003-05-20,2002,"Montpellier HSC","Olympique Lyon","1-1",1,1,"1",1,2,0,"D"
2003-05-20,2002,"OGC Nice","Girondins Bordeaux","1-1",1,1,"1",1,2,0,"D"
2003-05-20,2002,"Paris Saint-Germain","Stade Rennes","0-0",0,0,"1",1,0,0,"D"
2003-05-20,2002,"RC Strasbourg","AJ Auxerre","1-2",1,2,"1",1,3,-1,"D"
2003-05-20,2002,"ESTAC Troyes","FC Nantes","2-0",2,0,"1",1,2,2,"H"
2003-05-24,2002,"AC Ajaccio","RC Strasbourg","0-0",0,0,"1",1,0,0,"D"
2003-05-24,2002,"AJ Auxerre","Paris Saint-Germain","2-0",2,0,"1",1,2,2,"H"
2003-05-24,2002,"Girondins Bordeaux","Lille OSC","2-0",2,0,"1",1,2,2,"H"
2003-05-24,2002,"Le Havre AC","OGC Nice","2-1",2,1,"1",1,3,1,"H"
2003-05-24,2002,"RC Lens","SC Bastia","2-0",2,0,"1",1,2,2,"H"
2003-05-24,2002,"Olympique Lyon","EA Guingamp","1-4",1,4,"1",1,5,-3,"D"
2003-05-24,2002,"AS Monaco","ESTAC Troyes","6-0",6,0,"1",1,6,6,"H"
2003-05-24,2002,"FC Nantes","Olympique Marseille","1-0",1,0,"1",1,1,1,"H"
2003-05-24,2002,"Stade Rennes","Montpellier HSC","3-1",3,1,"1",1,4,2,"H"
2003-05-24,2002,"FC Sochaux","CS Sedan","2-1",2,1,"1",1,3,1,"H"
2003-08-01,2003,"Lille OSC","Olympique Lyon","1-0",1,0,"1",1,1,1,"H"
2003-08-02,2003,"AS Monaco","Girondins Bordeaux","2-0",2,0,"1",1,2,2,"H"
2003-08-02,2003,"FC Sochaux","FC Nantes","2-1",2,1,"1",1,3,1,"H"
2003-08-02,2003,"EA Guingamp","Olympique Marseille","0-1",0,1,"1",1,1,-1,"D"
2003-08-02,2003,"Toulouse FC","RC Strasbourg","1-1",1,1,"1",1,2,0,"D"
2003-08-02,2003,"FC Metz","AC Ajaccio","0-1",0,1,"1",1,1,-1,"D"
2003-08-02,2003,"RC Lens","Le Mans UC 72","0-0",0,0,"1",1,0,0,"D"
2003-08-02,2003,"Montpellier HSC","Stade Rennes","1-1",1,1,"1",1,2,0,"D"
2003-08-02,2003,"Paris Saint-Germain","SC Bastia","0-0",0,0,"1",1,0,0,"D"
2003-08-02,2003,"AJ Auxerre","OGC Nice","1-2",1,2,"1",1,3,-1,"D"
2003-08-08,2003,"Olympique Marseille","AJ Auxerre","1-0",1,0,"1",1,1,1,"H"
2003-08-09,2003,"Lille OSC","Paris Saint-Germain","1-0",1,0,"1",1,1,1,"H"
2003-08-09,2003,"Stade Rennes","Toulouse FC","1-0",1,0,"1",1,1,1,"H"
2003-08-09,2003,"OGC Nice","FC Sochaux","1-0",1,0,"1",1,1,1,"H"
2003-08-09,2003,"Le Mans UC 72","AC Ajaccio","0-1",0,1,"1",1,1,-1,"D"
2003-08-09,2003,"SC Bastia","FC Metz","0-2",0,2,"1",1,2,-2,"D"
2003-08-09,2003,"FC Nantes","RC Lens","2-0",2,0,"1",1,2,2,"H"
2003-08-09,2003,"Girondins Bordeaux","Montpellier HSC","0-1",0,1,"1",1,1,-1,"D"
2003-08-09,2003,"Olympique Lyon","AS Monaco","3-1",3,1,"1",1,4,2,"H"
2003-08-09,2003,"RC Strasbourg","EA Guingamp","2-0",2,0,"1",1,2,2,"H"
2003-08-16,2003,"AJ Auxerre","RC Strasbourg","3-2",3,2,"1",1,5,1,"H"
2003-08-16,2003,"AC Ajaccio","FC Nantes","1-3",1,3,"1",1,4,-2,"D"
2003-08-16,2003,"EA Guingamp","Girondins Bordeaux","1-3",1,3,"1",1,4,-2,"D"
2003-08-16,2003,"Toulouse FC","Lille OSC","0-3",0,3,"1",1,3,-3,"D"
2003-08-16,2003,"Le Mans UC 72","OGC Nice","1-1",1,1,"1",1,2,0,"D"
2003-08-16,2003,"Montpellier HSC","Olympique Lyon","0-2",0,2,"1",1,2,-2,"D"
2003-08-16,2003,"FC Sochaux","Stade Rennes","1-1",1,1,"1",1,2,0,"D"
2003-08-16,2003,"AS Monaco","SC Bastia","2-0",2,0,"1",1,2,2,"H"
2003-08-16,2003,"FC Metz","Paris Saint-Germain","0-1",0,1,"1",1,1,-1,"D"
2003-08-17,2003,"RC Lens","Olympique Marseille","2-1",2,1,"1",1,3,1,"H"
2003-08-23,2003,"Girondins Bordeaux","AJ Auxerre","2-0",2,0,"1",1,2,2,"H"
2003-08-23,2003,"Lille OSC","FC Metz","1-1",1,1,"1",1,2,0,"D"
2003-08-23,2003,"Olympique Marseille","FC Sochaux","2-0",2,0,"1",1,2,2,"H"
2003-08-23,2003,"Stade Rennes","EA Guingamp","0-0",0,0,"1",1,0,0,"D"
2003-08-23,2003,"OGC Nice","AC Ajaccio","2-2",2,2,"1",1,4,0,"D"
2003-08-23,2003,"RC Strasbourg","RC Lens","0-1",0,1,"1",1,1,-1,"D"
2003-08-23,2003,"SC Bastia","Montpellier HSC","1-0",1,0,"1",1,1,1,"H"
2003-08-23,2003,"FC Nantes","Le Mans UC 72","1-0",1,0,"1",1,1,1,"H"
2003-08-23,2003,"Olympique Lyon","Toulouse FC","0-0",0,0,"1",1,0,0,"D"
2003-08-24,2003,"Paris Saint-Germain","AS Monaco","2-4",2,4,"1",1,6,-2,"D"
2003-08-30,2003,"EA Guingamp","Olympique Lyon","2-0",2,0,"1",1,2,2,"H"
2003-08-30,2003,"Toulouse FC","SC Bastia","0-2",0,2,"1",1,2,-2,"D"
2003-08-30,2003,"Le Mans UC 72","RC Strasbourg","0-3",0,3,"1",1,3,-3,"D"
2003-08-30,2003,"Montpellier HSC","Paris Saint-Germain","3-2",3,2,"1",1,5,1,"H"
2003-08-30,2003,"FC Sochaux","Lille OSC","2-1",2,1,"1",1,3,1,"H"
2003-08-30,2003,"AJ Auxerre","Stade Rennes","2-1",2,1,"1",1,3,1,"H"
2003-08-30,2003,"FC Nantes","Girondins Bordeaux","0-0",0,0,"1",1,0,0,"D"
2003-08-31,2003,"RC Lens","OGC Nice","1-0",1,0,"1",1,1,1,"H"
2003-08-31,2003,"AS Monaco","FC Metz","1-0",1,0,"1",1,1,1,"H"
2003-08-31,2003,"AC Ajaccio","Olympique Marseille","0-1",0,1,"1",1,1,-1,"D"
2003-09-13,2003,"Olympique Lyon","AJ Auxerre","1-1",1,1,"1",1,2,0,"D"
2003-09-13,2003,"Lille OSC","AS Monaco","1-1",1,1,"1",1,2,0,"D"
2003-09-13,2003,"Olympique Marseille","Le Mans UC 72","5-0",5,0,"1",1,5,5,"H"
2003-09-13,2003,"Stade Rennes","RC Lens","2-0",2,0,"1",1,2,2,"H"
2003-09-13,2003,"OGC Nice","FC Nantes","1-0",1,0,"1",1,1,1,"H"
2003-09-13,2003,"RC Strasbourg","AC Ajaccio","3-2",3,2,"1",1,5,1,"H"
2003-09-13,2003,"SC Bastia","EA Guingamp","4-2",4,2,"1",1,6,2,"H"
2003-09-13,2003,"FC Metz","Montpellier HSC","2-1",2,1,"1",1,3,1,"H"
2003-09-13,2003,"Girondins Bordeaux","FC Sochaux","1-3",1,3,"1",1,4,-2,"D"
2003-09-14,2003,"Paris Saint-Germain","Toulouse FC","2-1",2,1,"1",1,3,1,"H"
2003-09-20,2003,"FC Sochaux","RC Strasbourg","3-0",3,0,"1",1,3,3,"H"
2003-09-20,2003,"AC Ajaccio","Stade Rennes","1-0",1,0,"1",1,1,1,"H"
2003-09-20,2003,"Toulouse FC","FC Metz","1-0",1,0,"1",1,1,1,"H"
2003-09-20,2003,"OGC Nice","Lille OSC","2-0",2,0,"1",1,2,2,"H"
2003-09-20,2003,"EA Guingamp","Paris Saint-Germain","0-2",0,2,"1",1,2,-2,"D"
2003-09-20,2003,"AJ Auxerre","SC Bastia","4-1",4,1,"1",1,5,3,"H"
2003-09-20,2003,"RC Lens","Girondins Bordeaux","1-0",1,0,"1",1,1,1,"H"
2003-09-21,2003,"Le Mans UC 72","Olympique Lyon","0-2",0,2,"1",1,2,-2,"D"
2003-09-21,2003,"Montpellier HSC","AS Monaco","1-2",1,2,"1",1,3,-1,"D"
2003-09-21,2003,"FC Nantes","Olympique Marseille","1-0",1,0,"1",1,1,1,"H"
2003-09-27,2003,"Olympique Lyon","RC Lens","4-0",4,0,"1",1,4,4,"H"
2003-09-27,2003,"Lille OSC","Montpellier HSC","1-1",1,1,"1",1,2,0,"D"
2003-09-27,2003,"SC Bastia","FC Sochaux","2-0",2,0,"1",1,2,2,"H"
2003-09-27,2003,"Olympique Marseille","OGC Nice","2-1",2,1,"1",1,3,1,"H"
2003-09-27,2003,"Stade Rennes","Le Mans UC 72","2-0",2,0,"1",1,2,2,"H"
2003-09-27,2003,"Paris Saint-Germain","AJ Auxerre","1-0",1,0,"1",1,1,1,"H"
2003-09-27,2003,"AS Monaco","Toulouse FC","3-0",3,0,"1",1,3,3,"H"
2003-09-27,2003,"FC Metz","EA Guingamp","1-1",1,1,"1",1,2,0,"D"
2003-09-28,2003,"Girondins Bordeaux","AC Ajaccio","1-0",1,0,"1",1,1,1,"H"
2003-09-28,2003,"RC Strasbourg","FC Nantes","1-0",1,0,"1",1,1,1,"H"
2003-10-04,2003,"FC Nantes","Stade Rennes","1-0",1,0,"1",1,1,1,"H"
2003-10-04,2003,"AC Ajaccio","Olympique Lyon","2-4",2,4,"1",1,6,-2,"D"
2003-10-04,2003,"Toulouse FC","Montpellier HSC","2-2",2,2,"1",1,4,0,"D"
2003-10-04,2003,"OGC Nice","RC Strasbourg","0-0",0,0,"1",1,0,0,"D"
2003-10-04,2003,"Le Mans UC 72","Girondins Bordeaux","0-0",0,0,"1",1,0,0,"D"
2003-10-04,2003,"RC Lens","FC Metz","0-2",0,2,"1",1,2,-2,"D"
2003-10-04,2003,"FC Sochaux","Paris Saint-Germain","0-1",0,1,"1",1,1,-1,"D"
2003-10-04,2003,"EA Guingamp","AS Monaco","1-2",1,2,"1",1,3,-1,"D"
2003-10-04,2003,"AJ Auxerre","Lille OSC","3-0",3,0,"1",1,3,3,"H"
2003-10-05,2003,"Olympique Marseille","SC Bastia","3-1",3,1,"1",1,4,2,"H"
2003-10-17,2003,"RC Strasbourg","Olympique Marseille","4-1",4,1,"1",1,5,3,"H"
2003-10-18,2003,"AS Monaco","AJ Auxerre","1-1",1,1,"1",1,2,0,"D"
2003-10-18,2003,"Lille OSC","AC Ajaccio","0-0",0,0,"1",1,0,0,"D"
2003-10-18,2003,"SC Bastia","RC Lens","3-1",3,1,"1",1,4,2,"H"
2003-10-18,2003,"Stade Rennes","OGC Nice","0-0",0,0,"1",1,0,0,"D"
2003-10-18,2003,"Montpellier HSC","EA Guingamp","2-0",2,0,"1",1,2,2,"H"
2003-10-18,2003,"Girondins Bordeaux","Toulouse FC","1-2",1,2,"1",1,3,-1,"D"
2003-10-18,2003,"Olympique Lyon","FC Sochaux","1-1",1,1,"1",1,2,0,"D"
2003-10-18,2003,"Paris Saint-Germain","Le Mans UC 72","5-1",5,1,"1",1,6,4,"H"
2003-10-18,2003,"FC Metz","FC Nantes","1-3",1,3,"1",1,4,-2,"D"
2003-10-25,2003,"FC Nantes","Olympique Lyon","0-1",0,1,"1",1,1,-1,"D"
2003-10-25,2003,"AC Ajaccio","Paris Saint-Germain","0-0",0,0,"1",1,0,0,"D"
2003-10-25,2003,"EA Guingamp","Toulouse FC","1-0",1,0,"1",1,1,1,"H"
2003-10-25,2003,"OGC Nice","Girondins Bordeaux","0-0",0,0,"1",1,0,0,"D"
2003-10-25,2003,"Le Mans UC 72","SC Bastia","1-1",1,1,"1",1,2,0,"D"
2003-10-25,2003,"Olympique Marseille","Stade Rennes","2-0",2,0,"1",1,2,2,"H"
2003-10-25,2003,"RC Lens","Lille OSC","2-1",2,1,"1",1,3,1,"H"
2003-10-25,2003,"AJ Auxerre","Montpellier HSC","0-1",0,1,"1",1,1,-1,"D"
2003-10-25,2003,"RC Strasbourg","FC Metz","0-2",0,2,"1",1,2,-2,"D"
2003-10-26,2003,"FC Sochaux","AS Monaco","1-1",1,1,"1",1,2,0,"D"
2003-11-01,2003,"Olympique Lyon","OGC Nice","5-0",5,0,"1",1,5,5,"H"
2003-11-01,2003,"Lille OSC","EA Guingamp","1-3",1,3,"1",1,4,-2,"D"
2003-11-01,2003,"Stade Rennes","RC Strasbourg","1-1",1,1,"1",1,2,0,"D"
2003-11-01,2003,"Montpellier HSC","FC Nantes","4-1",4,1,"1",1,5,3,"H"
2003-11-01,2003,"Toulouse FC","AJ Auxerre","0-3",0,3,"1",1,3,-3,"D"
2003-11-01,2003,"Girondins Bordeaux","Olympique Marseille","1-0",1,0,"1",1,1,1,"H"
2003-11-01,2003,"SC Bastia","AC Ajaccio","1-1",1,1,"1",1,2,0,"D"
2003-11-01,2003,"AS Monaco","Le Mans UC 72","4-2",4,2,"1",1,6,2,"H"
2003-11-01,2003,"FC Metz","FC Sochaux","0-1",0,1,"1",1,1,-1,"D"
2003-11-02,2003,"Paris Saint-Germain","RC Lens","0-1",0,1,"1",1,1,-1,"D"
2003-11-08,2003,"OGC Nice","SC Bastia","2-0",2,0,"1",1,2,2,"H"
2003-11-08,2003,"Le Mans UC 72","FC Metz","2-0",2,0,"1",1,2,2,"H"
2003-11-08,2003,"Stade Rennes","Lille OSC","2-2",2,2,"1",1,4,0,"D"
2003-11-08,2003,"FC Nantes","Paris Saint-Germain","0-1",0,1,"1",1,1,-1,"D"
2003-11-09,2003,"AC Ajaccio","AS Monaco","0-1",0,1,"1",1,1,-1,"D"
2003-11-09,2003,"FC Sochaux","Toulouse FC","3-1",3,1,"1",1,4,2,"H"
2003-11-09,2003,"RC Lens","Montpellier HSC","3-2",3,2,"1",1,5,1,"H"
2003-11-09,2003,"AJ Auxerre","EA Guingamp","3-0",3,0,"1",1,3,3,"H"
2003-11-09,2003,"RC Strasbourg","Girondins Bordeaux","1-1",1,1,"1",1,2,0,"D"
2003-11-09,2003,"Olympique Marseille","Olympique Lyon","1-4",1,4,"1",1,5,-3,"D"
2003-11-21,2003,"Olympique Lyon","RC Strasbourg","1-0",1,0,"1",1,1,1,"H"
2003-11-22,2003,"AS Monaco","RC Lens","2-0",2,0,"1",1,2,2,"H"
2003-11-22,2003,"Lille OSC","Olympique Marseille","0-2",0,2,"1",1,2,-2,"D"
2003-11-22,2003,"Montpellier HSC","AC Ajaccio","3-1",3,1,"1",1,4,2,"H"
2003-11-22,2003,"EA Guingamp","FC Sochaux","1-2",1,2,"1",1,3,-1,"D"
2003-11-22,2003,"Toulouse FC","Le Mans UC 72","1-1",1,1,"1",1,2,0,"D"
2003-11-22,2003,"Girondins Bordeaux","Stade Rennes","2-1",2,1,"1",1,3,1,"H"
2003-11-22,2003,"SC Bastia","FC Nantes","1-3",1,3,"1",1,4,-2,"D"
2003-11-22,2003,"FC Metz","AJ Auxerre","0-2",0,2,"1",1,2,-2,"D"
2003-11-23,2003,"Paris Saint-Germain","OGC Nice","0-0",0,0,"1",1,0,0,"D"
2003-11-29,2003,"Stade Rennes","Olympique Lyon","3-1",3,1,"1",1,4,2,"H"
2003-11-29,2003,"AC Ajaccio","Toulouse FC","2-1",2,1,"1",1,3,1,"H"
2003-11-29,2003,"OGC Nice","FC Metz","1-1",1,1,"1",1,2,0,"D"
2003-11-29,2003,"Le Mans UC 72","Montpellier HSC","4-0",4,0,"1",1,4,4,"H"
2003-11-29,2003,"RC Strasbourg","Lille OSC","2-2",2,2,"1",1,4,0,"D"
2003-11-29,2003,"FC Nantes","AS Monaco","0-1",0,1,"1",1,1,-1,"D"
2003-11-30,2003,"FC Sochaux","AJ Auxerre","3-2",3,2,"1",1,5,1,"H"
2003-11-30,2003,"RC Lens","EA Guingamp","2-1",2,1,"1",1,3,1,"H"
2003-11-30,2003,"Girondins Bordeaux","SC Bastia","1-1",1,1,"1",1,2,0,"D"
2003-11-30,2003,"Olympique Marseille","Paris Saint-Germain","0-1",0,1,"1",1,1,-1,"D"
2003-12-03,2003,"Lille OSC","FC Nantes","2-0",2,0,"1",1,2,2,"H"
2003-12-03,2003,"EA Guingamp","AC Ajaccio","2-0",2,0,"1",1,2,2,"H"
2003-12-03,2003,"Toulouse FC","RC Lens","1-2",1,2,"1",1,3,-1,"D"
2003-12-03,2003,"SC Bastia","Stade Rennes","3-2",3,2,"1",1,5,1,"H"
2003-12-03,2003,"AJ Auxerre","Le Mans UC 72","1-0",1,0,"1",1,1,1,"H"
2003-12-03,2003,"Paris Saint-Germain","RC Strasbourg","3-2",3,2,"1",1,5,1,"H"
2003-12-05,2003,"Olympique Lyon","FC Metz","2-1",2,1,"1",1,3,1,"H"
2003-12-05,2003,"Olympique Marseille","AS Monaco","1-2",1,2,"1",1,3,-1,"D"
2003-12-06,2003,"RC Lens","FC Sochaux","0-3",0,3,"1",1,3,-3,"D"
2003-12-06,2003,"AC Ajaccio","AJ Auxerre","1-2",1,2,"1",1,3,-1,"D"
2003-12-06,2003,"Stade Rennes","Paris Saint-Germain","1-1",1,1,"1",1,2,0,"D"
2003-12-06,2003,"FC Nantes","Toulouse FC","1-1",1,1,"1",1,2,0,"D"
2003-12-06,2003,"Girondins Bordeaux","Lille OSC","2-1",2,1,"1",1,3,1,"H"
2003-12-06,2003,"RC Strasbourg","SC Bastia","4-2",4,2,"1",1,6,2,"H"
2003-12-07,2003,"OGC Nice","Montpellier HSC","2-1",2,1,"1",1,3,1,"H"
2003-12-07,2003,"Le Mans UC 72","EA Guingamp","2-0",2,0,"1",1,2,2,"H"
2003-12-13,2003,"Paris Saint-Germain","Girondins Bordeaux","2-1",2,1,"1",1,3,1,"H"
2003-12-13,2003,"Lille OSC","Le Mans UC 72","1-1",1,1,"1",1,2,0,"D"
2003-12-13,2003,"FC Sochaux","AC Ajaccio","2-0",2,0,"1",1,2,2,"H"
2003-12-13,2003,"EA Guingamp","FC Nantes","1-1",1,1,"1",1,2,0,"D"
2003-12-13,2003,"Toulouse FC","OGC Nice","1-1",1,1,"1",1,2,0,"D"
2003-12-13,2003,"FC Metz","Stade Rennes","1-1",1,1,"1",1,2,0,"D"
2003-12-13,2003,"SC Bastia","Olympique Lyon","0-0",0,0,"1",1,0,0,"D"
2003-12-13,2003,"AJ Auxerre","RC Lens","2-0",2,0,"1",1,2,2,"H"
2003-12-14,2003,"AS Monaco","RC Strasbourg","2-0",2,0,"1",1,2,2,"H"
2003-12-19,2003,"Olympique Lyon","Paris Saint-Germain","1-1",1,1,"1",1,2,0,"D"
2003-12-20,2003,"Olympique Marseille","Toulouse FC","1-0",1,0,"1",1,1,1,"H"
2003-12-20,2003,"AC Ajaccio","RC Lens","2-0",2,0,"1",1,2,2,"H"
2003-12-20,2003,"Stade Rennes","AS Monaco","1-0",1,0,"1",1,1,1,"H"
2003-12-20,2003,"OGC Nice","EA Guingamp","2-0",2,0,"1",1,2,2,"H"
2003-12-20,2003,"Le Mans UC 72","FC Sochaux","2-2",2,2,"1",1,4,0,"D"
2003-12-20,2003,"SC Bastia","Lille OSC","0-2",0,2,"1",1,2,-2,"D"
2003-12-20,2003,"FC Nantes","AJ Auxerre","1-0",1,0,"1",1,1,1,"H"
2003-12-20,2003,"Girondins Bordeaux","FC Metz","2-0",2,0,"1",1,2,2,"H"
2003-12-20,2003,"RC Strasbourg","Montpellier HSC","4-2",4,2,"1",1,6,2,"H"
2004-01-09,2003,"AS Monaco","Olympique Lyon","3-0",3,0,"1",1,3,3,"H"
2004-01-10,2003,"Paris Saint-Germain","Lille OSC","1-0",1,0,"1",1,1,1,"H"
2004-01-10,2003,"Toulouse FC","Stade Rennes","2-0",2,0,"1",1,2,2,"H"
2004-01-10,2003,"FC Sochaux","OGC Nice","0-0",0,0,"1",1,0,0,"D"
2004-01-10,2003,"AC Ajaccio","Le Mans UC 72","2-0",2,0,"1",1,2,2,"H"
2004-01-10,2003,"FC Metz","SC Bastia","1-0",1,0,"1",1,1,1,"H"
2004-01-10,2003,"RC Lens","FC Nantes","0-0",0,0,"1",1,0,0,"D"
2004-01-10,2003,"AJ Auxerre","Olympique Marseille","2-0",2,0,"1",1,2,2,"H"
2004-01-10,2003,"Montpellier HSC","Girondins Bordeaux","1-2",1,2,"1",1,3,-1,"D"
2004-01-10,2003,"EA Guingamp","RC Strasbourg","3-2",3,2,"1",1,5,1,"H"
2004-01-17,2003,"SC Bastia","AS Monaco","0-0",0,0,"1",1,0,0,"D"
2004-01-17,2003,"FC Nantes","AC Ajaccio","4-0",4,0,"1",1,4,4,"H"
2004-01-17,2003,"Girondins Bordeaux","EA Guingamp","2-0",2,0,"1",1,2,2,"H"
2004-01-17,2003,"Lille OSC","Toulouse FC","0-1",0,1,"1",1,1,-1,"D"
2004-01-17,2003,"OGC Nice","Le Mans UC 72","0-1",0,1,"1",1,1,-1,"D"
2004-01-17,2003,"Olympique Lyon","Montpellier HSC","3-0",3,0,"1",1,3,3,"H"
2004-01-17,2003,"Stade Rennes","FC Sochaux","4-0",4,0,"1",1,4,4,"H"
2004-01-17,2003,"RC Strasbourg","AJ Auxerre","0-2",0,2,"1",1,2,-2,"D"
2004-01-17,2003,"Paris Saint-Germain","FC Metz","0-0",0,0,"1",1,0,0,"D"
2004-01-18,2003,"Olympique Marseille","RC Lens","3-2",3,2,"1",1,5,1,"H"
2004-01-21,2003,"AS Monaco","OGC Nice","1-1",1,1,"1",1,2,0,"D"
2004-01-21,2003,"Montpellier HSC","FC Sochaux","1-3",1,3,"1",1,4,-2,"D"
2004-01-27,2003,"FC Metz","Olympique Marseille","1-1",1,1,"1",1,2,0,"D"
2004-01-28,2003,"Olympique Lyon","Girondins Bordeaux","3-0",3,0,"1",1,3,3,"H"
2004-01-30,2003,"AS Monaco","Paris Saint-Germain","1-1",1,1,"1",1,2,0,"D"
2004-01-31,2003,"AJ Auxerre","Girondins Bordeaux","5-0",5,0,"1",1,5,5,"H"
2004-01-31,2003,"FC Metz","Lille OSC","0-1",0,1,"1",1,1,-1,"D"
2004-01-31,2003,"FC Sochaux","Olympique Marseille","2-1",2,1,"1",1,3,1,"H"
2004-01-31,2003,"EA Guingamp","Stade Rennes","0-2",0,2,"1",1,2,-2,"D"
2004-01-31,2003,"AC Ajaccio","OGC Nice","1-1",1,1,"1",1,2,0,"D"
2004-01-31,2003,"RC Lens","RC Strasbourg","2-1",2,1,"1",1,3,1,"H"
2004-01-31,2003,"Montpellier HSC","SC Bastia","1-1",1,1,"1",1,2,0,"D"
2004-01-31,2003,"Le Mans UC 72","FC Nantes","0-1",0,1,"1",1,1,-1,"D"
2004-01-31,2003,"Toulouse FC","Olympique Lyon","0-1",0,1,"1",1,1,-1,"D"
2004-02-04,2003,"Montpellier HSC","Olympique Marseille","0-1",0,1,"1",1,1,-1,"D"
2004-02-06,2003,"Girondins Bordeaux","FC Nantes","2-0",2,0,"1",1,2,2,"H"
2004-02-07,2003,"Olympique Marseille","AC Ajaccio","2-1",2,1,"1",1,3,1,"H"
2004-02-07,2003,"Olympique Lyon","EA Guingamp","0-1",0,1,"1",1,1,-1,"D"
2004-02-07,2003,"SC Bastia","Toulouse FC","1-0",1,0,"1",1,1,1,"H"
2004-02-07,2003,"RC Strasbourg","Le Mans UC 72","3-0",3,0,"1",1,3,3,"H"
2004-02-07,2003,"OGC Nice","RC Lens","4-0",4,0,"1",1,4,4,"H"
2004-02-07,2003,"Paris Saint-Germain","Montpellier HSC","6-1",6,1,"1",1,7,5,"H"
2004-02-07,2003,"Lille OSC","FC Sochaux","2-0",2,0,"1",1,2,2,"H"
2004-02-07,2003,"FC Metz","AS Monaco","0-2",0,2,"1",1,2,-2,"D"
2004-02-07,2003,"Stade Rennes","AJ Auxerre","0-2",0,2,"1",1,2,-2,"D"
2004-02-14,2003,"FC Sochaux","Girondins Bordeaux","1-1",1,1,"1",1,2,0,"D"
2004-02-14,2003,"AS Monaco","Lille OSC","0-1",0,1,"1",1,1,-1,"D"
2004-02-14,2003,"Le Mans UC 72","Olympique Marseille","0-0",0,0,"1",1,0,0,"D"
2004-02-14,2003,"RC Lens","Stade Rennes","2-1",2,1,"1",1,3,1,"H"
2004-02-14,2003,"FC Nantes","OGC Nice","3-1",3,1,"1",1,4,2,"H"
2004-02-14,2003,"AC Ajaccio","RC Strasbourg","0-0",0,0,"1",1,0,0,"D"
2004-02-14,2003,"EA Guingamp","SC Bastia","1-0",1,0,"1",1,1,1,"H"
2004-02-14,2003,"Toulouse FC","Paris Saint-Germain","0-1",0,1,"1",1,1,-1,"D"
2004-02-14,2003,"Montpellier HSC","FC Metz","0-1",0,1,"1",1,1,-1,"D"
2004-02-15,2003,"AJ Auxerre","Olympique Lyon","1-2",1,2,"1",1,3,-1,"D"
2004-02-20,2003,"AS Monaco","Montpellier HSC","4-0",4,0,"1",1,4,4,"H"
2004-02-21,2003,"Olympique Lyon","Le Mans UC 72","2-0",2,0,"1",1,2,2,"H"
2004-02-21,2003,"Stade Rennes","AC Ajaccio","4-1",4,1,"1",1,5,3,"H"
2004-02-21,2003,"FC Metz","Toulouse FC","0-2",0,2,"1",1,2,-2,"D"
2004-02-21,2003,"Lille OSC","OGC Nice","1-2",1,2,"1",1,3,-1,"D"
2004-02-21,2003,"RC Strasbourg","FC Sochaux","0-2",0,2,"1",1,2,-2,"D"
2004-02-21,2003,"Paris Saint-Germain","EA Guingamp","2-0",2,0,"1",1,2,2,"H"
2004-02-21,2003,"SC Bastia","AJ Auxerre","0-0",0,0,"1",1,0,0,"D"
2004-02-21,2003,"Girondins Bordeaux","RC Lens","0-0",0,0,"1",1,0,0,"D"
2004-02-22,2003,"Olympique Marseille","FC Nantes","1-1",1,1,"1",1,2,0,"D"
2004-02-28,2003,"FC Nantes","RC Strasbourg","1-1",1,1,"1",1,2,0,"D"
2004-02-28,2003,"Montpellier HSC","Lille OSC","0-2",0,2,"1",1,2,-2,"D"
2004-02-28,2003,"Le Mans UC 72","Stade Rennes","2-2",2,2,"1",1,4,0,"D"
2004-02-28,2003,"RC Lens","Olympique Lyon","1-1",1,1,"1",1,2,0,"D"
2004-02-28,2003,"Toulouse FC","AS Monaco","1-1",1,1,"1",1,2,0,"D"
2004-02-29,2003,"FC Sochaux","SC Bastia","2-1",2,1,"1",1,3,1,"H"
2004-02-29,2003,"OGC Nice","Olympique Marseille","0-0",0,0,"1",1,0,0,"D"
2004-02-29,2003,"AC Ajaccio","Girondins Bordeaux","1-0",1,0,"1",1,1,1,"H"
2004-02-29,2003,"AJ Auxerre","Paris Saint-Germain","1-1",1,1,"1",1,2,0,"D"
2004-03-05,2003,"Olympique Lyon","AC Ajaccio","4-0",4,0,"1",1,4,4,"H"
2004-03-05,2003,"AS Monaco","EA Guingamp","3-1",3,1,"1",1,4,2,"H"
2004-03-06,2003,"Lille OSC","AJ Auxerre","1-0",1,0,"1",1,1,1,"H"
2004-03-06,2003,"Montpellier HSC","Toulouse FC","0-1",0,1,"1",1,1,-1,"D"
2004-03-06,2003,"RC Strasbourg","OGC Nice","2-2",2,2,"1",1,4,0,"D"
2004-03-06,2003,"Girondins Bordeaux","Le Mans UC 72","2-0",2,0,"1",1,2,2,"H"
2004-03-06,2003,"FC Metz","RC Lens","0-2",0,2,"1",1,2,-2,"D"
2004-03-06,2003,"Paris Saint-Germain","FC Sochaux","1-1",1,1,"1",1,2,0,"D"
2004-03-06,2003,"Stade Rennes","FC Nantes","0-3",0,3,"1",1,3,-3,"D"
2004-03-07,2003,"SC Bastia","Olympique Marseille","4-1",4,1,"1",1,5,3,"H"
2004-03-13,2003,"Le Mans UC 72","Paris Saint-Germain","0-1",0,1,"1",1,1,-1,"D"
2004-03-13,2003,"AC Ajaccio","Lille OSC","0-3",0,3,"1",1,3,-3,"D"
2004-03-13,2003,"RC Lens","SC Bastia","0-0",0,0,"1",1,0,0,"D"
2004-03-13,2003,"OGC Nice","Stade Rennes","3-1",3,1,"1",1,4,2,"H"
2004-03-13,2003,"EA Guingamp","Montpellier HSC","4-3",4,3,"1",1,7,1,"H"
2004-03-13,2003,"FC Sochaux","Olympique Lyon","1-2",1,2,"1",1,3,-1,"D"
2004-03-13,2003,"FC Nantes","FC Metz","2-2",2,2,"1",1,4,0,"D"
2004-03-14,2003,"Toulouse FC","Girondins Bordeaux","1-0",1,0,"1",1,1,1,"H"
2004-03-14,2003,"Olympique Marseille","RC Strasbourg","4-0",4,0,"1",1,4,4,"H"
2004-03-14,2003,"AJ Auxerre","AS Monaco","0-0",0,0,"1",1,0,0,"D"
2004-03-19,2003,"Toulouse FC","EA Guingamp","0-0",0,0,"1",1,0,0,"D"
2004-03-20,2003,"Olympique Lyon","FC Nantes","1-0",1,0,"1",1,1,1,"H"
2004-03-20,2003,"Paris Saint-Germain","AC Ajaccio","1-0",1,0,"1",1,1,1,"H"
2004-03-20,2003,"Girondins Bordeaux","OGC Nice","1-1",1,1,"1",1,2,0,"D"
2004-03-20,2003,"SC Bastia","Le Mans UC 72","0-0",0,0,"1",1,0,0,"D"
2004-03-20,2003,"Lille OSC","RC Lens","1-1",1,1,"1",1,2,0,"D"
2004-03-20,2003,"AS Monaco","FC Sochaux","1-1",1,1,"1",1,2,0,"D"
2004-03-20,2003,"Montpellier HSC","AJ Auxerre","1-0",1,0,"1",1,1,1,"H"
2004-03-20,2003,"FC Metz","RC Strasbourg","1-0",1,0,"1",1,1,1,"H"
2004-03-21,2003,"Stade Rennes","Olympique Marseille","4-3",4,3,"1",1,7,1,"H"
2004-03-27,2003,"FC Sochaux","FC Metz","2-0",2,0,"1",1,2,2,"H"
2004-03-27,2003,"EA Guingamp","Lille OSC","2-1",2,1,"1",1,3,1,"H"
2004-03-27,2003,"RC Strasbourg","Stade Rennes","0-3",0,3,"1",1,3,-3,"D"
2004-03-27,2003,"FC Nantes","Montpellier HSC","3-2",3,2,"1",1,5,1,"H"
2004-03-27,2003,"OGC Nice","Olympique Lyon","0-1",0,1,"1",1,1,-1,"D"
2004-03-27,2003,"AC Ajaccio","SC Bastia","1-0",1,0,"1",1,1,1,"H"
2004-03-27,2003,"Le Mans UC 72","AS Monaco","0-1",0,1,"1",1,1,-1,"D"
2004-03-28,2003,"AJ Auxerre","Toulouse FC","3-2",3,2,"1",1,5,1,"H"
2004-03-28,2003,"Olympique Marseille","Girondins Bordeaux","1-1",1,1,"1",1,2,0,"D"
2004-03-28,2003,"RC Lens","Paris Saint-Germain","1-0",1,0,"1",1,1,1,"H"
2004-04-02,2003,"AS Monaco","AC Ajaccio","3-3",3,3,"1",1,6,0,"D"
2004-04-03,2003,"Olympique Lyon","Olympique Marseille","1-2",1,2,"1",1,3,-1,"D"
2004-04-03,2003,"Toulouse FC","FC Sochaux","0-0",0,0,"1",1,0,0,"D"
2004-04-03,2003,"SC Bastia","OGC Nice","2-1",2,1,"1",1,3,1,"H"
2004-04-03,2003,"FC Metz","Le Mans UC 72","5-0",5,0,"1",1,5,5,"H"
2004-04-03,2003,"Montpellier HSC","RC Lens","1-0",1,0,"1",1,1,1,"H"
2004-04-03,2003,"Lille OSC","Stade Rennes","1-0",1,0,"1",1,1,1,"H"
2004-04-03,2003,"Girondins Bordeaux","RC Strasbourg","1-1",1,1,"1",1,2,0,"D"
2004-04-03,2003,"Paris Saint-Germain","FC Nantes","3-2",3,2,"1",1,5,1,"H"
2004-04-04,2003,"EA Guingamp","AJ Auxerre","2-2",2,2,"1",1,4,0,"D"
2004-04-10,2003,"RC Lens","AS Monaco","0-0",0,0,"1",1,0,0,"D"
2004-04-10,2003,"AC Ajaccio","Montpellier HSC","0-0",0,0,"1",1,0,0,"D"
2004-04-10,2003,"FC Sochaux","EA Guingamp","2-0",2,0,"1",1,2,2,"H"
2004-04-10,2003,"Le Mans UC 72","Toulouse FC","2-1",2,1,"1",1,3,1,"H"
2004-04-10,2003,"FC Nantes","SC Bastia","1-1",1,1,"1",1,2,0,"D"
2004-04-10,2003,"OGC Nice","Paris Saint-Germain","1-2",1,2,"1",1,3,-1,"D"
2004-04-10,2003,"AJ Auxerre","FC Metz","2-1",2,1,"1",1,3,1,"H"
2004-04-11,2003,"RC Strasbourg","Olympique Lyon","0-1",0,1,"1",1,1,-1,"D"
2004-04-16,2003,"EA Guingamp","FC Metz","1-1",1,1,"1",1,2,0,"D"
2004-04-18,2003,"Olympique Marseille","Lille OSC","2-1",2,1,"1",1,3,1,"H"
2004-04-18,2003,"Stade Rennes","Girondins Bordeaux","3-1",3,1,"1",1,4,2,"H"
2004-04-24,2003,"AS Monaco","FC Nantes","0-1",0,1,"1",1,1,-1,"D"
2004-04-24,2003,"Toulouse FC","AC Ajaccio","3-1",3,1,"1",1,4,2,"H"
2004-04-24,2003,"AJ Auxerre","FC Sochaux","2-1",2,1,"1",1,3,1,"H"
2004-04-24,2003,"FC Metz","OGC Nice","1-0",1,0,"1",1,1,1,"H"
2004-04-24,2003,"Montpellier HSC","Le Mans UC 72","0-3",0,3,"1",1,3,-3,"D"
2004-04-24,2003,"EA Guingamp","RC Lens","1-0",1,0,"1",1,1,1,"H"
2004-04-24,2003,"Olympique Lyon","Stade Rennes","3-0",3,0,"1",1,3,3,"H"
2004-04-24,2003,"SC Bastia","Girondins Bordeaux","0-2",0,2,"1",1,2,-2,"D"
2004-04-24,2003,"Lille OSC","RC Strasbourg","0-1",0,1,"1",1,1,-1,"D"
2004-04-25,2003,"Paris Saint-Germain","Olympique Marseille","2-1",2,1,"1",1,3,1,"H"
2004-04-30,2003,"OGC Nice","AS Monaco","1-2",1,2,"1",1,3,-1,"D"
2004-05-01,2003,"Olympique Marseille","FC Metz","0-1",0,1,"1",1,1,-1,"D"
2004-05-01,2003,"FC Nantes","Lille OSC","2-0",2,0,"1",1,2,2,"H"
2004-05-01,2003,"FC Sochaux","Montpellier HSC","3-1",3,1,"1",1,4,2,"H"
2004-05-01,2003,"AC Ajaccio","EA Guingamp","0-0",0,0,"1",1,0,0,"D"
2004-05-01,2003,"RC Lens","Toulouse FC","1-1",1,1,"1",1,2,0,"D"
2004-05-01,2003,"Stade Rennes","SC Bastia","4-0",4,0,"1",1,4,4,"H"
2004-05-01,2003,"RC Strasbourg","Paris Saint-Germain","0-0",0,0,"1",1,0,0,"D"
2004-05-01,2003,"Le Mans UC 72","AJ Auxerre","2-1",2,1,"1",1,3,1,"H"
2004-05-02,2003,"Girondins Bordeaux","Olympique Lyon","1-1",1,1,"1",1,2,0,"D"
2004-05-08,2003,"Paris Saint-Germain","Stade Rennes","1-0",1,0,"1",1,1,1,"H"
2004-05-08,2003,"AJ Auxerre","AC Ajaccio","1-1",1,1,"1",1,2,0,"D"
2004-05-08,2003,"Montpellier HSC","OGC Nice","2-2",2,2,"1",1,4,0,"D"
2004-05-08,2003,"EA Guingamp","Le Mans UC 72","2-4",2,4,"1",1,6,-2,"D"
2004-05-08,2003,"Toulouse FC","FC Nantes","0-1",0,1,"1",1,1,-1,"D"
2004-05-08,2003,"FC Sochaux","RC Lens","0-3",0,3,"1",1,3,-3,"D"
2004-05-08,2003,"Lille OSC","Girondins Bordeaux","2-1",2,1,"1",1,3,1,"H"
2004-05-08,2003,"FC Metz","Olympique Lyon","1-2",1,2,"1",1,3,-1,"D"
2004-05-08,2003,"SC Bastia","RC Strasbourg","0-0",0,0,"1",1,0,0,"D"
2004-05-09,2003,"AS Monaco","Olympique Marseille","1-0",1,0,"1",1,1,1,"H"
2004-05-11,2003,"RC Lens","AJ Auxerre","1-3",1,3,"1",1,4,-2,"D"
2004-05-11,2003,"Girondins Bordeaux","Paris Saint-Germain","3-0",3,0,"1",1,3,3,"H"
2004-05-12,2003,"Le Mans UC 72","Lille OSC","1-1",1,1,"1",1,2,0,"D"
2004-05-12,2003,"AC Ajaccio","FC Sochaux","1-0",1,0,"1",1,1,1,"H"
2004-05-12,2003,"FC Nantes","EA Guingamp","0-0",0,0,"1",1,0,0,"D"
2004-05-12,2003,"OGC Nice","Toulouse FC","1-1",1,1,"1",1,2,0,"D"
2004-05-12,2003,"Stade Rennes","FC Metz","0-0",0,0,"1",1,0,0,"D"
2004-05-12,2003,"Olympique Lyon","SC Bastia","1-0",1,0,"1",1,1,1,"H"
2004-05-12,2003,"Olympique Marseille","Montpellier HSC","1-1",1,1,"1",1,2,0,"D"
2004-05-12,2003,"RC Strasbourg","AS Monaco","0-0",0,0,"1",1,0,0,"D"
2004-05-15,2003,"RC Lens","AC Ajaccio","2-0",2,0,"1",1,2,2,"H"
2004-05-15,2003,"AS Monaco","Stade Rennes","1-4",1,4,"1",1,5,-3,"D"
2004-05-15,2003,"EA Guingamp","OGC Nice","1-2",1,2,"1",1,3,-1,"D"
2004-05-15,2003,"FC Sochaux","Le Mans UC 72","3-0",3,0,"1",1,3,3,"H"
2004-05-15,2003,"Lille OSC","SC Bastia","2-0",2,0,"1",1,2,2,"H"
2004-05-15,2003,"AJ Auxerre","FC Nantes","2-0",2,0,"1",1,2,2,"H"
2004-05-15,2003,"Toulouse FC","Olympique Marseille","2-1",2,1,"1",1,3,1,"H"
2004-05-15,2003,"FC Metz","Girondins Bordeaux","3-1",3,1,"1",1,4,2,"H"
2004-05-15,2003,"Paris Saint-Germain","Olympique Lyon","1-0",1,0,"1",1,1,1,"H"
2004-05-15,2003,"Montpellier HSC","RC Strasbourg","1-2",1,2,"1",1,3,-1,"D"
2004-05-21,2003,"Girondins Bordeaux","AS Monaco","1-3",1,3,"1",1,4,-2,"D"
2004-05-23,2003,"Olympique Lyon","Lille OSC","3-0",3,0,"1",1,3,3,"H"
2004-05-23,2003,"FC Nantes","FC Sochaux","3-1",3,1,"1",1,4,2,"H"
2004-05-23,2003,"Olympique Marseille","EA Guingamp","2-1",2,1,"1",1,3,1,"H"
2004-05-23,2003,"RC Strasbourg","Toulouse FC","0-0",0,0,"1",1,0,0,"D"
2004-05-23,2003,"AC Ajaccio","FC Metz","3-1",3,1,"1",1,4,2,"H"
2004-05-23,2003,"Le Mans UC 72","RC Lens","3-0",3,0,"1",1,3,3,"H"
2004-05-23,2003,"Stade Rennes","Montpellier HSC","4-0",4,0,"1",1,4,4,"H"
2004-05-23,2003,"SC Bastia","Paris Saint-Germain","0-1",0,1,"1",1,1,-1,"D"
2004-05-23,2003,"OGC Nice","AJ Auxerre","1-1",1,1,"1",1,2,0,"D"
2004-08-06,2004,"OGC Nice","Olympique Lyon","0-1",0,1,"1",1,1,-1,"D"
2004-08-07,2004,"AS Saint-Etienne","AS Monaco","0-1",0,1,"1",1,1,-1,"D"
2004-08-07,2004,"SC Bastia","RC Strasbourg","2-1",2,1,"1",1,3,1,"H"
2004-08-07,2004,"SM Caen","FC Istres","1-1",1,1,"1",1,2,0,"D"
2004-08-07,2004,"Lille OSC","AJ Auxerre","2-0",2,0,"1",1,2,2,"H"
2004-08-07,2004,"Olympique Marseille","Girondins Bordeaux","1-0",1,0,"1",1,1,1,"H"
2004-08-07,2004,"FC Metz","FC Nantes","1-0",1,0,"1",1,1,1,"H"
2004-08-07,2004,"Stade Rennes","Paris Saint-Germain","2-1",2,1,"1",1,3,1,"H"
2004-08-07,2004,"FC Sochaux","AC Ajaccio","1-0",1,0,"1",1,1,1,"H"
2004-08-07,2004,"Toulouse FC","RC Lens","0-0",0,0,"1",1,0,0,"D"
2004-08-14,2004,"Paris Saint-Germain","SM Caen","2-2",2,2,"1",1,4,0,"D"
2004-08-14,2004,"AC Ajaccio","FC Metz","1-2",1,2,"1",1,3,-1,"D"
2004-08-14,2004,"AJ Auxerre","Stade Rennes","3-1",3,1,"1",1,4,2,"H"
2004-08-14,2004,"Girondins Bordeaux","OGC Nice","5-1",5,1,"1",1,6,4,"H"
2004-08-14,2004,"RC Lens","AS Saint-Etienne","3-0",3,0,"1",1,3,3,"H"
2004-08-14,2004,"Olympique Lyon","FC Sochaux","1-1",1,1,"1",1,2,0,"D"
2004-08-14,2004,"AS Monaco","FC Istres","2-1",2,1,"1",1,3,1,"H"
2004-08-14,2004,"FC Nantes","SC Bastia","1-1",1,1,"1",1,2,0,"D"
2004-08-14,2004,"RC Strasbourg","Toulouse FC","1-4",1,4,"1",1,5,-3,"D"
2004-08-15,2004,"Olympique Marseille","Lille OSC","3-0",3,0,"1",1,3,3,"H"
2004-08-21,2004,"OGC Nice","Olympique Marseille","1-1",1,1,"1",1,2,0,"D"
2004-08-21,2004,"SC Bastia","AC Ajaccio","1-0",1,0,"1",1,1,1,"H"
2004-08-21,2004,"SM Caen","AS Monaco","1-0",1,0,"1",1,1,1,"H"
2004-08-21,2004,"FC Istres","RC Lens","0-2",0,2,"1",1,2,-2,"D"
2004-08-21,2004,"Lille OSC","Girondins Bordeaux","0-0",0,0,"1",1,0,0,"D"
2004-08-21,2004,"Stade Rennes","FC Nantes","1-0",1,0,"1",1,1,1,"H"
2004-08-21,2004,"AS Saint-Etienne","RC Strasbourg","1-1",1,1,"1",1,2,0,"D"
2004-08-21,2004,"FC Sochaux","AJ Auxerre","1-2",1,2,"1",1,3,-1,"D"
2004-08-21,2004,"Toulouse FC","Paris Saint-Germain","2-1",2,1,"1",1,3,1,"H"
2004-08-22,2004,"FC Metz","Olympique Lyon","1-1",1,1,"1",1,2,0,"D"
2004-08-27,2004,"OGC Nice","SC Bastia","1-1",1,1,"1",1,2,0,"D"
2004-08-28,2004,"Girondins Bordeaux","FC Sochaux","2-0",2,0,"1",1,2,2,"H"
2004-08-28,2004,"AC Ajaccio","Stade Rennes","1-1",1,1,"1",1,2,0,"D"
2004-08-28,2004,"AJ Auxerre","SM Caen","1-0",1,0,"1",1,1,1,"H"
2004-08-28,2004,"RC Lens","AS Monaco","1-1",1,1,"1",1,2,0,"D"
2004-08-28,2004,"Olympique Lyon","Lille OSC","1-0",1,0,"1",1,1,1,"H"
2004-08-28,2004,"Olympique Marseille","FC Metz","1-3",1,3,"1",1,4,-2,"D"
2004-08-28,2004,"FC Nantes","Toulouse FC","2-2",2,2,"1",1,4,0,"D"
2004-08-28,2004,"RC Strasbourg","FC Istres","1-1",1,1,"1",1,2,0,"D"
2004-08-29,2004,"Paris Saint-Germain","AS Saint-Etienne","2-2",2,2,"1",1,4,0,"D"
2004-09-11,2004,"SC Bastia","AJ Auxerre","1-0",1,0,"1",1,1,1,"H"
2004-09-11,2004,"SM Caen","RC Lens","1-0",1,0,"1",1,1,1,"H"
2004-09-11,2004,"FC Istres","Paris Saint-Germain","1-1",1,1,"1",1,2,0,"D"
2004-09-11,2004,"Lille OSC","OGC Nice","1-0",1,0,"1",1,1,1,"H"
2004-09-11,2004,"FC Metz","Girondins Bordeaux","0-0",0,0,"1",1,0,0,"D"
2004-09-11,2004,"AS Monaco","RC Strasbourg","3-1",3,1,"1",1,4,2,"H"
2004-09-11,2004,"AS Saint-Etienne","FC Nantes","0-0",0,0,"1",1,0,0,"D"
2004-09-11,2004,"Toulouse FC","AC Ajaccio","3-1",3,1,"1",1,4,2,"H"
2004-09-11,2004,"Stade Rennes","Olympique Lyon","1-2",1,2,"1",1,3,-1,"D"
2004-09-12,2004,"FC Sochaux","Olympique Marseille","2-0",2,0,"1",1,2,2,"H"
2004-09-18,2004,"Girondins Bordeaux","Stade Rennes","0-0",0,0,"1",1,0,0,"D"
2004-09-18,2004,"AC Ajaccio","AS Saint-Etienne","1-1",1,1,"1",1,2,0,"D"
2004-09-18,2004,"Olympique Lyon","SC Bastia","0-0",0,0,"1",1,0,0,"D"
2004-09-18,2004,"Olympique Marseille","Toulouse FC","1-0",1,0,"1",1,1,1,"H"
2004-09-18,2004,"FC Nantes","FC Istres","1-0",1,0,"1",1,1,1,"H"
2004-09-18,2004,"RC Strasbourg","RC Lens","2-2",2,2,"1",1,4,0,"D"
2004-09-19,2004,"AJ Auxerre","FC Metz","4-0",4,0,"1",1,4,4,"H"
2004-09-19,2004,"Lille OSC","SM Caen","2-0",2,0,"1",1,2,2,"H"
2004-09-19,2004,"OGC Nice","FC Sochaux","2-1",2,1,"1",1,3,1,"H"
2004-09-19,2004,"Paris Saint-Germain","AS Monaco","0-1",0,1,"1",1,1,-1,"D"
2004-09-21,2004,"Toulouse FC","Olympique Lyon","0-2",0,2,"1",1,2,-2,"D"
2004-09-22,2004,"Stade Rennes","Olympique Marseille","1-0",1,0,"1",1,1,1,"H"
2004-09-22,2004,"SC Bastia","Girondins Bordeaux","1-4",1,4,"1",1,5,-3,"D"
2004-09-22,2004,"SM Caen","RC Strasbourg","0-0",0,0,"1",1,0,0,"D"
2004-09-22,2004,"FC Istres","AC Ajaccio","0-1",0,1,"1",1,1,-1,"D"
2004-09-22,2004,"RC Lens","Paris Saint-Germain","2-2",2,2,"1",1,4,0,"D"
2004-09-22,2004,"FC Metz","OGC Nice","1-1",1,1,"1",1,2,0,"D"
2004-09-22,2004,"AS Monaco","FC Nantes","2-1",2,1,"1",1,3,1,"H"
2004-09-22,2004,"AS Saint-Etienne","AJ Auxerre","3-1",3,1,"1",1,4,2,"H"
2004-09-22,2004,"FC Sochaux","Lille OSC","0-2",0,2,"1",1,2,-2,"D"
2004-09-25,2004,"Olympique Lyon","AS Monaco","0-0",0,0,"1",1,0,0,"D"
2004-09-25,2004,"AC Ajaccio","SM Caen","2-2",2,2,"1",1,4,0,"D"
2004-09-25,2004,"AJ Auxerre","FC Istres","0-0",0,0,"1",1,0,0,"D"
2004-09-25,2004,"Girondins Bordeaux","Toulouse FC","1-1",1,1,"1",1,2,0,"D"
2004-09-25,2004,"Lille OSC","FC Metz","4-0",4,0,"1",1,4,4,"H"
2004-09-25,2004,"Olympique Marseille","SC Bastia","1-0",1,0,"1",1,1,1,"H"
2004-09-25,2004,"OGC Nice","Stade Rennes","2-0",2,0,"1",1,2,2,"H"
2004-09-25,2004,"Paris Saint-Germain","RC Strasbourg","1-0",1,0,"1",1,1,1,"H"
2004-09-25,2004,"FC Sochaux","AS Saint-Etienne","2-1",2,1,"1",1,3,1,"H"
2004-09-26,2004,"FC Nantes","RC Lens","1-0",1,0,"1",1,1,1,"H"
2004-10-02,2004,"FC Istres","Olympique Marseille","0-2",0,2,"1",1,2,-2,"D"
2004-10-02,2004,"SC Bastia","Paris Saint-Germain","1-2",1,2,"1",1,3,-1,"D"
2004-10-02,2004,"SM Caen","Girondins Bordeaux","1-1",1,1,"1",1,2,0,"D"
2004-10-02,2004,"RC Lens","AC Ajaccio","1-1",1,1,"1",1,2,0,"D"
2004-10-02,2004,"AS Monaco","OGC Nice","3-4",3,4,"1",1,7,-1,"D"
2004-10-02,2004,"RC Strasbourg","FC Nantes","0-2",0,2,"1",1,2,-2,"D"
2004-10-03,2004,"FC Metz","FC Sochaux","0-0",0,0,"1",1,0,0,"D"
2004-10-03,2004,"Stade Rennes","Lille OSC","0-1",0,1,"1",1,1,-1,"D"
2004-10-03,2004,"Toulouse FC","AJ Auxerre","1-2",1,2,"1",1,3,-1,"D"
2004-10-03,2004,"AS Saint-Etienne","Olympique Lyon","2-3",2,3,"1",1,5,-1,"D"
2004-10-15,2004,"Olympique Lyon","SM Caen","4-0",4,0,"1",1,4,4,"H"
2004-10-16,2004,"AJ Auxerre","RC Lens","3-0",3,0,"1",1,3,3,"H"
2004-10-16,2004,"AC Ajaccio","RC Strasbourg","2-2",2,2,"1",1,4,0,"D"
2004-10-16,2004,"Girondins Bordeaux","FC Istres","2-2",2,2,"1",1,4,0,"D"
2004-10-16,2004,"Lille OSC","SC Bastia","2-1",2,1,"1",1,3,1,"H"
2004-10-16,2004,"FC Metz","AS Monaco","1-1",1,1,"1",1,2,0,"D"
2004-10-16,2004,"FC Nantes","Paris Saint-Germain","1-0",1,0,"1",1,1,1,"H"
2004-10-16,2004,"OGC Nice","Toulouse FC","1-0",1,0,"1",1,1,1,"H"
2004-10-16,2004,"FC Sochaux","Stade Rennes","3-0",3,0,"1",1,3,3,"H"
2004-10-17,2004,"Olympique Marseille","AS Saint-Etienne","1-1",1,1,"1",1,2,0,"D"
2004-10-23,2004,"FC Istres","Olympique Lyon","0-0",0,0,"1",1,0,0,"D"
2004-10-23,2004,"SM Caen","FC Nantes","2-1",2,1,"1",1,3,1,"H"
2004-10-23,2004,"Paris Saint-Germain","AC Ajaccio","1-0",1,0,"1",1,1,1,"H"
2004-10-23,2004,"Stade Rennes","FC Metz","3-1",3,1,"1",1,4,2,"H"
2004-10-23,2004,"AS Saint-Etienne","Girondins Bordeaux","0-0",0,0,"1",1,0,0,"D"
2004-10-23,2004,"RC Strasbourg","OGC Nice","3-1",3,1,"1",1,4,2,"H"
2004-10-24,2004,"SC Bastia","FC Sochaux","1-1",1,1,"1",1,2,0,"D"
2004-10-24,2004,"AS Monaco","AJ Auxerre","0-0",0,0,"1",1,0,0,"D"
2004-10-24,2004,"Toulouse FC","Lille OSC","1-0",1,0,"1",1,1,1,"H"
2004-10-24,2004,"RC Lens","Olympique Marseille","0-0",0,0,"1",1,0,0,"D"
2004-10-29,2004,"Olympique Marseille","AS Monaco","1-1",1,1,"1",1,2,0,"D"
2004-10-30,2004,"FC Sochaux","Toulouse FC","2-0",2,0,"1",1,2,2,"H"
2004-10-30,2004,"AC Ajaccio","FC Nantes","1-1",1,1,"1",1,2,0,"D"
2004-10-30,2004,"AJ Auxerre","Paris Saint-Germain","1-1",1,1,"1",1,2,0,"D"
2004-10-30,2004,"Girondins Bordeaux","RC Lens","1-1",1,1,"1",1,2,0,"D"
2004-10-30,2004,"Lille OSC","AS Saint-Etienne","1-0",1,0,"1",1,1,1,"H"
2004-10-30,2004,"Olympique Lyon","RC Strasbourg","1-0",1,0,"1",1,1,1,"H"
2004-10-30,2004,"FC Metz","SC Bastia","2-0",2,0,"1",1,2,2,"H"
2004-10-30,2004,"OGC Nice","FC Istres","0-0",0,0,"1",1,0,0,"D"
2004-10-30,2004,"Stade Rennes","SM Caen","1-1",1,1,"1",1,2,0,"D"
2004-11-06,2004,"AS Saint-Etienne","OGC Nice","2-1",2,1,"1",1,3,1,"H"
2004-11-06,2004,"SC Bastia","Stade Rennes","1-1",1,1,"1",1,2,0,"D"
2004-11-06,2004,"SM Caen","FC Sochaux","0-2",0,2,"1",1,2,-2,"D"
2004-11-06,2004,"RC Lens","Olympique Lyon","0-1",0,1,"1",1,1,-1,"D"
2004-11-06,2004,"AS Monaco","AC Ajaccio","2-2",2,2,"1",1,4,0,"D"
2004-11-06,2004,"RC Strasbourg","Girondins Bordeaux","1-0",1,0,"1",1,1,1,"H"
2004-11-06,2004,"Toulouse FC","FC Metz","1-1",1,1,"1",1,2,0,"D"
2004-11-07,2004,"FC Istres","Lille OSC","0-2",0,2,"1",1,2,-2,"D"
2004-11-07,2004,"FC Nantes","AJ Auxerre","1-1",1,1,"1",1,2,0,"D"
2004-11-07,2004,"Paris Saint-Germain","Olympique Marseille","2-1",2,1,"1",1,3,1,"H"
2004-11-13,2004,"Olympique Lyon","FC Nantes","2-0",2,0,"1",1,2,2,"H"
2004-11-13,2004,"AJ Auxerre","AC Ajaccio","1-0",1,0,"1",1,1,1,"H"
2004-11-13,2004,"SC Bastia","AS Saint-Etienne","0-3",0,3,"1",1,3,-3,"D"
2004-11-13,2004,"Girondins Bordeaux","Paris Saint-Germain","3-0",3,0,"1",1,3,3,"H"
2004-11-13,2004,"Olympique Marseille","RC Strasbourg","2-0",2,0,"1",1,2,2,"H"
2004-11-13,2004,"FC Metz","SM Caen","1-2",1,2,"1",1,3,-1,"D"
2004-11-13,2004,"OGC Nice","RC Lens","1-1",1,1,"1",1,2,0,"D"
2004-11-13,2004,"Stade Rennes","Toulouse FC","1-1",1,1,"1",1,2,0,"D"
2004-11-13,2004,"FC Sochaux","FC Istres","1-1",1,1,"1",1,2,0,"D"
2004-11-14,2004,"Lille OSC","AS Monaco","1-1",1,1,"1",1,2,0,"D"
2004-11-19,2004,"AS Monaco","FC Sochaux","1-3",1,3,"1",1,4,-2,"D"
2004-11-19,2004,"Paris Saint-Germain","Olympique Lyon","0-0",0,0,"1",1,0,0,"D"
2004-11-20,2004,"RC Lens","Lille OSC","1-1",1,1,"1",1,2,0,"D"
2004-11-20,2004,"AC Ajaccio","Olympique Marseille","2-0",2,0,"1",1,2,2,"H"
2004-11-20,2004,"SM Caen","OGC Nice","0-0",0,0,"1",1,0,0,"D"
2004-11-20,2004,"FC Istres","FC Metz","0-0",0,0,"1",1,0,0,"D"
2004-11-20,2004,"FC Nantes","Girondins Bordeaux","0-1",0,1,"1",1,1,-1,"D"
2004-11-20,2004,"AS Saint-Etienne","Stade Rennes","1-0",1,0,"1",1,1,1,"H"
2004-11-20,2004,"RC Strasbourg","AJ Auxerre","3-1",3,1,"1",1,4,2,"H"
2004-11-20,2004,"Toulouse FC","SC Bastia","1-0",1,0,"1",1,1,1,"H"
2004-11-27,2004,"Olympique Lyon","AJ Auxerre","2-1",2,1,"1",1,3,1,"H"
2004-11-27,2004,"SC Bastia","SM Caen","2-0",2,0,"1",1,2,2,"H"
2004-11-27,2004,"Girondins Bordeaux","AC Ajaccio","0-0",0,0,"1",1,0,0,"D"
2004-11-27,2004,"Olympique Marseille","FC Nantes","3-1",3,1,"1",1,4,2,"H"
2004-11-27,2004,"FC Metz","AS Saint-Etienne","2-2",2,2,"1",1,4,0,"D"
2004-11-27,2004,"Stade Rennes","FC Istres","3-1",3,1,"1",1,4,2,"H"
2004-11-27,2004,"Toulouse FC","AS Monaco","0-0",0,0,"1",1,0,0,"D"
2004-11-28,2004,"Lille OSC","RC Strasbourg","1-1",1,1,"1",1,2,0,"D"
2004-11-28,2004,"FC Sochaux","RC Lens","1-2",1,2,"1",1,3,-1,"D"
2004-11-28,2004,"OGC Nice","Paris Saint-Germain","1-1",1,1,"1",1,2,0,"D"
2004-12-03,2004,"AS Monaco","Stade Rennes","2-0",2,0,"1",1,2,2,"H"
2004-12-04,2004,"Paris Saint-Germain","Lille OSC","1-1",1,1,"1",1,2,0,"D"
2004-12-04,2004,"AC Ajaccio","Olympique Lyon","1-1",1,1,"1",1,2,0,"D"
2004-12-04,2004,"SM Caen","Olympique Marseille","2-3",2,3,"1",1,5,-1,"D"
2004-12-04,2004,"FC Istres","SC Bastia","1-0",1,0,"1",1,1,1,"H"
2004-12-04,2004,"RC Lens","FC Metz","2-0",2,0,"1",1,2,2,"H"
2004-12-04,2004,"FC Nantes","OGC Nice","0-1",0,1,"1",1,1,-1,"D"
2004-12-04,2004,"AS Saint-Etienne","Toulouse FC","0-0",0,0,"1",1,0,0,"D"
2004-12-04,2004,"RC Strasbourg","FC Sochaux","0-0",0,0,"1",1,0,0,"D"
2004-12-05,2004,"AJ Auxerre","Girondins Bordeaux","0-0",0,0,"1",1,0,0,"D"
2004-12-11,2004,"Olympique Marseille","AJ Auxerre","0-1",0,1,"1",1,1,-1,"D"
2004-12-11,2004,"SC Bastia","AS Monaco","0-2",0,2,"1",1,2,-2,"D"
2004-12-11,2004,"Girondins Bordeaux","Olympique Lyon","0-0",0,0,"1",1,0,0,"D"
2004-12-11,2004,"Lille OSC","FC Nantes","2-1",2,1,"1",1,3,1,"H"
2004-12-11,2004,"FC Metz","RC Strasbourg","1-0",1,0,"1",1,1,1,"H"
2004-12-11,2004,"OGC Nice","AC Ajaccio","3-0",3,0,"1",1,3,3,"H"
2004-12-11,2004,"Stade Rennes","RC Lens","3-1",3,1,"1",1,4,2,"H"
2004-12-11,2004,"AS Saint-Etienne","SM Caen","5-0",5,0,"1",1,5,5,"H"
2004-12-11,2004,"Toulouse FC","FC Istres","2-1",2,1,"1",1,3,1,"H"
2004-12-12,2004,"FC Sochaux","Paris Saint-Germain","1-2",1,2,"1",1,3,-1,"D"
2004-12-17,2004,"Olympique Lyon","Olympique Marseille","1-1",1,1,"1",1,2,0,"D"
2004-12-18,2004,"AS Monaco","Girondins Bordeaux","1-1",1,1,"1",1,2,0,"D"
2004-12-18,2004,"AC Ajaccio","Lille OSC","0-0",0,0,"1",1,0,0,"D"
2004-12-18,2004,"AJ Auxerre","OGC Nice","4-3",4,3,"1",1,7,1,"H"
2004-12-18,2004,"SM Caen","Toulouse FC","0-2",0,2,"1",1,2,-2,"D"
2004-12-18,2004,"FC Istres","AS Saint-Etienne","0-2",0,2,"1",1,2,-2,"D"
2004-12-18,2004,"RC Lens","SC Bastia","2-1",2,1,"1",1,3,1,"H"
2004-12-18,2004,"Paris Saint-Germain","FC Metz","3-0",3,0,"1",1,3,3,"H"
2004-12-18,2004,"RC Strasbourg","Stade Rennes","1-0",1,0,"1",1,1,1,"H"
2004-12-19,2004,"FC Nantes","FC Sochaux","2-2",2,2,"1",1,4,0,"D"
2005-01-11,2004,"Lille OSC","Olympique Marseille","1-2",1,2,"1",1,3,-1,"D"
2005-01-12,2004,"SM Caen","Paris Saint-Germain","0-0",0,0,"1",1,0,0,"D"
2005-01-12,2004,"FC Metz","AC Ajaccio","1-0",1,0,"1",1,1,1,"H"
2005-01-12,2004,"Stade Rennes","AJ Auxerre","1-0",1,0,"1",1,1,1,"H"
2005-01-12,2004,"OGC Nice","Girondins Bordeaux","3-3",3,3,"1",1,6,0,"D"
2005-01-12,2004,"AS Saint-Etienne","RC Lens","0-0",0,0,"1",1,0,0,"D"
2005-01-12,2004,"FC Sochaux","Olympique Lyon","0-2",0,2,"1",1,2,-2,"D"
2005-01-12,2004,"FC Istres","AS Monaco","0-1",0,1,"1",1,1,-1,"D"
2005-01-12,2004,"SC Bastia","FC Nantes","0-0",0,0,"1",1,0,0,"D"
2005-01-12,2004,"Toulouse FC","RC Strasbourg","2-0",2,0,"1",1,2,2,"H"
2005-01-15,2004,"AJ Auxerre","FC Sochaux","2-0",2,0,"1",1,2,2,"H"
2005-01-15,2004,"AC Ajaccio","SC Bastia","1-0",1,0,"1",1,1,1,"H"
2005-01-15,2004,"AS Monaco","SM Caen","5-2",5,2,"1",1,7,3,"H"
2005-01-15,2004,"RC Lens","FC Istres","0-1",0,1,"1",1,1,-1,"D"
2005-01-15,2004,"Girondins Bordeaux","Lille OSC","1-3",1,3,"1",1,4,-2,"D"
2005-01-15,2004,"Olympique Lyon","FC Metz","2-0",2,0,"1",1,2,2,"H"
2005-01-15,2004,"FC Nantes","Stade Rennes","2-0",2,0,"1",1,2,2,"H"
2005-01-15,2004,"RC Strasbourg","AS Saint-Etienne","1-1",1,1,"1",1,2,0,"D"
2005-01-15,2004,"Paris Saint-Germain","Toulouse FC","0-0",0,0,"1",1,0,0,"D"
2005-01-16,2004,"Olympique Marseille","OGC Nice","2-0",2,0,"1",1,2,2,"H"
2005-01-22,2004,"FC Metz","Olympique Marseille","0-1",0,1,"1",1,1,-1,"D"
2005-01-22,2004,"Stade Rennes","AC Ajaccio","2-0",2,0,"1",1,2,2,"H"
2005-01-22,2004,"SM Caen","AJ Auxerre","0-2",0,2,"1",1,2,-2,"D"
2005-01-22,2004,"FC Sochaux","Girondins Bordeaux","4-0",4,0,"1",1,4,4,"H"
2005-01-22,2004,"AS Monaco","RC Lens","2-0",2,0,"1",1,2,2,"H"
2005-01-22,2004,"Toulouse FC","FC Nantes","2-1",2,1,"1",1,3,1,"H"
2005-01-22,2004,"SC Bastia","OGC Nice","2-0",2,0,"1",1,2,2,"H"
2005-01-22,2004,"AS Saint-Etienne","Paris Saint-Germain","0-0",0,0,"1",1,0,0,"D"
2005-01-22,2004,"FC Istres","RC Strasbourg","1-1",1,1,"1",1,2,0,"D"
2005-01-23,2004,"Lille OSC","Olympique Lyon","2-1",2,1,"1",1,3,1,"H"
2005-01-25,2004,"Olympique Marseille","FC Sochaux","0-2",0,2,"1",1,2,-2,"D"
2005-01-26,2004,"Olympique Lyon","Stade Rennes","2-1",2,1,"1",1,3,1,"H"
2005-01-26,2004,"AJ Auxerre","SC Bastia","4-1",4,1,"1",1,5,3,"H"
2005-01-26,2004,"RC Lens","SM Caen","0-1",0,1,"1",1,1,-1,"D"
2005-01-26,2004,"Paris Saint-Germain","FC Istres","2-2",2,2,"1",1,4,0,"D"
2005-01-26,2004,"OGC Nice","Lille OSC","1-1",1,1,"1",1,2,0,"D"
2005-01-26,2004,"Girondins Bordeaux","FC Metz","1-0",1,0,"1",1,1,1,"H"
2005-01-26,2004,"FC Nantes","AS Saint-Etienne","0-0",0,0,"1",1,0,0,"D"
2005-01-26,2004,"AC Ajaccio","Toulouse FC","1-0",1,0,"1",1,1,1,"H"
2005-01-29,2004,"FC Metz","AJ Auxerre","3-0",3,0,"1",1,3,3,"H"
2005-01-29,2004,"Stade Rennes","Girondins Bordeaux","2-0",2,0,"1",1,2,2,"H"
2005-01-29,2004,"SM Caen","Lille OSC","0-0",0,0,"1",1,0,0,"D"
2005-01-29,2004,"Toulouse FC","Olympique Marseille","1-3",1,3,"1",1,4,-2,"D"
2005-01-29,2004,"FC Sochaux","OGC Nice","0-0",0,0,"1",1,0,0,"D"
2005-01-29,2004,"RC Lens","RC Strasbourg","2-1",2,1,"1",1,3,1,"H"
2005-01-30,2004,"FC Istres","FC Nantes","0-1",0,1,"1",1,1,-1,"D"
2005-01-30,2004,"AS Monaco","Paris Saint-Germain","2-0",2,0,"1",1,2,2,"H"
2005-02-01,2004,"SC Bastia","Olympique Lyon","1-1",1,1,"1",1,2,0,"D"
2005-02-05,2004,"Lille OSC","FC Sochaux","0-0",0,0,"1",1,0,0,"D"
2005-02-05,2004,"Girondins Bordeaux","SC Bastia","0-0",0,0,"1",1,0,0,"D"
2005-02-05,2004,"RC Strasbourg","SM Caen","5-0",5,0,"1",1,5,5,"H"
2005-02-05,2004,"AC Ajaccio","FC Istres","0-0",0,0,"1",1,0,0,"D"
2005-02-05,2004,"OGC Nice","FC Metz","1-1",1,1,"1",1,2,0,"D"
2005-02-05,2004,"FC Nantes","AS Monaco","0-0",0,0,"1",1,0,0,"D"
2005-02-05,2004,"Olympique Marseille","Stade Rennes","3-1",3,1,"1",1,4,2,"H"
2005-02-05,2004,"AJ Auxerre","AS Saint-Etienne","2-2",2,2,"1",1,4,0,"D"
2005-02-05,2004,"Olympique Lyon","Toulouse FC","4-0",4,0,"1",1,4,4,"H"
2005-02-06,2004,"Paris Saint-Germain","RC Lens","0-2",0,2,"1",1,2,-2,"D"
2005-02-18,2004,"AS Monaco","Olympique Lyon","1-1",1,1,"1",1,2,0,"D"
2005-02-19,2004,"RC Strasbourg","Paris Saint-Germain","3-1",3,1,"1",1,4,2,"H"
2005-02-19,2004,"SM Caen","AC Ajaccio","2-2",2,2,"1",1,4,0,"D"
2005-02-19,2004,"Toulouse FC","Girondins Bordeaux","1-0",1,0,"1",1,1,1,"H"
2005-02-19,2004,"SC Bastia","Olympique Marseille","0-1",0,1,"1",1,1,-1,"D"
2005-02-19,2004,"RC Lens","FC Nantes","2-0",2,0,"1",1,2,2,"H"
2005-02-19,2004,"Stade Rennes","OGC Nice","4-1",4,1,"1",1,5,3,"H"
2005-02-20,2004,"FC Istres","AJ Auxerre","1-0",1,0,"1",1,1,1,"H"
2005-02-20,2004,"FC Metz","Lille OSC","1-1",1,1,"1",1,2,0,"D"
2005-02-20,2004,"AS Saint-Etienne","FC Sochaux","1-0",1,0,"1",1,1,1,"H"
2005-02-26,2004,"Olympique Lyon","AS Saint-Etienne","3-2",3,2,"1",1,5,1,"H"
2005-02-26,2004,"Paris Saint-Germain","SC Bastia","1-0",1,0,"1",1,1,1,"H"
2005-02-26,2004,"Girondins Bordeaux","SM Caen","2-2",2,2,"1",1,4,0,"D"
2005-02-26,2004,"AC Ajaccio","RC Lens","0-0",0,0,"1",1,0,0,"D"
2005-02-26,2004,"OGC Nice","AS Monaco","2-1",2,1,"1",1,3,1,"H"
2005-02-26,2004,"FC Nantes","RC Strasbourg","2-1",2,1,"1",1,3,1,"H"
2005-02-27,2004,"Lille OSC","Stade Rennes","0-0",0,0,"1",1,0,0,"D"
2005-02-27,2004,"Olympique Marseille","FC Istres","1-1",1,1,"1",1,2,0,"D"
2005-03-04,2004,"SM Caen","Olympique Lyon","1-0",1,0,"1",1,1,1,"H"
2005-03-05,2004,"RC Lens","AJ Auxerre","3-1",3,1,"1",1,4,2,"H"
2005-03-05,2004,"RC Strasbourg","AC Ajaccio","1-0",1,0,"1",1,1,1,"H"
2005-03-05,2004,"FC Istres","Girondins Bordeaux","0-1",0,1,"1",1,1,-1,"D"
2005-03-05,2004,"SC Bastia","Lille OSC","3-1",3,1,"1",1,4,2,"H"
2005-03-05,2004,"AS Monaco","FC Metz","0-0",0,0,"1",1,0,0,"D"
2005-03-05,2004,"Paris Saint-Germain","FC Nantes","1-0",1,0,"1",1,1,1,"H"
2005-03-05,2004,"Toulouse FC","OGC Nice","1-0",1,0,"1",1,1,1,"H"
2005-03-05,2004,"Stade Rennes","FC Sochaux","3-0",3,0,"1",1,3,3,"H"
2005-03-06,2004,"AS Saint-Etienne","Olympique Marseille","2-0",2,0,"1",1,2,2,"H"
2005-03-12,2004,"Olympique Lyon","FC Istres","2-1",2,1,"1",1,3,1,"H"
2005-03-12,2004,"FC Sochaux","SC Bastia","1-0",1,0,"1",1,1,1,"H"
2005-03-12,2004,"FC Nantes","SM Caen","2-0",2,0,"1",1,2,2,"H"
2005-03-12,2004,"Olympique Marseille","RC Lens","2-1",2,1,"1",1,3,1,"H"
2005-03-12,2004,"AC Ajaccio","Paris Saint-Germain","1-0",1,0,"1",1,1,1,"H"
2005-03-12,2004,"FC Metz","Stade Rennes","1-1",1,1,"1",1,2,0,"D"
2005-03-12,2004,"Girondins Bordeaux","AS Saint-Etienne","2-0",2,0,"1",1,2,2,"H"
2005-03-12,2004,"OGC Nice","RC Strasbourg","0-0",0,0,"1",1,0,0,"D"
2005-03-13,2004,"Lille OSC","Toulouse FC","1-1",1,1,"1",1,2,0,"D"
2005-03-13,2004,"AJ Auxerre","AS Monaco","2-2",2,2,"1",1,4,0,"D"
2005-03-16,2004,"RC Strasbourg","AS Monaco","0-0",0,0,"1",1,0,0,"D"
2005-03-16,2004,"AS Saint-Etienne","AC Ajaccio","3-0",3,0,"1",1,3,3,"H"
2005-03-16,2004,"FC Sochaux","FC Metz","2-1",2,1,"1",1,3,1,"H"
2005-03-19,2004,"Toulouse FC","FC Sochaux","0-0",0,0,"1",1,0,0,"D"
2005-03-19,2004,"FC Nantes","AC Ajaccio","0-0",0,0,"1",1,0,0,"D"
2005-03-19,2004,"RC Lens","Girondins Bordeaux","2-0",2,0,"1",1,2,2,"H"
2005-03-19,2004,"RC Strasbourg","Olympique Lyon","0-1",0,1,"1",1,1,-1,"D"
2005-03-19,2004,"SC Bastia","FC Metz","1-0",1,0,"1",1,1,1,"H"
2005-03-19,2004,"FC Istres","OGC Nice","1-1",1,1,"1",1,2,0,"D"
2005-03-19,2004,"SM Caen","Stade Rennes","2-2",2,2,"1",1,4,0,"D"
2005-03-20,2004,"Paris Saint-Germain","AJ Auxerre","1-0",1,0,"1",1,1,1,"H"
2005-03-20,2004,"AS Saint-Etienne","Lille OSC","0-0",0,0,"1",1,0,0,"D"
2005-03-20,2004,"AS Monaco","Olympique Marseille","2-1",2,1,"1",1,3,1,"H"
2005-04-02,2004,"AJ Auxerre","FC Nantes","2-1",2,1,"1",1,3,1,"H"
2005-04-02,2004,"Stade Rennes","SC Bastia","1-0",1,0,"1",1,1,1,"H"
2005-04-02,2004,"FC Sochaux","SM Caen","1-0",1,0,"1",1,1,1,"H"
2005-04-02,2004,"Lille OSC","FC Istres","8-0",8,0,"1",1,8,8,"H"
2005-04-02,2004,"Olympique Lyon","RC Lens","1-0",1,0,"1",1,1,1,"H"
2005-04-02,2004,"AC Ajaccio","AS Monaco","3-0",3,0,"1",1,3,3,"H"
2005-04-02,2004,"OGC Nice","AS Saint-Etienne","2-0",2,0,"1",1,2,2,"H"
2005-04-02,2004,"Girondins Bordeaux","RC Strasbourg","0-2",0,2,"1",1,2,-2,"D"
2005-04-02,2004,"FC Metz","Toulouse FC","0-1",0,1,"1",1,1,-1,"D"
2005-04-03,2004,"Olympique Marseille","Paris Saint-Germain","1-1",1,1,"1",1,2,0,"D"
2005-04-09,2004,"FC Nantes","Olympique Lyon","2-2",2,2,"1",1,4,0,"D"
2005-04-09,2004,"AS Saint-Etienne","SC Bastia","3-0",3,0,"1",1,3,3,"H"
2005-04-09,2004,"Paris Saint-Germain","Girondins Bordeaux","1-1",1,1,"1",1,2,0,"D"
2005-04-09,2004,"RC Strasbourg","Olympique Marseille","1-0",1,0,"1",1,1,1,"H"
2005-04-09,2004,"SM Caen","FC Metz","0-1",0,1,"1",1,1,-1,"D"
2005-04-09,2004,"RC Lens","OGC Nice","0-0",0,0,"1",1,0,0,"D"
2005-04-09,2004,"Toulouse FC","Stade Rennes","0-2",0,2,"1",1,2,-2,"D"
2005-04-09,2004,"FC Istres","FC Sochaux","2-0",2,0,"1",1,2,2,"H"
2005-04-10,2004,"AC Ajaccio","AJ Auxerre","4-3",4,3,"1",1,7,1,"H"
2005-04-16,2004,"Lille OSC","RC Lens","2-1",2,1,"1",1,3,1,"H"
2005-04-16,2004,"Olympique Marseille","AC Ajaccio","1-2",1,2,"1",1,3,-1,"D"
2005-04-16,2004,"OGC Nice","SM Caen","0-1",0,1,"1",1,1,-1,"D"
2005-04-16,2004,"FC Metz","FC Istres","2-1",2,1,"1",1,3,1,"H"
2005-04-16,2004,"FC Sochaux","AS Monaco","1-1",1,1,"1",1,2,0,"D"
2005-04-16,2004,"Girondins Bordeaux","FC Nantes","0-2",0,2,"1",1,2,-2,"D"
2005-04-16,2004,"Stade Rennes","AS Saint-Etienne","2-2",2,2,"1",1,4,0,"D"
2005-04-16,2004,"SC Bastia","Toulouse FC","2-1",2,1,"1",1,3,1,"H"
2005-04-17,2004,"AJ Auxerre","RC Strasbourg","0-0",0,0,"1",1,0,0,"D"
2005-04-17,2004,"Olympique Lyon","Paris Saint-Germain","0-1",0,1,"1",1,1,-1,"D"
2005-04-22,2004,"Paris Saint-Germain","OGC Nice","3-1",3,1,"1",1,4,2,"H"
2005-04-23,2004,"AS Monaco","Toulouse FC","2-1",2,1,"1",1,3,1,"H"
2005-04-23,2004,"SM Caen","SC Bastia","0-1",0,1,"1",1,1,-1,"D"
2005-04-23,2004,"AC Ajaccio","Girondins Bordeaux","0-0",0,0,"1",1,0,0,"D"
2005-04-23,2004,"RC Strasbourg","Lille OSC","1-2",1,2,"1",1,3,-1,"D"
2005-04-23,2004,"FC Nantes","Olympique Marseille","2-2",2,2,"1",1,4,0,"D"
2005-04-23,2004,"AS Saint-Etienne","FC Metz","0-0",0,0,"1",1,0,0,"D"
2005-04-23,2004,"FC Istres","Stade Rennes","0-2",0,2,"1",1,2,-2,"D"
2005-04-23,2004,"RC Lens","FC Sochaux","3-2",3,2,"1",1,5,1,"H"
2005-04-24,2004,"AJ Auxerre","Olympique Lyon","0-3",0,3,"1",1,3,-3,"D"
2005-04-29,2004,"AJ Auxerre","Toulouse FC","3-2",3,2,"1",1,5,1,"H"
2005-05-01,2004,"AS Monaco","Lille OSC","2-0",2,0,"1",1,2,2,"H"
2005-05-06,2004,"Girondins Bordeaux","AJ Auxerre","0-0",0,0,"1",1,0,0,"D"
2005-05-07,2004,"Olympique Marseille","SM Caen","2-3",2,3,"1",1,5,-1,"D"
2005-05-07,2004,"SC Bastia","FC Istres","2-0",2,0,"1",1,2,2,"H"
2005-05-07,2004,"FC Metz","RC Lens","1-1",1,1,"1",1,2,0,"D"
2005-05-07,2004,"Stade Rennes","AS Monaco","0-0",0,0,"1",1,0,0,"D"
2005-05-07,2004,"OGC Nice","FC Nantes","0-0",0,0,"1",1,0,0,"D"
2005-05-07,2004,"Lille OSC","Paris Saint-Germain","1-0",1,0,"1",1,1,1,"H"
2005-05-07,2004,"Toulouse FC","AS Saint-Etienne","0-2",0,2,"1",1,2,-2,"D"
2005-05-07,2004,"FC Sochaux","RC Strasbourg","1-2",1,2,"1",1,3,-1,"D"
2005-05-08,2004,"Olympique Lyon","AC Ajaccio","2-1",2,1,"1",1,3,1,"H"
2005-05-14,2004,"FC Nantes","Lille OSC","1-3",1,3,"1",1,4,-2,"D"
2005-05-14,2004,"AS Monaco","SC Bastia","5-2",5,2,"1",1,7,3,"H"
2005-05-14,2004,"AJ Auxerre","Olympique Marseille","0-0",0,0,"1",1,0,0,"D"
2005-05-14,2004,"RC Strasbourg","FC Metz","3-1",3,1,"1",1,4,2,"H"
2005-05-14,2004,"AC Ajaccio","OGC Nice","0-1",0,1,"1",1,1,-1,"D"
2005-05-14,2004,"RC Lens","Stade Rennes","5-2",5,2,"1",1,7,3,"H"
2005-05-14,2004,"SM Caen","AS Saint-Etienne","2-0",2,0,"1",1,2,2,"H"
2005-05-14,2004,"Paris Saint-Germain","FC Sochaux","2-2",2,2,"1",1,4,0,"D"
2005-05-14,2004,"FC Istres","Toulouse FC","1-0",1,0,"1",1,1,1,"H"
2005-05-15,2004,"Olympique Lyon","Girondins Bordeaux","5-1",5,1,"1",1,6,4,"H"
2005-05-21,2004,"Lille OSC","AC Ajaccio","0-2",0,2,"1",1,2,-2,"D"
2005-05-21,2004,"OGC Nice","AJ Auxerre","1-0",1,0,"1",1,1,1,"H"
2005-05-21,2004,"Toulouse FC","SM Caen","2-3",2,3,"1",1,5,-1,"D"
2005-05-21,2004,"AS Saint-Etienne","FC Istres","2-0",2,0,"1",1,2,2,"H"
2005-05-21,2004,"SC Bastia","RC Lens","3-1",3,1,"1",1,4,2,"H"
2005-05-21,2004,"Olympique Marseille","Olympique Lyon","0-1",0,1,"1",1,1,-1,"D"
2005-05-21,2004,"Girondins Bordeaux","AS Monaco","1-1",1,1,"1",1,2,0,"D"
2005-05-21,2004,"FC Sochaux","FC Nantes","1-0",1,0,"1",1,1,1,"H"
2005-05-21,2004,"FC Metz","Paris Saint-Germain","3-2",3,2,"1",1,5,1,"H"
2005-05-21,2004,"Stade Rennes","RC Strasbourg","4-0",4,0,"1",1,4,4,"H"
2005-05-28,2004,"RC Strasbourg","SC Bastia","2-0",2,0,"1",1,2,2,"H"
2005-05-28,2004,"FC Istres","SM Caen","3-2",3,2,"1",1,5,1,"H"
2005-05-28,2004,"AJ Auxerre","Lille OSC","1-3",1,3,"1",1,4,-2,"D"
2005-05-28,2004,"Girondins Bordeaux","Olympique Marseille","3-3",3,3,"1",1,6,0,"D"
2005-05-28,2004,"FC Nantes","FC Metz","1-0",1,0,"1",1,1,1,"H"
2005-05-28,2004,"Olympique Lyon","OGC Nice","0-0",0,0,"1",1,0,0,"D"
2005-05-28,2004,"Paris Saint-Germain","Stade Rennes","1-0",1,0,"1",1,1,1,"H"
2005-05-28,2004,"AS Monaco","AS Saint-Etienne","1-1",1,1,"1",1,2,0,"D"
2005-05-28,2004,"AC Ajaccio","FC Sochaux","3-1",3,1,"1",1,4,2,"H"
2005-05-28,2004,"RC Lens","Toulouse FC","1-0",1,0,"1",1,1,1,"H"
2005-07-29,2005,"Paris Saint-Germain","FC Metz","4-1",4,1,"1",1,5,3,"H"
2005-07-30,2005,"Olympique Marseille","Girondins Bordeaux","0-2",0,2,"1",1,2,-2,"D"
2005-07-30,2005,"Lille OSC","Stade Rennes","1-0",1,0,"1",1,1,1,"H"
2005-07-30,2005,"AS Nancy","AS Monaco","0-1",0,1,"1",1,1,-1,"D"
2005-07-30,2005,"OGC Nice","ESTAC Troyes","1-1",1,1,"1",1,2,0,"D"
2005-07-30,2005,"AS Saint-Etienne","AC Ajaccio","0-0",0,0,"1",1,0,0,"D"
2005-07-30,2005,"FC Sochaux","Toulouse FC","0-1",0,1,"1",1,1,-1,"D"
2005-07-30,2005,"RC Strasbourg","AJ Auxerre","0-0",0,0,"1",1,0,0,"D"
2005-07-30,2005,"FC Nantes","RC Lens","2-0",2,0,"1",1,2,2,"H"
2005-07-31,2005,"Le Mans UC 72","Olympique Lyon","1-2",1,2,"1",1,3,-1,"D"
2005-08-06,2005,"RC Lens","Olympique Marseille","2-0",2,0,"1",1,2,2,"H"
2005-08-06,2005,"AC Ajaccio","Lille OSC","3-3",3,3,"1",1,6,0,"D"
2005-08-06,2005,"Girondins Bordeaux","AS Nancy","1-0",1,0,"1",1,1,1,"H"
2005-08-06,2005,"FC Metz","Le Mans UC 72","0-0",0,0,"1",1,0,0,"D"
2005-08-06,2005,"AS Monaco","AJ Auxerre","0-2",0,2,"1",1,2,-2,"D"
2005-08-06,2005,"FC Sochaux","Paris Saint-Germain","0-1",0,1,"1",1,1,-1,"D"
2005-08-06,2005,"Toulouse FC","OGC Nice","0-2",0,2,"1",1,2,-2,"D"
2005-08-06,2005,"ESTAC Troyes","AS Saint-Etienne","0-0",0,0,"1",1,0,0,"D"
2005-08-07,2005,"Stade Rennes","FC Nantes","0-3",0,3,"1",1,3,-3,"D"
2005-08-07,2005,"Olympique Lyon","RC Strasbourg","1-0",1,0,"1",1,1,1,"H"
2005-08-13,2005,"Paris Saint-Germain","Toulouse FC","2-0",2,0,"1",1,2,2,"H"
2005-08-13,2005,"AJ Auxerre","Girondins Bordeaux","1-0",1,0,"1",1,1,1,"H"
2005-08-13,2005,"Le Mans UC 72","Stade Rennes","4-0",4,0,"1",1,4,4,"H"
2005-08-13,2005,"Lille OSC","ESTAC Troyes","1-2",1,2,"1",1,3,-1,"D"
2005-08-13,2005,"AS Nancy","RC Lens","1-2",1,2,"1",1,3,-1,"D"
2005-08-13,2005,"FC Nantes","AC Ajaccio","0-2",0,2,"1",1,2,-2,"D"
2005-08-13,2005,"OGC Nice","FC Sochaux","1-2",1,2,"1",1,3,-1,"D"
2005-08-13,2005,"AS Saint-Etienne","FC Metz","2-0",2,0,"1",1,2,2,"H"
2005-08-14,2005,"RC Strasbourg","AS Monaco","1-2",1,2,"1",1,3,-1,"D"
2005-08-14,2005,"Olympique Marseille","Olympique Lyon","1-1",1,1,"1",1,2,0,"D"
2005-08-20,2005,"Girondins Bordeaux","AS Monaco","1-0",1,0,"1",1,1,1,"H"
2005-08-20,2005,"AC Ajaccio","Le Mans UC 72","0-0",0,0,"1",1,0,0,"D"
2005-08-20,2005,"RC Lens","AJ Auxerre","7-0",7,0,"1",1,7,7,"H"
2005-08-20,2005,"Olympique Lyon","AS Nancy","1-0",1,0,"1",1,1,1,"H"
2005-08-20,2005,"FC Metz","RC Strasbourg","0-0",0,0,"1",1,0,0,"D"
2005-08-20,2005,"OGC Nice","FC Nantes","1-1",1,1,"1",1,2,0,"D"
2005-08-20,2005,"Stade Rennes","Olympique Marseille","3-2",3,2,"1",1,5,1,"H"
2005-08-20,2005,"FC Sochaux","Lille OSC","0-0",0,0,"1",1,0,0,"D"
2005-08-21,2005,"Toulouse FC","AS Saint-Etienne","1-1",1,1,"1",1,2,0,"D"
2005-08-21,2005,"ESTAC Troyes","Paris Saint-Germain","1-1",1,1,"1",1,2,0,"D"
2005-08-24,2005,"Lille OSC","Toulouse FC","0-0",0,0,"1",1,0,0,"D"
2005-08-27,2005,"Olympique Marseille","AC Ajaccio","1-1",1,1,"1",1,2,0,"D"
2005-08-27,2005,"Le Mans UC 72","ESTAC Troyes","1-0",1,0,"1",1,1,1,"H"
2005-08-27,2005,"AS Nancy","Stade Rennes","6-0",6,0,"1",1,6,6,"H"
2005-08-27,2005,"FC Nantes","FC Metz","0-0",0,0,"1",1,0,0,"D"
2005-08-27,2005,"Paris Saint-Germain","OGC Nice","1-2",1,2,"1",1,3,-1,"D"
2005-08-27,2005,"AS Saint-Etienne","FC Sochaux","0-0",0,0,"1",1,0,0,"D"
2005-08-27,2005,"RC Strasbourg","Girondins Bordeaux","0-0",0,0,"1",1,0,0,"D"
2005-08-28,2005,"AS Monaco","RC Lens","0-0",0,0,"1",1,0,0,"D"
2005-08-28,2005,"AJ Auxerre","Olympique Lyon","0-2",0,2,"1",1,2,-2,"D"
2005-09-10,2005,"Olympique Lyon","AS Monaco","2-1",2,1,"1",1,3,1,"H"
2005-09-10,2005,"AC Ajaccio","AS Nancy","1-0",1,0,"1",1,1,1,"H"
2005-09-10,2005,"FC Metz","Lille OSC","0-2",0,2,"1",1,2,-2,"D"
2005-09-10,2005,"OGC Nice","AS Saint-Etienne","0-1",0,1,"1",1,1,-1,"D"
2005-09-10,2005,"Paris Saint-Germain","RC Strasbourg","1-0",1,0,"1",1,1,1,"H"
2005-09-10,2005,"Stade Rennes","AJ Auxerre","3-1",3,1,"1",1,4,2,"H"
2005-09-10,2005,"Toulouse FC","Le Mans UC 72","0-2",0,2,"1",1,2,-2,"D"
2005-09-10,2005,"ESTAC Troyes","FC Nantes","1-0",1,0,"1",1,1,1,"H"
2005-09-11,2005,"RC Lens","Girondins Bordeaux","1-1",1,1,"1",1,2,0,"D"
2005-09-11,2005,"FC Sochaux","Olympique Marseille","0-1",0,1,"1",1,1,-1,"D"
2005-09-17,2005,"Girondins Bordeaux","Olympique Lyon","1-1",1,1,"1",1,2,0,"D"
2005-09-17,2005,"Le Mans UC 72","FC Sochaux","2-1",2,1,"1",1,3,1,"H"
2005-09-17,2005,"Lille OSC","OGC Nice","4-0",4,0,"1",1,4,4,"H"
2005-09-17,2005,"AS Nancy","FC Metz","1-1",1,1,"1",1,2,0,"D"
2005-09-17,2005,"FC Nantes","Toulouse FC","2-0",2,0,"1",1,2,2,"H"
2005-09-18,2005,"AJ Auxerre","AC Ajaccio","2-0",2,0,"1",1,2,2,"H"
2005-09-18,2005,"Olympique Marseille","ESTAC Troyes","2-1",2,1,"1",1,3,1,"H"
2005-09-18,2005,"AS Monaco","Stade Rennes","0-2",0,2,"1",1,2,-2,"D"
2005-09-18,2005,"RC Strasbourg","RC Lens","1-1",1,1,"1",1,2,0,"D"
2005-09-18,2005,"AS Saint-Etienne","Paris Saint-Germain","3-0",3,0,"1",1,3,3,"H"
2005-09-21,2005,"Toulouse FC","Olympique Marseille","1-0",1,0,"1",1,1,1,"H"
2005-09-21,2005,"AC Ajaccio","RC Strasbourg","0-0",0,0,"1",1,0,0,"D"
2005-09-21,2005,"FC Metz","AJ Auxerre","1-2",1,2,"1",1,3,-1,"D"
2005-09-21,2005,"OGC Nice","Le Mans UC 72","1-0",1,0,"1",1,1,1,"H"
2005-09-21,2005,"Stade Rennes","Girondins Bordeaux","2-2",2,2,"1",1,4,0,"D"
2005-09-21,2005,"AS Saint-Etienne","AS Nancy","0-2",0,2,"1",1,2,-2,"D"
2005-09-21,2005,"FC Sochaux","FC Nantes","1-0",1,0,"1",1,1,1,"H"
2005-09-21,2005,"ESTAC Troyes","AS Monaco","1-2",1,2,"1",1,3,-1,"D"
2005-09-21,2005,"Paris Saint-Germain","Lille OSC","2-1",2,1,"1",1,3,1,"H"
2005-09-22,2005,"Olympique Lyon","RC Lens","1-1",1,1,"1",1,2,0,"D"
2005-09-24,2005,"AS Monaco","OGC Nice","0-0",0,0,"1",1,0,0,"D"
2005-09-24,2005,"AJ Auxerre","FC Sochaux","3-0",3,0,"1",1,3,3,"H"
2005-09-24,2005,"Girondins Bordeaux","AC Ajaccio","1-0",1,0,"1",1,1,1,"H"
2005-09-24,2005,"Le Mans UC 72","Paris Saint-Germain","0-0",0,0,"1",1,0,0,"D"
2005-09-24,2005,"Lille OSC","AS Saint-Etienne","2-0",2,0,"1",1,2,2,"H"
2005-09-24,2005,"Olympique Marseille","FC Metz","3-1",3,1,"1",1,4,2,"H"
2005-09-24,2005,"AS Nancy","ESTAC Troyes","2-1",2,1,"1",1,3,1,"H"
2005-09-24,2005,"RC Strasbourg","Toulouse FC","2-4",2,4,"1",1,6,-2,"D"
2005-09-25,2005,"FC Nantes","Olympique Lyon","0-1",0,1,"1",1,1,-1,"D"
2005-09-25,2005,"RC Lens","Stade Rennes","0-0",0,0,"1",1,0,0,"D"
2005-10-01,2005,"Paris Saint-Germain","FC Nantes","2-0",2,0,"1",1,2,2,"H"
2005-10-01,2005,"FC Metz","Girondins Bordeaux","0-1",0,1,"1",1,1,-1,"D"
2005-10-01,2005,"AS Saint-Etienne","Le Mans UC 72","3-0",3,0,"1",1,3,3,"H"
2005-10-01,2005,"FC Sochaux","AS Nancy","0-2",0,2,"1",1,2,-2,"D"
2005-10-02,2005,"Lille OSC","AS Monaco","0-1",0,1,"1",1,1,-1,"D"
2005-10-02,2005,"Stade Rennes","Olympique Lyon","1-3",1,3,"1",1,4,-2,"D"
2005-10-02,2005,"Toulouse FC","AJ Auxerre","2-0",2,0,"1",1,2,2,"H"
2005-10-02,2005,"ESTAC Troyes","RC Strasbourg","1-1",1,1,"1",1,2,0,"D"
2005-10-02,2005,"OGC Nice","Olympique Marseille","0-1",0,1,"1",1,1,-1,"D"
2005-10-15,2005,"FC Nantes","AS Saint-Etienne","1-1",1,1,"1",1,2,0,"D"
2005-10-15,2005,"AJ Auxerre","ESTAC Troyes","3-0",3,0,"1",1,3,3,"H"
2005-10-15,2005,"Girondins Bordeaux","FC Sochaux","1-1",1,1,"1",1,2,0,"D"
2005-10-15,2005,"Le Mans UC 72","Lille OSC","1-1",1,1,"1",1,2,0,"D"
2005-10-15,2005,"RC Lens","OGC Nice","2-2",2,2,"1",1,4,0,"D"
2005-10-15,2005,"AS Monaco","FC Metz","3-0",3,0,"1",1,3,3,"H"
2005-10-15,2005,"AS Nancy","Toulouse FC","2-0",2,0,"1",1,2,2,"H"
2005-10-15,2005,"RC Strasbourg","Stade Rennes","0-1",0,1,"1",1,1,-1,"D"
2005-10-16,2005,"Olympique Lyon","AC Ajaccio","3-2",3,2,"1",1,5,1,"H"
2005-10-16,2005,"Olympique Marseille","Paris Saint-Germain","1-0",1,0,"1",1,1,1,"H"
2005-10-22,2005,"FC Metz","Olympique Lyon","0-4",0,4,"1",1,4,-4,"D"
2005-10-22,2005,"Lille OSC","FC Nantes","2-0",2,0,"1",1,2,2,"H"
2005-10-22,2005,"OGC Nice","AJ Auxerre","1-0",1,0,"1",1,1,1,"H"
2005-10-22,2005,"Paris Saint-Germain","AS Nancy","1-0",1,0,"1",1,1,1,"H"
2005-10-22,2005,"Toulouse FC","Girondins Bordeaux","1-1",1,1,"1",1,2,0,"D"
2005-10-23,2005,"AC Ajaccio","Stade Rennes","0-1",0,1,"1",1,1,-1,"D"
2005-10-23,2005,"Le Mans UC 72","RC Strasbourg","2-0",2,0,"1",1,2,2,"H"
2005-10-23,2005,"FC Sochaux","AS Monaco","2-1",2,1,"1",1,3,1,"H"
2005-10-23,2005,"ESTAC Troyes","RC Lens","1-1",1,1,"1",1,2,0,"D"
2005-10-23,2005,"AS Saint-Etienne","Olympique Marseille","2-1",2,1,"1",1,3,1,"H"
2005-10-29,2005,"Olympique Marseille","Lille OSC","1-1",1,1,"1",1,2,0,"D"
2005-10-29,2005,"Girondins Bordeaux","ESTAC Troyes","2-0",2,0,"1",1,2,2,"H"
2005-10-29,2005,"RC Lens","Toulouse FC","1-0",1,0,"1",1,1,1,"H"
2005-10-29,2005,"Olympique Lyon","FC Sochaux","1-0",1,0,"1",1,1,1,"H"
2005-10-29,2005,"AS Monaco","AC Ajaccio","3-0",3,0,"1",1,3,3,"H"
2005-10-29,2005,"FC Nantes","Le Mans UC 72","1-0",1,0,"1",1,1,1,"H"
2005-10-29,2005,"Stade Rennes","FC Metz","2-1",2,1,"1",1,3,1,"H"
2005-10-29,2005,"RC Strasbourg","AS Saint-Etienne","0-1",0,1,"1",1,1,-1,"D"
2005-10-30,2005,"AS Nancy","OGC Nice","0-0",0,0,"1",1,0,0,"D"
2005-10-30,2005,"AJ Auxerre","Paris Saint-Germain","2-0",2,0,"1",1,2,2,"H"
2005-11-05,2005,"Toulouse FC","Olympique Lyon","0-1",0,1,"1",1,1,-1,"D"
2005-11-05,2005,"Le Mans UC 72","Olympique Marseille","3-0",3,0,"1",1,3,3,"H"
2005-11-05,2005,"FC Metz","AC Ajaccio","2-0",2,0,"1",1,2,2,"H"
2005-11-05,2005,"FC Nantes","AS Nancy","3-0",3,0,"1",1,3,3,"H"
2005-11-05,2005,"OGC Nice","Girondins Bordeaux","0-1",0,1,"1",1,1,-1,"D"
2005-11-05,2005,"AS Saint-Etienne","AJ Auxerre","1-1",1,1,"1",1,2,0,"D"
2005-11-06,2005,"Lille OSC","RC Strasbourg","2-0",2,0,"1",1,2,2,"H"
2005-11-06,2005,"FC Sochaux","RC Lens","1-1",1,1,"1",1,2,0,"D"
2005-11-06,2005,"ESTAC Troyes","Stade Rennes","2-1",2,1,"1",1,3,1,"H"
2005-11-06,2005,"Paris Saint-Germain","AS Monaco","0-0",0,0,"1",1,0,0,"D"
2005-11-11,2005,"AC Ajaccio","RC Lens","0-0",0,0,"1",1,0,0,"D"
2005-11-19,2005,"Olympique Marseille","FC Nantes","2-1",2,1,"1",1,3,1,"H"
2005-11-19,2005,"AS Monaco","AS Saint-Etienne","1-0",1,0,"1",1,1,1,"H"
2005-11-19,2005,"AC Ajaccio","FC Sochaux","0-1",0,1,"1",1,1,-1,"D"
2005-11-19,2005,"AJ Auxerre","Lille OSC","3-2",3,2,"1",1,5,1,"H"
2005-11-19,2005,"RC Lens","FC Metz","0-0",0,0,"1",1,0,0,"D"
2005-11-19,2005,"Olympique Lyon","ESTAC Troyes","2-1",2,1,"1",1,3,1,"H"
2005-11-19,2005,"AS Nancy","Le Mans UC 72","1-0",1,0,"1",1,1,1,"H"
2005-11-19,2005,"RC Strasbourg","OGC Nice","0-0",0,0,"1",1,0,0,"D"
2005-11-20,2005,"Stade Rennes","Toulouse FC","4-1",4,1,"1",1,5,3,"H"
2005-11-20,2005,"Girondins Bordeaux","Paris Saint-Germain","0-2",0,2,"1",1,2,-2,"D"
2005-11-25,2005,"Le Mans UC 72","AJ Auxerre","0-2",0,2,"1",1,2,-2,"D"
2005-11-26,2005,"AS Saint-Etienne","Girondins Bordeaux","1-1",1,1,"1",1,2,0,"D"
2005-11-26,2005,"Lille OSC","AS Nancy","1-0",1,0,"1",1,1,1,"H"
2005-11-26,2005,"OGC Nice","Olympique Lyon","1-1",1,1,"1",1,2,0,"D"
2005-11-26,2005,"FC Sochaux","Stade Rennes","1-0",1,0,"1",1,1,1,"H"
2005-11-26,2005,"Toulouse FC","AC Ajaccio","3-0",3,0,"1",1,3,3,"H"
2005-11-26,2005,"ESTAC Troyes","FC Metz","0-0",0,0,"1",1,0,0,"D"
2005-11-27,2005,"FC Nantes","RC Strasbourg","4-3",4,3,"1",1,7,1,"H"
2005-11-27,2005,"Paris Saint-Germain","RC Lens","3-4",3,4,"1",1,7,-1,"D"
2005-11-27,2005,"Olympique Marseille","AS Monaco","2-1",2,1,"1",1,3,1,"H"
2005-12-03,2005,"Olympique Lyon","Paris Saint-Germain","2-0",2,0,"1",1,2,2,"H"
2005-12-03,2005,"AC Ajaccio","ESTAC Troyes","0-1",0,1,"1",1,1,-1,"D"
2005-12-03,2005,"AJ Auxerre","FC Nantes","4-0",4,0,"1",1,4,4,"H"
2005-12-03,2005,"Girondins Bordeaux","Lille OSC","1-0",1,0,"1",1,1,1,"H"
2005-12-03,2005,"FC Metz","Toulouse FC","2-2",2,2,"1",1,4,0,"D"
2005-12-03,2005,"AS Monaco","Le Mans UC 72","2-0",2,0,"1",1,2,2,"H"
2005-12-03,2005,"RC Strasbourg","FC Sochaux","0-0",0,0,"1",1,0,0,"D"
2005-12-04,2005,"AS Nancy","Olympique Marseille","1-1",1,1,"1",1,2,0,"D"
2005-12-04,2005,"Stade Rennes","OGC Nice","1-0",1,0,"1",1,1,1,"H"
2005-12-04,2005,"RC Lens","AS Saint-Etienne","2-1",2,1,"1",1,3,1,"H"
2005-12-10,2005,"Lille OSC","RC Lens","0-0",0,0,"1",1,0,0,"D"
2005-12-10,2005,"Le Mans UC 72","Girondins Bordeaux","1-0",1,0,"1",1,1,1,"H"
2005-12-10,2005,"Olympique Marseille","AJ Auxerre","1-0",1,0,"1",1,1,1,"H"
2005-12-10,2005,"AS Nancy","RC Strasbourg","1-2",1,2,"1",1,3,-1,"D"
2005-12-10,2005,"OGC Nice","AC Ajaccio","1-0",1,0,"1",1,1,1,"H"
2005-12-10,2005,"Paris Saint-Germain","Stade Rennes","2-0",2,0,"1",1,2,2,"H"
2005-12-10,2005,"FC Sochaux","FC Metz","1-1",1,1,"1",1,2,0,"D"
2005-12-10,2005,"Toulouse FC","ESTAC Troyes","2-1",2,1,"1",1,3,1,"H"
2005-12-11,2005,"FC Nantes","AS Monaco","0-0",0,0,"1",1,0,0,"D"
2005-12-11,2005,"AS Saint-Etienne","Olympique Lyon","0-0",0,0,"1",1,0,0,"D"
2005-12-16,2005,"Olympique Lyon","Lille OSC","1-3",1,3,"1",1,4,-2,"D"
2005-12-17,2005,"AC Ajaccio","Paris Saint-Germain","1-1",1,1,"1",1,2,0,"D"
2005-12-17,2005,"AJ Auxerre","AS Nancy","0-1",0,1,"1",1,1,-1,"D"
2005-12-17,2005,"Girondins Bordeaux","FC Nantes","0-0",0,0,"1",1,0,0,"D"
2005-12-17,2005,"FC Metz","OGC Nice","1-0",1,0,"1",1,1,1,"H"
2005-12-17,2005,"Stade Rennes","AS Saint-Etienne","0-1",0,1,"1",1,1,-1,"D"
2005-12-17,2005,"RC Strasbourg","Olympique Marseille","0-1",0,1,"1",1,1,-1,"D"
2005-12-17,2005,"ESTAC Troyes","FC Sochaux","2-1",2,1,"1",1,3,1,"H"
2005-12-18,2005,"RC Lens","Le Mans UC 72","2-0",2,0,"1",1,2,2,"H"
2005-12-18,2005,"AS Monaco","Toulouse FC","1-0",1,0,"1",1,1,1,"H"
2006-01-04,2005,"RC Strasbourg","Olympique Lyon","0-4",0,4,"1",1,4,-4,"D"
2006-01-04,2005,"Le Mans UC 72","FC Metz","2-0",2,0,"1",1,2,2,"H"
2006-01-04,2005,"Lille OSC","AC Ajaccio","2-0",2,0,"1",1,2,2,"H"
2006-01-04,2005,"AS Nancy","Girondins Bordeaux","0-0",0,0,"1",1,0,0,"D"
2006-01-04,2005,"FC Nantes","Stade Rennes","0-2",0,2,"1",1,2,-2,"D"
2006-01-04,2005,"OGC Nice","Toulouse FC","2-1",2,1,"1",1,3,1,"H"
2006-01-04,2005,"Paris Saint-Germain","FC Sochaux","3-1",3,1,"1",1,4,2,"H"
2006-01-04,2005,"AS Saint-Etienne","ESTAC Troyes","1-1",1,1,"1",1,2,0,"D"
2006-01-04,2005,"Olympique Marseille","RC Lens","1-1",1,1,"1",1,2,0,"D"
2006-01-05,2005,"AJ Auxerre","AS Monaco","2-1",2,1,"1",1,3,1,"H"
2006-01-11,2005,"Girondins Bordeaux","AJ Auxerre","1-0",1,0,"1",1,1,1,"H"
2006-01-11,2005,"AC Ajaccio","FC Nantes","0-2",0,2,"1",1,2,-2,"D"
2006-01-11,2005,"RC Lens","AS Nancy","1-2",1,2,"1",1,3,-1,"D"
2006-01-11,2005,"FC Metz","AS Saint-Etienne","0-1",0,1,"1",1,1,-1,"D"
2006-01-11,2005,"AS Monaco","RC Strasbourg","1-1",1,1,"1",1,2,0,"D"
2006-01-11,2005,"Stade Rennes","Le Mans UC 72","1-0",1,0,"1",1,1,1,"H"
2006-01-11,2005,"FC Sochaux","OGC Nice","1-1",1,1,"1",1,2,0,"D"
2006-01-11,2005,"ESTAC Troyes","Lille OSC","1-0",1,0,"1",1,1,1,"H"
2006-01-11,2005,"Olympique Lyon","Olympique Marseille","2-1",2,1,"1",1,3,1,"H"
2006-01-12,2005,"Toulouse FC","Paris Saint-Germain","1-0",1,0,"1",1,1,1,"H"
2006-01-14,2005,"AS Nancy","Olympique Lyon","0-2",0,2,"1",1,2,-2,"D"
2006-01-14,2005,"AJ Auxerre","RC Lens","1-0",1,0,"1",1,1,1,"H"
2006-01-14,2005,"Le Mans UC 72","AC Ajaccio","1-0",1,0,"1",1,1,1,"H"
2006-01-14,2005,"Lille OSC","FC Sochaux","3-0",3,0,"1",1,3,3,"H"
2006-01-14,2005,"AS Monaco","Girondins Bordeaux","0-1",0,1,"1",1,1,-1,"D"
2006-01-14,2005,"FC Nantes","OGC Nice","0-0",0,0,"1",1,0,0,"D"
2006-01-14,2005,"RC Strasbourg","FC Metz","2-1",2,1,"1",1,3,1,"H"
2006-01-15,2005,"Paris Saint-Germain","ESTAC Troyes","2-1",2,1,"1",1,3,1,"H"
2006-01-15,2005,"Olympique Marseille","Stade Rennes","1-0",1,0,"1",1,1,1,"H"
2006-01-21,2005,"AC Ajaccio","Olympique Marseille","3-1",3,1,"1",1,4,2,"H"
2006-01-21,2005,"Girondins Bordeaux","RC Strasbourg","2-1",2,1,"1",1,3,1,"H"
2006-01-21,2005,"FC Metz","FC Nantes","1-4",1,4,"1",1,5,-3,"D"
2006-01-21,2005,"OGC Nice","Paris Saint-Germain","1-0",1,0,"1",1,1,1,"H"
2006-01-21,2005,"Stade Rennes","AS Nancy","0-2",0,2,"1",1,2,-2,"D"
2006-01-21,2005,"FC Sochaux","AS Saint-Etienne","4-0",4,0,"1",1,4,4,"H"
2006-01-21,2005,"Toulouse FC","Lille OSC","0-0",0,0,"1",1,0,0,"D"
2006-01-21,2005,"ESTAC Troyes","Le Mans UC 72","1-3",1,3,"1",1,4,-2,"D"
2006-01-22,2005,"RC Lens","AS Monaco","1-1",1,1,"1",1,2,0,"D"
2006-01-22,2005,"Olympique Lyon","AJ Auxerre","1-1",1,1,"1",1,2,0,"D"
2006-01-28,2005,"Girondins Bordeaux","RC Lens","1-0",1,0,"1",1,1,1,"H"
2006-01-28,2005,"AJ Auxerre","Stade Rennes","2-0",2,0,"1",1,2,2,"H"
2006-01-28,2005,"Le Mans UC 72","Toulouse FC","1-1",1,1,"1",1,2,0,"D"
2006-01-28,2005,"Olympique Marseille","FC Sochaux","0-0",0,0,"1",1,0,0,"D"
2006-01-28,2005,"AS Nancy","AC Ajaccio","0-0",0,0,"1",1,0,0,"D"
2006-01-29,2005,"Lille OSC","FC Metz","3-1",3,1,"1",1,4,2,"H"
2006-02-01,2005,"AS Saint-Etienne","Toulouse FC","1-3",1,3,"1",1,4,-2,"D"
2006-02-04,2005,"Paris Saint-Germain","AS Saint-Etienne","2-2",2,2,"1",1,4,0,"D"
2006-02-04,2005,"AC Ajaccio","AJ Auxerre","1-0",1,0,"1",1,1,1,"H"
2006-02-04,2005,"RC Lens","RC Strasbourg","2-1",2,1,"1",1,3,1,"H"
2006-02-04,2005,"OGC Nice","Lille OSC","2-0",2,0,"1",1,2,2,"H"
2006-02-04,2005,"Stade Rennes","AS Monaco","1-3",1,3,"1",1,4,-2,"D"
2006-02-04,2005,"FC Sochaux","Le Mans UC 72","0-0",0,0,"1",1,0,0,"D"
2006-02-04,2005,"Toulouse FC","FC Nantes","1-0",1,0,"1",1,1,1,"H"
2006-02-05,2005,"ESTAC Troyes","Olympique Marseille","0-1",0,1,"1",1,1,-1,"D"
2006-02-05,2005,"Olympique Lyon","Girondins Bordeaux","0-0",0,0,"1",1,0,0,"D"
2006-02-08,2005,"RC Strasbourg","Paris Saint-Germain","1-1",1,1,"1",1,2,0,"D"
2006-02-11,2005,"RC Lens","Olympique Lyon","1-1",1,1,"1",1,2,0,"D"
2006-02-11,2005,"AJ Auxerre","FC Metz","1-1",1,1,"1",1,2,0,"D"
2006-02-11,2005,"Girondins Bordeaux","Stade Rennes","2-0",2,0,"1",1,2,2,"H"
2006-02-11,2005,"Le Mans UC 72","OGC Nice","2-0",2,0,"1",1,2,2,"H"
2006-02-11,2005,"AS Monaco","ESTAC Troyes","1-1",1,1,"1",1,2,0,"D"
2006-02-11,2005,"AS Nancy","AS Saint-Etienne","2-0",2,0,"1",1,2,2,"H"
2006-02-11,2005,"FC Nantes","FC Sochaux","3-1",3,1,"1",1,4,2,"H"
2006-02-11,2005,"RC Strasbourg","AC Ajaccio","2-2",2,2,"1",1,4,0,"D"
2006-02-12,2005,"Olympique Marseille","Toulouse FC","0-0",0,0,"1",1,0,0,"D"
2006-02-12,2005,"Lille OSC","Paris Saint-Germain","0-0",0,0,"1",1,0,0,"D"
2006-02-14,2005,"FC Nantes","ESTAC Troyes","1-1",1,1,"1",1,2,0,"D"
2006-02-14,2005,"AS Saint-Etienne","OGC Nice","0-1",0,1,"1",1,1,-1,"D"
2006-02-17,2005,"Olympique Lyon","FC Nantes","3-1",3,1,"1",1,4,2,"H"
2006-02-18,2005,"OGC Nice","AS Monaco","2-0",2,0,"1",1,2,2,"H"
2006-02-18,2005,"AC Ajaccio","Girondins Bordeaux","0-2",0,2,"1",1,2,-2,"D"
2006-02-18,2005,"Paris Saint-Germain","Le Mans UC 72","0-1",0,1,"1",1,1,-1,"D"
2006-02-18,2005,"Stade Rennes","RC Lens","4-1",4,1,"1",1,5,3,"H"
2006-02-18,2005,"AS Saint-Etienne","Lille OSC","0-2",0,2,"1",1,2,-2,"D"
2006-02-18,2005,"FC Sochaux","AJ Auxerre","1-0",1,0,"1",1,1,1,"H"
2006-02-18,2005,"Toulouse FC","RC Strasbourg","1-2",1,2,"1",1,3,-1,"D"
2006-02-18,2005,"ESTAC Troyes","AS Nancy","0-1",0,1,"1",1,1,-1,"D"
2006-02-19,2005,"FC Metz","Olympique Marseille","1-0",1,0,"1",1,1,1,"H"
2006-02-25,2005,"FC Nantes","Paris Saint-Germain","0-0",0,0,"1",1,0,0,"D"
2006-02-25,2005,"AJ Auxerre","Toulouse FC","2-0",2,0,"1",1,2,2,"H"
2006-02-25,2005,"Girondins Bordeaux","FC Metz","3-3",3,3,"1",1,6,0,"D"
2006-02-25,2005,"Le Mans UC 72","AS Saint-Etienne","0-1",0,1,"1",1,1,-1,"D"
2006-02-25,2005,"Olympique Lyon","Stade Rennes","1-4",1,4,"1",1,5,-3,"D"
2006-02-25,2005,"AS Nancy","FC Sochaux","0-3",0,3,"1",1,3,-3,"D"
2006-02-26,2005,"RC Lens","AC Ajaccio","1-0",1,0,"1",1,1,1,"H"
2006-02-26,2005,"AS Monaco","Lille OSC","0-1",0,1,"1",1,1,-1,"D"
2006-02-26,2005,"RC Strasbourg","ESTAC Troyes","2-0",2,0,"1",1,2,2,"H"
2006-02-26,2005,"Olympique Marseille","OGC Nice","1-0",1,0,"1",1,1,1,"H"
2006-03-04,2005,"AC Ajaccio","Olympique Lyon","1-3",1,3,"1",1,4,-2,"D"
2006-03-04,2005,"Lille OSC","Le Mans UC 72","4-0",4,0,"1",1,4,4,"H"
2006-03-04,2005,"FC Metz","AS Monaco","2-1",2,1,"1",1,3,1,"H"
2006-03-04,2005,"OGC Nice","RC Lens","0-0",0,0,"1",1,0,0,"D"
2006-03-04,2005,"Stade Rennes","RC Strasbourg","2-1",2,1,"1",1,3,1,"H"
2006-03-04,2005,"Toulouse FC","AS Nancy","1-1",1,1,"1",1,2,0,"D"
2006-03-05,2005,"Paris Saint-Germain","Olympique Marseille","0-0",0,0,"1",1,0,0,"D"
2006-03-05,2005,"ESTAC Troyes","AJ Auxerre","1-1",1,1,"1",1,2,0,"D"
2006-03-05,2005,"AS Saint-Etienne","FC Nantes","1-0",1,0,"1",1,1,1,"H"
2006-03-07,2005,"FC Metz","AS Nancy","0-0",0,0,"1",1,0,0,"D"
2006-03-11,2005,"AS Nancy","Paris Saint-Germain","1-1",1,1,"1",1,2,0,"D"
2006-03-11,2005,"AJ Auxerre","OGC Nice","2-0",2,0,"1",1,2,2,"H"
2006-03-11,2005,"Girondins Bordeaux","Toulouse FC","2-0",2,0,"1",1,2,2,"H"
2006-03-11,2005,"RC Lens","ESTAC Troyes","1-0",1,0,"1",1,1,1,"H"
2006-03-11,2005,"Olympique Lyon","FC Metz","4-0",4,0,"1",1,4,4,"H"
2006-03-11,2005,"AS Monaco","FC Sochaux","4-1",4,1,"1",1,5,3,"H"
2006-03-11,2005,"Stade Rennes","AC Ajaccio","3-0",3,0,"1",1,3,3,"H"
2006-03-12,2005,"FC Nantes","Lille OSC","1-1",1,1,"1",1,2,0,"D"
2006-03-12,2005,"RC Strasbourg","Le Mans UC 72","1-2",1,2,"1",1,3,-1,"D"
2006-03-12,2005,"Olympique Marseille","AS Saint-Etienne","2-0",2,0,"1",1,2,2,"H"
2006-03-18,2005,"Le Mans UC 72","FC Nantes","0-0",0,0,"1",1,0,0,"D"
2006-03-18,2005,"AC Ajaccio","AS Monaco","1-0",1,0,"1",1,1,1,"H"
2006-03-18,2005,"FC Metz","Stade Rennes","0-1",0,1,"1",1,1,-1,"D"
2006-03-18,2005,"OGC Nice","AS Nancy","1-0",1,0,"1",1,1,1,"H"
2006-03-18,2005,"FC Sochaux","Olympique Lyon","0-4",0,4,"1",1,4,-4,"D"
2006-03-18,2005,"Toulouse FC","RC Lens","1-1",1,1,"1",1,2,0,"D"
2006-03-18,2005,"ESTAC Troyes","Girondins Bordeaux","1-1",1,1,"1",1,2,0,"D"
2006-03-19,2005,"Lille OSC","Olympique Marseille","0-0",0,0,"1",1,0,0,"D"
2006-03-19,2005,"AS Saint-Etienne","RC Strasbourg","0-2",0,2,"1",1,2,-2,"D"
2006-03-19,2005,"Paris Saint-Germain","AJ Auxerre","4-1",4,1,"1",1,5,3,"H"
2006-03-25,2005,"Olympique Lyon","Toulouse FC","1-1",1,1,"1",1,2,0,"D"
2006-03-25,2005,"AC Ajaccio","FC Metz","0-1",0,1,"1",1,1,-1,"D"
2006-03-25,2005,"AJ Auxerre","AS Saint-Etienne","0-0",0,0,"1",1,0,0,"D"
2006-03-25,2005,"RC Lens","FC Sochaux","2-1",2,1,"1",1,3,1,"H"
2006-03-25,2005,"Olympique Marseille","Le Mans UC 72","1-1",1,1,"1",1,2,0,"D"
2006-03-25,2005,"AS Nancy","FC Nantes","0-0",0,0,"1",1,0,0,"D"
2006-03-25,2005,"Stade Rennes","ESTAC Troyes","2-0",2,0,"1",1,2,2,"H"
2006-03-25,2005,"RC Strasbourg","Lille OSC","2-2",2,2,"1",1,4,0,"D"
2006-03-26,2005,"Girondins Bordeaux","OGC Nice","1-0",1,0,"1",1,1,1,"H"
2006-03-26,2005,"AS Monaco","Paris Saint-Germain","1-1",1,1,"1",1,2,0,"D"
2006-04-01,2005,"Lille OSC","AJ Auxerre","1-1",1,1,"1",1,2,0,"D"
2006-04-01,2005,"ESTAC Troyes","Olympique Lyon","0-1",0,1,"1",1,1,-1,"D"
2006-04-01,2005,"FC Metz","RC Lens","0-1",0,1,"1",1,1,-1,"D"
2006-04-01,2005,"FC Nantes","Olympique Marseille","1-3",1,3,"1",1,4,-2,"D"
2006-04-01,2005,"OGC Nice","RC Strasbourg","3-1",3,1,"1",1,4,2,"H"
2006-04-01,2005,"AS Saint-Etienne","AS Monaco","1-1",1,1,"1",1,2,0,"D"
2006-04-01,2005,"FC Sochaux","AC Ajaccio","3-1",3,1,"1",1,4,2,"H"
2006-04-02,2005,"Le Mans UC 72","AS Nancy","0-0",0,0,"1",1,0,0,"D"
2006-04-02,2005,"Toulouse FC","Stade Rennes","0-1",0,1,"1",1,1,-1,"D"
2006-04-02,2005,"Paris Saint-Germain","Girondins Bordeaux","3-1",3,1,"1",1,4,2,"H"
2006-04-08,2005,"RC Lens","Paris Saint-Germain","1-1",1,1,"1",1,2,0,"D"
2006-04-08,2005,"AC Ajaccio","Toulouse FC","1-0",1,0,"1",1,1,1,"H"
2006-04-08,2005,"Girondins Bordeaux","AS Saint-Etienne","0-0",0,0,"1",1,0,0,"D"
2006-04-08,2005,"Olympique Lyon","OGC Nice","2-1",2,1,"1",1,3,1,"H"
2006-04-08,2005,"FC Metz","ESTAC Troyes","2-4",2,4,"1",1,6,-2,"D"
2006-04-08,2005,"AS Monaco","Olympique Marseille","1-0",1,0,"1",1,1,1,"H"
2006-04-08,2005,"AS Nancy","Lille OSC","0-0",0,0,"1",1,0,0,"D"
2006-04-08,2005,"RC Strasbourg","FC Nantes","0-1",0,1,"1",1,1,-1,"D"
2006-04-09,2005,"AJ Auxerre","Le Mans UC 72","0-0",0,0,"1",1,0,0,"D"
2006-04-09,2005,"Stade Rennes","FC Sochaux","2-1",2,1,"1",1,3,1,"H"
2006-04-14,2005,"Toulouse FC","FC Metz","2-0",2,0,"1",1,2,2,"H"
2006-04-15,2005,"Lille OSC","Girondins Bordeaux","3-2",3,2,"1",1,5,1,"H"
2006-04-15,2005,"Le Mans UC 72","AS Monaco","0-0",0,0,"1",1,0,0,"D"
2006-04-15,2005,"Olympique Marseille","AS Nancy","6-0",6,0,"1",1,6,6,"H"
2006-04-15,2005,"FC Nantes","AJ Auxerre","3-2",3,2,"1",1,5,1,"H"
2006-04-15,2005,"AS Saint-Etienne","RC Lens","2-0",2,0,"1",1,2,2,"H"
2006-04-15,2005,"FC Sochaux","RC Strasbourg","1-1",1,1,"1",1,2,0,"D"
2006-04-15,2005,"ESTAC Troyes","AC Ajaccio","3-0",3,0,"1",1,3,3,"H"
2006-04-16,2005,"OGC Nice","Stade Rennes","2-1",2,1,"1",1,3,1,"H"
2006-04-16,2005,"Paris Saint-Germain","Olympique Lyon","0-1",0,1,"1",1,1,-1,"D"
2006-04-23,2005,"AS Monaco","Olympique Lyon","2-1",2,1,"1",1,3,1,"H"
2006-04-23,2005,"FC Sochaux","Girondins Bordeaux","0-3",0,3,"1",1,3,-3,"D"
2006-04-29,2005,"RC Lens","Lille OSC","4-2",4,2,"1",1,6,2,"H"
2006-04-30,2005,"AC Ajaccio","OGC Nice","0-3",0,3,"1",1,3,-3,"D"
2006-04-30,2005,"Girondins Bordeaux","Le Mans UC 72","2-2",2,2,"1",1,4,0,"D"
2006-04-30,2005,"FC Metz","FC Sochaux","0-1",0,1,"1",1,1,-1,"D"
2006-04-30,2005,"AS Monaco","FC Nantes","1-1",1,1,"1",1,2,0,"D"
2006-04-30,2005,"RC Strasbourg","AS Nancy","1-3",1,3,"1",1,4,-2,"D"
2006-04-30,2005,"ESTAC Troyes","Toulouse FC","3-1",3,1,"1",1,4,2,"H"
2006-04-30,2005,"Olympique Lyon","AS Saint-Etienne","4-0",4,0,"1",1,4,4,"H"
2006-05-03,2005,"AJ Auxerre","Olympique Marseille","1-2",1,2,"1",1,3,-1,"D"
2006-05-03,2005,"Stade Rennes","Paris Saint-Germain","1-1",1,1,"1",1,2,0,"D"
2006-05-06,2005,"Le Mans UC 72","RC Lens","0-0",0,0,"1",1,0,0,"D"
2006-05-06,2005,"Lille OSC","Olympique Lyon","4-0",4,0,"1",1,4,4,"H"
2006-05-06,2005,"Olympique Marseille","RC Strasbourg","2-2",2,2,"1",1,4,0,"D"
2006-05-06,2005,"AS Nancy","AJ Auxerre","1-3",1,3,"1",1,4,-2,"D"
2006-05-06,2005,"FC Nantes","Girondins Bordeaux","0-1",0,1,"1",1,1,-1,"D"
2006-05-06,2005,"OGC Nice","FC Metz","2-1",2,1,"1",1,3,1,"H"
2006-05-06,2005,"Paris Saint-Germain","AC Ajaccio","2-4",2,4,"1",1,6,-2,"D"
2006-05-06,2005,"AS Saint-Etienne","Stade Rennes","0-0",0,0,"1",1,0,0,"D"
2006-05-06,2005,"FC Sochaux","ESTAC Troyes","1-1",1,1,"1",1,2,0,"D"
2006-05-06,2005,"Toulouse FC","AS Monaco","3-3",3,3,"1",1,6,0,"D"
2006-05-13,2005,"AC Ajaccio","AS Saint-Etienne","3-1",3,1,"1",1,4,2,"H"
2006-05-13,2005,"AJ Auxerre","RC Strasbourg","4-0",4,0,"1",1,4,4,"H"
2006-05-13,2005,"Girondins Bordeaux","Olympique Marseille","1-1",1,1,"1",1,2,0,"D"
2006-05-13,2005,"RC Lens","FC Nantes","3-1",3,1,"1",1,4,2,"H"
2006-05-13,2005,"Olympique Lyon","Le Mans UC 72","8-1",8,1,"1",1,9,7,"H"
2006-05-13,2005,"FC Metz","Paris Saint-Germain","1-0",1,0,"1",1,1,1,"H"
2006-05-13,2005,"AS Monaco","AS Nancy","2-2",2,2,"1",1,4,0,"D"
2006-05-13,2005,"Stade Rennes","Lille OSC","2-2",2,2,"1",1,4,0,"D"
2006-05-13,2005,"Toulouse FC","FC Sochaux","1-2",1,2,"1",1,3,-1,"D"
2006-05-13,2005,"ESTAC Troyes","OGC Nice","1-2",1,2,"1",1,3,-1,"D"
2006-08-04,2006,"FC Nantes","Olympique Lyon","1-3",1,3,"1",1,4,-2,"D"
2006-08-05,2006,"Stade Rennes","Lille OSC","1-2",1,2,"1",1,3,-1,"D"
2006-08-05,2006,"AJ Auxerre","Valenciennes FC","1-1",1,1,"1",1,2,0,"D"
2006-08-05,2006,"Girondins Bordeaux","Toulouse FC","2-0",2,0,"1",1,2,2,"H"
2006-08-05,2006,"Le Mans UC 72","OGC Nice","1-0",1,0,"1",1,1,1,"H"
2006-08-05,2006,"RC Lens","ESTAC Troyes","1-0",1,0,"1",1,1,1,"H"
2006-08-05,2006,"AS Nancy","AS Monaco","1-0",1,0,"1",1,1,1,"H"
2006-08-05,2006,"Paris Saint-Germain","FC Lorient","2-3",2,3,"1",1,5,-1,"D"
2006-08-05,2006,"AS Saint-Etienne","FC Sochaux","1-2",1,2,"1",1,3,-1,"D"
2006-08-06,2006,"CS Sedan","Olympique Marseille","0-0",0,0,"1",1,0,0,"D"
2006-08-12,2006,"FC Lorient","Girondins Bordeaux","0-1",0,1,"1",1,1,-1,"D"
2006-08-12,2006,"Olympique Lyon","Toulouse FC","1-1",1,1,"1",1,2,0,"D"
2006-08-12,2006,"Valenciennes FC","Paris Saint-Germain","0-0",0,0,"1",1,0,0,"D"
2006-08-12,2006,"AS Monaco","AS Saint-Etienne","1-2",1,2,"1",1,3,-1,"D"
2006-08-12,2006,"FC Sochaux","AJ Auxerre","1-1",1,1,"1",1,2,0,"D"
2006-08-12,2006,"OGC Nice","FC Nantes","1-1",1,1,"1",1,2,0,"D"
2006-08-12,2006,"AS Nancy","CS Sedan","3-1",3,1,"1",1,4,2,"H"
2006-08-12,2006,"ESTAC Troyes","Le Mans UC 72","2-2",2,2,"1",1,4,0,"D"
2006-08-13,2006,"Lille OSC","RC Lens","4-0",4,0,"1",1,4,4,"H"
2006-08-13,2006,"Olympique Marseille","Stade Rennes","2-0",2,0,"1",1,2,2,"H"
2006-08-19,2006,"AJ Auxerre","Olympique Marseille","0-3",0,3,"1",1,3,-3,"D"
2006-08-19,2006,"Le Mans UC 72","Valenciennes FC","3-2",3,2,"1",1,5,1,"H"
2006-08-19,2006,"FC Nantes","ESTAC Troyes","1-1",1,1,"1",1,2,0,"D"
2006-08-19,2006,"Paris Saint-Germain","Lille OSC","1-0",1,0,"1",1,1,1,"H"
2006-08-19,2006,"Stade Rennes","AS Monaco","1-1",1,1,"1",1,2,0,"D"
2006-08-19,2006,"AS Saint-Etienne","AS Nancy","1-0",1,0,"1",1,1,1,"H"
2006-08-19,2006,"CS Sedan","FC Sochaux","1-1",1,1,"1",1,2,0,"D"
2006-08-19,2006,"RC Lens","FC Lorient","1-1",1,1,"1",1,2,0,"D"
2006-08-20,2006,"Toulouse FC","OGC Nice","1-0",1,0,"1",1,1,1,"H"
2006-08-20,2006,"Girondins Bordeaux","Olympique Lyon","1-2",1,2,"1",1,3,-1,"D"
2006-08-26,2006,"OGC Nice","Olympique Lyon","1-4",1,4,"1",1,5,-3,"D"
2006-08-26,2006,"Lille OSC","Girondins Bordeaux","3-0",3,0,"1",1,3,3,"H"
2006-08-26,2006,"FC Lorient","FC Nantes","3-1",3,1,"1",1,4,2,"H"
2006-08-26,2006,"FC Sochaux","Paris Saint-Germain","3-2",3,2,"1",1,5,1,"H"
2006-08-26,2006,"ESTAC Troyes","Toulouse FC","1-2",1,2,"1",1,3,-1,"D"
2006-08-27,2006,"Olympique Marseille","Le Mans UC 72","2-0",2,0,"1",1,2,2,"H"
2006-08-27,2006,"AS Monaco","CS Sedan","2-1",2,1,"1",1,3,1,"H"
2006-08-27,2006,"AS Nancy","AJ Auxerre","1-0",1,0,"1",1,1,1,"H"
2006-08-27,2006,"Valenciennes FC","Stade Rennes","3-1",3,1,"1",1,4,2,"H"
2006-08-27,2006,"AS Saint-Etienne","RC Lens","3-2",3,2,"1",1,5,1,"H"
2006-09-09,2006,"Girondins Bordeaux","OGC Nice","3-2",3,2,"1",1,5,1,"H"
2006-09-09,2006,"Olympique Lyon","ESTAC Troyes","2-0",2,0,"1",1,2,2,"H"
2006-09-09,2006,"AJ Auxerre","AS Monaco","2-1",2,1,"1",1,3,1,"H"
2006-09-09,2006,"CS Sedan","AS Saint-Etienne","2-2",2,2,"1",1,4,0,"D"
2006-09-09,2006,"Le Mans UC 72","FC Lorient","1-1",1,1,"1",1,2,0,"D"
2006-09-09,2006,"FC Nantes","Lille OSC","1-1",1,1,"1",1,2,0,"D"
2006-09-09,2006,"RC Lens","Valenciennes FC","3-0",3,0,"1",1,3,3,"H"
2006-09-09,2006,"Stade Rennes","FC Sochaux","2-1",2,1,"1",1,3,1,"H"
2006-09-10,2006,"Toulouse FC","AS Nancy","2-2",2,2,"1",1,4,0,"D"
2006-09-10,2006,"Paris Saint-Germain","Olympique Marseille","1-3",1,3,"1",1,4,-2,"D"
2006-09-16,2006,"CS Sedan","Le Mans UC 72","1-2",1,2,"1",1,3,-1,"D"
2006-09-16,2006,"Lille OSC","Toulouse FC","1-3",1,3,"1",1,4,-2,"D"
2006-09-16,2006,"Valenciennes FC","FC Nantes","1-0",1,0,"1",1,1,1,"H"
2006-09-16,2006,"ESTAC Troyes","OGC Nice","2-0",2,0,"1",1,2,2,"H"
2006-09-16,2006,"FC Lorient","Olympique Lyon","1-3",1,3,"1",1,4,-2,"D"
2006-09-17,2006,"AS Monaco","Paris Saint-Germain","1-2",1,2,"1",1,3,-1,"D"
2006-09-17,2006,"FC Sochaux","RC Lens","0-3",0,3,"1",1,3,-3,"D"
2006-09-17,2006,"AS Saint-Etienne","AJ Auxerre","2-3",2,3,"1",1,5,-1,"D"
2006-09-17,2006,"AS Nancy","Stade Rennes","0-0",0,0,"1",1,0,0,"D"
2006-09-17,2006,"Olympique Marseille","Girondins Bordeaux","2-1",2,1,"1",1,3,1,"H"
2006-09-23,2006,"Olympique Lyon","Lille OSC","4-1",4,1,"1",1,5,3,"H"
2006-09-23,2006,"AJ Auxerre","CS Sedan","2-2",2,2,"1",1,4,0,"D"
2006-09-23,2006,"Girondins Bordeaux","ESTAC Troyes","2-1",2,1,"1",1,3,1,"H"
2006-09-23,2006,"Le Mans UC 72","FC Sochaux","2-2",2,2,"1",1,4,0,"D"
2006-09-23,2006,"OGC Nice","Valenciennes FC","2-0",2,0,"1",1,2,2,"H"
2006-09-23,2006,"Paris Saint-Germain","AS Nancy","0-0",0,0,"1",1,0,0,"D"
2006-09-23,2006,"Stade Rennes","AS Saint-Etienne","0-0",0,0,"1",1,0,0,"D"
2006-09-23,2006,"Toulouse FC","FC Lorient","0-0",0,0,"1",1,0,0,"D"
2006-09-24,2006,"RC Lens","AS Monaco","1-0",1,0,"1",1,1,1,"H"
2006-09-24,2006,"FC Nantes","Olympique Marseille","2-1",2,1,"1",1,3,1,"H"
2006-09-30,2006,"FC Sochaux","Olympique Lyon","0-1",0,1,"1",1,1,-1,"D"
2006-09-30,2006,"Lille OSC","OGC Nice","1-0",1,0,"1",1,1,1,"H"
2006-09-30,2006,"Valenciennes FC","Girondins Bordeaux","2-0",2,0,"1",1,2,2,"H"
2006-09-30,2006,"AS Monaco","Le Mans UC 72","2-1",2,1,"1",1,3,1,"H"
2006-09-30,2006,"CS Sedan","Stade Rennes","1-0",1,0,"1",1,1,1,"H"
2006-09-30,2006,"FC Lorient","ESTAC Troyes","0-0",0,0,"1",1,0,0,"D"
2006-10-01,2006,"AJ Auxerre","FC Nantes","1-0",1,0,"1",1,1,1,"H"
2006-10-01,2006,"Olympique Marseille","Toulouse FC","3-0",3,0,"1",1,3,3,"H"
2006-10-01,2006,"AS Nancy","RC Lens","2-1",2,1,"1",1,3,1,"H"
2006-10-01,2006,"AS Saint-Etienne","Paris Saint-Germain","1-0",1,0,"1",1,1,1,"H"
2006-10-14,2006,"Olympique Lyon","AS Saint-Etienne","2-1",2,1,"1",1,3,1,"H"
2006-10-14,2006,"Girondins Bordeaux","AS Monaco","1-0",1,0,"1",1,1,1,"H"
2006-10-14,2006,"FC Nantes","FC Sochaux","0-2",0,2,"1",1,2,-2,"D"
2006-10-14,2006,"OGC Nice","FC Lorient","3-0",3,0,"1",1,3,3,"H"
2006-10-14,2006,"Paris Saint-Germain","CS Sedan","4-2",4,2,"1",1,6,2,"H"
2006-10-14,2006,"Stade Rennes","AJ Auxerre","3-1",3,1,"1",1,4,2,"H"
2006-10-14,2006,"Toulouse FC","Valenciennes FC","3-0",3,0,"1",1,3,3,"H"
2006-10-14,2006,"ESTAC Troyes","Lille OSC","1-1",1,1,"1",1,2,0,"D"
2006-10-15,2006,"Le Mans UC 72","AS Nancy","0-0",0,0,"1",1,0,0,"D"
2006-10-15,2006,"RC Lens","Olympique Marseille","1-1",1,1,"1",1,2,0,"D"
2006-10-21,2006,"Lille OSC","FC Lorient","1-0",1,0,"1",1,1,1,"H"
2006-10-21,2006,"Valenciennes FC","ESTAC Troyes","3-1",3,1,"1",1,4,2,"H"
2006-10-21,2006,"AS Monaco","Toulouse FC","1-3",1,3,"1",1,4,-2,"D"
2006-10-21,2006,"AS Nancy","FC Nantes","1-0",1,0,"1",1,1,1,"H"
2006-10-21,2006,"CS Sedan","RC Lens","2-2",2,2,"1",1,4,0,"D"
2006-10-21,2006,"FC Sochaux","Girondins Bordeaux","2-1",2,1,"1",1,3,1,"H"
2006-10-21,2006,"AS Saint-Etienne","Le Mans UC 72","2-0",2,0,"1",1,2,2,"H"
2006-10-21,2006,"Stade Rennes","OGC Nice","1-0",1,0,"1",1,1,1,"H"
2006-10-22,2006,"AJ Auxerre","Paris Saint-Germain","0-0",0,0,"1",1,0,0,"D"
2006-10-22,2006,"Olympique Marseille","Olympique Lyon","1-4",1,4,"1",1,5,-3,"D"
2006-10-28,2006,"RC Lens","AJ Auxerre","1-0",1,0,"1",1,1,1,"H"
2006-10-28,2006,"FC Nantes","AS Monaco","1-0",1,0,"1",1,1,1,"H"
2006-10-28,2006,"Paris Saint-Germain","Stade Rennes","1-0",1,0,"1",1,1,1,"H"
2006-10-28,2006,"Girondins Bordeaux","CS Sedan","3-1",3,1,"1",1,4,2,"H"
2006-10-28,2006,"Toulouse FC","FC Sochaux","1-2",1,2,"1",1,3,-1,"D"
2006-10-28,2006,"Le Mans UC 72","Lille OSC","1-1",1,1,"1",1,2,0,"D"
2006-10-28,2006,"ESTAC Troyes","AS Saint-Etienne","3-1",3,1,"1",1,4,2,"H"
2006-10-28,2006,"FC Lorient","Valenciennes FC","1-0",1,0,"1",1,1,1,"H"
2006-10-29,2006,"OGC Nice","Olympique Marseille","2-1",2,1,"1",1,3,1,"H"
2006-10-29,2006,"Olympique Lyon","AS Nancy","1-0",1,0,"1",1,1,1,"H"
2006-11-04,2006,"Stade Rennes","Olympique Lyon","1-0",1,0,"1",1,1,1,"H"
2006-11-04,2006,"AJ Auxerre","Le Mans UC 72","2-3",2,3,"1",1,5,-1,"D"
2006-11-04,2006,"Olympique Marseille","FC Lorient","0-1",0,1,"1",1,1,-1,"D"
2006-11-04,2006,"AS Monaco","OGC Nice","0-0",0,0,"1",1,0,0,"D"
2006-11-04,2006,"AS Saint-Etienne","Toulouse FC","3-0",3,0,"1",1,3,3,"H"
2006-11-04,2006,"CS Sedan","FC Nantes","1-1",1,1,"1",1,2,0,"D"
2006-11-04,2006,"FC Sochaux","ESTAC Troyes","1-0",1,0,"1",1,1,1,"H"
2006-11-04,2006,"Valenciennes FC","Lille OSC","0-3",0,3,"1",1,3,-3,"D"
2006-11-05,2006,"AS Nancy","Girondins Bordeaux","2-1",2,1,"1",1,3,1,"H"
2006-11-05,2006,"Paris Saint-Germain","RC Lens","1-3",1,3,"1",1,4,-2,"D"
2006-11-10,2006,"Olympique Lyon","Valenciennes FC","2-1",2,1,"1",1,3,1,"H"
2006-11-11,2006,"Girondins Bordeaux","AJ Auxerre","0-0",0,0,"1",1,0,0,"D"
2006-11-11,2006,"Le Mans UC 72","Paris Saint-Germain","1-1",1,1,"1",1,2,0,"D"
2006-11-11,2006,"RC Lens","Stade Rennes","0-0",0,0,"1",1,0,0,"D"
2006-11-11,2006,"FC Lorient","AS Nancy","2-0",2,0,"1",1,2,2,"H"
2006-11-11,2006,"FC Nantes","AS Saint-Etienne","2-2",2,2,"1",1,4,0,"D"
2006-11-11,2006,"OGC Nice","FC Sochaux","0-0",0,0,"1",1,0,0,"D"
2006-11-11,2006,"Toulouse FC","CS Sedan","3-1",3,1,"1",1,4,2,"H"
2006-11-12,2006,"ESTAC Troyes","AS Monaco","0-4",0,4,"1",1,4,-4,"D"
2006-11-12,2006,"Lille OSC","Olympique Marseille","1-0",1,0,"1",1,1,1,"H"
2006-11-18,2006,"FC Sochaux","Lille OSC","0-0",0,0,"1",1,0,0,"D"
2006-11-18,2006,"RC Lens","FC Nantes","2-0",2,0,"1",1,2,2,"H"
2006-11-18,2006,"AS Monaco","FC Lorient","2-2",2,2,"1",1,4,0,"D"
2006-11-18,2006,"AS Nancy","ESTAC Troyes","1-0",1,0,"1",1,1,1,"H"
2006-11-18,2006,"Paris Saint-Germain","Girondins Bordeaux","0-2",0,2,"1",1,2,-2,"D"
2006-11-18,2006,"Stade Rennes","Le Mans UC 72","1-1",1,1,"1",1,2,0,"D"
2006-11-18,2006,"AS Saint-Etienne","OGC Nice","2-1",2,1,"1",1,3,1,"H"
2006-11-18,2006,"CS Sedan","Olympique Lyon","0-1",0,1,"1",1,1,-1,"D"
2006-11-19,2006,"AJ Auxerre","Toulouse FC","1-0",1,0,"1",1,1,1,"H"
2006-11-19,2006,"Olympique Marseille","Valenciennes FC","1-0",1,0,"1",1,1,1,"H"
2006-11-25,2006,"ESTAC Troyes","Olympique Marseille","1-1",1,1,"1",1,2,0,"D"
2006-11-25,2006,"Girondins Bordeaux","AS Saint-Etienne","1-0",1,0,"1",1,1,1,"H"
2006-11-25,2006,"Lille OSC","AS Monaco","1-1",1,1,"1",1,2,0,"D"
2006-11-25,2006,"FC Lorient","FC Sochaux","1-3",1,3,"1",1,4,-2,"D"
2006-11-25,2006,"OGC Nice","CS Sedan","2-2",2,2,"1",1,4,0,"D"
2006-11-25,2006,"Toulouse FC","Stade Rennes","1-0",1,0,"1",1,1,1,"H"
2006-11-26,2006,"Le Mans UC 72","RC Lens","1-1",1,1,"1",1,2,0,"D"
2006-11-26,2006,"FC Nantes","Paris Saint-Germain","1-1",1,1,"1",1,2,0,"D"
2006-11-26,2006,"Valenciennes FC","AS Nancy","1-0",1,0,"1",1,1,1,"H"
2006-11-26,2006,"Olympique Lyon","AJ Auxerre","1-0",1,0,"1",1,1,1,"H"
2006-12-02,2006,"Le Mans UC 72","Olympique Lyon","0-1",0,1,"1",1,1,-1,"D"
2006-12-02,2006,"AJ Auxerre","OGC Nice","0-0",0,0,"1",1,0,0,"D"
2006-12-02,2006,"AS Monaco","Valenciennes FC","3-0",3,0,"1",1,3,3,"H"
2006-12-02,2006,"CS Sedan","ESTAC Troyes","1-2",1,2,"1",1,3,-1,"D"
2006-12-02,2006,"AS Saint-Etienne","FC Lorient","2-0",2,0,"1",1,2,2,"H"
2006-12-02,2006,"RC Lens","Girondins Bordeaux","3-0",3,0,"1",1,3,3,"H"
2006-12-02,2006,"Stade Rennes","FC Nantes","2-0",2,0,"1",1,2,2,"H"
2006-12-03,2006,"FC Sochaux","Olympique Marseille","1-0",1,0,"1",1,1,1,"H"
2006-12-03,2006,"AS Nancy","Lille OSC","1-3",1,3,"1",1,4,-2,"D"
2006-12-09,2006,"Toulouse FC","RC Lens","0-1",0,1,"1",1,1,-1,"D"
2006-12-09,2006,"Girondins Bordeaux","Stade Rennes","1-2",1,2,"1",1,3,-1,"D"
2006-12-09,2006,"FC Lorient","CS Sedan","2-0",2,0,"1",1,2,2,"H"
2006-12-09,2006,"Olympique Marseille","AS Monaco","2-1",2,1,"1",1,3,1,"H"
2006-12-09,2006,"FC Nantes","Le Mans UC 72","0-0",0,0,"1",1,0,0,"D"
2006-12-09,2006,"OGC Nice","AS Nancy","0-0",0,0,"1",1,0,0,"D"
2006-12-09,2006,"ESTAC Troyes","AJ Auxerre","3-3",3,3,"1",1,6,0,"D"
2006-12-09,2006,"Valenciennes FC","FC Sochaux","0-0",0,0,"1",1,0,0,"D"
2006-12-10,2006,"Lille OSC","AS Saint-Etienne","2-2",2,2,"1",1,4,0,"D"
2006-12-10,2006,"Olympique Lyon","Paris Saint-Germain","3-1",3,1,"1",1,4,2,"H"
2006-12-16,2006,"AS Nancy","Olympique Marseille","2-0",2,0,"1",1,2,2,"H"
2006-12-16,2006,"Le Mans UC 72","Toulouse FC","2-0",2,0,"1",1,2,2,"H"
2006-12-16,2006,"AS Monaco","FC Sochaux","3-0",3,0,"1",1,3,3,"H"
2006-12-16,2006,"FC Nantes","Girondins Bordeaux","0-0",0,0,"1",1,0,0,"D"
2006-12-16,2006,"Stade Rennes","ESTAC Troyes","1-1",1,1,"1",1,2,0,"D"
2006-12-16,2006,"AS Saint-Etienne","Valenciennes FC","3-0",3,0,"1",1,3,3,"H"
2006-12-16,2006,"CS Sedan","Lille OSC","2-0",2,0,"1",1,2,2,"H"
2006-12-17,2006,"Paris Saint-Germain","OGC Nice","0-0",0,0,"1",1,0,0,"D"
2006-12-17,2006,"AJ Auxerre","FC Lorient","2-1",2,1,"1",1,3,1,"H"
2006-12-17,2006,"RC Lens","Olympique Lyon","0-4",0,4,"1",1,4,-4,"D"
2006-12-22,2006,"Olympique Marseille","AS Saint-Etienne","2-1",2,1,"1",1,3,1,"H"
2006-12-23,2006,"FC Sochaux","AS Nancy","2-1",2,1,"1",1,3,1,"H"
2006-12-23,2006,"ESTAC Troyes","Paris Saint-Germain","1-1",1,1,"1",1,2,0,"D"
2006-12-23,2006,"Olympique Lyon","AS Monaco","0-0",0,0,"1",1,0,0,"D"
2006-12-23,2006,"Lille OSC","AJ Auxerre","1-1",1,1,"1",1,2,0,"D"
2006-12-23,2006,"Valenciennes FC","CS Sedan","2-1",2,1,"1",1,3,1,"H"
2006-12-23,2006,"Girondins Bordeaux","Le Mans UC 72","1-0",1,0,"1",1,1,1,"H"
2006-12-23,2006,"Toulouse FC","FC Nantes","0-4",0,4,"1",1,4,-4,"D"
2006-12-23,2006,"OGC Nice","RC Lens","1-2",1,2,"1",1,3,-1,"D"
2006-12-23,2006,"FC Lorient","Stade Rennes","0-0",0,0,"1",1,0,0,"D"
2007-01-13,2006,"Paris Saint-Germain","Valenciennes FC","1-2",1,2,"1",1,3,-1,"D"
2007-01-13,2006,"RC Lens","Lille OSC","1-1",1,1,"1",1,2,0,"D"
2007-01-13,2006,"AJ Auxerre","FC Sochaux","1-0",1,0,"1",1,1,1,"H"
2007-01-13,2006,"Girondins Bordeaux","FC Lorient","1-1",1,1,"1",1,2,0,"D"
2007-01-13,2006,"Le Mans UC 72","ESTAC Troyes","2-0",2,0,"1",1,2,2,"H"
2007-01-13,2006,"FC Nantes","OGC Nice","1-0",1,0,"1",1,1,1,"H"
2007-01-13,2006,"CS Sedan","AS Nancy","2-2",2,2,"1",1,4,0,"D"
2007-01-13,2006,"Toulouse FC","Olympique Lyon","2-0",2,0,"1",1,2,2,"H"
2007-01-14,2006,"AS Saint-Etienne","AS Monaco","0-1",0,1,"1",1,1,-1,"D"
2007-01-14,2006,"Stade Rennes","Olympique Marseille","0-2",0,2,"1",1,2,-2,"D"
2007-01-17,2006,"Paris Saint-Germain","Toulouse FC","0-0",0,0,"1",1,0,0,"D"
2007-01-24,2006,"Olympique Marseille","AJ Auxerre","3-1",3,1,"1",1,4,2,"H"
2007-01-24,2006,"Lille OSC","Paris Saint-Germain","1-0",1,0,"1",1,1,1,"H"
2007-01-24,2006,"FC Lorient","RC Lens","1-0",1,0,"1",1,1,1,"H"
2007-01-24,2006,"Olympique Lyon","Girondins Bordeaux","1-2",1,2,"1",1,3,-1,"D"
2007-01-24,2006,"AS Monaco","Stade Rennes","0-2",0,2,"1",1,2,-2,"D"
2007-01-24,2006,"OGC Nice","Toulouse FC","0-1",0,1,"1",1,1,-1,"D"
2007-01-24,2006,"FC Sochaux","CS Sedan","1-1",1,1,"1",1,2,0,"D"
2007-01-24,2006,"ESTAC Troyes","FC Nantes","1-0",1,0,"1",1,1,1,"H"
2007-01-24,2006,"Valenciennes FC","Le Mans UC 72","1-1",1,1,"1",1,2,0,"D"
2007-01-25,2006,"AS Nancy","AS Saint-Etienne","0-2",0,2,"1",1,2,-2,"D"
2007-01-27,2006,"Le Mans UC 72","Olympique Marseille","2-0",2,0,"1",1,2,2,"H"
2007-01-27,2006,"Olympique Lyon","OGC Nice","1-1",1,1,"1",1,2,0,"D"
2007-01-27,2006,"Paris Saint-Germain","FC Sochaux","0-0",0,0,"1",1,0,0,"D"
2007-01-27,2006,"Girondins Bordeaux","Lille OSC","0-1",0,1,"1",1,1,-1,"D"
2007-01-27,2006,"CS Sedan","AS Monaco","0-1",0,1,"1",1,1,-1,"D"
2007-01-27,2006,"Toulouse FC","ESTAC Troyes","1-1",1,1,"1",1,2,0,"D"
2007-01-27,2006,"FC Nantes","FC Lorient","0-2",0,2,"1",1,2,-2,"D"
2007-01-27,2006,"Stade Rennes","Valenciennes FC","1-0",1,0,"1",1,1,1,"H"
2007-01-28,2006,"AJ Auxerre","AS Nancy","2-0",2,0,"1",1,2,2,"H"
2007-01-28,2006,"RC Lens","AS Saint-Etienne","3-3",3,3,"1",1,6,0,"D"
2007-02-03,2006,"Lille OSC","FC Nantes","0-0",0,0,"1",1,0,0,"D"
2007-02-03,2006,"AS Monaco","AJ Auxerre","2-1",2,1,"1",1,3,1,"H"
2007-02-03,2006,"OGC Nice","Girondins Bordeaux","2-1",2,1,"1",1,3,1,"H"
2007-02-03,2006,"Valenciennes FC","RC Lens","1-3",1,3,"1",1,4,-2,"D"
2007-02-03,2006,"FC Lorient","Le Mans UC 72","2-1",2,1,"1",1,3,1,"H"
2007-02-03,2006,"FC Sochaux","Stade Rennes","0-0",0,0,"1",1,0,0,"D"
2007-02-03,2006,"AS Saint-Etienne","CS Sedan","1-2",1,2,"1",1,3,-1,"D"
2007-02-03,2006,"AS Nancy","Toulouse FC","2-1",2,1,"1",1,3,1,"H"
2007-02-04,2006,"ESTAC Troyes","Olympique Lyon","1-0",1,0,"1",1,1,1,"H"
2007-02-04,2006,"Olympique Marseille","Paris Saint-Germain","1-1",1,1,"1",1,2,0,"D"
2007-02-10,2006,"Paris Saint-Germain","AS Monaco","4-2",4,2,"1",1,6,2,"H"
2007-02-10,2006,"AJ Auxerre","AS Saint-Etienne","1-1",1,1,"1",1,2,0,"D"
2007-02-10,2006,"Le Mans UC 72","CS Sedan","3-2",3,2,"1",1,5,1,"H"
2007-02-10,2006,"Olympique Lyon","FC Lorient","1-0",1,0,"1",1,1,1,"H"
2007-02-10,2006,"FC Nantes","Valenciennes FC","2-5",2,5,"1",1,7,-3,"D"
2007-02-10,2006,"OGC Nice","ESTAC Troyes","3-0",3,0,"1",1,3,3,"H"
2007-02-10,2006,"Stade Rennes","AS Nancy","1-1",1,1,"1",1,2,0,"D"
2007-02-10,2006,"Toulouse FC","Lille OSC","1-0",1,0,"1",1,1,1,"H"
2007-02-11,2006,"RC Lens","FC Sochaux","3-1",3,1,"1",1,4,2,"H"
2007-02-11,2006,"Girondins Bordeaux","Olympique Marseille","1-0",1,0,"1",1,1,1,"H"
2007-02-16,2006,"Lille OSC","Olympique Lyon","1-2",1,2,"1",1,3,-1,"D"
2007-02-17,2006,"AS Saint-Etienne","Stade Rennes","1-3",1,3,"1",1,4,-2,"D"
2007-02-17,2006,"FC Lorient","Toulouse FC","0-1",0,1,"1",1,1,-1,"D"
2007-02-17,2006,"AS Nancy","Paris Saint-Germain","0-3",0,3,"1",1,3,-3,"D"
2007-02-17,2006,"CS Sedan","AJ Auxerre","2-2",2,2,"1",1,4,0,"D"
2007-02-17,2006,"FC Sochaux","Le Mans UC 72","2-0",2,0,"1",1,2,2,"H"
2007-02-17,2006,"ESTAC Troyes","Girondins Bordeaux","1-0",1,0,"1",1,1,1,"H"
2007-02-17,2006,"Valenciennes FC","OGC Nice","0-1",0,1,"1",1,1,-1,"D"
2007-02-18,2006,"AS Monaco","RC Lens","0-0",0,0,"1",1,0,0,"D"
2007-02-18,2006,"Olympique Marseille","FC Nantes","0-0",0,0,"1",1,0,0,"D"
2007-02-24,2006,"Toulouse FC","Olympique Marseille","3-0",3,0,"1",1,3,3,"H"
2007-02-24,2006,"FC Nantes","AJ Auxerre","1-1",1,1,"1",1,2,0,"D"
2007-02-24,2006,"Olympique Lyon","FC Sochaux","3-3",3,3,"1",1,6,0,"D"
2007-02-24,2006,"OGC Nice","Lille OSC","2-1",2,1,"1",1,3,1,"H"
2007-02-24,2006,"Le Mans UC 72","AS Monaco","0-2",0,2,"1",1,2,-2,"D"
2007-02-24,2006,"Stade Rennes","CS Sedan","0-2",0,2,"1",1,2,-2,"D"
2007-02-24,2006,"ESTAC Troyes","FC Lorient","3-0",3,0,"1",1,3,3,"H"
2007-02-25,2006,"RC Lens","AS Nancy","2-2",2,2,"1",1,4,0,"D"
2007-02-25,2006,"Girondins Bordeaux","Valenciennes FC","2-1",2,1,"1",1,3,1,"H"
2007-02-25,2006,"Paris Saint-Germain","AS Saint-Etienne","0-2",0,2,"1",1,2,-2,"D"
2007-03-03,2006,"AS Saint-Etienne","Olympique Lyon","1-3",1,3,"1",1,4,-2,"D"
2007-03-03,2006,"AJ Auxerre","Stade Rennes","1-0",1,0,"1",1,1,1,"H"
2007-03-03,2006,"Lille OSC","ESTAC Troyes","4-0",4,0,"1",1,4,4,"H"
2007-03-03,2006,"Valenciennes FC","Toulouse FC","0-0",0,0,"1",1,0,0,"D"
2007-03-03,2006,"AS Monaco","Girondins Bordeaux","0-0",0,0,"1",1,0,0,"D"
2007-03-03,2006,"CS Sedan","Paris Saint-Germain","2-0",2,0,"1",1,2,2,"H"
2007-03-03,2006,"FC Lorient","OGC Nice","0-0",0,0,"1",1,0,0,"D"
2007-03-03,2006,"AS Nancy","Le Mans UC 72","1-1",1,1,"1",1,2,0,"D"
2007-03-04,2006,"FC Sochaux","FC Nantes","1-2",1,2,"1",1,3,-1,"D"
2007-03-04,2006,"Olympique Marseille","RC Lens","0-1",0,1,"1",1,1,-1,"D"
2007-03-10,2006,"Toulouse FC","AS Monaco","1-1",1,1,"1",1,2,0,"D"
2007-03-10,2006,"OGC Nice","Stade Rennes","1-1",1,1,"1",1,2,0,"D"
2007-03-10,2006,"Le Mans UC 72","AS Saint-Etienne","2-1",2,1,"1",1,3,1,"H"
2007-03-10,2006,"Girondins Bordeaux","FC Sochaux","2-0",2,0,"1",1,2,2,"H"
2007-03-10,2006,"ESTAC Troyes","Valenciennes FC","1-3",1,3,"1",1,4,-2,"D"
2007-03-10,2006,"FC Lorient","Lille OSC","0-0",0,0,"1",1,0,0,"D"
2007-03-10,2006,"FC Nantes","AS Nancy","2-1",2,1,"1",1,3,1,"H"
2007-03-11,2006,"Paris Saint-Germain","AJ Auxerre","0-1",0,1,"1",1,1,-1,"D"
2007-03-11,2006,"RC Lens","CS Sedan","1-1",1,1,"1",1,2,0,"D"
2007-03-11,2006,"Olympique Lyon","Olympique Marseille","1-1",1,1,"1",1,2,0,"D"
2007-03-17,2006,"FC Sochaux","Toulouse FC","4-2",4,2,"1",1,6,2,"H"
2007-03-17,2006,"Lille OSC","Le Mans UC 72","0-2",0,2,"1",1,2,-2,"D"
2007-03-17,2006,"Olympique Marseille","OGC Nice","3-0",3,0,"1",1,3,3,"H"
2007-03-17,2006,"AS Monaco","FC Nantes","2-1",2,1,"1",1,3,1,"H"
2007-03-17,2006,"AS Nancy","Olympique Lyon","0-3",0,3,"1",1,3,-3,"D"
2007-03-17,2006,"AS Saint-Etienne","ESTAC Troyes","3-1",3,1,"1",1,4,2,"H"
2007-03-17,2006,"CS Sedan","Girondins Bordeaux","1-1",1,1,"1",1,2,0,"D"
2007-03-17,2006,"Valenciennes FC","FC Lorient","0-0",0,0,"1",1,0,0,"D"
2007-03-18,2006,"AJ Auxerre","RC Lens","1-0",1,0,"1",1,1,1,"H"
2007-03-18,2006,"Stade Rennes","Paris Saint-Germain","1-0",1,0,"1",1,1,1,"H"
2007-03-31,2006,"FC Lorient","Olympique Marseille","2-1",2,1,"1",1,3,1,"H"
2007-04-01,2006,"FC Nantes","CS Sedan","0-1",0,1,"1",1,1,-1,"D"
2007-04-01,2006,"Le Mans UC 72","AJ Auxerre","2-2",2,2,"1",1,4,0,"D"
2007-04-01,2006,"Lille OSC","Valenciennes FC","0-2",0,2,"1",1,2,-2,"D"
2007-04-01,2006,"Toulouse FC","AS Saint-Etienne","1-0",1,0,"1",1,1,1,"H"
2007-04-01,2006,"OGC Nice","AS Monaco","1-1",1,1,"1",1,2,0,"D"
2007-04-01,2006,"ESTAC Troyes","FC Sochaux","0-1",0,1,"1",1,1,-1,"D"
2007-04-01,2006,"RC Lens","Paris Saint-Germain","1-2",1,2,"1",1,3,-1,"D"
2007-04-07,2006,"Valenciennes FC","Olympique Lyon","0-0",0,0,"1",1,0,0,"D"
2007-04-07,2006,"AJ Auxerre","Girondins Bordeaux","0-0",0,0,"1",1,0,0,"D"
2007-04-07,2006,"AS Monaco","ESTAC Troyes","0-0",0,0,"1",1,0,0,"D"
2007-04-07,2006,"AS Nancy","FC Lorient","0-1",0,1,"1",1,1,-1,"D"
2007-04-07,2006,"Paris Saint-Germain","Le Mans UC 72","2-1",2,1,"1",1,3,1,"H"
2007-04-07,2006,"Stade Rennes","RC Lens","1-0",1,0,"1",1,1,1,"H"
2007-04-07,2006,"AS Saint-Etienne","FC Nantes","2-1",2,1,"1",1,3,1,"H"
2007-04-07,2006,"FC Sochaux","OGC Nice","1-1",1,1,"1",1,2,0,"D"
2007-04-08,2006,"CS Sedan","Toulouse FC","0-2",0,2,"1",1,2,-2,"D"
2007-04-08,2006,"Olympique Marseille","Lille OSC","4-1",4,1,"1",1,5,3,"H"
2007-04-14,2006,"Girondins Bordeaux","Paris Saint-Germain","0-0",0,0,"1",1,0,0,"D"
2007-04-14,2006,"Le Mans UC 72","Stade Rennes","0-0",0,0,"1",1,0,0,"D"
2007-04-14,2006,"Lille OSC","FC Sochaux","2-0",2,0,"1",1,2,2,"H"
2007-04-14,2006,"FC Lorient","AS Monaco","0-0",0,0,"1",1,0,0,"D"
2007-04-14,2006,"FC Nantes","RC Lens","0-0",0,0,"1",1,0,0,"D"
2007-04-14,2006,"Toulouse FC","AJ Auxerre","2-0",2,0,"1",1,2,2,"H"
2007-04-14,2006,"ESTAC Troyes","AS Nancy","0-0",0,0,"1",1,0,0,"D"
2007-04-14,2006,"Valenciennes FC","Olympique Marseille","0-0",0,0,"1",1,0,0,"D"
2007-04-15,2006,"OGC Nice","AS Saint-Etienne","2-1",2,1,"1",1,3,1,"H"
2007-04-15,2006,"Olympique Lyon","CS Sedan","1-0",1,0,"1",1,1,1,"H"
2007-04-18,2006,"Olympique Lyon","Stade Rennes","0-0",0,0,"1",1,0,0,"D"
2007-04-18,2006,"Girondins Bordeaux","AS Nancy","3-0",3,0,"1",1,3,3,"H"
2007-04-21,2006,"Paris Saint-Germain","FC Nantes","4-0",4,0,"1",1,4,4,"H"
2007-04-21,2006,"RC Lens","Le Mans UC 72","2-0",2,0,"1",1,2,2,"H"
2007-04-21,2006,"Olympique Marseille","ESTAC Troyes","2-1",2,1,"1",1,3,1,"H"
2007-04-21,2006,"AS Monaco","Lille OSC","3-1",3,1,"1",1,4,2,"H"
2007-04-21,2006,"AS Nancy","Valenciennes FC","1-0",1,0,"1",1,1,1,"H"
2007-04-21,2006,"Stade Rennes","Toulouse FC","3-2",3,2,"1",1,5,1,"H"
2007-04-21,2006,"CS Sedan","OGC Nice","1-1",1,1,"1",1,2,0,"D"
2007-04-21,2006,"FC Sochaux","FC Lorient","1-1",1,1,"1",1,2,0,"D"
2007-04-22,2006,"AJ Auxerre","Olympique Lyon","0-0",0,0,"1",1,0,0,"D"
2007-04-22,2006,"AS Saint-Etienne","Girondins Bordeaux","0-2",0,2,"1",1,2,-2,"D"
2007-04-28,2006,"Toulouse FC","Paris Saint-Germain","1-3",1,3,"1",1,4,-2,"D"
2007-04-28,2006,"Lille OSC","AS Nancy","0-1",0,1,"1",1,1,-1,"D"
2007-04-28,2006,"FC Lorient","AS Saint-Etienne","0-0",0,0,"1",1,0,0,"D"
2007-04-28,2006,"Olympique Lyon","Le Mans UC 72","2-1",2,1,"1",1,3,1,"H"
2007-04-28,2006,"FC Nantes","Stade Rennes","0-2",0,2,"1",1,2,-2,"D"
2007-04-28,2006,"OGC Nice","AJ Auxerre","0-0",0,0,"1",1,0,0,"D"
2007-04-28,2006,"ESTAC Troyes","CS Sedan","3-2",3,2,"1",1,5,1,"H"
2007-04-28,2006,"Valenciennes FC","AS Monaco","2-2",2,2,"1",1,4,0,"D"
2007-04-29,2006,"Girondins Bordeaux","RC Lens","1-0",1,0,"1",1,1,1,"H"
2007-04-29,2006,"Olympique Marseille","FC Sochaux","4-2",4,2,"1",1,6,2,"H"
2007-05-05,2006,"Paris Saint-Germain","Olympique Lyon","1-1",1,1,"1",1,2,0,"D"
2007-05-05,2006,"AJ Auxerre","ESTAC Troyes","1-0",1,0,"1",1,1,1,"H"
2007-05-05,2006,"Le Mans UC 72","FC Nantes","1-1",1,1,"1",1,2,0,"D"
2007-05-05,2006,"RC Lens","Toulouse FC","2-0",2,0,"1",1,2,2,"H"
2007-05-05,2006,"AS Nancy","OGC Nice","3-0",3,0,"1",1,3,3,"H"
2007-05-05,2006,"Stade Rennes","Girondins Bordeaux","0-0",0,0,"1",1,0,0,"D"
2007-05-05,2006,"CS Sedan","FC Lorient","3-1",3,1,"1",1,4,2,"H"
2007-05-05,2006,"FC Sochaux","Valenciennes FC","1-0",1,0,"1",1,1,1,"H"
2007-05-06,2006,"AS Saint-Etienne","Lille OSC","2-1",2,1,"1",1,3,1,"H"
2007-05-06,2006,"AS Monaco","Olympique Marseille","1-2",1,2,"1",1,3,-1,"D"
2007-05-09,2006,"FC Sochaux","AS Monaco","2-1",2,1,"1",1,3,1,"H"
2007-05-09,2006,"Lille OSC","CS Sedan","2-1",2,1,"1",1,3,1,"H"
2007-05-09,2006,"Valenciennes FC","AS Saint-Etienne","1-0",1,0,"1",1,1,1,"H"
2007-05-09,2006,"Girondins Bordeaux","FC Nantes","0-1",0,1,"1",1,1,-1,"D"
2007-05-09,2006,"OGC Nice","Paris Saint-Germain","1-0",1,0,"1",1,1,1,"H"
2007-05-09,2006,"Olympique Marseille","AS Nancy","2-1",2,1,"1",1,3,1,"H"
2007-05-09,2006,"ESTAC Troyes","Stade Rennes","2-2",2,2,"1",1,4,0,"D"
2007-05-09,2006,"FC Lorient","AJ Auxerre","2-1",2,1,"1",1,3,1,"H"
2007-05-09,2006,"Olympique Lyon","RC Lens","3-0",3,0,"1",1,3,3,"H"
2007-05-10,2006,"Toulouse FC","Le Mans UC 72","0-1",0,1,"1",1,1,-1,"D"
2007-05-19,2006,"AJ Auxerre","Lille OSC","2-1",2,1,"1",1,3,1,"H"
2007-05-19,2006,"Le Mans UC 72","Girondins Bordeaux","1-1",1,1,"1",1,2,0,"D"
2007-05-19,2006,"RC Lens","OGC Nice","0-0",0,0,"1",1,0,0,"D"
2007-05-19,2006,"AS Monaco","Olympique Lyon","1-0",1,0,"1",1,1,1,"H"
2007-05-19,2006,"AS Nancy","FC Sochaux","5-2",5,2,"1",1,7,3,"H"
2007-05-19,2006,"Paris Saint-Germain","ESTAC Troyes","2-1",2,1,"1",1,3,1,"H"
2007-05-19,2006,"Stade Rennes","FC Lorient","4-1",4,1,"1",1,5,3,"H"
2007-05-19,2006,"AS Saint-Etienne","Olympique Marseille","1-2",1,2,"1",1,3,-1,"D"
2007-05-19,2006,"CS Sedan","Valenciennes FC","1-1",1,1,"1",1,2,0,"D"
2007-05-26,2006,"Olympique Lyon","FC Nantes","3-1",3,1,"1",1,4,2,"H"
2007-05-26,2006,"Lille OSC","Stade Rennes","1-1",1,1,"1",1,2,0,"D"
2007-05-26,2006,"Valenciennes FC","AJ Auxerre","1-3",1,3,"1",1,4,-2,"D"
2007-05-26,2006,"AS Monaco","AS Nancy","2-0",2,0,"1",1,2,2,"H"
2007-05-26,2006,"FC Sochaux","AS Saint-Etienne","1-0",1,0,"1",1,1,1,"H"
2007-05-26,2006,"Toulouse FC","Girondins Bordeaux","3-1",3,1,"1",1,4,2,"H"
2007-05-26,2006,"OGC Nice","Le Mans UC 72","3-3",3,3,"1",1,6,0,"D"
2007-05-26,2006,"Olympique Marseille","CS Sedan","1-0",1,0,"1",1,1,1,"H"
2007-05-26,2006,"ESTAC Troyes","RC Lens","3-0",3,0,"1",1,3,3,"H"
2007-05-26,2006,"FC Lorient","Paris Saint-Germain","0-1",0,1,"1",1,1,-1,"D"
2007-08-04,2007,"RC Strasbourg","Olympique Marseille","0-0",0,0,"1",1,0,0,"D"
2007-08-04,2007,"Girondins Bordeaux","RC Lens","1-0",1,0,"1",1,1,1,"H"
2007-08-04,2007,"SM Caen","OGC Nice","1-0",1,0,"1",1,1,1,"H"
2007-08-04,2007,"Lille OSC","FC Lorient","0-0",0,0,"1",1,0,0,"D"
2007-08-04,2007,"AS Monaco","AS Saint-Etienne","1-1",1,1,"1",1,2,0,"D"
2007-08-04,2007,"Paris Saint-Germain","FC Sochaux","0-0",0,0,"1",1,0,0,"D"
2007-08-04,2007,"Stade Rennes","AS Nancy","0-2",0,2,"1",1,2,-2,"D"
2007-08-04,2007,"Valenciennes FC","Toulouse FC","3-1",3,1,"1",1,4,2,"H"
2007-08-05,2007,"Le Mans UC 72","FC Metz","1-0",1,0,"1",1,1,1,"H"
2007-08-05,2007,"Olympique Lyon","AJ Auxerre","2-0",2,0,"1",1,2,2,"H"
2007-08-11,2007,"Toulouse FC","Olympique Lyon","1-0",1,0,"1",1,1,1,"H"
2007-08-11,2007,"AJ Auxerre","Girondins Bordeaux","0-2",0,2,"1",1,2,-2,"D"
2007-08-11,2007,"FC Lorient","AS Monaco","2-1",2,1,"1",1,3,1,"H"
2007-08-11,2007,"Olympique Marseille","Stade Rennes","0-0",0,0,"1",1,0,0,"D"
2007-08-11,2007,"AS Nancy","SM Caen","1-0",1,0,"1",1,1,1,"H"
2007-08-11,2007,"OGC Nice","RC Strasbourg","1-0",1,0,"1",1,1,1,"H"
2007-08-11,2007,"AS Saint-Etienne","Valenciennes FC","3-1",3,1,"1",1,4,2,"H"
2007-08-11,2007,"FC Sochaux","Le Mans UC 72","1-3",1,3,"1",1,4,-2,"D"
2007-08-12,2007,"FC Metz","Lille OSC","1-2",1,2,"1",1,3,-1,"D"
2007-08-12,2007,"RC Lens","Paris Saint-Germain","0-0",0,0,"1",1,0,0,"D"
2007-08-15,2007,"Valenciennes FC","Olympique Marseille","2-1",2,1,"1",1,3,1,"H"
2007-08-15,2007,"Girondins Bordeaux","Le Mans UC 72","1-2",1,2,"1",1,3,-1,"D"
2007-08-15,2007,"Lille OSC","FC Sochaux","1-1",1,1,"1",1,2,0,"D"
2007-08-15,2007,"AS Monaco","FC Metz","2-0",2,0,"1",1,2,2,"H"
2007-08-15,2007,"Paris Saint-Germain","FC Lorient","1-3",1,3,"1",1,4,-2,"D"
2007-08-15,2007,"RC Strasbourg","AJ Auxerre","3-0",3,0,"1",1,3,3,"H"
2007-08-15,2007,"Stade Rennes","AS Saint-Etienne","1-0",1,0,"1",1,1,1,"H"
2007-08-16,2007,"AS Nancy","OGC Nice","2-1",2,1,"1",1,3,1,"H"
2007-08-18,2007,"FC Sochaux","AS Monaco","0-3",0,3,"1",1,3,-3,"D"
2007-08-18,2007,"AJ Auxerre","SM Caen","1-0",1,0,"1",1,1,1,"H"
2007-08-18,2007,"Le Mans UC 72","Lille OSC","1-1",1,1,"1",1,2,0,"D"
2007-08-18,2007,"FC Lorient","Olympique Lyon","2-1",2,1,"1",1,3,1,"H"
2007-08-18,2007,"FC Metz","Paris Saint-Germain","0-0",0,0,"1",1,0,0,"D"
2007-08-18,2007,"AS Saint-Etienne","Girondins Bordeaux","0-0",0,0,"1",1,0,0,"D"
2007-08-18,2007,"Toulouse FC","RC Strasbourg","1-3",1,3,"1",1,4,-2,"D"
2007-08-19,2007,"RC Lens","Valenciennes FC","0-0",0,0,"1",1,0,0,"D"
2007-08-19,2007,"OGC Nice","Stade Rennes","1-1",1,1,"1",1,2,0,"D"
2007-08-19,2007,"Olympique Marseille","AS Nancy","2-2",2,2,"1",1,4,0,"D"
2007-08-25,2007,"SM Caen","Olympique Marseille","1-2",1,2,"1",1,3,-1,"D"
2007-08-25,2007,"Girondins Bordeaux","FC Lorient","2-2",2,2,"1",1,4,0,"D"
2007-08-25,2007,"AS Monaco","Le Mans UC 72","3-1",3,1,"1",1,4,2,"H"
2007-08-25,2007,"AS Nancy","AJ Auxerre","4-1",4,1,"1",1,5,3,"H"
2007-08-25,2007,"OGC Nice","Toulouse FC","1-1",1,1,"1",1,2,0,"D"
2007-08-25,2007,"Stade Rennes","FC Metz","2-0",2,0,"1",1,2,2,"H"
2007-08-25,2007,"RC Strasbourg","RC Lens","2-1",2,1,"1",1,3,1,"H"
2007-08-25,2007,"Valenciennes FC","FC Sochaux","3-1",3,1,"1",1,4,2,"H"
2007-08-26,2007,"Paris Saint-Germain","Lille OSC","1-1",1,1,"1",1,2,0,"D"
2007-08-26,2007,"Olympique Lyon","AS Saint-Etienne","1-0",1,0,"1",1,1,1,"H"
2007-08-28,2007,"FC Lorient","Valenciennes FC","1-3",1,3,"1",1,4,-2,"D"
2007-08-29,2007,"Olympique Marseille","OGC Nice","0-2",0,2,"1",1,2,-2,"D"
2007-08-29,2007,"AJ Auxerre","Stade Rennes","0-2",0,2,"1",1,2,-2,"D"
2007-08-29,2007,"Le Mans UC 72","Paris Saint-Germain","0-2",0,2,"1",1,2,-2,"D"
2007-08-29,2007,"Lille OSC","AS Monaco","0-1",0,1,"1",1,1,-1,"D"
2007-08-29,2007,"FC Metz","Girondins Bordeaux","0-1",0,1,"1",1,1,-1,"D"
2007-08-29,2007,"AS Saint-Etienne","RC Strasbourg","2-0",2,0,"1",1,2,2,"H"
2007-08-29,2007,"FC Sochaux","Olympique Lyon","1-2",1,2,"1",1,3,-1,"D"
2007-09-01,2007,"Girondins Bordeaux","AS Monaco","2-1",2,1,"1",1,3,1,"H"
2007-09-01,2007,"SM Caen","FC Sochaux","2-2",2,2,"1",1,4,0,"D"
2007-09-01,2007,"Olympique Lyon","Le Mans UC 72","3-2",3,2,"1",1,5,1,"H"
2007-09-01,2007,"AS Nancy","AS Saint-Etienne","2-0",2,0,"1",1,2,2,"H"
2007-09-01,2007,"Stade Rennes","Lille OSC","2-2",2,2,"1",1,4,0,"D"
2007-09-01,2007,"RC Strasbourg","FC Lorient","0-0",0,0,"1",1,0,0,"D"
2007-09-01,2007,"Toulouse FC","AJ Auxerre","2-0",2,0,"1",1,2,2,"H"
2007-09-01,2007,"Valenciennes FC","FC Metz","0-0",0,0,"1",1,0,0,"D"
2007-09-02,2007,"Paris Saint-Germain","Olympique Marseille","1-1",1,1,"1",1,2,0,"D"
2007-09-02,2007,"OGC Nice","RC Lens","1-0",1,0,"1",1,1,1,"H"
2007-09-15,2007,"Olympique Marseille","Toulouse FC","1-2",1,2,"1",1,3,-1,"D"
2007-09-15,2007,"AJ Auxerre","OGC Nice","2-0",2,0,"1",1,2,2,"H"
2007-09-15,2007,"Le Mans UC 72","Valenciennes FC","2-0",2,0,"1",1,2,2,"H"
2007-09-15,2007,"RC Lens","AS Nancy","1-0",1,0,"1",1,1,1,"H"
2007-09-15,2007,"Lille OSC","Girondins Bordeaux","1-1",1,1,"1",1,2,0,"D"
2007-09-15,2007,"FC Metz","Olympique Lyon","1-5",1,5,"1",1,6,-4,"D"
2007-09-15,2007,"AS Saint-Etienne","SM Caen","3-0",3,0,"1",1,3,3,"H"
2007-09-15,2007,"FC Sochaux","RC Strasbourg","0-0",0,0,"1",1,0,0,"D"
2007-09-16,2007,"AS Monaco","Paris Saint-Germain","1-2",1,2,"1",1,3,-1,"D"
2007-09-16,2007,"FC Lorient","Stade Rennes","0-1",0,1,"1",1,1,-1,"D"
2007-09-22,2007,"AJ Auxerre","Olympique Marseille","2-0",2,0,"1",1,2,2,"H"
2007-09-22,2007,"SM Caen","FC Metz","1-2",1,2,"1",1,3,-1,"D"
2007-09-22,2007,"AS Nancy","FC Lorient","2-0",2,0,"1",1,2,2,"H"
2007-09-22,2007,"OGC Nice","AS Saint-Etienne","3-0",3,0,"1",1,3,3,"H"
2007-09-22,2007,"RC Strasbourg","Le Mans UC 72","0-1",0,1,"1",1,1,-1,"D"
2007-09-22,2007,"Toulouse FC","RC Lens","1-1",1,1,"1",1,2,0,"D"
2007-09-22,2007,"Valenciennes FC","AS Monaco","1-0",1,0,"1",1,1,1,"H"
2007-09-23,2007,"Paris Saint-Germain","Girondins Bordeaux","0-2",0,2,"1",1,2,-2,"D"
2007-09-23,2007,"Stade Rennes","FC Sochaux","0-2",0,2,"1",1,2,-2,"D"
2007-09-23,2007,"Olympique Lyon","Lille OSC","1-1",1,1,"1",1,2,0,"D"
2007-09-29,2007,"Olympique Lyon","RC Lens","3-0",3,0,"1",1,3,3,"H"
2007-09-30,2007,"SM Caen","Toulouse FC","2-1",2,1,"1",1,3,1,"H"
2007-10-05,2007,"AS Monaco","AS Nancy","1-3",1,3,"1",1,4,-2,"D"
2007-10-06,2007,"AS Saint-Etienne","Olympique Marseille","1-0",1,0,"1",1,1,1,"H"
2007-10-06,2007,"Le Mans UC 72","OGC Nice","2-0",2,0,"1",1,2,2,"H"
2007-10-06,2007,"RC Lens","AJ Auxerre","2-0",2,0,"1",1,2,2,"H"
2007-10-06,2007,"Lille OSC","Valenciennes FC","3-0",3,0,"1",1,3,3,"H"
2007-10-06,2007,"FC Lorient","SM Caen","0-0",0,0,"1",1,0,0,"D"
2007-10-06,2007,"FC Metz","RC Strasbourg","1-2",1,2,"1",1,3,-1,"D"
2007-10-06,2007,"Paris Saint-Germain","Stade Rennes","1-3",1,3,"1",1,4,-2,"D"
2007-10-07,2007,"Girondins Bordeaux","Olympique Lyon","1-3",1,3,"1",1,4,-2,"D"
2007-10-07,2007,"FC Sochaux","Toulouse FC","0-1",0,1,"1",1,1,-1,"D"
2007-10-20,2007,"AJ Auxerre","FC Lorient","5-3",5,3,"1",1,8,2,"H"
2007-10-20,2007,"SM Caen","Lille OSC","1-0",1,0,"1",1,1,1,"H"
2007-10-20,2007,"OGC Nice","FC Metz","3-1",3,1,"1",1,4,2,"H"
2007-10-20,2007,"Stade Rennes","Le Mans UC 72","3-0",3,0,"1",1,3,3,"H"
2007-10-20,2007,"RC Strasbourg","Girondins Bordeaux","1-1",1,1,"1",1,2,0,"D"
2007-10-20,2007,"Toulouse FC","AS Saint-Etienne","0-2",0,2,"1",1,2,-2,"D"
2007-10-20,2007,"Valenciennes FC","Paris Saint-Germain","0-0",0,0,"1",1,0,0,"D"
2007-10-20,2007,"Olympique Lyon","AS Monaco","3-1",3,1,"1",1,4,2,"H"
2007-10-21,2007,"AS Nancy","FC Sochaux","1-1",1,1,"1",1,2,0,"D"
2007-10-21,2007,"Olympique Marseille","RC Lens","1-0",1,0,"1",1,1,1,"H"
2007-10-27,2007,"FC Metz","AS Nancy","0-0",0,0,"1",1,0,0,"D"
2007-10-27,2007,"Girondins Bordeaux","Valenciennes FC","2-1",2,1,"1",1,3,1,"H"
2007-10-27,2007,"Lille OSC","RC Strasbourg","0-3",0,3,"1",1,3,-3,"D"
2007-10-27,2007,"FC Lorient","OGC Nice","0-0",0,0,"1",1,0,0,"D"
2007-10-27,2007,"AS Monaco","SM Caen","0-0",0,0,"1",1,0,0,"D"
2007-10-27,2007,"AS Saint-Etienne","AJ Auxerre","0-0",0,0,"1",1,0,0,"D"
2007-10-27,2007,"FC Sochaux","Olympique Marseille","2-1",2,1,"1",1,3,1,"H"
2007-10-28,2007,"Le Mans UC 72","Toulouse FC","1-1",1,1,"1",1,2,0,"D"
2007-10-28,2007,"RC Lens","Stade Rennes","1-2",1,2,"1",1,3,-1,"D"
2007-10-28,2007,"Paris Saint-Germain","Olympique Lyon","2-3",2,3,"1",1,5,-1,"D"
2007-11-03,2007,"AS Nancy","Girondins Bordeaux","1-0",1,0,"1",1,1,1,"H"
2007-11-03,2007,"AJ Auxerre","Lille OSC","0-1",0,1,"1",1,1,-1,"D"
2007-11-03,2007,"Olympique Lyon","Valenciennes FC","2-0",2,0,"1",1,2,2,"H"
2007-11-03,2007,"Olympique Marseille","FC Lorient","0-0",0,0,"1",1,0,0,"D"
2007-11-03,2007,"OGC Nice","FC Sochaux","0-0",0,0,"1",1,0,0,"D"
2007-11-03,2007,"Stade Rennes","AS Monaco","0-1",0,1,"1",1,1,-1,"D"
2007-11-03,2007,"RC Strasbourg","Paris Saint-Germain","1-2",1,2,"1",1,3,-1,"D"
2007-11-04,2007,"SM Caen","Le Mans UC 72","3-2",3,2,"1",1,5,1,"H"
2007-11-04,2007,"Toulouse FC","FC Metz","0-0",0,0,"1",1,0,0,"D"
2007-11-04,2007,"RC Lens","AS Saint-Etienne","3-2",3,2,"1",1,5,1,"H"
2007-11-10,2007,"Le Mans UC 72","AS Saint-Etienne","3-2",3,2,"1",1,5,1,"H"
2007-11-10,2007,"Lille OSC","OGC Nice","1-1",1,1,"1",1,2,0,"D"
2007-11-10,2007,"FC Metz","RC Lens","1-2",1,2,"1",1,3,-1,"D"
2007-11-10,2007,"AS Monaco","RC Strasbourg","3-0",3,0,"1",1,3,3,"H"
2007-11-10,2007,"Paris Saint-Germain","AS Nancy","0-0",0,0,"1",1,0,0,"D"
2007-11-10,2007,"FC Sochaux","AJ Auxerre","1-1",1,1,"1",1,2,0,"D"
2007-11-10,2007,"Valenciennes FC","SM Caen","3-0",3,0,"1",1,3,3,"H"
2007-11-11,2007,"Girondins Bordeaux","Stade Rennes","3-0",3,0,"1",1,3,3,"H"
2007-11-11,2007,"FC Lorient","Toulouse FC","1-0",1,0,"1",1,1,1,"H"
2007-11-11,2007,"Olympique Lyon","Olympique Marseille","1-2",1,2,"1",1,3,-1,"D"
2007-11-24,2007,"Stade Rennes","Olympique Lyon","0-2",0,2,"1",1,2,-2,"D"
2007-11-24,2007,"SM Caen","Girondins Bordeaux","5-0",5,0,"1",1,5,5,"H"
2007-11-24,2007,"RC Lens","FC Lorient","1-1",1,1,"1",1,2,0,"D"
2007-11-24,2007,"Olympique Marseille","FC Metz","3-1",3,1,"1",1,4,2,"H"
2007-11-24,2007,"AS Nancy","Lille OSC","2-0",2,0,"1",1,2,2,"H"
2007-11-24,2007,"AS Saint-Etienne","FC Sochaux","1-0",1,0,"1",1,1,1,"H"
2007-11-24,2007,"RC Strasbourg","Valenciennes FC","0-0",0,0,"1",1,0,0,"D"
2007-11-24,2007,"Toulouse FC","AS Monaco","0-0",0,0,"1",1,0,0,"D"
2007-11-25,2007,"AJ Auxerre","Le Mans UC 72","3-0",3,0,"1",1,3,3,"H"
2007-11-25,2007,"OGC Nice","Paris Saint-Germain","2-1",2,1,"1",1,3,1,"H"
2007-11-28,2007,"RC Lens","SM Caen","1-1",1,1,"1",1,2,0,"D"
2007-12-01,2007,"Le Mans UC 72","AS Nancy","2-1",2,1,"1",1,3,1,"H"
2007-12-01,2007,"Lille OSC","Olympique Marseille","1-1",1,1,"1",1,2,0,"D"
2007-12-01,2007,"FC Lorient","AS Saint-Etienne","1-1",1,1,"1",1,2,0,"D"
2007-12-01,2007,"FC Metz","AJ Auxerre","0-1",0,1,"1",1,1,-1,"D"
2007-12-01,2007,"AS Monaco","OGC Nice","1-1",1,1,"1",1,2,0,"D"
2007-12-01,2007,"Paris Saint-Germain","SM Caen","0-1",0,1,"1",1,1,-1,"D"
2007-12-01,2007,"FC Sochaux","RC Lens","0-2",0,2,"1",1,2,-2,"D"
2007-12-02,2007,"Girondins Bordeaux","Toulouse FC","4-3",4,3,"1",1,7,1,"H"
2007-12-02,2007,"Valenciennes FC","Stade Rennes","3-0",3,0,"1",1,3,3,"H"
2007-12-02,2007,"Olympique Lyon","RC Strasbourg","5-0",5,0,"1",1,5,5,"H"
2007-12-05,2007,"Toulouse FC","AS Nancy","1-1",1,1,"1",1,2,0,"D"
2007-12-08,2007,"Olympique Marseille","AS Monaco","2-0",2,0,"1",1,2,2,"H"
2007-12-08,2007,"SM Caen","Olympique Lyon","1-0",1,0,"1",1,1,1,"H"
2007-12-08,2007,"RC Lens","Le Mans UC 72","1-3",1,3,"1",1,4,-2,"D"
2007-12-08,2007,"FC Lorient","FC Sochaux","2-1",2,1,"1",1,3,1,"H"
2007-12-08,2007,"AS Nancy","Valenciennes FC","0-0",0,0,"1",1,0,0,"D"
2007-12-08,2007,"AS Saint-Etienne","FC Metz","2-0",2,0,"1",1,2,2,"H"
2007-12-08,2007,"RC Strasbourg","Stade Rennes","3-0",3,0,"1",1,3,3,"H"
2007-12-08,2007,"Toulouse FC","Lille OSC","1-0",1,0,"1",1,1,1,"H"
2007-12-09,2007,"OGC Nice","Girondins Bordeaux","1-1",1,1,"1",1,2,0,"D"
2007-12-09,2007,"AJ Auxerre","Paris Saint-Germain","0-1",0,1,"1",1,1,-1,"D"
2007-12-15,2007,"Paris Saint-Germain","Toulouse FC","1-2",1,2,"1",1,3,-1,"D"
2007-12-15,2007,"Olympique Lyon","OGC Nice","0-0",0,0,"1",1,0,0,"D"
2007-12-15,2007,"Le Mans UC 72","FC Lorient","0-0",0,0,"1",1,0,0,"D"
2007-12-15,2007,"Lille OSC","AS Saint-Etienne","3-0",3,0,"1",1,3,3,"H"
2007-12-15,2007,"FC Metz","FC Sochaux","1-2",1,2,"1",1,3,-1,"D"
2007-12-15,2007,"AS Monaco","RC Lens","2-0",2,0,"1",1,2,2,"H"
2007-12-15,2007,"Stade Rennes","SM Caen","1-2",1,2,"1",1,3,-1,"D"
2007-12-15,2007,"Valenciennes FC","AJ Auxerre","3-0",3,0,"1",1,3,3,"H"
2007-12-16,2007,"RC Strasbourg","AS Nancy","0-0",0,0,"1",1,0,0,"D"
2007-12-16,2007,"Girondins Bordeaux","Olympique Marseille","2-2",2,2,"1",1,4,0,"D"
2007-12-22,2007,"AS Nancy","Olympique Lyon","1-1",1,1,"1",1,2,0,"D"
2007-12-22,2007,"AJ Auxerre","AS Monaco","1-0",1,0,"1",1,1,1,"H"
2007-12-22,2007,"SM Caen","RC Strasbourg","2-0",2,0,"1",1,2,2,"H"
2007-12-22,2007,"FC Lorient","FC Metz","2-0",2,0,"1",1,2,2,"H"
2007-12-22,2007,"Olympique Marseille","Le Mans UC 72","1-0",1,0,"1",1,1,1,"H"
2007-12-22,2007,"OGC Nice","Valenciennes FC","1-0",1,0,"1",1,1,1,"H"
2007-12-22,2007,"FC Sochaux","Girondins Bordeaux","0-1",0,1,"1",1,1,-1,"D"
2007-12-23,2007,"Toulouse FC","Stade Rennes","0-0",0,0,"1",1,0,0,"D"
2007-12-23,2007,"AS Saint-Etienne","Paris Saint-Germain","0-1",0,1,"1",1,1,-1,"D"
2008-01-12,2007,"Valenciennes FC","AS Saint-Etienne","2-0",2,0,"1",1,2,2,"H"
2008-01-12,2007,"Girondins Bordeaux","AJ Auxerre","4-1",4,1,"1",1,5,3,"H"
2008-01-12,2007,"SM Caen","AS Nancy","0-0",0,0,"1",1,0,0,"D"
2008-01-12,2007,"Le Mans UC 72","FC Sochaux","0-2",0,2,"1",1,2,-2,"D"
2008-01-12,2007,"Lille OSC","FC Metz","1-1",1,1,"1",1,2,0,"D"
2008-01-12,2007,"Olympique Lyon","Toulouse FC","3-2",3,2,"1",1,5,1,"H"
2008-01-12,2007,"AS Monaco","FC Lorient","1-0",1,0,"1",1,1,1,"H"
2008-01-12,2007,"RC Strasbourg","OGC Nice","0-1",0,1,"1",1,1,-1,"D"
2008-01-13,2007,"Paris Saint-Germain","RC Lens","3-0",3,0,"1",1,3,3,"H"
2008-01-13,2007,"Stade Rennes","Olympique Marseille","3-1",3,1,"1",1,4,2,"H"
2008-01-19,2007,"FC Lorient","Paris Saint-Germain","1-0",1,0,"1",1,1,1,"H"
2008-01-19,2007,"AJ Auxerre","RC Strasbourg","1-1",1,1,"1",1,2,0,"D"
2008-01-19,2007,"Le Mans UC 72","Girondins Bordeaux","1-2",1,2,"1",1,3,-1,"D"
2008-01-19,2007,"Olympique Marseille","Valenciennes FC","3-1",3,1,"1",1,4,2,"H"
2008-01-19,2007,"FC Metz","AS Monaco","1-4",1,4,"1",1,5,-3,"D"
2008-01-19,2007,"AS Saint-Etienne","Stade Rennes","2-0",2,0,"1",1,2,2,"H"
2008-01-19,2007,"FC Sochaux","Lille OSC","1-1",1,1,"1",1,2,0,"D"
2008-01-19,2007,"Toulouse FC","SM Caen","1-1",1,1,"1",1,2,0,"D"
2008-01-20,2007,"OGC Nice","AS Nancy","1-0",1,0,"1",1,1,1,"H"
2008-01-20,2007,"RC Lens","Olympique Lyon","3-0",3,0,"1",1,3,3,"H"
2008-01-23,2007,"Valenciennes FC","RC Lens","1-2",1,2,"1",1,3,-1,"D"
2008-01-23,2007,"SM Caen","AJ Auxerre","0-0",0,0,"1",1,0,0,"D"
2008-01-23,2007,"Lille OSC","Le Mans UC 72","3-1",3,1,"1",1,4,2,"H"
2008-01-23,2007,"Olympique Lyon","FC Lorient","2-0",2,0,"1",1,2,2,"H"
2008-01-23,2007,"AS Monaco","FC Sochaux","1-0",1,0,"1",1,1,1,"H"
2008-01-23,2007,"Paris Saint-Germain","FC Metz","3-0",3,0,"1",1,3,3,"H"
2008-01-23,2007,"Stade Rennes","OGC Nice","1-1",1,1,"1",1,2,0,"D"
2008-01-23,2007,"RC Strasbourg","Toulouse FC","2-0",2,0,"1",1,2,2,"H"
2008-01-23,2007,"AS Nancy","Olympique Marseille","1-1",1,1,"1",1,2,0,"D"
2008-01-24,2007,"Girondins Bordeaux","AS Saint-Etienne","1-0",1,0,"1",1,1,1,"H"
2008-01-26,2007,"Lille OSC","Paris Saint-Germain","0-0",0,0,"1",1,0,0,"D"
2008-01-26,2007,"AJ Auxerre","AS Nancy","0-0",0,0,"1",1,0,0,"D"
2008-01-26,2007,"Le Mans UC 72","AS Monaco","1-0",1,0,"1",1,1,1,"H"
2008-01-26,2007,"RC Lens","RC Strasbourg","2-2",2,2,"1",1,4,0,"D"
2008-01-26,2007,"Olympique Marseille","SM Caen","6-1",6,1,"1",1,7,5,"H"
2008-01-26,2007,"FC Metz","Stade Rennes","1-1",1,1,"1",1,2,0,"D"
2008-01-26,2007,"FC Sochaux","Valenciennes FC","1-0",1,0,"1",1,1,1,"H"
2008-01-26,2007,"Toulouse FC","OGC Nice","1-1",1,1,"1",1,2,0,"D"
2008-01-27,2007,"FC Lorient","Girondins Bordeaux","1-0",1,0,"1",1,1,1,"H"
2008-01-27,2007,"AS Saint-Etienne","Olympique Lyon","1-1",1,1,"1",1,2,0,"D"
2008-02-09,2007,"Paris Saint-Germain","Le Mans UC 72","0-0",0,0,"1",1,0,0,"D"
2008-02-09,2007,"Girondins Bordeaux","FC Metz","3-0",3,0,"1",1,3,3,"H"
2008-02-09,2007,"Olympique Lyon","FC Sochaux","4-1",4,1,"1",1,5,3,"H"
2008-02-09,2007,"AS Monaco","Lille OSC","0-0",0,0,"1",1,0,0,"D"
2008-02-09,2007,"AS Nancy","Toulouse FC","1-0",1,0,"1",1,1,1,"H"
2008-02-09,2007,"Stade Rennes","AJ Auxerre","1-2",1,2,"1",1,3,-1,"D"
2008-02-09,2007,"RC Strasbourg","AS Saint-Etienne","3-0",3,0,"1",1,3,3,"H"
2008-02-09,2007,"Valenciennes FC","FC Lorient","3-0",3,0,"1",1,3,3,"H"
2008-02-10,2007,"SM Caen","RC Lens","1-4",1,4,"1",1,5,-3,"D"
2008-02-10,2007,"OGC Nice","Olympique Marseille","0-2",0,2,"1",1,2,-2,"D"
2008-02-16,2007,"Le Mans UC 72","Olympique Lyon","1-0",1,0,"1",1,1,1,"H"
2008-02-16,2007,"AJ Auxerre","Toulouse FC","1-0",1,0,"1",1,1,1,"H"
2008-02-16,2007,"RC Lens","OGC Nice","0-0",0,0,"1",1,0,0,"D"
2008-02-16,2007,"Lille OSC","Stade Rennes","3-1",3,1,"1",1,4,2,"H"
2008-02-16,2007,"FC Lorient","RC Strasbourg","1-0",1,0,"1",1,1,1,"H"
2008-02-16,2007,"FC Metz","Valenciennes FC","2-1",2,1,"1",1,3,1,"H"
2008-02-16,2007,"AS Saint-Etienne","AS Nancy","4-0",4,0,"1",1,4,4,"H"
2008-02-16,2007,"FC Sochaux","SM Caen","1-1",1,1,"1",1,2,0,"D"
2008-02-17,2007,"AS Monaco","Girondins Bordeaux","0-6",0,6,"1",1,6,-6,"D"
2008-02-17,2007,"Olympique Marseille","Paris Saint-Germain","2-1",2,1,"1",1,3,1,"H"
2008-02-23,2007,"SM Caen","AS Saint-Etienne","1-3",1,3,"1",1,4,-2,"D"
2008-02-23,2007,"Olympique Lyon","FC Metz","2-0",2,0,"1",1,2,2,"H"
2008-02-23,2007,"AS Nancy","RC Lens","2-1",2,1,"1",1,3,1,"H"
2008-02-23,2007,"OGC Nice","AJ Auxerre","1-2",1,2,"1",1,3,-1,"D"
2008-02-23,2007,"Paris Saint-Germain","AS Monaco","1-1",1,1,"1",1,2,0,"D"
2008-02-23,2007,"Stade Rennes","FC Lorient","2-0",2,0,"1",1,2,2,"H"
2008-02-23,2007,"RC Strasbourg","FC Sochaux","0-2",0,2,"1",1,2,-2,"D"
2008-02-23,2007,"Valenciennes FC","Le Mans UC 72","1-2",1,2,"1",1,3,-1,"D"
2008-02-24,2007,"Toulouse FC","Olympique Marseille","0-0",0,0,"1",1,0,0,"D"
2008-02-24,2007,"Girondins Bordeaux","Lille OSC","0-0",0,0,"1",1,0,0,"D"
2008-03-01,2007,"Lille OSC","Olympique Lyon","0-1",0,1,"1",1,1,-1,"D"
2008-03-01,2007,"Le Mans UC 72","RC Strasbourg","0-1",0,1,"1",1,1,-1,"D"
2008-03-01,2007,"RC Lens","Toulouse FC","1-1",1,1,"1",1,2,0,"D"
2008-03-01,2007,"FC Lorient","AS Nancy","0-0",0,0,"1",1,0,0,"D"
2008-03-01,2007,"Olympique Marseille","AJ Auxerre","2-1",2,1,"1",1,3,1,"H"
2008-03-01,2007,"FC Metz","SM Caen","2-1",2,1,"1",1,3,1,"H"
2008-03-01,2007,"AS Monaco","Valenciennes FC","0-0",0,0,"1",1,0,0,"D"
2008-03-01,2007,"FC Sochaux","Stade Rennes","0-0",0,0,"1",1,0,0,"D"
2008-03-02,2007,"AS Saint-Etienne","OGC Nice","0-0",0,0,"1",1,0,0,"D"
2008-03-02,2007,"Girondins Bordeaux","Paris Saint-Germain","3-0",3,0,"1",1,3,3,"H"
2008-03-08,2007,"Stade Rennes","Paris Saint-Germain","2-0",2,0,"1",1,2,2,"H"
2008-03-08,2007,"AJ Auxerre","RC Lens","0-0",0,0,"1",1,0,0,"D"
2008-03-08,2007,"SM Caen","FC Lorient","0-0",0,0,"1",1,0,0,"D"
2008-03-08,2007,"AS Nancy","AS Monaco","2-0",2,0,"1",1,2,2,"H"
2008-03-08,2007,"OGC Nice","Le Mans UC 72","0-0",0,0,"1",1,0,0,"D"
2008-03-08,2007,"RC Strasbourg","FC Metz","2-3",2,3,"1",1,5,-1,"D"
2008-03-08,2007,"Toulouse FC","FC Sochaux","1-2",1,2,"1",1,3,-1,"D"
2008-03-08,2007,"Valenciennes FC","Lille OSC","0-0",0,0,"1",1,0,0,"D"
2008-03-09,2007,"Olympique Marseille","AS Saint-Etienne","2-0",2,0,"1",1,2,2,"H"
2008-03-09,2007,"Olympique Lyon","Girondins Bordeaux","4-2",4,2,"1",1,6,2,"H"
2008-03-11,2007,"RC Lens","Lille OSC","1-2",1,2,"1",1,3,-1,"D"
2008-03-15,2007,"AS Monaco","Olympique Lyon","0-3",0,3,"1",1,3,-3,"D"
2008-03-15,2007,"Le Mans UC 72","Stade Rennes","1-1",1,1,"1",1,2,0,"D"
2008-03-15,2007,"Lille OSC","SM Caen","5-0",5,0,"1",1,5,5,"H"
2008-03-15,2007,"FC Lorient","AJ Auxerre","1-1",1,1,"1",1,2,0,"D"
2008-03-15,2007,"FC Metz","OGC Nice","1-2",1,2,"1",1,3,-1,"D"
2008-03-15,2007,"Paris Saint-Germain","Valenciennes FC","1-1",1,1,"1",1,2,0,"D"
2008-03-15,2007,"AS Saint-Etienne","Toulouse FC","0-0",0,0,"1",1,0,0,"D"
2008-03-15,2007,"FC Sochaux","AS Nancy","1-1",1,1,"1",1,2,0,"D"
2008-03-16,2007,"Girondins Bordeaux","RC Strasbourg","3-0",3,0,"1",1,3,3,"H"
2008-03-16,2007,"RC Lens","Olympique Marseille","3-3",3,3,"1",1,6,0,"D"
2008-03-22,2007,"AS Nancy","FC Metz","2-1",2,1,"1",1,3,1,"H"
2008-03-22,2007,"AJ Auxerre","AS Saint-Etienne","1-3",1,3,"1",1,4,-2,"D"
2008-03-22,2007,"SM Caen","AS Monaco","4-1",4,1,"1",1,5,3,"H"
2008-03-22,2007,"Olympique Marseille","FC Sochaux","0-1",0,1,"1",1,1,-1,"D"
2008-03-22,2007,"OGC Nice","FC Lorient","1-2",1,2,"1",1,3,-1,"D"
2008-03-22,2007,"RC Strasbourg","Lille OSC","0-1",0,1,"1",1,1,-1,"D"
2008-03-22,2007,"Toulouse FC","Le Mans UC 72","1-1",1,1,"1",1,2,0,"D"
2008-03-22,2007,"Valenciennes FC","Girondins Bordeaux","3-1",3,1,"1",1,4,2,"H"
2008-03-23,2007,"Stade Rennes","RC Lens","3-1",3,1,"1",1,4,2,"H"
2008-03-23,2007,"Olympique Lyon","Paris Saint-Germain","4-2",4,2,"1",1,6,2,"H"
2008-03-29,2007,"Girondins Bordeaux","AS Nancy","2-1",2,1,"1",1,3,1,"H"
2008-03-30,2007,"Le Mans UC 72","SM Caen","1-1",1,1,"1",1,2,0,"D"
2008-03-30,2007,"Lille OSC","AJ Auxerre","0-2",0,2,"1",1,2,-2,"D"
2008-03-30,2007,"FC Metz","Toulouse FC","0-2",0,2,"1",1,2,-2,"D"
2008-03-30,2007,"FC Sochaux","OGC Nice","1-0",1,0,"1",1,1,1,"H"
2008-03-30,2007,"Valenciennes FC","Olympique Lyon","1-2",1,2,"1",1,3,-1,"D"
2008-03-30,2007,"FC Lorient","Olympique Marseille","1-2",1,2,"1",1,3,-1,"D"
2008-03-31,2007,"AS Monaco","Stade Rennes","1-2",1,2,"1",1,3,-1,"D"
2008-04-02,2007,"Paris Saint-Germain","RC Strasbourg","1-0",1,0,"1",1,1,1,"H"
2008-04-05,2007,"Stade Rennes","Girondins Bordeaux","0-2",0,2,"1",1,2,-2,"D"
2008-04-05,2007,"AJ Auxerre","FC Sochaux","0-1",0,1,"1",1,1,-1,"D"
2008-04-05,2007,"SM Caen","Valenciennes FC","1-0",1,0,"1",1,1,1,"H"
2008-04-05,2007,"RC Lens","FC Metz","1-1",1,1,"1",1,2,0,"D"
2008-04-05,2007,"OGC Nice","Lille OSC","0-0",0,0,"1",1,0,0,"D"
2008-04-05,2007,"AS Saint-Etienne","Le Mans UC 72","4-1",4,1,"1",1,5,3,"H"
2008-04-05,2007,"RC Strasbourg","AS Monaco","0-2",0,2,"1",1,2,-2,"D"
2008-04-05,2007,"Toulouse FC","FC Lorient","0-0",0,0,"1",1,0,0,"D"
2008-04-06,2007,"AS Nancy","Paris Saint-Germain","1-0",1,0,"1",1,1,1,"H"
2008-04-06,2007,"Olympique Marseille","Olympique Lyon","3-1",3,1,"1",1,4,2,"H"
2008-04-09,2007,"AS Saint-Etienne","RC Lens","2-0",2,0,"1",1,2,2,"H"
2008-04-12,2007,"Olympique Lyon","Stade Rennes","1-1",1,1,"1",1,2,0,"D"
2008-04-12,2007,"Le Mans UC 72","AJ Auxerre","3-0",3,0,"1",1,3,3,"H"
2008-04-12,2007,"Lille OSC","AS Nancy","2-1",2,1,"1",1,3,1,"H"
2008-04-12,2007,"FC Lorient","RC Lens","1-0",1,0,"1",1,1,1,"H"
2008-04-12,2007,"FC Metz","Olympique Marseille","1-2",1,2,"1",1,3,-1,"D"
2008-04-12,2007,"AS Monaco","Toulouse FC","0-2",0,2,"1",1,2,-2,"D"
2008-04-12,2007,"FC Sochaux","AS Saint-Etienne","1-1",1,1,"1",1,2,0,"D"
2008-04-12,2007,"Valenciennes FC","RC Strasbourg","2-0",2,0,"1",1,2,2,"H"
2008-04-13,2007,"Girondins Bordeaux","SM Caen","2-1",2,1,"1",1,3,1,"H"
2008-04-13,2007,"Paris Saint-Germain","OGC Nice","2-3",2,3,"1",1,5,-1,"D"
2008-04-19,2007,"RC Lens","FC Sochaux","3-2",3,2,"1",1,5,1,"H"
2008-04-19,2007,"AJ Auxerre","FC Metz","0-0",0,0,"1",1,0,0,"D"
2008-04-19,2007,"SM Caen","Paris Saint-Germain","3-0",3,0,"1",1,3,3,"H"
2008-04-19,2007,"AS Nancy","Le Mans UC 72","1-1",1,1,"1",1,2,0,"D"
2008-04-19,2007,"OGC Nice","AS Monaco","0-2",0,2,"1",1,2,-2,"D"
2008-04-19,2007,"Stade Rennes","Valenciennes FC","1-0",1,0,"1",1,1,1,"H"
2008-04-19,2007,"AS Saint-Etienne","FC Lorient","1-0",1,0,"1",1,1,1,"H"
2008-04-19,2007,"RC Strasbourg","Olympique Lyon","1-2",1,2,"1",1,3,-1,"D"
2008-04-20,2007,"Toulouse FC","Girondins Bordeaux","0-1",0,1,"1",1,1,-1,"D"
2008-04-20,2007,"Olympique Marseille","Lille OSC","1-3",1,3,"1",1,4,-2,"D"
2008-04-26,2007,"Paris Saint-Germain","AJ Auxerre","3-1",3,1,"1",1,4,2,"H"
2008-04-26,2007,"Girondins Bordeaux","OGC Nice","0-0",0,0,"1",1,0,0,"D"
2008-04-26,2007,"Le Mans UC 72","RC Lens","3-2",3,2,"1",1,5,1,"H"
2008-04-26,2007,"Lille OSC","Toulouse FC","3-2",3,2,"1",1,5,1,"H"
2008-04-26,2007,"Olympique Lyon","SM Caen","2-2",2,2,"1",1,4,0,"D"
2008-04-26,2007,"FC Metz","AS Saint-Etienne","0-1",0,1,"1",1,1,-1,"D"
2008-04-26,2007,"Stade Rennes","RC Strasbourg","3-0",3,0,"1",1,3,3,"H"
2008-04-26,2007,"FC Sochaux","FC Lorient","1-1",1,1,"1",1,2,0,"D"
2008-04-27,2007,"Valenciennes FC","AS Nancy","1-1",1,1,"1",1,2,0,"D"
2008-04-27,2007,"AS Monaco","Olympique Marseille","2-3",2,3,"1",1,5,-1,"D"
2008-05-03,2007,"OGC Nice","Olympique Lyon","0-0",0,0,"1",1,0,0,"D"
2008-05-03,2007,"Toulouse FC","Paris Saint-Germain","1-1",1,1,"1",1,2,0,"D"
2008-05-03,2007,"AJ Auxerre","Valenciennes FC","2-0",2,0,"1",1,2,2,"H"
2008-05-03,2007,"SM Caen","Stade Rennes","2-2",2,2,"1",1,4,0,"D"
2008-05-03,2007,"RC Lens","AS Monaco","0-0",0,0,"1",1,0,0,"D"
2008-05-03,2007,"FC Lorient","Le Mans UC 72","0-0",0,0,"1",1,0,0,"D"
2008-05-03,2007,"AS Nancy","RC Strasbourg","3-0",3,0,"1",1,3,3,"H"
2008-05-03,2007,"FC Sochaux","FC Metz","0-0",0,0,"1",1,0,0,"D"
2008-05-04,2007,"AS Saint-Etienne","Lille OSC","0-0",0,0,"1",1,0,0,"D"
2008-05-04,2007,"Olympique Marseille","Girondins Bordeaux","1-2",1,2,"1",1,3,-1,"D"
2008-05-10,2007,"Girondins Bordeaux","FC Sochaux","2-0",2,0,"1",1,2,2,"H"
2008-05-10,2007,"Le Mans UC 72","Olympique Marseille","0-0",0,0,"1",1,0,0,"D"
2008-05-10,2007,"Lille OSC","RC Lens","2-1",2,1,"1",1,3,1,"H"
2008-05-10,2007,"Olympique Lyon","AS Nancy","1-0",1,0,"1",1,1,1,"H"
2008-05-10,2007,"FC Metz","FC Lorient","1-2",1,2,"1",1,3,-1,"D"
2008-05-10,2007,"AS Monaco","AJ Auxerre","3-0",3,0,"1",1,3,3,"H"
2008-05-10,2007,"Paris Saint-Germain","AS Saint-Etienne","1-1",1,1,"1",1,2,0,"D"
2008-05-10,2007,"Stade Rennes","Toulouse FC","2-1",2,1,"1",1,3,1,"H"
2008-05-10,2007,"RC Strasbourg","SM Caen","1-4",1,4,"1",1,5,-3,"D"
2008-05-10,2007,"Valenciennes FC","OGC Nice","1-2",1,2,"1",1,3,-1,"D"
2008-05-17,2007,"AJ Auxerre","Olympique Lyon","1-3",1,3,"1",1,4,-2,"D"
2008-05-17,2007,"RC Lens","Girondins Bordeaux","2-2",2,2,"1",1,4,0,"D"
2008-05-17,2007,"FC Lorient","Lille OSC","1-1",1,1,"1",1,2,0,"D"
2008-05-17,2007,"Olympique Marseille","RC Strasbourg","4-3",4,3,"1",1,7,1,"H"
2008-05-17,2007,"FC Metz","Le Mans UC 72","4-3",4,3,"1",1,7,1,"H"
2008-05-17,2007,"AS Nancy","Stade Rennes","2-3",2,3,"1",1,5,-1,"D"
2008-05-17,2007,"OGC Nice","SM Caen","3-1",3,1,"1",1,4,2,"H"
2008-05-17,2007,"AS Saint-Etienne","AS Monaco","4-0",4,0,"1",1,4,4,"H"
2008-05-17,2007,"FC Sochaux","Paris Saint-Germain","1-2",1,2,"1",1,3,-1,"D"
2008-05-17,2007,"Toulouse FC","Valenciennes FC","2-1",2,1,"1",1,3,1,"H"
2008-08-09,2008,"AJ Auxerre","FC Nantes","2-1",2,1,"1",1,3,1,"H"
2008-08-09,2008,"Girondins Bordeaux","SM Caen","2-1",2,1,"1",1,3,1,"H"
2008-08-09,2008,"Le Havre AC","OGC Nice","1-0",1,0,"1",1,1,1,"H"
2008-08-09,2008,"Le Mans UC 72","FC Lorient","0-1",0,1,"1",1,1,-1,"D"
2008-08-09,2008,"AS Monaco","Paris Saint-Germain","1-0",1,0,"1",1,1,1,"H"
2008-08-09,2008,"AS Nancy","Lille OSC","0-0",0,0,"1",1,0,0,"D"
2008-08-09,2008,"Stade Rennes","Olympique Marseille","4-4",4,4,"1",1,8,0,"D"
2008-08-09,2008,"FC Sochaux","Grenoble Foot 38","1-2",1,2,"1",1,3,-1,"D"
2008-08-09,2008,"Valenciennes FC","AS Saint-Etienne","1-0",1,0,"1",1,1,1,"H"
2008-08-10,2008,"Olympique Lyon","Toulouse FC","3-0",3,0,"1",1,3,3,"H"
2008-08-16,2008,"SM Caen","Valenciennes FC","3-1",3,1,"1",1,4,2,"H"
2008-08-16,2008,"Lille OSC","Le Mans UC 72","1-3",1,3,"1",1,4,-2,"D"
2008-08-16,2008,"FC Nantes","AS Monaco","1-1",1,1,"1",1,2,0,"D"
2008-08-16,2008,"OGC Nice","AS Nancy","2-1",2,1,"1",1,3,1,"H"
2008-08-16,2008,"AS Saint-Etienne","FC Sochaux","2-1",2,1,"1",1,3,1,"H"
2008-08-16,2008,"Toulouse FC","Le Havre AC","2-1",2,1,"1",1,3,1,"H"
2008-08-16,2008,"Paris Saint-Germain","Girondins Bordeaux","1-0",1,0,"1",1,1,1,"H"
2008-08-17,2008,"Grenoble Foot 38","Stade Rennes","1-0",1,0,"1",1,1,1,"H"
2008-08-17,2008,"FC Lorient","Olympique Lyon","0-0",0,0,"1",1,0,0,"D"
2008-08-17,2008,"Olympique Marseille","AJ Auxerre","4-0",4,0,"1",1,4,4,"H"
2008-08-23,2008,"Le Havre AC","Olympique Marseille","0-1",0,1,"1",1,1,-1,"D"
2008-08-23,2008,"Le Mans UC 72","AS Saint-Etienne","1-0",1,0,"1",1,1,1,"H"
2008-08-23,2008,"AS Monaco","SM Caen","1-1",1,1,"1",1,2,0,"D"
2008-08-23,2008,"AS Nancy","Toulouse FC","0-0",0,0,"1",1,0,0,"D"
2008-08-23,2008,"FC Sochaux","Paris Saint-Germain","1-1",1,1,"1",1,2,0,"D"
2008-08-23,2008,"Valenciennes FC","FC Lorient","3-1",3,1,"1",1,4,2,"H"
2008-08-23,2008,"Olympique Lyon","Grenoble Foot 38","2-0",2,0,"1",1,2,2,"H"
2008-08-24,2008,"AJ Auxerre","OGC Nice","0-1",0,1,"1",1,1,-1,"D"
2008-08-24,2008,"Stade Rennes","Lille OSC","2-1",2,1,"1",1,3,1,"H"
2008-08-24,2008,"Girondins Bordeaux","FC Nantes","2-0",2,0,"1",1,2,2,"H"
2008-08-30,2008,"SM Caen","Paris Saint-Germain","0-1",0,1,"1",1,1,-1,"D"
2008-08-30,2008,"Grenoble Foot 38","AS Monaco","1-0",1,0,"1",1,1,1,"H"
2008-08-30,2008,"FC Lorient","AJ Auxerre","0-2",0,2,"1",1,2,-2,"D"
2008-08-30,2008,"AS Nancy","Le Havre AC","2-1",2,1,"1",1,3,1,"H"
2008-08-30,2008,"FC Nantes","Le Mans UC 72","1-4",1,4,"1",1,5,-3,"D"
2008-08-30,2008,"OGC Nice","Valenciennes FC","2-0",2,0,"1",1,2,2,"H"
2008-08-30,2008,"Olympique Marseille","FC Sochaux","2-1",2,1,"1",1,3,1,"H"
2008-08-31,2008,"Lille OSC","Girondins Bordeaux","2-1",2,1,"1",1,3,1,"H"
2008-08-31,2008,"Toulouse FC","Stade Rennes","0-0",0,0,"1",1,0,0,"D"
2008-08-31,2008,"AS Saint-Etienne","Olympique Lyon","0-1",0,1,"1",1,1,-1,"D"
2008-09-13,2008,"AJ Auxerre","AS Nancy","1-1",1,1,"1",1,2,0,"D"
2008-09-13,2008,"Le Mans UC 72","Toulouse FC","1-2",1,2,"1",1,3,-1,"D"
2008-09-13,2008,"Olympique Lyon","OGC Nice","3-2",3,2,"1",1,5,1,"H"
2008-09-13,2008,"AS Monaco","FC Lorient","2-0",2,0,"1",1,2,2,"H"
2008-09-13,2008,"Stade Rennes","Le Havre AC","1-1",1,1,"1",1,2,0,"D"
2008-09-13,2008,"Valenciennes FC","Grenoble Foot 38","1-1",1,1,"1",1,2,0,"D"
2008-09-13,2008,"Girondins Bordeaux","Olympique Marseille","1-1",1,1,"1",1,2,0,"D"
2008-09-14,2008,"SM Caen","AS Saint-Etienne","2-0",2,0,"1",1,2,2,"H"
2008-09-14,2008,"FC Sochaux","Lille OSC","1-1",1,1,"1",1,2,0,"D"
2008-09-14,2008,"Paris Saint-Germain","FC Nantes","1-0",1,0,"1",1,1,1,"H"
2008-09-20,2008,"Grenoble Foot 38","Girondins Bordeaux","0-1",0,1,"1",1,1,-1,"D"
2008-09-20,2008,"Le Havre AC","Olympique Lyon","0-1",0,1,"1",1,1,-1,"D"
2008-09-20,2008,"Lille OSC","AJ Auxerre","3-2",3,2,"1",1,5,1,"H"
2008-09-20,2008,"FC Lorient","SM Caen","1-1",1,1,"1",1,2,0,"D"
2008-09-20,2008,"FC Nantes","Valenciennes FC","2-0",2,0,"1",1,2,2,"H"
2008-09-20,2008,"Toulouse FC","FC Sochaux","2-1",2,1,"1",1,3,1,"H"
2008-09-20,2008,"OGC Nice","Le Mans UC 72","2-2",2,2,"1",1,4,0,"D"
2008-09-21,2008,"AS Nancy","Stade Rennes","0-0",0,0,"1",1,0,0,"D"
2008-09-21,2008,"AS Saint-Etienne","Paris Saint-Germain","1-0",1,0,"1",1,1,1,"H"
2008-09-21,2008,"Olympique Marseille","AS Monaco","0-0",0,0,"1",1,0,0,"D"
2008-09-27,2008,"AJ Auxerre","Le Havre AC","3-0",3,0,"1",1,3,3,"H"
2008-09-27,2008,"SM Caen","FC Nantes","3-0",3,0,"1",1,3,3,"H"
2008-09-27,2008,"Le Mans UC 72","Olympique Marseille","1-1",1,1,"1",1,2,0,"D"
2008-09-27,2008,"Olympique Lyon","AS Nancy","2-1",2,1,"1",1,3,1,"H"
2008-09-27,2008,"Stade Rennes","OGC Nice","1-0",1,0,"1",1,1,1,"H"
2008-09-27,2008,"FC Sochaux","FC Lorient","1-1",1,1,"1",1,2,0,"D"
2008-09-27,2008,"Paris Saint-Germain","Grenoble Foot 38","0-1",0,1,"1",1,1,-1,"D"
2008-09-28,2008,"AS Monaco","Lille OSC","0-2",0,2,"1",1,2,-2,"D"
2008-09-28,2008,"Valenciennes FC","Toulouse FC","0-1",0,1,"1",1,1,-1,"D"
2008-09-28,2008,"Girondins Bordeaux","AS Saint-Etienne","1-1",1,1,"1",1,2,0,"D"
2008-10-04,2008,"Grenoble Foot 38","FC Nantes","0-1",0,1,"1",1,1,-1,"D"
2008-10-04,2008,"Le Havre AC","Le Mans UC 72","1-2",1,2,"1",1,3,-1,"D"
2008-10-04,2008,"FC Lorient","Girondins Bordeaux","1-2",1,2,"1",1,3,-1,"D"
2008-10-04,2008,"Olympique Marseille","SM Caen","2-1",2,1,"1",1,3,1,"H"
2008-10-04,2008,"OGC Nice","FC Sochaux","1-1",1,1,"1",1,2,0,"D"
2008-10-04,2008,"Toulouse FC","AJ Auxerre","1-0",1,0,"1",1,1,1,"H"
2008-10-04,2008,"Lille OSC","Valenciennes FC","1-0",1,0,"1",1,1,1,"H"
2008-10-05,2008,"Stade Rennes","Olympique Lyon","3-0",3,0,"1",1,3,3,"H"
2008-10-05,2008,"AS Saint-Etienne","AS Monaco","2-0",2,0,"1",1,2,2,"H"
2008-10-05,2008,"AS Nancy","Paris Saint-Germain","1-1",1,1,"1",1,2,0,"D"
2008-10-18,2008,"Girondins Bordeaux","Toulouse FC","2-1",2,1,"1",1,3,1,"H"
2008-10-18,2008,"SM Caen","Grenoble Foot 38","2-2",2,2,"1",1,4,0,"D"
2008-10-18,2008,"AS Monaco","OGC Nice","1-2",1,2,"1",1,3,-1,"D"
2008-10-18,2008,"FC Nantes","AS Saint-Etienne","1-0",1,0,"1",1,1,1,"H"
2008-10-18,2008,"Paris Saint-Germain","FC Lorient","3-2",3,2,"1",1,5,1,"H"
2008-10-18,2008,"FC Sochaux","Le Havre AC","1-1",1,1,"1",1,2,0,"D"
2008-10-18,2008,"Olympique Lyon","Lille OSC","2-2",2,2,"1",1,4,0,"D"
2008-10-19,2008,"AJ Auxerre","Stade Rennes","0-0",0,0,"1",1,0,0,"D"
2008-10-19,2008,"Le Mans UC 72","AS Nancy","2-0",2,0,"1",1,2,2,"H"
2008-10-19,2008,"Valenciennes FC","Olympique Marseille","1-3",1,3,"1",1,4,-2,"D"
2008-10-25,2008,"AJ Auxerre","Olympique Lyon","0-0",0,0,"1",1,0,0,"D"
2008-10-25,2008,"Le Havre AC","Valenciennes FC","2-1",2,1,"1",1,3,1,"H"
2008-10-25,2008,"Lille OSC","SM Caen","2-2",2,2,"1",1,4,0,"D"
2008-10-25,2008,"FC Lorient","FC Nantes","3-0",3,0,"1",1,3,3,"H"
2008-10-25,2008,"OGC Nice","Girondins Bordeaux","2-2",2,2,"1",1,4,0,"D"
2008-10-25,2008,"Stade Rennes","Le Mans UC 72","2-2",2,2,"1",1,4,0,"D"
2008-10-25,2008,"Toulouse FC","AS Monaco","0-0",0,0,"1",1,0,0,"D"
2008-10-26,2008,"AS Nancy","FC Sochaux","1-1",1,1,"1",1,2,0,"D"
2008-10-26,2008,"AS Saint-Etienne","Grenoble Foot 38","0-2",0,2,"1",1,2,-2,"D"
2008-10-26,2008,"Olympique Marseille","Paris Saint-Germain","2-4",2,4,"1",1,6,-2,"D"
2008-10-28,2008,"Girondins Bordeaux","Le Havre AC","4-0",4,0,"1",1,4,4,"H"
2008-10-29,2008,"SM Caen","OGC Nice","1-1",1,1,"1",1,2,0,"D"
2008-10-29,2008,"Grenoble Foot 38","Lille OSC","0-0",0,0,"1",1,0,0,"D"
2008-10-29,2008,"Le Mans UC 72","AJ Auxerre","0-2",0,2,"1",1,2,-2,"D"
2008-10-29,2008,"AS Monaco","AS Nancy","3-1",3,1,"1",1,4,2,"H"
2008-10-29,2008,"FC Nantes","Olympique Marseille","1-1",1,1,"1",1,2,0,"D"
2008-10-29,2008,"Paris Saint-Germain","Toulouse FC","0-1",0,1,"1",1,1,-1,"D"
2008-10-29,2008,"FC Sochaux","Olympique Lyon","0-2",0,2,"1",1,2,-2,"D"
2008-10-29,2008,"Valenciennes FC","Stade Rennes","0-0",0,0,"1",1,0,0,"D"
2008-10-29,2008,"AS Saint-Etienne","FC Lorient","1-4",1,4,"1",1,5,-3,"D"
2008-11-01,2008,"AJ Auxerre","Valenciennes FC","0-0",0,0,"1",1,0,0,"D"
2008-11-01,2008,"Lille OSC","FC Nantes","2-0",2,0,"1",1,2,2,"H"
2008-11-01,2008,"FC Lorient","Grenoble Foot 38","1-1",1,1,"1",1,2,0,"D"
2008-11-01,2008,"AS Nancy","Girondins Bordeaux","1-0",1,0,"1",1,1,1,"H"
2008-11-01,2008,"OGC Nice","Paris Saint-Germain","1-0",1,0,"1",1,1,1,"H"
2008-11-01,2008,"Toulouse FC","SM Caen","0-1",0,1,"1",1,1,-1,"D"
2008-11-01,2008,"Olympique Marseille","AS Saint-Etienne","3-1",3,1,"1",1,4,2,"H"
2008-11-02,2008,"Le Havre AC","AS Monaco","2-3",2,3,"1",1,5,-1,"D"
2008-11-02,2008,"Stade Rennes","FC Sochaux","1-0",1,0,"1",1,1,1,"H"
2008-11-02,2008,"Olympique Lyon","Le Mans UC 72","2-0",2,0,"1",1,2,2,"H"
2008-11-08,2008,"Girondins Bordeaux","AJ Auxerre","2-0",2,0,"1",1,2,2,"H"
2008-11-08,2008,"SM Caen","Le Havre AC","0-1",0,1,"1",1,1,-1,"D"
2008-11-08,2008,"Grenoble Foot 38","Olympique Marseille","0-3",0,3,"1",1,3,-3,"D"
2008-11-08,2008,"FC Lorient","OGC Nice","0-1",0,1,"1",1,1,-1,"D"
2008-11-08,2008,"AS Monaco","Olympique Lyon","0-1",0,1,"1",1,1,-1,"D"
2008-11-08,2008,"FC Sochaux","Le Mans UC 72","2-1",2,1,"1",1,3,1,"H"
2008-11-08,2008,"FC Nantes","Toulouse FC","1-1",1,1,"1",1,2,0,"D"
2008-11-09,2008,"AS Saint-Etienne","Stade Rennes","0-3",0,3,"1",1,3,-3,"D"
2008-11-09,2008,"Valenciennes FC","AS Nancy","0-1",0,1,"1",1,1,-1,"D"
2008-11-09,2008,"Paris Saint-Germain","Lille OSC","1-0",1,0,"1",1,1,1,"H"
2008-11-15,2008,"AJ Auxerre","FC Sochaux","1-0",1,0,"1",1,1,1,"H"
2008-11-15,2008,"Le Havre AC","Paris Saint-Germain","1-3",1,3,"1",1,4,-2,"D"
2008-11-15,2008,"Le Mans UC 72","Valenciennes FC","1-0",1,0,"1",1,1,1,"H"
2008-11-15,2008,"Olympique Marseille","FC Lorient","2-3",2,3,"1",1,5,-1,"D"
2008-11-15,2008,"AS Nancy","SM Caen","1-1",1,1,"1",1,2,0,"D"
2008-11-15,2008,"Toulouse FC","Grenoble Foot 38","2-0",2,0,"1",1,2,2,"H"
2008-11-15,2008,"Lille OSC","AS Saint-Etienne","3-0",3,0,"1",1,3,3,"H"
2008-11-16,2008,"OGC Nice","FC Nantes","2-1",2,1,"1",1,3,1,"H"
2008-11-16,2008,"Stade Rennes","AS Monaco","2-1",2,1,"1",1,3,1,"H"
2008-11-16,2008,"Olympique Lyon","Girondins Bordeaux","2-1",2,1,"1",1,3,1,"H"
2008-11-22,2008,"Girondins Bordeaux","Stade Rennes","1-1",1,1,"1",1,2,0,"D"
2008-11-22,2008,"SM Caen","AJ Auxerre","1-0",1,0,"1",1,1,1,"H"
2008-11-22,2008,"Grenoble Foot 38","Le Havre AC","0-0",0,0,"1",1,0,0,"D"
2008-11-22,2008,"FC Lorient","Toulouse FC","1-0",1,0,"1",1,1,1,"H"
2008-11-22,2008,"AS Saint-Etienne","OGC Nice","0-1",0,1,"1",1,1,-1,"D"
2008-11-22,2008,"Valenciennes FC","FC Sochaux","2-2",2,2,"1",1,4,0,"D"
2008-11-22,2008,"Paris Saint-Germain","Olympique Lyon","1-0",1,0,"1",1,1,1,"H"
2008-11-23,2008,"AS Monaco","Le Mans UC 72","3-0",3,0,"1",1,3,3,"H"
2008-11-23,2008,"FC Nantes","AS Nancy","0-1",0,1,"1",1,1,-1,"D"
2008-11-23,2008,"Olympique Marseille","Lille OSC","2-2",2,2,"1",1,4,0,"D"
2008-11-29,2008,"AJ Auxerre","AS Monaco","0-1",0,1,"1",1,1,-1,"D"
2008-11-29,2008,"Le Havre AC","FC Nantes","0-2",0,2,"1",1,2,-2,"D"
2008-11-29,2008,"Le Mans UC 72","SM Caen","2-0",2,0,"1",1,2,2,"H"
2008-11-29,2008,"Lille OSC","FC Lorient","1-1",1,1,"1",1,2,0,"D"
2008-11-29,2008,"Olympique Lyon","Valenciennes FC","0-0",0,0,"1",1,0,0,"D"
2008-11-29,2008,"FC Sochaux","Girondins Bordeaux","0-0",0,0,"1",1,0,0,"D"
2008-11-30,2008,"AS Nancy","AS Saint-Etienne","1-2",1,2,"1",1,3,-1,"D"
2008-11-30,2008,"Toulouse FC","Olympique Marseille","0-0",0,0,"1",1,0,0,"D"
2008-11-30,2008,"Stade Rennes","Paris Saint-Germain","1-0",1,0,"1",1,1,1,"H"
2008-12-05,2008,"Girondins Bordeaux","Valenciennes FC","2-1",2,1,"1",1,3,1,"H"
2008-12-06,2008,"SM Caen","Stade Rennes","1-1",1,1,"1",1,2,0,"D"
2008-12-06,2008,"Lille OSC","Toulouse FC","1-1",1,1,"1",1,2,0,"D"
2008-12-06,2008,"Olympique Marseille","OGC Nice","2-1",2,1,"1",1,3,1,"H"
2008-12-06,2008,"AS Saint-Etienne","Le Havre AC","2-0",2,0,"1",1,2,2,"H"
2008-12-06,2008,"FC Nantes","Olympique Lyon","2-1",2,1,"1",1,3,1,"H"
2008-12-07,2008,"Grenoble Foot 38","AJ Auxerre","0-0",0,0,"1",1,0,0,"D"
2008-12-07,2008,"FC Lorient","AS Nancy","1-0",1,0,"1",1,1,1,"H"
2008-12-07,2008,"AS Monaco","FC Sochaux","1-1",1,1,"1",1,2,0,"D"
2008-12-07,2008,"Paris Saint-Germain","Le Mans UC 72","3-1",3,1,"1",1,4,2,"H"
2008-12-10,2008,"OGC Nice","Grenoble Foot 38","0-0",0,0,"1",1,0,0,"D"
2008-12-13,2008,"AJ Auxerre","Paris Saint-Germain","1-2",1,2,"1",1,3,-1,"D"
2008-12-13,2008,"Le Mans UC 72","Girondins Bordeaux","1-3",1,3,"1",1,4,-2,"D"
2008-12-13,2008,"AS Nancy","Grenoble Foot 38","2-0",2,0,"1",1,2,2,"H"
2008-12-13,2008,"FC Sochaux","SM Caen","2-2",2,2,"1",1,4,0,"D"
2008-12-13,2008,"Toulouse FC","AS Saint-Etienne","3-1",3,1,"1",1,4,2,"H"
2008-12-13,2008,"Valenciennes FC","AS Monaco","3-1",3,1,"1",1,4,2,"H"
2008-12-13,2008,"Stade Rennes","FC Nantes","0-0",0,0,"1",1,0,0,"D"
2008-12-14,2008,"Le Havre AC","FC Lorient","1-3",1,3,"1",1,4,-2,"D"
2008-12-14,2008,"OGC Nice","Lille OSC","0-1",0,1,"1",1,1,-1,"D"
2008-12-14,2008,"Olympique Lyon","Olympique Marseille","0-0",0,0,"1",1,0,0,"D"
2008-12-20,2008,"Grenoble Foot 38","Le Mans UC 72","2-1",2,1,"1",1,3,1,"H"
2008-12-20,2008,"Lille OSC","Le Havre AC","3-1",3,1,"1",1,4,2,"H"
2008-12-20,2008,"FC Lorient","Stade Rennes","1-2",1,2,"1",1,3,-1,"D"
2008-12-20,2008,"FC Nantes","FC Sochaux","1-1",1,1,"1",1,2,0,"D"
2008-12-20,2008,"AS Saint-Etienne","AJ Auxerre","2-0",2,0,"1",1,2,2,"H"
2008-12-20,2008,"Toulouse FC","OGC Nice","2-2",2,2,"1",1,4,0,"D"
2008-12-20,2008,"SM Caen","Olympique Lyon","0-1",0,1,"1",1,1,-1,"D"
2008-12-21,2008,"Olympique Marseille","AS Nancy","0-3",0,3,"1",1,3,-3,"D"
2008-12-21,2008,"Paris Saint-Germain","Valenciennes FC","2-2",2,2,"1",1,4,0,"D"
2008-12-21,2008,"AS Monaco","Girondins Bordeaux","3-4",3,4,"1",1,7,-1,"D"
2009-01-10,2008,"AJ Auxerre","Olympique Marseille","0-2",0,2,"1",1,2,-2,"D"
2009-01-10,2008,"Le Havre AC","Toulouse FC","0-1",0,1,"1",1,1,-1,"D"
2009-01-10,2008,"Olympique Lyon","FC Lorient","1-1",1,1,"1",1,2,0,"D"
2009-01-10,2008,"AS Monaco","FC Nantes","1-2",1,2,"1",1,3,-1,"D"
2009-01-10,2008,"Stade Rennes","Grenoble Foot 38","1-0",1,0,"1",1,1,1,"H"
2009-01-10,2008,"FC Sochaux","AS Saint-Etienne","1-0",1,0,"1",1,1,1,"H"
2009-01-11,2008,"Girondins Bordeaux","Paris Saint-Germain","4-0",4,0,"1",1,4,4,"H"
2009-01-17,2008,"Grenoble Foot 38","Olympique Lyon","0-2",0,2,"1",1,2,-2,"D"
2009-01-17,2008,"FC Lorient","Valenciennes FC","1-1",1,1,"1",1,2,0,"D"
2009-01-17,2008,"Olympique Marseille","Le Havre AC","2-0",2,0,"1",1,2,2,"H"
2009-01-17,2008,"OGC Nice","AJ Auxerre","2-0",2,0,"1",1,2,2,"H"
2009-01-17,2008,"AS Saint-Etienne","Le Mans UC 72","1-1",1,1,"1",1,2,0,"D"
2009-01-17,2008,"Toulouse FC","AS Nancy","3-0",3,0,"1",1,3,3,"H"
2009-01-17,2008,"FC Nantes","Girondins Bordeaux","1-2",1,2,"1",1,3,-1,"D"
2009-01-18,2008,"SM Caen","AS Monaco","2-2",2,2,"1",1,4,0,"D"
2009-01-18,2008,"Paris Saint-Germain","FC Sochaux","2-1",2,1,"1",1,3,1,"H"
2009-01-18,2008,"Lille OSC","Stade Rennes","1-0",1,0,"1",1,1,1,"H"
2009-01-31,2008,"AJ Auxerre","FC Lorient","0-0",0,0,"1",1,0,0,"D"
2009-01-31,2008,"Le Havre AC","AS Nancy","2-3",2,3,"1",1,5,-1,"D"
2009-01-31,2008,"Le Mans UC 72","FC Nantes","0-2",0,2,"1",1,2,-2,"D"
2009-01-31,2008,"AS Monaco","Grenoble Foot 38","1-0",1,0,"1",1,1,1,"H"
2009-01-31,2008,"Paris Saint-Germain","SM Caen","2-0",2,0,"1",1,2,2,"H"
2009-01-31,2008,"Valenciennes FC","OGC Nice","1-0",1,0,"1",1,1,1,"H"
2009-01-31,2008,"Stade Rennes","Toulouse FC","0-0",0,0,"1",1,0,0,"D"
2009-02-01,2008,"Girondins Bordeaux","Lille OSC","2-2",2,2,"1",1,4,0,"D"
2009-02-01,2008,"FC Sochaux","Olympique Marseille","1-0",1,0,"1",1,1,1,"H"
2009-02-01,2008,"Olympique Lyon","AS Saint-Etienne","1-1",1,1,"1",1,2,0,"D"
2009-02-07,2008,"Le Havre AC","Stade Rennes","1-0",1,0,"1",1,1,1,"H"
2009-02-07,2008,"FC Lorient","AS Monaco","1-1",1,1,"1",1,2,0,"D"
2009-02-07,2008,"AS Nancy","AJ Auxerre","0-2",0,2,"1",1,2,-2,"D"
2009-02-07,2008,"FC Nantes","Paris Saint-Germain","1-4",1,4,"1",1,5,-3,"D"
2009-02-07,2008,"AS Saint-Etienne","SM Caen","3-2",3,2,"1",1,5,1,"H"
2009-02-07,2008,"Toulouse FC","Le Mans UC 72","2-0",2,0,"1",1,2,2,"H"
2009-02-07,2008,"Lille OSC","FC Sochaux","3-2",3,2,"1",1,5,1,"H"
2009-02-08,2008,"Grenoble Foot 38","Valenciennes FC","0-0",0,0,"1",1,0,0,"D"
2009-02-08,2008,"OGC Nice","Olympique Lyon","1-3",1,3,"1",1,4,-2,"D"
2009-02-08,2008,"Olympique Marseille","Girondins Bordeaux","1-0",1,0,"1",1,1,1,"H"
2009-02-14,2008,"AJ Auxerre","Lille OSC","2-0",2,0,"1",1,2,2,"H"
2009-02-14,2008,"Girondins Bordeaux","Grenoble Foot 38","1-1",1,1,"1",1,2,0,"D"
2009-02-14,2008,"SM Caen","FC Lorient","1-1",1,1,"1",1,2,0,"D"
2009-02-14,2008,"Le Mans UC 72","OGC Nice","1-2",1,2,"1",1,3,-1,"D"
2009-02-14,2008,"Stade Rennes","AS Nancy","1-1",1,1,"1",1,2,0,"D"
2009-02-14,2008,"Valenciennes FC","FC Nantes","1-1",1,1,"1",1,2,0,"D"
2009-02-14,2008,"Paris Saint-Germain","AS Saint-Etienne","2-1",2,1,"1",1,3,1,"H"
2009-02-15,2008,"Olympique Lyon","Le Havre AC","3-1",3,1,"1",1,4,2,"H"
2009-02-15,2008,"FC Sochaux","Toulouse FC","1-2",1,2,"1",1,3,-1,"D"
2009-02-15,2008,"AS Monaco","Olympique Marseille","0-1",0,1,"1",1,1,-1,"D"
2009-02-17,2008,"Le Mans UC 72","Lille OSC","0-0",0,0,"1",1,0,0,"D"
2009-02-17,2008,"AS Nancy","OGC Nice","1-2",1,2,"1",1,3,-1,"D"
2009-02-17,2008,"Valenciennes FC","SM Caen","2-0",2,0,"1",1,2,2,"H"
2009-02-21,2008,"Grenoble Foot 38","Paris Saint-Germain","0-0",0,0,"1",1,0,0,"D"
2009-02-21,2008,"Le Havre AC","AJ Auxerre","1-2",1,2,"1",1,3,-1,"D"
2009-02-21,2008,"FC Lorient","FC Sochaux","1-2",1,2,"1",1,3,-1,"D"
2009-02-21,2008,"AS Nancy","Olympique Lyon","0-2",0,2,"1",1,2,-2,"D"
2009-02-21,2008,"FC Nantes","SM Caen","1-1",1,1,"1",1,2,0,"D"
2009-02-21,2008,"Toulouse FC","Valenciennes FC","0-0",0,0,"1",1,0,0,"D"
2009-02-21,2008,"OGC Nice","Stade Rennes","0-1",0,1,"1",1,1,-1,"D"
2009-02-22,2008,"Olympique Marseille","Le Mans UC 72","0-0",0,0,"1",1,0,0,"D"
2009-02-22,2008,"AS Saint-Etienne","Girondins Bordeaux","1-1",1,1,"1",1,2,0,"D"
2009-02-22,2008,"Lille OSC","AS Monaco","2-1",2,1,"1",1,3,1,"H"
2009-02-28,2008,"Le Mans UC 72","Le Havre AC","2-0",2,0,"1",1,2,2,"H"
2009-02-28,2008,"FC Nantes","Grenoble Foot 38","1-1",1,1,"1",1,2,0,"D"
2009-02-28,2008,"FC Sochaux","OGC Nice","1-0",1,0,"1",1,1,1,"H"
2009-02-28,2008,"Valenciennes FC","Lille OSC","2-0",2,0,"1",1,2,2,"H"
2009-02-28,2008,"AJ Auxerre","Toulouse FC","1-1",1,1,"1",1,2,0,"D"
2009-03-01,2008,"Girondins Bordeaux","FC Lorient","1-0",1,0,"1",1,1,1,"H"
2009-03-01,2008,"SM Caen","Olympique Marseille","0-1",0,1,"1",1,1,-1,"D"
2009-03-01,2008,"AS Monaco","AS Saint-Etienne","2-2",2,2,"1",1,4,0,"D"
2009-03-01,2008,"Paris Saint-Germain","AS Nancy","4-1",4,1,"1",1,5,3,"H"
2009-03-01,2008,"Olympique Lyon","Stade Rennes","1-1",1,1,"1",1,2,0,"D"
2009-03-07,2008,"Grenoble Foot 38","SM Caen","2-1",2,1,"1",1,3,1,"H"
2009-03-07,2008,"FC Lorient","Paris Saint-Germain","0-1",0,1,"1",1,1,-1,"D"
2009-03-07,2008,"Olympique Marseille","Valenciennes FC","0-0",0,0,"1",1,0,0,"D"
2009-03-07,2008,"AS Nancy","Le Mans UC 72","2-2",2,2,"1",1,4,0,"D"
2009-03-07,2008,"OGC Nice","AS Monaco","0-0",0,0,"1",1,0,0,"D"
2009-03-07,2008,"Toulouse FC","Girondins Bordeaux","3-0",3,0,"1",1,3,3,"H"
2009-03-07,2008,"Lille OSC","Olympique Lyon","2-0",2,0,"1",1,2,2,"H"
2009-03-08,2008,"Le Havre AC","FC Sochaux","2-1",2,1,"1",1,3,1,"H"
2009-03-08,2008,"Stade Rennes","AJ Auxerre","2-0",2,0,"1",1,2,2,"H"
2009-03-08,2008,"AS Saint-Etienne","FC Nantes","2-1",2,1,"1",1,3,1,"H"
2009-03-14,2008,"SM Caen","Lille OSC","0-1",0,1,"1",1,1,-1,"D"
2009-03-14,2008,"Le Mans UC 72","Stade Rennes","2-2",2,2,"1",1,4,0,"D"
2009-03-14,2008,"AS Monaco","Toulouse FC","3-2",3,2,"1",1,5,1,"H"
2009-03-14,2008,"FC Nantes","FC Lorient","1-1",1,1,"1",1,2,0,"D"
2009-03-14,2008,"FC Sochaux","AS Nancy","2-1",2,1,"1",1,3,1,"H"
2009-03-14,2008,"Valenciennes FC","Le Havre AC","3-2",3,2,"1",1,5,1,"H"
2009-03-14,2008,"Girondins Bordeaux","OGC Nice","2-1",2,1,"1",1,3,1,"H"
2009-03-15,2008,"Grenoble Foot 38","AS Saint-Etienne","1-0",1,0,"1",1,1,1,"H"
2009-03-15,2008,"Olympique Lyon","AJ Auxerre","0-2",0,2,"1",1,2,-2,"D"
2009-03-15,2008,"Paris Saint-Germain","Olympique Marseille","1-3",1,3,"1",1,4,-2,"D"
2009-03-21,2008,"AJ Auxerre","Le Mans UC 72","2-0",2,0,"1",1,2,2,"H"
2009-03-21,2008,"Le Havre AC","Girondins Bordeaux","0-3",0,3,"1",1,3,-3,"D"
2009-03-21,2008,"Lille OSC","Grenoble Foot 38","2-1",2,1,"1",1,3,1,"H"
2009-03-21,2008,"AS Nancy","AS Monaco","0-1",0,1,"1",1,1,-1,"D"
2009-03-21,2008,"OGC Nice","SM Caen","2-2",2,2,"1",1,4,0,"D"
2009-03-21,2008,"Stade Rennes","Valenciennes FC","0-0",0,0,"1",1,0,0,"D"
2009-03-21,2008,"Olympique Marseille","FC Nantes","2-0",2,0,"1",1,2,2,"H"
2009-03-22,2008,"FC Lorient","AS Saint-Etienne","3-1",3,1,"1",1,4,2,"H"
2009-03-22,2008,"Olympique Lyon","FC Sochaux","2-0",2,0,"1",1,2,2,"H"
2009-03-22,2008,"Toulouse FC","Paris Saint-Germain","4-1",4,1,"1",1,5,3,"H"
2009-04-04,2008,"Girondins Bordeaux","AS Nancy","1-0",1,0,"1",1,1,1,"H"
2009-04-04,2008,"Grenoble Foot 38","FC Lorient","1-3",1,3,"1",1,4,-2,"D"
2009-04-04,2008,"Le Mans UC 72","Olympique Lyon","1-3",1,3,"1",1,4,-2,"D"
2009-04-04,2008,"AS Monaco","Le Havre AC","0-1",0,1,"1",1,1,-1,"D"
2009-04-04,2008,"FC Nantes","Lille OSC","0-2",0,2,"1",1,2,-2,"D"
2009-04-04,2008,"Valenciennes FC","AJ Auxerre","2-0",2,0,"1",1,2,2,"H"
2009-04-04,2008,"SM Caen","Toulouse FC","0-0",0,0,"1",1,0,0,"D"
2009-04-05,2008,"Paris Saint-Germain","OGC Nice","2-1",2,1,"1",1,3,1,"H"
2009-04-05,2008,"FC Sochaux","Stade Rennes","3-0",3,0,"1",1,3,3,"H"
2009-04-05,2008,"AS Saint-Etienne","Olympique Marseille","0-3",0,3,"1",1,3,-3,"D"
2009-04-11,2008,"AJ Auxerre","Girondins Bordeaux","0-2",0,2,"1",1,2,-2,"D"
2009-04-11,2008,"Le Havre AC","SM Caen","1-2",1,2,"1",1,3,-1,"D"
2009-04-11,2008,"Le Mans UC 72","FC Sochaux","2-0",2,0,"1",1,2,2,"H"
2009-04-11,2008,"AS Nancy","Valenciennes FC","2-0",2,0,"1",1,2,2,"H"
2009-04-11,2008,"OGC Nice","FC Lorient","2-0",2,0,"1",1,2,2,"H"
2009-04-11,2008,"Toulouse FC","FC Nantes","1-0",1,0,"1",1,1,1,"H"
2009-04-11,2008,"Stade Rennes","AS Saint-Etienne","1-0",1,0,"1",1,1,1,"H"
2009-04-12,2008,"Olympique Marseille","Grenoble Foot 38","4-1",4,1,"1",1,5,3,"H"
2009-04-12,2008,"Lille OSC","Paris Saint-Germain","0-0",0,0,"1",1,0,0,"D"
2009-04-12,2008,"Olympique Lyon","AS Monaco","2-2",2,2,"1",1,4,0,"D"
2009-04-18,2008,"SM Caen","AS Nancy","1-2",1,2,"1",1,3,-1,"D"
2009-04-18,2008,"Grenoble Foot 38","Toulouse FC","1-0",1,0,"1",1,1,1,"H"
2009-04-18,2008,"AS Monaco","Stade Rennes","3-1",3,1,"1",1,4,2,"H"
2009-04-18,2008,"FC Nantes","OGC Nice","2-0",2,0,"1",1,2,2,"H"
2009-04-18,2008,"FC Sochaux","AJ Auxerre","0-1",0,1,"1",1,1,-1,"D"
2009-04-18,2008,"Valenciennes FC","Le Mans UC 72","0-2",0,2,"1",1,2,-2,"D"
2009-04-18,2008,"AS Saint-Etienne","Lille OSC","2-1",2,1,"1",1,3,1,"H"
2009-04-19,2008,"FC Lorient","Olympique Marseille","1-2",1,2,"1",1,3,-1,"D"
2009-04-19,2008,"Paris Saint-Germain","Le Havre AC","3-0",3,0,"1",1,3,3,"H"
2009-04-19,2008,"Girondins Bordeaux","Olympique Lyon","1-0",1,0,"1",1,1,1,"H"
2009-04-24,2008,"Olympique Lyon","Paris Saint-Germain","0-0",0,0,"1",1,0,0,"D"
2009-04-26,2008,"AJ Auxerre","SM Caen","2-1",2,1,"1",1,3,1,"H"
2009-04-26,2008,"Le Havre AC","Grenoble Foot 38","0-1",0,1,"1",1,1,-1,"D"
2009-04-26,2008,"Le Mans UC 72","AS Monaco","0-1",0,1,"1",1,1,-1,"D"
2009-04-26,2008,"AS Nancy","FC Nantes","2-0",2,0,"1",1,2,2,"H"
2009-04-26,2008,"OGC Nice","AS Saint-Etienne","3-1",3,1,"1",1,4,2,"H"
2009-04-26,2008,"FC Sochaux","Valenciennes FC","1-1",1,1,"1",1,2,0,"D"
2009-04-26,2008,"Toulouse FC","FC Lorient","1-1",1,1,"1",1,2,0,"D"
2009-04-26,2008,"Lille OSC","Olympique Marseille","1-2",1,2,"1",1,3,-1,"D"
2009-04-29,2008,"Stade Rennes","Girondins Bordeaux","2-3",2,3,"1",1,5,-1,"D"
2009-05-02,2008,"SM Caen","Le Mans UC 72","3-1",3,1,"1",1,4,2,"H"
2009-05-02,2008,"Grenoble Foot 38","OGC Nice","0-0",0,0,"1",1,0,0,"D"
2009-05-02,2008,"FC Lorient","Lille OSC","3-1",3,1,"1",1,4,2,"H"
2009-05-02,2008,"AS Monaco","AJ Auxerre","0-1",0,1,"1",1,1,-1,"D"
2009-05-02,2008,"AS Saint-Etienne","AS Nancy","0-0",0,0,"1",1,0,0,"D"
2009-05-02,2008,"Valenciennes FC","Olympique Lyon","2-0",2,0,"1",1,2,2,"H"
2009-05-02,2008,"Olympique Marseille","Toulouse FC","2-2",2,2,"1",1,4,0,"D"
2009-05-03,2008,"FC Nantes","Le Havre AC","1-2",1,2,"1",1,3,-1,"D"
2009-05-03,2008,"Paris Saint-Germain","Stade Rennes","0-1",0,1,"1",1,1,-1,"D"
2009-05-03,2008,"Girondins Bordeaux","FC Sochaux","3-0",3,0,"1",1,3,3,"H"
2009-05-12,2008,"Olympique Lyon","FC Nantes","3-0",3,0,"1",1,3,3,"H"
2009-05-13,2008,"AJ Auxerre","Grenoble Foot 38","2-0",2,0,"1",1,2,2,"H"
2009-05-13,2008,"Le Havre AC","AS Saint-Etienne","2-4",2,4,"1",1,6,-2,"D"
2009-05-13,2008,"Le Mans UC 72","Paris Saint-Germain","0-1",0,1,"1",1,1,-1,"D"
2009-05-13,2008,"AS Nancy","FC Lorient","2-2",2,2,"1",1,4,0,"D"
2009-05-13,2008,"OGC Nice","Olympique Marseille","0-2",0,2,"1",1,2,-2,"D"
2009-05-13,2008,"Stade Rennes","SM Caen","1-0",1,0,"1",1,1,1,"H"
2009-05-13,2008,"FC Sochaux","AS Monaco","3-0",3,0,"1",1,3,3,"H"
2009-05-13,2008,"Toulouse FC","Lille OSC","0-0",0,0,"1",1,0,0,"D"
2009-05-13,2008,"Valenciennes FC","Girondins Bordeaux","1-2",1,2,"1",1,3,-1,"D"
2009-05-16,2008,"Girondins Bordeaux","Le Mans UC 72","3-2",3,2,"1",1,5,1,"H"
2009-05-16,2008,"SM Caen","FC Sochaux","2-0",2,0,"1",1,2,2,"H"
2009-05-16,2008,"Grenoble Foot 38","AS Nancy","0-0",0,0,"1",1,0,0,"D"
2009-05-16,2008,"FC Lorient","Le Havre AC","1-1",1,1,"1",1,2,0,"D"
2009-05-16,2008,"AS Monaco","Valenciennes FC","1-1",1,1,"1",1,2,0,"D"
2009-05-16,2008,"AS Saint-Etienne","Toulouse FC","2-2",2,2,"1",1,4,0,"D"
2009-05-16,2008,"Paris Saint-Germain","AJ Auxerre","1-2",1,2,"1",1,3,-1,"D"
2009-05-17,2008,"Lille OSC","OGC Nice","1-1",1,1,"1",1,2,0,"D"
2009-05-17,2008,"FC Nantes","Stade Rennes","1-1",1,1,"1",1,2,0,"D"
2009-05-17,2008,"Olympique Marseille","Olympique Lyon","1-3",1,3,"1",1,4,-2,"D"
2009-05-23,2008,"AJ Auxerre","AS Saint-Etienne","1-0",1,0,"1",1,1,1,"H"
2009-05-23,2008,"Girondins Bordeaux","AS Monaco","1-0",1,0,"1",1,1,1,"H"
2009-05-23,2008,"Le Havre AC","Lille OSC","0-1",0,1,"1",1,1,-1,"D"
2009-05-23,2008,"Le Mans UC 72","Grenoble Foot 38","1-1",1,1,"1",1,2,0,"D"
2009-05-23,2008,"Olympique Lyon","SM Caen","3-1",3,1,"1",1,4,2,"H"
2009-05-23,2008,"AS Nancy","Olympique Marseille","1-2",1,2,"1",1,3,-1,"D"
2009-05-23,2008,"OGC Nice","Toulouse FC","0-2",0,2,"1",1,2,-2,"D"
2009-05-23,2008,"Stade Rennes","FC Lorient","3-1",3,1,"1",1,4,2,"H"
2009-05-23,2008,"FC Sochaux","FC Nantes","2-1",2,1,"1",1,3,1,"H"
2009-05-23,2008,"Valenciennes FC","Paris Saint-Germain","2-1",2,1,"1",1,3,1,"H"
2009-05-30,2008,"SM Caen","Girondins Bordeaux","0-1",0,1,"1",1,1,-1,"D"
2009-05-30,2008,"Grenoble Foot 38","FC Sochaux","0-1",0,1,"1",1,1,-1,"D"
2009-05-30,2008,"Lille OSC","AS Nancy","3-2",3,2,"1",1,5,1,"H"
2009-05-30,2008,"FC Lorient","Le Mans UC 72","1-1",1,1,"1",1,2,0,"D"
2009-05-30,2008,"Olympique Marseille","Stade Rennes","4-0",4,0,"1",1,4,4,"H"
2009-05-30,2008,"FC Nantes","AJ Auxerre","2-1",2,1,"1",1,3,1,"H"
2009-05-30,2008,"OGC Nice","Le Havre AC","0-0",0,0,"1",1,0,0,"D"
2009-05-30,2008,"Paris Saint-Germain","AS Monaco","0-0",0,0,"1",1,0,0,"D"
2009-05-30,2008,"AS Saint-Etienne","Valenciennes FC","4-0",4,0,"1",1,4,4,"H"
2009-05-30,2008,"Toulouse FC","Olympique Lyon","0-0",0,0,"1",1,0,0,"D"
2009-08-08,2009,"AJ Auxerre","FC Sochaux","0-1",0,1,"1",1,1,-1,"D"
2009-08-08,2009,"Grenoble Foot 38","Olympique Marseille","0-2",0,2,"1",1,2,-2,"D"
2009-08-08,2009,"Le Mans UC 72","Olympique Lyon","2-2",2,2,"1",1,4,0,"D"
2009-08-08,2009,"AS Monaco","Toulouse FC","1-0",1,0,"1",1,1,1,"H"
2009-08-08,2009,"Montpellier HSC","Paris Saint-Germain","1-1",1,1,"1",1,2,0,"D"
2009-08-08,2009,"Stade Rennes","US Boulogne","3-0",3,0,"1",1,3,3,"H"
2009-08-08,2009,"AS Saint-Etienne","OGC Nice","0-2",0,2,"1",1,2,-2,"D"
2009-08-08,2009,"Valenciennes FC","AS Nancy","1-3",1,3,"1",1,4,-2,"D"
2009-08-09,2009,"Lille OSC","FC Lorient","1-2",1,2,"1",1,3,-1,"D"
2009-08-09,2009,"Girondins Bordeaux","RC Lens","4-1",4,1,"1",1,5,3,"H"
2009-08-15,2009,"RC Lens","AJ Auxerre","2-0",2,0,"1",1,2,2,"H"
2009-08-15,2009,"FC Lorient","Montpellier HSC","2-2",2,2,"1",1,4,0,"D"
2009-08-15,2009,"Olympique Lyon","Valenciennes FC","1-0",1,0,"1",1,1,1,"H"
2009-08-15,2009,"AS Nancy","AS Monaco","4-0",4,0,"1",1,4,4,"H"
2009-08-15,2009,"Paris Saint-Germain","Le Mans UC 72","3-1",3,1,"1",1,4,2,"H"
2009-08-15,2009,"FC Sochaux","Girondins Bordeaux","2-3",2,3,"1",1,5,-1,"D"
2009-08-15,2009,"Toulouse FC","AS Saint-Etienne","3-1",3,1,"1",1,4,2,"H"
2009-08-16,2009,"US Boulogne","Grenoble Foot 38","2-1",2,1,"1",1,3,1,"H"
2009-08-16,2009,"OGC Nice","Stade Rennes","1-1",1,1,"1",1,2,0,"D"
2009-08-16,2009,"Olympique Marseille","Lille OSC","1-0",1,0,"1",1,1,1,"H"
2009-08-22,2009,"AJ Auxerre","Olympique Lyon","0-3",0,3,"1",1,3,-3,"D"
2009-08-22,2009,"Le Mans UC 72","AS Nancy","2-1",2,1,"1",1,3,1,"H"
2009-08-22,2009,"AS Monaco","FC Lorient","2-0",2,0,"1",1,2,2,"H"
2009-08-22,2009,"Montpellier HSC","FC Sochaux","2-0",2,0,"1",1,2,2,"H"
2009-08-22,2009,"AS Saint-Etienne","US Boulogne","0-1",0,1,"1",1,1,-1,"D"
2009-08-22,2009,"Valenciennes FC","Paris Saint-Germain","2-3",2,3,"1",1,5,-1,"D"
2009-08-22,2009,"Stade Rennes","Olympique Marseille","1-1",1,1,"1",1,2,0,"D"
2009-08-23,2009,"Girondins Bordeaux","OGC Nice","4-0",4,0,"1",1,4,4,"H"
2009-08-23,2009,"Grenoble Foot 38","RC Lens","1-2",1,2,"1",1,3,-1,"D"
2009-08-23,2009,"Lille OSC","Toulouse FC","1-1",1,1,"1",1,2,0,"D"
2009-08-29,2009,"US Boulogne","AJ Auxerre","0-0",0,0,"1",1,0,0,"D"
2009-08-29,2009,"RC Lens","Stade Rennes","2-2",2,2,"1",1,4,0,"D"
2009-08-29,2009,"FC Lorient","Le Mans UC 72","1-0",1,0,"1",1,1,1,"H"
2009-08-29,2009,"OGC Nice","Montpellier HSC","0-3",0,3,"1",1,3,-3,"D"
2009-08-29,2009,"AS Saint-Etienne","Grenoble Foot 38","1-0",1,0,"1",1,1,1,"H"
2009-08-29,2009,"FC Sochaux","AS Monaco","1-0",1,0,"1",1,1,1,"H"
2009-08-29,2009,"Olympique Lyon","AS Nancy","3-1",3,1,"1",1,4,2,"H"
2009-08-30,2009,"Paris Saint-Germain","Lille OSC","3-0",3,0,"1",1,3,3,"H"
2009-08-30,2009,"Toulouse FC","Valenciennes FC","0-1",0,1,"1",1,1,-1,"D"
2009-08-30,2009,"Olympique Marseille","Girondins Bordeaux","0-0",0,0,"1",1,0,0,"D"
2009-09-12,2009,"Le Mans UC 72","Olympique Marseille","1-2",1,2,"1",1,3,-1,"D"
2009-09-12,2009,"Lille OSC","FC Sochaux","1-0",1,0,"1",1,1,1,"H"
2009-09-12,2009,"Olympique Lyon","FC Lorient","1-0",1,0,"1",1,1,1,"H"
2009-09-12,2009,"Montpellier HSC","RC Lens","1-0",1,0,"1",1,1,1,"H"
2009-09-12,2009,"AS Nancy","Toulouse FC","0-0",0,0,"1",1,0,0,"D"
2009-09-12,2009,"Valenciennes FC","US Boulogne","1-1",1,1,"1",1,2,0,"D"
2009-09-12,2009,"Girondins Bordeaux","Grenoble Foot 38","1-0",1,0,"1",1,1,1,"H"
2009-09-13,2009,"AJ Auxerre","OGC Nice","2-0",2,0,"1",1,2,2,"H"
2009-09-13,2009,"Stade Rennes","AS Saint-Etienne","1-0",1,0,"1",1,1,1,"H"
2009-09-13,2009,"AS Monaco","Paris Saint-Germain","2-0",2,0,"1",1,2,2,"H"
2009-09-19,2009,"US Boulogne","Girondins Bordeaux","0-2",0,2,"1",1,2,-2,"D"
2009-09-19,2009,"Grenoble Foot 38","Stade Rennes","0-4",0,4,"1",1,4,-4,"D"
2009-09-19,2009,"FC Lorient","AS Nancy","3-1",3,1,"1",1,4,2,"H"
2009-09-19,2009,"OGC Nice","AS Monaco","1-3",1,3,"1",1,4,-2,"D"
2009-09-19,2009,"AS Saint-Etienne","AJ Auxerre","1-1",1,1,"1",1,2,0,"D"
2009-09-19,2009,"FC Sochaux","Valenciennes FC","2-5",2,5,"1",1,7,-3,"D"
2009-09-19,2009,"Olympique Marseille","Montpellier HSC","4-2",4,2,"1",1,6,2,"H"
2009-09-20,2009,"RC Lens","Lille OSC","1-1",1,1,"1",1,2,0,"D"
2009-09-20,2009,"Toulouse FC","Le Mans UC 72","2-0",2,0,"1",1,2,2,"H"
2009-09-20,2009,"Paris Saint-Germain","Olympique Lyon","1-1",1,1,"1",1,2,0,"D"
2009-09-26,2009,"AJ Auxerre","Grenoble Foot 38","2-0",2,0,"1",1,2,2,"H"
2009-09-26,2009,"FC Lorient","Paris Saint-Germain","1-1",1,1,"1",1,2,0,"D"
2009-09-26,2009,"AS Monaco","AS Saint-Etienne","1-2",1,2,"1",1,3,-1,"D"
2009-09-26,2009,"Montpellier HSC","US Boulogne","1-0",1,0,"1",1,1,1,"H"
2009-09-26,2009,"AS Nancy","FC Sochaux","2-1",2,1,"1",1,3,1,"H"
2009-09-26,2009,"Valenciennes FC","Olympique Marseille","3-2",3,2,"1",1,5,1,"H"
2009-09-26,2009,"Olympique Lyon","Toulouse FC","2-1",2,1,"1",1,3,1,"H"
2009-09-27,2009,"Le Mans UC 72","RC Lens","3-0",3,0,"1",1,3,3,"H"
2009-09-27,2009,"Lille OSC","OGC Nice","1-1",1,1,"1",1,2,0,"D"
2009-09-27,2009,"Girondins Bordeaux","Stade Rennes","1-0",1,0,"1",1,1,1,"H"
2009-10-03,2009,"Grenoble Foot 38","Montpellier HSC","2-3",2,3,"1",1,5,-1,"D"
2009-10-03,2009,"OGC Nice","Valenciennes FC","3-2",3,2,"1",1,5,1,"H"
2009-10-03,2009,"Paris Saint-Germain","AS Nancy","1-1",1,1,"1",1,2,0,"D"
2009-10-03,2009,"Stade Rennes","AJ Auxerre","0-1",0,1,"1",1,1,-1,"D"
2009-10-03,2009,"AS Saint-Etienne","Girondins Bordeaux","3-1",3,1,"1",1,4,2,"H"
2009-10-03,2009,"FC Sochaux","Le Mans UC 72","1-0",1,0,"1",1,1,1,"H"
2009-10-03,2009,"RC Lens","Olympique Lyon","0-2",0,2,"1",1,2,-2,"D"
2009-10-04,2009,"US Boulogne","Lille OSC","2-3",2,3,"1",1,5,-1,"D"
2009-10-04,2009,"Toulouse FC","FC Lorient","0-1",0,1,"1",1,1,-1,"D"
2009-10-04,2009,"Olympique Marseille","AS Monaco","1-2",1,2,"1",1,3,-1,"D"
2009-10-17,2009,"AJ Auxerre","Girondins Bordeaux","1-0",1,0,"1",1,1,1,"H"
2009-10-17,2009,"Le Mans UC 72","US Boulogne","1-1",1,1,"1",1,2,0,"D"
2009-10-17,2009,"Olympique Lyon","FC Sochaux","0-2",0,2,"1",1,2,-2,"D"
2009-10-17,2009,"Montpellier HSC","AS Saint-Etienne","2-1",2,1,"1",1,3,1,"H"
2009-10-17,2009,"AS Nancy","Olympique Marseille","0-3",0,3,"1",1,3,-3,"D"
2009-10-17,2009,"Valenciennes FC","Grenoble Foot 38","2-0",2,0,"1",1,2,2,"H"
2009-10-17,2009,"Lille OSC","Stade Rennes","0-0",0,0,"1",1,0,0,"D"
2009-10-18,2009,"FC Lorient","OGC Nice","4-1",4,1,"1",1,5,3,"H"
2009-10-18,2009,"AS Monaco","RC Lens","2-0",2,0,"1",1,2,2,"H"
2009-10-18,2009,"Toulouse FC","Paris Saint-Germain","1-0",1,0,"1",1,1,1,"H"
2009-10-24,2009,"Girondins Bordeaux","Le Mans UC 72","3-0",3,0,"1",1,3,3,"H"
2009-10-24,2009,"US Boulogne","AS Monaco","1-3",1,3,"1",1,4,-2,"D"
2009-10-24,2009,"Grenoble Foot 38","AS Nancy","1-2",1,2,"1",1,3,-1,"D"
2009-10-24,2009,"OGC Nice","Olympique Lyon","4-1",4,1,"1",1,5,3,"H"
2009-10-24,2009,"AS Saint-Etienne","Valenciennes FC","0-2",0,2,"1",1,2,-2,"D"
2009-10-24,2009,"FC Sochaux","FC Lorient","1-0",1,0,"1",1,1,1,"H"
2009-10-24,2009,"Stade Rennes","Montpellier HSC","3-0",3,0,"1",1,3,3,"H"
2009-10-25,2009,"AJ Auxerre","Lille OSC","3-2",3,2,"1",1,5,1,"H"
2009-10-25,2009,"RC Lens","Toulouse FC","0-2",0,2,"1",1,2,-2,"D"
2009-10-31,2009,"AJ Auxerre","Montpellier HSC","2-1",2,1,"1",1,3,1,"H"
2009-10-31,2009,"Girondins Bordeaux","AS Monaco","1-0",1,0,"1",1,1,1,"H"
2009-10-31,2009,"US Boulogne","AS Nancy","1-2",1,2,"1",1,3,-1,"D"
2009-10-31,2009,"Grenoble Foot 38","Lille OSC","0-2",0,2,"1",1,2,-2,"D"
2009-10-31,2009,"RC Lens","FC Lorient","1-1",1,1,"1",1,2,0,"D"
2009-10-31,2009,"Olympique Marseille","Toulouse FC","1-1",1,1,"1",1,2,0,"D"
2009-10-31,2009,"AS Saint-Etienne","Olympique Lyon","0-1",0,1,"1",1,1,-1,"D"
2009-11-01,2009,"OGC Nice","Le Mans UC 72","1-0",1,0,"1",1,1,1,"H"
2009-11-01,2009,"Stade Rennes","Valenciennes FC","0-3",0,3,"1",1,3,-3,"D"
2009-11-01,2009,"FC Sochaux","Paris Saint-Germain","1-4",1,4,"1",1,5,-3,"D"
2009-11-07,2009,"Le Mans UC 72","AJ Auxerre","0-1",0,1,"1",1,1,-1,"D"
2009-11-07,2009,"FC Lorient","US Boulogne","5-0",5,0,"1",1,5,5,"H"
2009-11-07,2009,"AS Monaco","Grenoble Foot 38","0-0",0,0,"1",1,0,0,"D"
2009-11-07,2009,"AS Nancy","AS Saint-Etienne","0-1",0,1,"1",1,1,-1,"D"
2009-11-07,2009,"Paris Saint-Germain","OGC Nice","0-1",0,1,"1",1,1,-1,"D"
2009-11-07,2009,"Valenciennes FC","Montpellier HSC","1-1",1,1,"1",1,2,0,"D"
2009-11-07,2009,"FC Sochaux","RC Lens","1-2",1,2,"1",1,3,-1,"D"
2009-11-08,2009,"Lille OSC","Girondins Bordeaux","2-0",2,0,"1",1,2,2,"H"
2009-11-08,2009,"Toulouse FC","Stade Rennes","3-2",3,2,"1",1,5,1,"H"
2009-11-08,2009,"Olympique Lyon","Olympique Marseille","5-5",5,5,"1",1,10,0,"D"
2009-11-20,2009,"Olympique Marseille","Paris Saint-Germain","1-0",1,0,"1",1,1,1,"H"
2009-11-21,2009,"Girondins Bordeaux","Valenciennes FC","0-1",0,1,"1",1,1,-1,"D"
2009-11-21,2009,"Grenoble Foot 38","Olympique Lyon","1-1",1,1,"1",1,2,0,"D"
2009-11-21,2009,"RC Lens","AS Nancy","2-1",2,1,"1",1,3,1,"H"
2009-11-21,2009,"Stade Rennes","Le Mans UC 72","2-1",2,1,"1",1,3,1,"H"
2009-11-21,2009,"AJ Auxerre","AS Monaco","2-0",2,0,"1",1,2,2,"H"
2009-11-22,2009,"OGC Nice","Toulouse FC","1-0",1,0,"1",1,1,1,"H"
2009-11-22,2009,"AS Saint-Etienne","FC Lorient","0-2",0,2,"1",1,2,-2,"D"
2009-11-22,2009,"Montpellier HSC","Lille OSC","2-0",2,0,"1",1,2,2,"H"
2009-11-28,2009,"Lille OSC","Valenciennes FC","4-0",4,0,"1",1,4,4,"H"
2009-11-28,2009,"FC Lorient","Grenoble Foot 38","2-2",2,2,"1",1,4,0,"D"
2009-11-28,2009,"Paris Saint-Germain","AJ Auxerre","1-0",1,0,"1",1,1,1,"H"
2009-11-28,2009,"FC Sochaux","OGC Nice","1-0",1,0,"1",1,1,1,"H"
2009-11-28,2009,"Toulouse FC","US Boulogne","1-0",1,0,"1",1,1,1,"H"
2009-11-28,2009,"RC Lens","Olympique Marseille","1-0",1,0,"1",1,1,1,"H"
2009-11-29,2009,"Le Mans UC 72","AS Saint-Etienne","1-1",1,1,"1",1,2,0,"D"
2009-11-29,2009,"AS Nancy","Girondins Bordeaux","0-3",0,3,"1",1,3,-3,"D"
2009-11-29,2009,"Olympique Lyon","Stade Rennes","1-1",1,1,"1",1,2,0,"D"
2009-12-02,2009,"US Boulogne","Paris Saint-Germain","2-5",2,5,"1",1,7,-3,"D"
2009-12-05,2009,"Montpellier HSC","Le Mans UC 72","2-1",2,1,"1",1,3,1,"H"
2009-12-05,2009,"OGC Nice","Olympique Marseille","1-3",1,3,"1",1,4,-2,"D"
2009-12-05,2009,"Stade Rennes","FC Lorient","1-0",1,0,"1",1,1,1,"H"
2009-12-05,2009,"AS Saint-Etienne","FC Sochaux","0-0",0,0,"1",1,0,0,"D"
2009-12-05,2009,"Valenciennes FC","AS Monaco","3-1",3,1,"1",1,4,2,"H"
2009-12-05,2009,"Girondins Bordeaux","Paris Saint-Germain","1-0",1,0,"1",1,1,1,"H"
2009-12-06,2009,"AJ Auxerre","AS Nancy","1-3",1,3,"1",1,4,-2,"D"
2009-12-06,2009,"US Boulogne","RC Lens","2-1",2,1,"1",1,3,1,"H"
2009-12-06,2009,"Grenoble Foot 38","Toulouse FC","1-0",1,0,"1",1,1,1,"H"
2009-12-06,2009,"Lille OSC","Olympique Lyon","4-3",4,3,"1",1,7,1,"H"
2009-12-10,2009,"Lille OSC","AS Saint-Etienne","4-0",4,0,"1",1,4,4,"H"
2009-12-10,2009,"Toulouse FC","FC Sochaux","2-0",2,0,"1",1,2,2,"H"
2009-12-12,2009,"Le Mans UC 72","Valenciennes FC","2-1",2,1,"1",1,3,1,"H"
2009-12-12,2009,"RC Lens","OGC Nice","2-0",2,0,"1",1,2,2,"H"
2009-12-12,2009,"Olympique Marseille","US Boulogne","2-0",2,0,"1",1,2,2,"H"
2009-12-12,2009,"AS Nancy","Stade Rennes","1-2",1,2,"1",1,3,-1,"D"
2009-12-12,2009,"FC Lorient","AJ Auxerre","0-0",0,0,"1",1,0,0,"D"
2009-12-13,2009,"AS Monaco","Lille OSC","0-4",0,4,"1",1,4,-4,"D"
2009-12-13,2009,"Paris Saint-Germain","AS Saint-Etienne","3-0",3,0,"1",1,3,3,"H"
2009-12-13,2009,"FC Sochaux","Grenoble Foot 38","1-0",1,0,"1",1,1,1,"H"
2009-12-13,2009,"Toulouse FC","Montpellier HSC","0-1",0,1,"1",1,1,-1,"D"
2009-12-13,2009,"Olympique Lyon","Girondins Bordeaux","0-1",0,1,"1",1,1,-1,"D"
2009-12-15,2009,"Valenciennes FC","AJ Auxerre","0-0",0,0,"1",1,0,0,"D"
2009-12-16,2009,"Le Mans UC 72","Grenoble Foot 38","1-0",1,0,"1",1,1,1,"H"
2009-12-16,2009,"FC Lorient","Olympique Marseille","1-2",1,2,"1",1,3,-1,"D"
2009-12-16,2009,"Olympique Lyon","US Boulogne","2-0",2,0,"1",1,2,2,"H"
2009-12-16,2009,"AS Monaco","Stade Rennes","1-0",1,0,"1",1,1,1,"H"
2009-12-16,2009,"Montpellier HSC","Girondins Bordeaux","0-1",0,1,"1",1,1,-1,"D"
2009-12-16,2009,"AS Nancy","OGC Nice","2-0",2,0,"1",1,2,2,"H"
2009-12-16,2009,"Paris Saint-Germain","RC Lens","1-1",1,1,"1",1,2,0,"D"
2009-12-19,2009,"Girondins Bordeaux","FC Lorient","4-1",4,1,"1",1,5,3,"H"
2009-12-19,2009,"Grenoble Foot 38","OGC Nice","1-1",1,1,"1",1,2,0,"D"
2009-12-19,2009,"Montpellier HSC","AS Nancy","0-2",0,2,"1",1,2,-2,"D"
2009-12-19,2009,"Stade Rennes","Paris Saint-Germain","1-0",1,0,"1",1,1,1,"H"
2009-12-19,2009,"Valenciennes FC","RC Lens","0-0",0,0,"1",1,0,0,"D"
2009-12-19,2009,"AS Saint-Etienne","Olympique Marseille","0-0",0,0,"1",1,0,0,"D"
2009-12-20,2009,"AJ Auxerre","Toulouse FC","1-1",1,1,"1",1,2,0,"D"
2009-12-20,2009,"Lille OSC","Le Mans UC 72","3-0",3,0,"1",1,3,3,"H"
2009-12-20,2009,"AS Monaco","Olympique Lyon","1-1",1,1,"1",1,2,0,"D"
2009-12-22,2009,"RC Lens","AS Saint-Etienne","1-0",1,0,"1",1,1,1,"H"
2009-12-23,2009,"Le Mans UC 72","AS Monaco","1-1",1,1,"1",1,2,0,"D"
2009-12-23,2009,"FC Lorient","Valenciennes FC","3-2",3,2,"1",1,5,1,"H"
2009-12-23,2009,"Olympique Lyon","Montpellier HSC","1-2",1,2,"1",1,3,-1,"D"
2009-12-23,2009,"Olympique Marseille","AJ Auxerre","0-2",0,2,"1",1,2,-2,"D"
2009-12-23,2009,"AS Nancy","Lille OSC","0-4",0,4,"1",1,4,-4,"D"
2009-12-23,2009,"OGC Nice","US Boulogne","2-2",2,2,"1",1,4,0,"D"
2009-12-23,2009,"Paris Saint-Germain","Grenoble Foot 38","4-0",4,0,"1",1,4,4,"H"
2009-12-23,2009,"FC Sochaux","Stade Rennes","2-0",2,0,"1",1,2,2,"H"
2009-12-23,2009,"Toulouse FC","Girondins Bordeaux","1-2",1,2,"1",1,3,-1,"D"
2010-01-13,2009,"AS Monaco","Montpellier HSC","4-0",4,0,"1",1,4,4,"H"
2010-01-13,2009,"US Boulogne","FC Sochaux","0-0",0,0,"1",1,0,0,"D"
2010-01-16,2009,"AJ Auxerre","US Boulogne","0-0",0,0,"1",1,0,0,"D"
2010-01-16,2009,"Stade Rennes","RC Lens","1-1",1,1,"1",1,2,0,"D"
2010-01-16,2009,"Le Mans UC 72","FC Lorient","0-3",0,3,"1",1,3,-3,"D"
2010-01-16,2009,"AS Nancy","Olympique Lyon","0-2",0,2,"1",1,2,-2,"D"
2010-01-16,2009,"Montpellier HSC","OGC Nice","1-0",1,0,"1",1,1,1,"H"
2010-01-16,2009,"Lille OSC","Paris Saint-Germain","3-1",3,1,"1",1,4,2,"H"
2010-01-16,2009,"Grenoble Foot 38","AS Saint-Etienne","1-2",1,2,"1",1,3,-1,"D"
2010-01-16,2009,"AS Monaco","FC Sochaux","2-0",2,0,"1",1,2,2,"H"
2010-01-16,2009,"Valenciennes FC","Toulouse FC","1-3",1,3,"1",1,4,-2,"D"
2010-01-17,2009,"Girondins Bordeaux","Olympique Marseille","1-1",1,1,"1",1,2,0,"D"
2010-01-19,2009,"AS Saint-Etienne","Stade Rennes","0-0",0,0,"1",1,0,0,"D"
2010-01-20,2009,"OGC Nice","AJ Auxerre","0-1",0,1,"1",1,1,-1,"D"
2010-01-20,2009,"Grenoble Foot 38","Girondins Bordeaux","1-3",1,3,"1",1,4,-2,"D"
2010-01-20,2009,"Olympique Marseille","Le Mans UC 72","2-1",2,1,"1",1,3,1,"H"
2010-01-20,2009,"FC Sochaux","Lille OSC","2-1",2,1,"1",1,3,1,"H"
2010-01-20,2009,"FC Lorient","Olympique Lyon","1-3",1,3,"1",1,4,-2,"D"
2010-01-20,2009,"Paris Saint-Germain","AS Monaco","0-1",0,1,"1",1,1,-1,"D"
2010-01-20,2009,"RC Lens","Montpellier HSC","0-1",0,1,"1",1,1,-1,"D"
2010-01-20,2009,"Toulouse FC","AS Nancy","0-0",0,0,"1",1,0,0,"D"
2010-01-20,2009,"US Boulogne","Valenciennes FC","0-2",0,2,"1",1,2,-2,"D"
2010-01-30,2009,"Girondins Bordeaux","US Boulogne","0-0",0,0,"1",1,0,0,"D"
2010-01-30,2009,"Stade Rennes","Grenoble Foot 38","4-0",4,0,"1",1,4,4,"H"
2010-01-30,2009,"Lille OSC","RC Lens","1-0",1,0,"1",1,1,1,"H"
2010-01-30,2009,"AS Nancy","FC Lorient","1-0",1,0,"1",1,1,1,"H"
2010-01-30,2009,"AS Monaco","OGC Nice","3-2",3,2,"1",1,5,1,"H"
2010-01-30,2009,"Le Mans UC 72","Toulouse FC","1-3",1,3,"1",1,4,-2,"D"
2010-01-30,2009,"Montpellier HSC","Olympique Marseille","2-0",2,0,"1",1,2,2,"H"
2010-01-31,2009,"AJ Auxerre","AS Saint-Etienne","1-0",1,0,"1",1,1,1,"H"
2010-01-31,2009,"Valenciennes FC","FC Sochaux","1-1",1,1,"1",1,2,0,"D"
2010-01-31,2009,"Olympique Lyon","Paris Saint-Germain","2-1",2,1,"1",1,3,1,"H"
2010-02-06,2009,"US Boulogne","Montpellier HSC","0-2",0,2,"1",1,2,-2,"D"
2010-02-06,2009,"FC Sochaux","AS Nancy","1-1",1,1,"1",1,2,0,"D"
2010-02-06,2009,"Grenoble Foot 38","AJ Auxerre","5-0",5,0,"1",1,5,5,"H"
2010-02-06,2009,"RC Lens","Le Mans UC 72","2-1",2,1,"1",1,3,1,"H"
2010-02-06,2009,"OGC Nice","Lille OSC","1-1",1,1,"1",1,2,0,"D"
2010-02-06,2009,"Paris Saint-Germain","FC Lorient","0-3",0,3,"1",1,3,-3,"D"
2010-02-06,2009,"Stade Rennes","Girondins Bordeaux","4-2",4,2,"1",1,6,2,"H"
2010-02-07,2009,"Toulouse FC","Olympique Lyon","0-0",0,0,"1",1,0,0,"D"
2010-02-07,2009,"AS Saint-Etienne","AS Monaco","3-0",3,0,"1",1,3,3,"H"
2010-02-07,2009,"Olympique Marseille","Valenciennes FC","5-1",5,1,"1",1,6,4,"H"
2010-02-13,2009,"Lille OSC","US Boulogne","3-1",3,1,"1",1,4,2,"H"
2010-02-13,2009,"Montpellier HSC","Grenoble Foot 38","1-0",1,0,"1",1,1,1,"H"
2010-02-13,2009,"AS Monaco","Olympique Marseille","1-2",1,2,"1",1,3,-1,"D"
2010-02-13,2009,"Valenciennes FC","OGC Nice","2-1",2,1,"1",1,3,1,"H"
2010-02-13,2009,"AS Nancy","Paris Saint-Germain","0-0",0,0,"1",1,0,0,"D"
2010-02-13,2009,"Le Mans UC 72","FC Sochaux","0-0",0,0,"1",1,0,0,"D"
2010-02-13,2009,"Olympique Lyon","RC Lens","1-0",1,0,"1",1,1,1,"H"
2010-02-14,2009,"AJ Auxerre","Stade Rennes","1-0",1,0,"1",1,1,1,"H"
2010-02-14,2009,"FC Lorient","Toulouse FC","1-1",1,1,"1",1,2,0,"D"
2010-02-14,2009,"Girondins Bordeaux","AS Saint-Etienne","3-1",3,1,"1",1,4,2,"H"
2010-02-20,2009,"US Boulogne","Le Mans UC 72","1-3",1,3,"1",1,4,-2,"D"
2010-02-20,2009,"OGC Nice","FC Lorient","1-0",1,0,"1",1,1,1,"H"
2010-02-20,2009,"RC Lens","AS Monaco","3-0",3,0,"1",1,3,3,"H"
2010-02-20,2009,"AS Saint-Etienne","Montpellier HSC","1-0",1,0,"1",1,1,1,"H"
2010-02-20,2009,"Grenoble Foot 38","Valenciennes FC","0-1",0,1,"1",1,1,-1,"D"
2010-02-20,2009,"Paris Saint-Germain","Toulouse FC","1-0",1,0,"1",1,1,1,"H"
2010-02-21,2009,"FC Sochaux","Olympique Lyon","0-4",0,4,"1",1,4,-4,"D"
2010-02-21,2009,"Olympique Marseille","AS Nancy","3-1",3,1,"1",1,4,2,"H"
2010-02-21,2009,"Stade Rennes","Lille OSC","1-2",1,2,"1",1,3,-1,"D"
2010-02-27,2009,"AS Monaco","US Boulogne","1-0",1,0,"1",1,1,1,"H"
2010-02-27,2009,"AS Nancy","Grenoble Foot 38","0-2",0,2,"1",1,2,-2,"D"
2010-02-27,2009,"Toulouse FC","RC Lens","1-0",1,0,"1",1,1,1,"H"
2010-02-27,2009,"Olympique Lyon","OGC Nice","2-0",2,0,"1",1,2,2,"H"
2010-02-27,2009,"Valenciennes FC","AS Saint-Etienne","1-0",1,0,"1",1,1,1,"H"
2010-02-27,2009,"FC Lorient","FC Sochaux","1-0",1,0,"1",1,1,1,"H"
2010-02-27,2009,"Montpellier HSC","Stade Rennes","3-1",3,1,"1",1,4,2,"H"
2010-02-28,2009,"Lille OSC","AJ Auxerre","1-2",1,2,"1",1,3,-1,"D"
2010-02-28,2009,"Paris Saint-Germain","Olympique Marseille","0-3",0,3,"1",1,3,-3,"D"
2010-03-06,2009,"US Boulogne","Olympique Lyon","0-0",0,0,"1",1,0,0,"D"
2010-03-06,2009,"Stade Rennes","AS Monaco","1-0",1,0,"1",1,1,1,"H"
2010-03-06,2009,"OGC Nice","AS Nancy","2-3",2,3,"1",1,5,-1,"D"
2010-03-06,2009,"RC Lens","Paris Saint-Germain","1-1",1,1,"1",1,2,0,"D"
2010-03-06,2009,"FC Sochaux","Toulouse FC","1-0",1,0,"1",1,1,1,"H"
2010-03-06,2009,"AJ Auxerre","Valenciennes FC","1-0",1,0,"1",1,1,1,"H"
2010-03-06,2009,"AS Saint-Etienne","Lille OSC","1-1",1,1,"1",1,2,0,"D"
2010-03-07,2009,"Grenoble Foot 38","Le Mans UC 72","1-1",1,1,"1",1,2,0,"D"
2010-03-07,2009,"Olympique Marseille","FC Lorient","1-1",1,1,"1",1,2,0,"D"
2010-03-07,2009,"Girondins Bordeaux","Montpellier HSC","1-1",1,1,"1",1,2,0,"D"
2010-03-10,2009,"Girondins Bordeaux","AJ Auxerre","1-2",1,2,"1",1,3,-1,"D"
2010-03-13,2009,"Montpellier HSC","AJ Auxerre","1-1",1,1,"1",1,2,0,"D"
2010-03-13,2009,"AS Monaco","Girondins Bordeaux","0-0",0,0,"1",1,0,0,"D"
2010-03-13,2009,"AS Nancy","US Boulogne","1-3",1,3,"1",1,4,-2,"D"
2010-03-13,2009,"FC Lorient","RC Lens","1-0",1,0,"1",1,1,1,"H"
2010-03-13,2009,"Le Mans UC 72","OGC Nice","0-1",0,1,"1",1,1,-1,"D"
2010-03-13,2009,"Paris Saint-Germain","FC Sochaux","4-1",4,1,"1",1,5,3,"H"
2010-03-13,2009,"Olympique Lyon","AS Saint-Etienne","1-1",1,1,"1",1,2,0,"D"
2010-03-14,2009,"Lille OSC","Grenoble Foot 38","1-0",1,0,"1",1,1,1,"H"
2010-03-14,2009,"Valenciennes FC","Stade Rennes","0-2",0,2,"1",1,2,-2,"D"
2010-03-14,2009,"Toulouse FC","Olympique Marseille","1-1",1,1,"1",1,2,0,"D"
2010-03-20,2009,"AJ Auxerre","Le Mans UC 72","2-1",2,1,"1",1,3,1,"H"
2010-03-20,2009,"US Boulogne","FC Lorient","2-0",2,0,"1",1,2,2,"H"
2010-03-20,2009,"Grenoble Foot 38","AS Monaco","0-0",0,0,"1",1,0,0,"D"
2010-03-20,2009,"AS Saint-Etienne","AS Nancy","0-0",0,0,"1",1,0,0,"D"
2010-03-20,2009,"OGC Nice","Paris Saint-Germain","1-0",1,0,"1",1,1,1,"H"
2010-03-20,2009,"Stade Rennes","Toulouse FC","4-1",4,1,"1",1,5,3,"H"
2010-03-20,2009,"RC Lens","FC Sochaux","0-0",0,0,"1",1,0,0,"D"
2010-03-21,2009,"Girondins Bordeaux","Lille OSC","3-1",3,1,"1",1,4,2,"H"
2010-03-21,2009,"Montpellier HSC","Valenciennes FC","2-1",2,1,"1",1,3,1,"H"
2010-03-21,2009,"Olympique Marseille","Olympique Lyon","2-1",2,1,"1",1,3,1,"H"
2010-03-27,2009,"Olympique Lyon","Grenoble Foot 38","2-0",2,0,"1",1,2,2,"H"
2010-03-28,2009,"Paris Saint-Germain","US Boulogne","3-0",3,0,"1",1,3,3,"H"
2010-03-28,2009,"AS Nancy","RC Lens","5-1",5,1,"1",1,6,4,"H"
2010-03-28,2009,"Toulouse FC","OGC Nice","0-2",0,2,"1",1,2,-2,"D"
2010-03-28,2009,"Le Mans UC 72","Stade Rennes","1-3",1,3,"1",1,4,-2,"D"
2010-03-28,2009,"FC Lorient","AS Saint-Etienne","4-0",4,0,"1",1,4,4,"H"
2010-03-28,2009,"Lille OSC","Montpellier HSC","4-1",4,1,"1",1,5,3,"H"
2010-03-29,2009,"AS Monaco","AJ Auxerre","0-0",0,0,"1",1,0,0,"D"
2010-04-03,2009,"AS Saint-Etienne","Le Mans UC 72","2-0",2,0,"1",1,2,2,"H"
2010-04-03,2009,"Valenciennes FC","Lille OSC","1-0",1,0,"1",1,1,1,"H"
2010-04-03,2009,"Grenoble Foot 38","FC Lorient","1-2",1,2,"1",1,3,-1,"D"
2010-04-03,2009,"Stade Rennes","Olympique Lyon","1-2",1,2,"1",1,3,-1,"D"
2010-04-03,2009,"Girondins Bordeaux","AS Nancy","1-2",1,2,"1",1,3,-1,"D"
2010-04-03,2009,"OGC Nice","FC Sochaux","0-0",0,0,"1",1,0,0,"D"
2010-04-03,2009,"Montpellier HSC","AS Monaco","0-0",0,0,"1",1,0,0,"D"
2010-04-04,2009,"Olympique Marseille","RC Lens","1-0",1,0,"1",1,1,1,"H"
2010-04-04,2009,"US Boulogne","Toulouse FC","1-1",1,1,"1",1,2,0,"D"
2010-04-04,2009,"AJ Auxerre","Paris Saint-Germain","1-1",1,1,"1",1,2,0,"D"
2010-04-07,2009,"Olympique Marseille","FC Sochaux","3-0",3,0,"1",1,3,3,"H"
2010-04-10,2009,"RC Lens","US Boulogne","3-0",3,0,"1",1,3,3,"H"
2010-04-10,2009,"Toulouse FC","Grenoble Foot 38","4-0",4,0,"1",1,4,4,"H"
2010-04-10,2009,"Le Mans UC 72","Montpellier HSC","2-2",2,2,"1",1,4,0,"D"
2010-04-10,2009,"FC Lorient","Stade Rennes","1-1",1,1,"1",1,2,0,"D"
2010-04-10,2009,"FC Sochaux","AS Saint-Etienne","0-2",0,2,"1",1,2,-2,"D"
2010-04-10,2009,"AS Monaco","Valenciennes FC","2-1",2,1,"1",1,3,1,"H"
2010-04-10,2009,"Paris Saint-Germain","Girondins Bordeaux","3-1",3,1,"1",1,4,2,"H"
2010-04-11,2009,"AS Nancy","AJ Auxerre","0-1",0,1,"1",1,1,-1,"D"
2010-04-11,2009,"Olympique Lyon","Lille OSC","1-1",1,1,"1",1,2,0,"D"
2010-04-11,2009,"Olympique Marseille","OGC Nice","4-1",4,1,"1",1,5,3,"H"
2010-04-14,2009,"Le Mans UC 72","Girondins Bordeaux","2-1",2,1,"1",1,3,1,"H"
2010-04-14,2009,"FC Sochaux","Olympique Marseille","0-1",0,1,"1",1,1,-1,"D"
2010-04-17,2009,"Valenciennes FC","Le Mans UC 72","0-1",0,1,"1",1,1,-1,"D"
2010-04-17,2009,"OGC Nice","RC Lens","0-0",0,0,"1",1,0,0,"D"
2010-04-17,2009,"AJ Auxerre","FC Lorient","4-1",4,1,"1",1,5,3,"H"
2010-04-17,2009,"US Boulogne","Olympique Marseille","1-2",1,2,"1",1,3,-1,"D"
2010-04-17,2009,"Stade Rennes","AS Nancy","0-0",0,0,"1",1,0,0,"D"
2010-04-17,2009,"Grenoble Foot 38","FC Sochaux","2-2",2,2,"1",1,4,0,"D"
2010-04-17,2009,"Girondins Bordeaux","Olympique Lyon","2-2",2,2,"1",1,4,0,"D"
2010-04-18,2009,"Lille OSC","AS Monaco","4-0",4,0,"1",1,4,4,"H"
2010-04-18,2009,"Montpellier HSC","Toulouse FC","1-1",1,1,"1",1,2,0,"D"
2010-04-18,2009,"AS Saint-Etienne","Paris Saint-Germain","0-0",0,0,"1",1,0,0,"D"
2010-04-24,2009,"FC Lorient","Girondins Bordeaux","1-0",1,0,"1",1,1,1,"H"
2010-04-24,2009,"FC Sochaux","US Boulogne","0-3",0,3,"1",1,3,-3,"D"
2010-04-24,2009,"OGC Nice","Grenoble Foot 38","2-1",2,1,"1",1,3,1,"H"
2010-04-24,2009,"Le Mans UC 72","Lille OSC","1-2",1,2,"1",1,3,-1,"D"
2010-04-24,2009,"AS Nancy","Montpellier HSC","0-0",0,0,"1",1,0,0,"D"
2010-04-24,2009,"Paris Saint-Germain","Stade Rennes","1-1",1,1,"1",1,2,0,"D"
2010-04-25,2009,"Toulouse FC","AJ Auxerre","0-3",0,3,"1",1,3,-3,"D"
2010-04-25,2009,"RC Lens","Valenciennes FC","1-1",1,1,"1",1,2,0,"D"
2010-04-25,2009,"Olympique Marseille","AS Saint-Etienne","1-0",1,0,"1",1,1,1,"H"
2010-04-27,2009,"AS Monaco","Le Mans UC 72","1-1",1,1,"1",1,2,0,"D"
2010-04-27,2009,"Grenoble Foot 38","Paris Saint-Germain","4-0",4,0,"1",1,4,4,"H"
2010-04-28,2009,"Valenciennes FC","Girondins Bordeaux","2-0",2,0,"1",1,2,2,"H"
2010-04-30,2009,"AJ Auxerre","Olympique Marseille","0-0",0,0,"1",1,0,0,"D"
2010-05-02,2009,"AS Saint-Etienne","RC Lens","1-4",1,4,"1",1,5,-3,"D"
2010-05-02,2009,"Valenciennes FC","FC Lorient","0-0",0,0,"1",1,0,0,"D"
2010-05-02,2009,"Lille OSC","AS Nancy","3-1",3,1,"1",1,4,2,"H"
2010-05-02,2009,"US Boulogne","OGC Nice","3-3",3,3,"1",1,6,0,"D"
2010-05-02,2009,"Stade Rennes","FC Sochaux","1-2",1,2,"1",1,3,-1,"D"
2010-05-02,2009,"Girondins Bordeaux","Toulouse FC","1-0",1,0,"1",1,1,1,"H"
2010-05-02,2009,"Montpellier HSC","Olympique Lyon","0-1",0,1,"1",1,1,-1,"D"
2010-05-05,2009,"Olympique Lyon","AJ Auxerre","2-1",2,1,"1",1,3,1,"H"
2010-05-05,2009,"OGC Nice","Girondins Bordeaux","1-1",1,1,"1",1,2,0,"D"
2010-05-05,2009,"RC Lens","Grenoble Foot 38","1-1",1,1,"1",1,2,0,"D"
2010-05-05,2009,"AS Nancy","Le Mans UC 72","3-2",3,2,"1",1,5,1,"H"
2010-05-05,2009,"Toulouse FC","Lille OSC","0-2",0,2,"1",1,2,-2,"D"
2010-05-05,2009,"FC Lorient","AS Monaco","2-2",2,2,"1",1,4,0,"D"
2010-05-05,2009,"FC Sochaux","Montpellier HSC","0-1",0,1,"1",1,1,-1,"D"
2010-05-05,2009,"US Boulogne","AS Saint-Etienne","0-1",0,1,"1",1,1,-1,"D"
2010-05-05,2009,"Paris Saint-Germain","Valenciennes FC","2-2",2,2,"1",1,4,0,"D"
2010-05-05,2009,"Olympique Marseille","Stade Rennes","3-1",3,1,"1",1,4,2,"H"
2010-05-08,2009,"Grenoble Foot 38","US Boulogne","2-0",2,0,"1",1,2,2,"H"
2010-05-08,2009,"AJ Auxerre","RC Lens","0-0",0,0,"1",1,0,0,"D"
2010-05-08,2009,"Montpellier HSC","FC Lorient","2-1",2,1,"1",1,3,1,"H"
2010-05-08,2009,"Valenciennes FC","Olympique Lyon","2-2",2,2,"1",1,4,0,"D"
2010-05-08,2009,"Lille OSC","Olympique Marseille","3-2",3,2,"1",1,5,1,"H"
2010-05-08,2009,"AS Monaco","AS Nancy","2-1",2,1,"1",1,3,1,"H"
2010-05-08,2009,"Stade Rennes","OGC Nice","2-2",2,2,"1",1,4,0,"D"
2010-05-08,2009,"Le Mans UC 72","Paris Saint-Germain","1-0",1,0,"1",1,1,1,"H"
2010-05-08,2009,"Girondins Bordeaux","FC Sochaux","2-0",2,0,"1",1,2,2,"H"
2010-05-08,2009,"AS Saint-Etienne","Toulouse FC","0-1",0,1,"1",1,1,-1,"D"
2010-05-12,2009,"Olympique Lyon","AS Monaco","3-0",3,0,"1",1,3,3,"H"
2010-05-15,2009,"FC Sochaux","AJ Auxerre","1-2",1,2,"1",1,3,-1,"D"
2010-05-15,2009,"RC Lens","Girondins Bordeaux","4-3",4,3,"1",1,7,1,"H"
2010-05-15,2009,"Olympique Marseille","Grenoble Foot 38","2-0",2,0,"1",1,2,2,"H"
2010-05-15,2009,"Olympique Lyon","Le Mans UC 72","2-0",2,0,"1",1,2,2,"H"
2010-05-15,2009,"Toulouse FC","AS Monaco","0-0",0,0,"1",1,0,0,"D"
2010-05-15,2009,"Paris Saint-Germain","Montpellier HSC","1-3",1,3,"1",1,4,-2,"D"
2010-05-15,2009,"US Boulogne","Stade Rennes","1-0",1,0,"1",1,1,1,"H"
2010-05-15,2009,"OGC Nice","AS Saint-Etienne","1-1",1,1,"1",1,2,0,"D"
2010-05-15,2009,"AS Nancy","Valenciennes FC","1-1",1,1,"1",1,2,0,"D"
2010-05-15,2009,"FC Lorient","Lille OSC","2-1",2,1,"1",1,3,1,"H"
2010-08-07,2010,"AJ Auxerre","FC Lorient","2-2",2,2,"1",1,4,0,"D"
2010-08-07,2010,"RC Lens","AS Nancy","1-2",1,2,"1",1,3,-1,"D"
2010-08-07,2010,"Olympique Lyon","AS Monaco","0-0",0,0,"1",1,0,0,"D"
2010-08-07,2010,"Olympique Marseille","SM Caen","1-2",1,2,"1",1,3,-1,"D"
2010-08-07,2010,"OGC Nice","Valenciennes FC","0-0",0,0,"1",1,0,0,"D"
2010-08-07,2010,"Paris Saint-Germain","AS Saint-Etienne","3-1",3,1,"1",1,4,2,"H"
2010-08-07,2010,"Stade Rennes","Lille OSC","1-1",1,1,"1",1,2,0,"D"
2010-08-07,2010,"FC Sochaux","AC Arles-Avignon","2-1",2,1,"1",1,3,1,"H"
2010-08-07,2010,"Toulouse FC","Stade Brest","2-0",2,0,"1",1,2,2,"H"
2010-08-08,2010,"Montpellier HSC","Girondins Bordeaux","1-0",1,0,"1",1,1,1,"H"
2010-08-14,2010,"Stade Brest","AJ Auxerre","1-1",1,1,"1",1,2,0,"D"
2010-08-14,2010,"FC Lorient","OGC Nice","1-2",1,2,"1",1,3,-1,"D"
2010-08-14,2010,"AS Nancy","Stade Rennes","0-3",0,3,"1",1,3,-3,"D"
2010-08-14,2010,"AS Saint-Etienne","FC Sochaux","3-2",3,2,"1",1,5,1,"H"
2010-08-14,2010,"Valenciennes FC","Olympique Marseille","3-2",3,2,"1",1,5,1,"H"
2010-08-14,2010,"AC Arles-Avignon","RC Lens","0-1",0,1,"1",1,1,-1,"D"
2010-08-15,2010,"Girondins Bordeaux","Toulouse FC","1-2",1,2,"1",1,3,-1,"D"
2010-08-15,2010,"SM Caen","Olympique Lyon","3-2",3,2,"1",1,5,1,"H"
2010-08-15,2010,"Lille OSC","Paris Saint-Germain","0-0",0,0,"1",1,0,0,"D"
2010-08-17,2010,"AS Monaco","Montpellier HSC","0-0",0,0,"1",1,0,0,"D"
2010-08-21,2010,"RC Lens","AS Monaco","2-2",2,2,"1",1,4,0,"D"
2010-08-21,2010,"Olympique Lyon","Stade Brest","1-0",1,0,"1",1,1,1,"H"
2010-08-21,2010,"Olympique Marseille","FC Lorient","2-0",2,0,"1",1,2,2,"H"
2010-08-21,2010,"OGC Nice","AS Nancy","1-1",1,1,"1",1,2,0,"D"
2010-08-21,2010,"Stade Rennes","AS Saint-Etienne","0-0",0,0,"1",1,0,0,"D"
2010-08-21,2010,"Toulouse FC","AC Arles-Avignon","2-1",2,1,"1",1,3,1,"H"
2010-08-21,2010,"AJ Auxerre","Valenciennes FC","1-1",1,1,"1",1,2,0,"D"
2010-08-22,2010,"Montpellier HSC","SM Caen","0-0",0,0,"1",1,0,0,"D"
2010-08-22,2010,"FC Sochaux","Lille OSC","0-0",0,0,"1",1,0,0,"D"
2010-08-22,2010,"Paris Saint-Germain","Girondins Bordeaux","1-2",1,2,"1",1,3,-1,"D"
2010-08-28,2010,"AC Arles-Avignon","Stade Rennes","0-1",0,1,"1",1,1,-1,"D"
2010-08-28,2010,"FC Lorient","Olympique Lyon","2-0",2,0,"1",1,2,2,"H"
2010-08-28,2010,"AS Nancy","Toulouse FC","0-2",0,2,"1",1,2,-2,"D"
2010-08-28,2010,"AS Saint-Etienne","RC Lens","3-1",3,1,"1",1,4,2,"H"
2010-08-28,2010,"Valenciennes FC","Montpellier HSC","0-1",0,1,"1",1,1,-1,"D"
2010-08-28,2010,"SM Caen","Stade Brest","0-2",0,2,"1",1,2,-2,"D"
2010-08-29,2010,"Lille OSC","OGC Nice","1-1",1,1,"1",1,2,0,"D"
2010-08-29,2010,"AS Monaco","AJ Auxerre","2-0",2,0,"1",1,2,2,"H"
2010-08-29,2010,"FC Sochaux","Paris Saint-Germain","3-1",3,1,"1",1,4,2,"H"
2010-08-29,2010,"Girondins Bordeaux","Olympique Marseille","1-1",1,1,"1",1,2,0,"D"
2010-09-11,2010,"AJ Auxerre","SM Caen","1-1",1,1,"1",1,2,0,"D"
2010-09-11,2010,"Olympique Lyon","Valenciennes FC","1-1",1,1,"1",1,2,0,"D"
2010-09-11,2010,"Montpellier HSC","AS Nancy","1-2",1,2,"1",1,3,-1,"D"
2010-09-11,2010,"Paris Saint-Germain","AC Arles-Avignon","4-0",4,0,"1",1,4,4,"H"
2010-09-11,2010,"Stade Rennes","FC Sochaux","2-1",2,1,"1",1,3,1,"H"
2010-09-11,2010,"Toulouse FC","AS Saint-Etienne","0-1",0,1,"1",1,1,-1,"D"
2010-09-11,2010,"RC Lens","Lille OSC","1-4",1,4,"1",1,5,-3,"D"
2010-09-12,2010,"Stade Brest","FC Lorient","0-0",0,0,"1",1,0,0,"D"
2010-09-12,2010,"OGC Nice","Girondins Bordeaux","2-1",2,1,"1",1,3,1,"H"
2010-09-12,2010,"Olympique Marseille","AS Monaco","2-2",2,2,"1",1,4,0,"D"
2010-09-18,2010,"FC Lorient","SM Caen","0-1",0,1,"1",1,1,-1,"D"
2010-09-18,2010,"AS Monaco","Toulouse FC","0-0",0,0,"1",1,0,0,"D"
2010-09-18,2010,"AS Nancy","Stade Brest","0-2",0,2,"1",1,2,-2,"D"
2010-09-18,2010,"AS Saint-Etienne","Montpellier HSC","3-0",3,0,"1",1,3,3,"H"
2010-09-18,2010,"FC Sochaux","OGC Nice","4-0",4,0,"1",1,4,4,"H"
2010-09-18,2010,"Valenciennes FC","RC Lens","1-1",1,1,"1",1,2,0,"D"
2010-09-18,2010,"AC Arles-Avignon","Olympique Marseille","0-3",0,3,"1",1,3,-3,"D"
2010-09-19,2010,"Lille OSC","AJ Auxerre","1-0",1,0,"1",1,1,1,"H"
2010-09-19,2010,"Paris Saint-Germain","Stade Rennes","0-0",0,0,"1",1,0,0,"D"
2010-09-19,2010,"Girondins Bordeaux","Olympique Lyon","2-0",2,0,"1",1,2,2,"H"
2010-09-25,2010,"AJ Auxerre","AS Nancy","2-2",2,2,"1",1,4,0,"D"
2010-09-25,2010,"SM Caen","Girondins Bordeaux","0-0",0,0,"1",1,0,0,"D"
2010-09-25,2010,"FC Lorient","AS Monaco","2-1",2,1,"1",1,3,1,"H"
2010-09-25,2010,"Olympique Marseille","FC Sochaux","2-1",2,1,"1",1,3,1,"H"
2010-09-25,2010,"Montpellier HSC","AC Arles-Avignon","3-1",3,1,"1",1,4,2,"H"
2010-09-25,2010,"OGC Nice","Stade Rennes","1-2",1,2,"1",1,3,-1,"D"
2010-09-25,2010,"Olympique Lyon","AS Saint-Etienne","0-1",0,1,"1",1,1,-1,"D"
2010-09-26,2010,"Stade Brest","Valenciennes FC","1-0",1,0,"1",1,1,1,"H"
2010-09-26,2010,"Toulouse FC","Lille OSC","1-1",1,1,"1",1,2,0,"D"
2010-09-26,2010,"RC Lens","Paris Saint-Germain","0-2",0,2,"1",1,2,-2,"D"
2010-10-02,2010,"AC Arles-Avignon","AJ Auxerre","0-4",0,4,"1",1,4,-4,"D"
2010-10-02,2010,"Girondins Bordeaux","FC Lorient","1-0",1,0,"1",1,1,1,"H"
2010-10-02,2010,"AS Monaco","Stade Brest","0-1",0,1,"1",1,1,-1,"D"
2010-10-02,2010,"AS Nancy","Olympique Lyon","2-3",2,3,"1",1,5,-1,"D"
2010-10-02,2010,"FC Sochaux","RC Lens","3-0",3,0,"1",1,3,3,"H"
2010-10-02,2010,"Valenciennes FC","SM Caen","2-1",2,1,"1",1,3,1,"H"
2010-10-02,2010,"AS Saint-Etienne","Olympique Marseille","1-1",1,1,"1",1,2,0,"D"
2010-10-03,2010,"Lille OSC","Montpellier HSC","3-1",3,1,"1",1,4,2,"H"
2010-10-03,2010,"Paris Saint-Germain","OGC Nice","0-0",0,0,"1",1,0,0,"D"
2010-10-03,2010,"Stade Rennes","Toulouse FC","3-1",3,1,"1",1,4,2,"H"
2010-10-16,2010,"AJ Auxerre","Girondins Bordeaux","0-1",0,1,"1",1,1,-1,"D"
2010-10-16,2010,"Stade Brest","AC Arles-Avignon","0-0",0,0,"1",1,0,0,"D"
2010-10-16,2010,"SM Caen","AS Monaco","0-0",0,0,"1",1,0,0,"D"
2010-10-16,2010,"Olympique Marseille","AS Nancy","1-0",1,0,"1",1,1,1,"H"
2010-10-16,2010,"Montpellier HSC","FC Sochaux","2-0",2,0,"1",1,2,2,"H"
2010-10-16,2010,"Toulouse FC","Paris Saint-Germain","0-2",0,2,"1",1,2,-2,"D"
2010-10-17,2010,"RC Lens","Stade Rennes","0-0",0,0,"1",1,0,0,"D"
2010-10-17,2010,"FC Lorient","Valenciennes FC","2-1",2,1,"1",1,3,1,"H"
2010-10-17,2010,"OGC Nice","AS Saint-Etienne","2-1",2,1,"1",1,3,1,"H"
2010-10-17,2010,"Olympique Lyon","Lille OSC","3-1",3,1,"1",1,4,2,"H"
2010-10-23,2010,"Girondins Bordeaux","Stade Brest","0-2",0,2,"1",1,2,-2,"D"
2010-10-23,2010,"RC Lens","OGC Nice","1-0",1,0,"1",1,1,1,"H"
2010-10-23,2010,"AS Monaco","Valenciennes FC","0-2",0,2,"1",1,2,-2,"D"
2010-10-23,2010,"AS Nancy","FC Lorient","1-0",1,0,"1",1,1,1,"H"
2010-10-23,2010,"Stade Rennes","Montpellier HSC","0-1",0,1,"1",1,1,-1,"D"
2010-10-23,2010,"AS Saint-Etienne","SM Caen","1-1",1,1,"1",1,2,0,"D"
2010-10-23,2010,"FC Sochaux","Toulouse FC","1-3",1,3,"1",1,4,-2,"D"
2010-10-24,2010,"AC Arles-Avignon","Olympique Lyon","1-1",1,1,"1",1,2,0,"D"
2010-10-24,2010,"Paris Saint-Germain","AJ Auxerre","2-3",2,3,"1",1,5,-1,"D"
2010-10-24,2010,"Lille OSC","Olympique Marseille","1-3",1,3,"1",1,4,-2,"D"
2010-10-30,2010,"AJ Auxerre","OGC Nice","2-0",2,0,"1",1,2,2,"H"
2010-10-30,2010,"Stade Brest","AS Saint-Etienne","2-0",2,0,"1",1,2,2,"H"
2010-10-30,2010,"SM Caen","AS Nancy","2-3",2,3,"1",1,5,-1,"D"
2010-10-30,2010,"FC Lorient","AC Arles-Avignon","2-0",2,0,"1",1,2,2,"H"
2010-10-30,2010,"Olympique Lyon","FC Sochaux","2-1",2,1,"1",1,3,1,"H"
2010-10-30,2010,"Toulouse FC","RC Lens","1-1",1,1,"1",1,2,0,"D"
2010-10-31,2010,"Valenciennes FC","Lille OSC","1-1",1,1,"1",1,2,0,"D"
2010-10-31,2010,"Montpellier HSC","Paris Saint-Germain","1-1",1,1,"1",1,2,0,"D"
2010-11-02,2010,"AS Monaco","Girondins Bordeaux","2-2",2,2,"1",1,4,0,"D"
2010-11-06,2010,"AC Arles-Avignon","SM Caen","3-2",3,2,"1",1,5,1,"H"
2010-11-06,2010,"Girondins Bordeaux","Valenciennes FC","1-1",1,1,"1",1,2,0,"D"
2010-11-06,2010,"AS Saint-Etienne","FC Lorient","1-2",1,2,"1",1,3,-1,"D"
2010-11-06,2010,"FC Sochaux","AJ Auxerre","1-1",1,1,"1",1,2,0,"D"
2010-11-06,2010,"Stade Rennes","Olympique Lyon","1-1",1,1,"1",1,2,0,"D"
2010-11-07,2010,"RC Lens","Montpellier HSC","2-0",2,0,"1",1,2,2,"H"
2010-11-07,2010,"Lille OSC","Stade Brest","3-1",3,1,"1",1,4,2,"H"
2010-11-07,2010,"AS Nancy","AS Monaco","0-4",0,4,"1",1,4,-4,"D"
2010-11-07,2010,"OGC Nice","Toulouse FC","2-0",2,0,"1",1,2,2,"H"
2010-11-07,2010,"Paris Saint-Germain","Olympique Marseille","2-1",2,1,"1",1,3,1,"H"
2010-11-13,2010,"Girondins Bordeaux","AS Nancy","2-1",2,1,"1",1,3,1,"H"
2010-11-13,2010,"Stade Brest","FC Sochaux","1-1",1,1,"1",1,2,0,"D"
2010-11-13,2010,"Olympique Marseille","RC Lens","1-1",1,1,"1",1,2,0,"D"
2010-11-13,2010,"AS Monaco","AC Arles-Avignon","0-0",0,0,"1",1,0,0,"D"
2010-11-13,2010,"Montpellier HSC","Toulouse FC","1-0",1,0,"1",1,1,1,"H"
2010-11-13,2010,"SM Caen","Lille OSC","2-5",2,5,"1",1,7,-3,"D"
2010-11-14,2010,"AJ Auxerre","Stade Rennes","2-1",2,1,"1",1,3,1,"H"
2010-11-14,2010,"FC Lorient","Paris Saint-Germain","1-1",1,1,"1",1,2,0,"D"
2010-11-14,2010,"Olympique Lyon","OGC Nice","1-0",1,0,"1",1,1,1,"H"
2010-11-20,2010,"AS Nancy","Valenciennes FC","2-0",2,0,"1",1,2,2,"H"
2010-11-20,2010,"Paris Saint-Germain","SM Caen","2-1",2,1,"1",1,3,1,"H"
2010-11-20,2010,"Stade Rennes","Stade Brest","2-1",2,1,"1",1,3,1,"H"
2010-11-20,2010,"AS Saint-Etienne","AJ Auxerre","1-1",1,1,"1",1,2,0,"D"
2010-11-20,2010,"FC Sochaux","FC Lorient","2-0",2,0,"1",1,2,2,"H"
2010-11-20,2010,"Toulouse FC","Olympique Marseille","0-1",0,1,"1",1,1,-1,"D"
2010-11-20,2010,"OGC Nice","Montpellier HSC","0-1",0,1,"1",1,1,-1,"D"
2010-11-21,2010,"AC Arles-Avignon","Girondins Bordeaux","2-4",2,4,"1",1,6,-2,"D"
2010-11-21,2010,"Lille OSC","AS Monaco","2-1",2,1,"1",1,3,1,"H"
2010-11-21,2010,"RC Lens","Olympique Lyon","1-3",1,3,"1",1,4,-2,"D"
2010-11-27,2010,"FC Lorient","Stade Rennes","2-0",2,0,"1",1,2,2,"H"
2010-11-27,2010,"Olympique Marseille","Montpellier HSC","4-0",4,0,"1",1,4,4,"H"
2010-11-27,2010,"AS Monaco","OGC Nice","1-1",1,1,"1",1,2,0,"D"
2010-11-27,2010,"AS Nancy","AS Saint-Etienne","1-1",1,1,"1",1,2,0,"D"
2010-11-27,2010,"Valenciennes FC","AC Arles-Avignon","3-0",3,0,"1",1,3,3,"H"
2010-11-27,2010,"Girondins Bordeaux","Lille OSC","1-1",1,1,"1",1,2,0,"D"
2010-11-28,2010,"AJ Auxerre","Toulouse FC","1-2",1,2,"1",1,3,-1,"D"
2010-11-28,2010,"SM Caen","FC Sochaux","0-3",0,3,"1",1,3,-3,"D"
2010-11-28,2010,"Olympique Lyon","Paris Saint-Germain","2-2",2,2,"1",1,4,0,"D"
2010-11-30,2010,"Stade Brest","RC Lens","4-1",4,1,"1",1,5,3,"H"
2010-12-01,2010,"Olympique Marseille","Stade Rennes","0-0",0,0,"1",1,0,0,"D"
2010-12-01,2010,"Valenciennes FC","AS Saint-Etienne","1-1",1,1,"1",1,2,0,"D"
2010-12-04,2010,"AC Arles-Avignon","AS Nancy","1-1",1,1,"1",1,2,0,"D"
2010-12-04,2010,"RC Lens","AJ Auxerre","1-1",1,1,"1",1,2,0,"D"
2010-12-04,2010,"Stade Rennes","AS Monaco","1-0",1,0,"1",1,1,1,"H"
2010-12-04,2010,"FC Sochaux","Valenciennes FC","2-1",2,1,"1",1,3,1,"H"
2010-12-04,2010,"Toulouse FC","SM Caen","1-0",1,0,"1",1,1,1,"H"
2010-12-04,2010,"Montpellier HSC","Olympique Lyon","1-2",1,2,"1",1,3,-1,"D"
2010-12-05,2010,"Lille OSC","FC Lorient","6-3",6,3,"1",1,9,3,"H"
2010-12-05,2010,"OGC Nice","Olympique Marseille","1-0",1,0,"1",1,1,1,"H"
2010-12-05,2010,"Paris Saint-Germain","Stade Brest","3-1",3,1,"1",1,4,2,"H"
2010-12-05,2010,"AS Saint-Etienne","Girondins Bordeaux","2-2",2,2,"1",1,4,0,"D"
2010-12-11,2010,"AC Arles-Avignon","Lille OSC","0-1",0,1,"1",1,1,-1,"D"
2010-12-11,2010,"Stade Brest","Montpellier HSC","0-0",0,0,"1",1,0,0,"D"
2010-12-11,2010,"SM Caen","OGC Nice","0-0",0,0,"1",1,0,0,"D"
2010-12-11,2010,"FC Lorient","RC Lens","3-0",3,0,"1",1,3,3,"H"
2010-12-11,2010,"AS Nancy","FC Sochaux","1-0",1,0,"1",1,1,1,"H"
2010-12-11,2010,"Valenciennes FC","Paris Saint-Germain","1-2",1,2,"1",1,3,-1,"D"
2010-12-11,2010,"AJ Auxerre","Olympique Marseille","1-1",1,1,"1",1,2,0,"D"
2010-12-12,2010,"Olympique Lyon","Toulouse FC","2-0",2,0,"1",1,2,2,"H"
2010-12-12,2010,"AS Monaco","AS Saint-Etienne","0-2",0,2,"1",1,2,-2,"D"
2010-12-12,2010,"Girondins Bordeaux","Stade Rennes","0-0",0,0,"1",1,0,0,"D"
2010-12-18,2010,"Montpellier HSC","AJ Auxerre","1-1",1,1,"1",1,2,0,"D"
2010-12-18,2010,"OGC Nice","Stade Brest","1-1",1,1,"1",1,2,0,"D"
2010-12-18,2010,"Stade Rennes","Valenciennes FC","1-0",1,0,"1",1,1,1,"H"
2010-12-18,2010,"AS Saint-Etienne","AC Arles-Avignon","2-0",2,0,"1",1,2,2,"H"
2010-12-18,2010,"Toulouse FC","FC Lorient","3-0",3,0,"1",1,3,3,"H"
2010-12-18,2010,"Paris Saint-Germain","AS Monaco","2-2",2,2,"1",1,4,0,"D"
2010-12-19,2010,"FC Sochaux","Girondins Bordeaux","1-1",1,1,"1",1,2,0,"D"
2010-12-19,2010,"Olympique Marseille","Olympique Lyon","1-1",1,1,"1",1,2,0,"D"
2010-12-21,2010,"FC Lorient","Montpellier HSC","0-0",0,0,"1",1,0,0,"D"
2010-12-22,2010,"AC Arles-Avignon","OGC Nice","0-0",0,0,"1",1,0,0,"D"
2010-12-22,2010,"Stade Brest","Olympique Marseille","0-0",0,0,"1",1,0,0,"D"
2010-12-22,2010,"SM Caen","Stade Rennes","1-0",1,0,"1",1,1,1,"H"
2010-12-22,2010,"Lille OSC","AS Saint-Etienne","1-1",1,1,"1",1,2,0,"D"
2010-12-22,2010,"Olympique Lyon","AJ Auxerre","1-1",1,1,"1",1,2,0,"D"
2010-12-22,2010,"AS Monaco","FC Sochaux","2-1",2,1,"1",1,3,1,"H"
2010-12-22,2010,"AS Nancy","Paris Saint-Germain","2-0",2,0,"1",1,2,2,"H"
2010-12-22,2010,"Valenciennes FC","Toulouse FC","2-1",2,1,"1",1,3,1,"H"
2010-12-22,2010,"Girondins Bordeaux","RC Lens","2-2",2,2,"1",1,4,0,"D"
2011-01-15,2010,"AJ Auxerre","AS Monaco","1-1",1,1,"1",1,2,0,"D"
2011-01-15,2010,"Stade Brest","SM Caen","1-3",1,3,"1",1,4,-2,"D"
2011-01-15,2010,"RC Lens","AS Saint-Etienne","2-1",2,1,"1",1,3,1,"H"
2011-01-15,2010,"Olympique Lyon","FC Lorient","3-0",3,0,"1",1,3,3,"H"
2011-01-15,2010,"Montpellier HSC","Valenciennes FC","2-1",2,1,"1",1,3,1,"H"
2011-01-15,2010,"OGC Nice","Lille OSC","0-2",0,2,"1",1,2,-2,"D"
2011-01-15,2010,"Paris Saint-Germain","FC Sochaux","2-1",2,1,"1",1,3,1,"H"
2011-01-15,2010,"Stade Rennes","AC Arles-Avignon","4-0",4,0,"1",1,4,4,"H"
2011-01-15,2010,"Toulouse FC","AS Nancy","1-0",1,0,"1",1,1,1,"H"
2011-01-16,2010,"Olympique Marseille","Girondins Bordeaux","2-1",2,1,"1",1,3,1,"H"
2011-01-19,2010,"Lille OSC","AS Nancy","3-0",3,0,"1",1,3,3,"H"
2011-01-22,2010,"RC Lens","SM Caen","2-0",2,0,"1",1,2,2,"H"
2011-01-29,2010,"AC Arles-Avignon","Paris Saint-Germain","1-2",1,2,"1",1,3,-1,"D"
2011-01-29,2010,"SM Caen","AJ Auxerre","2-0",2,0,"1",1,2,2,"H"
2011-01-29,2010,"FC Lorient","Stade Brest","2-0",2,0,"1",1,2,2,"H"
2011-01-29,2010,"AS Saint-Etienne","Toulouse FC","2-1",2,1,"1",1,3,1,"H"
2011-01-29,2010,"FC Sochaux","Stade Rennes","5-1",5,1,"1",1,6,4,"H"
2011-01-29,2010,"Valenciennes FC","Olympique Lyon","2-1",2,1,"1",1,3,1,"H"
2011-01-29,2010,"Lille OSC","RC Lens","1-0",1,0,"1",1,1,1,"H"
2011-01-30,2010,"Girondins Bordeaux","OGC Nice","2-0",2,0,"1",1,2,2,"H"
2011-01-30,2010,"AS Nancy","Montpellier HSC","1-2",1,2,"1",1,3,-1,"D"
2011-01-30,2010,"AS Monaco","Olympique Marseille","0-0",0,0,"1",1,0,0,"D"
2011-02-05,2010,"Stade Brest","AS Nancy","2-1",2,1,"1",1,3,1,"H"
2011-02-05,2010,"SM Caen","FC Lorient","0-2",0,2,"1",1,2,-2,"D"
2011-02-05,2010,"RC Lens","Valenciennes FC","1-1",1,1,"1",1,2,0,"D"
2011-02-05,2010,"Olympique Marseille","AC Arles-Avignon","1-0",1,0,"1",1,1,1,"H"
2011-02-05,2010,"Montpellier HSC","AS Saint-Etienne","1-2",1,2,"1",1,3,-1,"D"
2011-02-05,2010,"OGC Nice","FC Sochaux","1-0",1,0,"1",1,1,1,"H"
2011-02-05,2010,"Stade Rennes","Paris Saint-Germain","1-0",1,0,"1",1,1,1,"H"
2011-02-06,2010,"AJ Auxerre","Lille OSC","1-1",1,1,"1",1,2,0,"D"
2011-02-06,2010,"Toulouse FC","AS Monaco","2-0",2,0,"1",1,2,2,"H"
2011-02-06,2010,"Olympique Lyon","Girondins Bordeaux","0-0",0,0,"1",1,0,0,"D"
2011-02-12,2010,"AC Arles-Avignon","Montpellier HSC","0-0",0,0,"1",1,0,0,"D"
2011-02-12,2010,"Girondins Bordeaux","SM Caen","1-2",1,2,"1",1,3,-1,"D"
2011-02-12,2010,"AS Monaco","FC Lorient","3-1",3,1,"1",1,4,2,"H"
2011-02-12,2010,"AS Nancy","AJ Auxerre","3-1",3,1,"1",1,4,2,"H"
2011-02-12,2010,"Paris Saint-Germain","RC Lens","0-0",0,0,"1",1,0,0,"D"
2011-02-12,2010,"FC Sochaux","Olympique Marseille","1-2",1,2,"1",1,3,-1,"D"
2011-02-12,2010,"AS Saint-Etienne","Olympique Lyon","1-4",1,4,"1",1,5,-3,"D"
2011-02-13,2010,"Stade Rennes","OGC Nice","2-0",2,0,"1",1,2,2,"H"
2011-02-13,2010,"Valenciennes FC","Stade Brest","3-0",3,0,"1",1,3,3,"H"
2011-02-13,2010,"Lille OSC","Toulouse FC","2-0",2,0,"1",1,2,2,"H"
2011-02-18,2010,"Olympique Lyon","AS Nancy","4-0",4,0,"1",1,4,4,"H"
2011-02-19,2010,"AJ Auxerre","AC Arles-Avignon","1-1",1,1,"1",1,2,0,"D"
2011-02-19,2010,"Stade Brest","AS Monaco","2-0",2,0,"1",1,2,2,"H"
2011-02-19,2010,"SM Caen","Valenciennes FC","2-2",2,2,"1",1,4,0,"D"
2011-02-19,2010,"RC Lens","FC Sochaux","2-3",2,3,"1",1,5,-1,"D"
2011-02-19,2010,"Olympique Marseille","AS Saint-Etienne","2-1",2,1,"1",1,3,1,"H"
2011-02-19,2010,"FC Lorient","Girondins Bordeaux","5-1",5,1,"1",1,6,4,"H"
2011-02-20,2010,"Montpellier HSC","Lille OSC","1-0",1,0,"1",1,1,1,"H"
2011-02-20,2010,"OGC Nice","Paris Saint-Germain","0-3",0,3,"1",1,3,-3,"D"
2011-02-20,2010,"Toulouse FC","Stade Rennes","1-2",1,2,"1",1,3,-1,"D"
2011-02-26,2010,"AC Arles-Avignon","Stade Brest","1-1",1,1,"1",1,2,0,"D"
2011-02-26,2010,"AS Monaco","SM Caen","2-2",2,2,"1",1,4,0,"D"
2011-02-26,2010,"Stade Rennes","RC Lens","2-0",2,0,"1",1,2,2,"H"
2011-02-26,2010,"AS Saint-Etienne","OGC Nice","0-2",0,2,"1",1,2,-2,"D"
2011-02-26,2010,"FC Sochaux","Montpellier HSC","0-0",0,0,"1",1,0,0,"D"
2011-02-26,2010,"Valenciennes FC","FC Lorient","0-0",0,0,"1",1,0,0,"D"
2011-02-26,2010,"Girondins Bordeaux","AJ Auxerre","3-0",3,0,"1",1,3,3,"H"
2011-02-27,2010,"AS Nancy","Olympique Marseille","1-2",1,2,"1",1,3,-1,"D"
2011-02-27,2010,"Paris Saint-Germain","Toulouse FC","2-1",2,1,"1",1,3,1,"H"
2011-02-27,2010,"Lille OSC","Olympique Lyon","1-1",1,1,"1",1,2,0,"D"
2011-03-05,2010,"SM Caen","AS Saint-Etienne","1-0",1,0,"1",1,1,1,"H"
2011-03-05,2010,"FC Lorient","AS Nancy","0-0",0,0,"1",1,0,0,"D"
2011-03-05,2010,"Montpellier HSC","Stade Rennes","0-1",0,1,"1",1,1,-1,"D"
2011-03-05,2010,"OGC Nice","RC Lens","0-0",0,0,"1",1,0,0,"D"
2011-03-05,2010,"Toulouse FC","FC Sochaux","0-1",0,1,"1",1,1,-1,"D"
2011-03-05,2010,"Valenciennes FC","AS Monaco","0-0",0,0,"1",1,0,0,"D"
2011-03-05,2010,"AJ Auxerre","Paris Saint-Germain","1-0",1,0,"1",1,1,1,"H"
2011-03-06,2010,"Stade Brest","Girondins Bordeaux","1-3",1,3,"1",1,4,-2,"D"
2011-03-06,2010,"Olympique Lyon","AC Arles-Avignon","5-0",5,0,"1",1,5,5,"H"
2011-03-06,2010,"Olympique Marseille","Lille OSC","1-2",1,2,"1",1,3,-1,"D"
2011-03-11,2010,"Stade Rennes","Olympique Marseille","0-2",0,2,"1",1,2,-2,"D"
2011-03-12,2010,"AC Arles-Avignon","FC Lorient","3-3",3,3,"1",1,6,0,"D"
2011-03-12,2010,"RC Lens","Toulouse FC","0-1",0,1,"1",1,1,-1,"D"
2011-03-12,2010,"AS Nancy","SM Caen","2-0",2,0,"1",1,2,2,"H"
2011-03-12,2010,"OGC Nice","AJ Auxerre","1-0",1,0,"1",1,1,1,"H"
2011-03-12,2010,"AS Saint-Etienne","Stade Brest","2-0",2,0,"1",1,2,2,"H"
2011-03-12,2010,"FC Sochaux","Olympique Lyon","0-2",0,2,"1",1,2,-2,"D"
2011-03-13,2010,"Girondins Bordeaux","AS Monaco","0-1",0,1,"1",1,1,-1,"D"
2011-03-13,2010,"Lille OSC","Valenciennes FC","2-1",2,1,"1",1,3,1,"H"
2011-03-13,2010,"Paris Saint-Germain","Montpellier HSC","2-2",2,2,"1",1,4,0,"D"
2011-03-19,2010,"AJ Auxerre","FC Sochaux","2-0",2,0,"1",1,2,2,"H"
2011-03-19,2010,"Stade Brest","Lille OSC","1-2",1,2,"1",1,3,-1,"D"
2011-03-19,2010,"FC Lorient","AS Saint-Etienne","0-0",0,0,"1",1,0,0,"D"
2011-03-19,2010,"Montpellier HSC","RC Lens","1-4",1,4,"1",1,5,-3,"D"
2011-03-19,2010,"Toulouse FC","OGC Nice","1-1",1,1,"1",1,2,0,"D"
2011-03-19,2010,"Valenciennes FC","Girondins Bordeaux","2-2",2,2,"1",1,4,0,"D"
2011-03-19,2010,"Olympique Lyon","Stade Rennes","1-1",1,1,"1",1,2,0,"D"
2011-03-20,2010,"SM Caen","AC Arles-Avignon","2-0",2,0,"1",1,2,2,"H"
2011-03-20,2010,"AS Monaco","AS Nancy","0-1",0,1,"1",1,1,-1,"D"
2011-03-20,2010,"Olympique Marseille","Paris Saint-Germain","2-1",2,1,"1",1,3,1,"H"
2011-04-02,2010,"AC Arles-Avignon","AS Monaco","0-2",0,2,"1",1,2,-2,"D"
2011-04-02,2010,"Lille OSC","SM Caen","3-1",3,1,"1",1,4,2,"H"
2011-04-02,2010,"AS Nancy","Girondins Bordeaux","0-0",0,0,"1",1,0,0,"D"
2011-04-02,2010,"Paris Saint-Germain","FC Lorient","0-0",0,0,"1",1,0,0,"D"
2011-04-02,2010,"Stade Rennes","AJ Auxerre","0-0",0,0,"1",1,0,0,"D"
2011-04-02,2010,"FC Sochaux","Stade Brest","2-1",2,1,"1",1,3,1,"H"
2011-04-02,2010,"Toulouse FC","Montpellier HSC","0-1",0,1,"1",1,1,-1,"D"
2011-04-03,2010,"OGC Nice","Olympique Lyon","2-2",2,2,"1",1,4,0,"D"
2011-04-03,2010,"AS Saint-Etienne","Valenciennes FC","1-1",1,1,"1",1,2,0,"D"
2011-04-03,2010,"RC Lens","Olympique Marseille","0-1",0,1,"1",1,1,-1,"D"
2011-04-09,2010,"AJ Auxerre","AS Saint-Etienne","2-2",2,2,"1",1,4,0,"D"
2011-04-09,2010,"Girondins Bordeaux","AC Arles-Avignon","0-0",0,0,"1",1,0,0,"D"
2011-04-09,2010,"SM Caen","Paris Saint-Germain","1-2",1,2,"1",1,3,-1,"D"
2011-04-09,2010,"FC Lorient","FC Sochaux","1-1",1,1,"1",1,2,0,"D"
2011-04-09,2010,"AS Monaco","Lille OSC","1-0",1,0,"1",1,1,1,"H"
2011-04-09,2010,"Valenciennes FC","AS Nancy","1-1",1,1,"1",1,2,0,"D"
2011-04-09,2010,"Stade Brest","Stade Rennes","2-0",2,0,"1",1,2,2,"H"
2011-04-10,2010,"Olympique Marseille","Toulouse FC","2-2",2,2,"1",1,4,0,"D"
2011-04-10,2010,"Montpellier HSC","OGC Nice","1-1",1,1,"1",1,2,0,"D"
2011-04-10,2010,"Olympique Lyon","RC Lens","3-0",3,0,"1",1,3,3,"H"
2011-04-16,2010,"RC Lens","Stade Brest","1-1",1,1,"1",1,2,0,"D"
2011-04-16,2010,"OGC Nice","AS Monaco","3-2",3,2,"1",1,5,1,"H"
2011-04-16,2010,"Stade Rennes","FC Lorient","1-2",1,2,"1",1,3,-1,"D"
2011-04-16,2010,"AS Saint-Etienne","AS Nancy","2-1",2,1,"1",1,3,1,"H"
2011-04-16,2010,"FC Sochaux","SM Caen","3-2",3,2,"1",1,5,1,"H"
2011-04-16,2010,"Toulouse FC","AJ Auxerre","0-1",0,1,"1",1,1,-1,"D"
2011-04-16,2010,"Lille OSC","Girondins Bordeaux","1-1",1,1,"1",1,2,0,"D"
2011-04-17,2010,"AC Arles-Avignon","Valenciennes FC","0-1",0,1,"1",1,1,-1,"D"
2011-04-17,2010,"Montpellier HSC","Olympique Marseille","1-2",1,2,"1",1,3,-1,"D"
2011-04-17,2010,"Paris Saint-Germain","Olympique Lyon","1-0",1,0,"1",1,1,1,"H"
2011-04-24,2010,"AJ Auxerre","RC Lens","1-1",1,1,"1",1,2,0,"D"
2011-04-24,2010,"Girondins Bordeaux","AS Saint-Etienne","2-0",2,0,"1",1,2,2,"H"
2011-04-24,2010,"Stade Brest","Paris Saint-Germain","2-2",2,2,"1",1,4,0,"D"
2011-04-24,2010,"SM Caen","Toulouse FC","1-1",1,1,"1",1,2,0,"D"
2011-04-24,2010,"AS Monaco","Stade Rennes","1-0",1,0,"1",1,1,1,"H"
2011-04-24,2010,"AS Nancy","AC Arles-Avignon","0-0",0,0,"1",1,0,0,"D"
2011-04-24,2010,"Valenciennes FC","FC Sochaux","1-1",1,1,"1",1,2,0,"D"
2011-04-24,2010,"FC Lorient","Lille OSC","1-1",1,1,"1",1,2,0,"D"
2011-04-27,2010,"Olympique Lyon","Montpellier HSC","3-2",3,2,"1",1,5,1,"H"
2011-04-27,2010,"Olympique Marseille","OGC Nice","4-2",4,2,"1",1,6,2,"H"
2011-04-30,2010,"RC Lens","FC Lorient","2-3",2,3,"1",1,5,-1,"D"
2011-04-30,2010,"Lille OSC","AC Arles-Avignon","5-0",5,0,"1",1,5,5,"H"
2011-04-30,2010,"Stade Rennes","Girondins Bordeaux","0-0",0,0,"1",1,0,0,"D"
2011-04-30,2010,"FC Sochaux","AS Nancy","1-0",1,0,"1",1,1,1,"H"
2011-04-30,2010,"Paris Saint-Germain","Valenciennes FC","3-1",3,1,"1",1,4,2,"H"
2011-05-01,2010,"Olympique Marseille","AJ Auxerre","1-1",1,1,"1",1,2,0,"D"
2011-05-01,2010,"Montpellier HSC","Stade Brest","0-0",0,0,"1",1,0,0,"D"
2011-05-01,2010,"OGC Nice","SM Caen","0-4",0,4,"1",1,4,-4,"D"
2011-05-01,2010,"Toulouse FC","Olympique Lyon","2-0",2,0,"1",1,2,2,"H"
2011-05-01,2010,"AS Saint-Etienne","AS Monaco","1-1",1,1,"1",1,2,0,"D"
2011-05-07,2010,"AC Arles-Avignon","AS Saint-Etienne","0-1",0,1,"1",1,1,-1,"D"
2011-05-07,2010,"AJ Auxerre","Montpellier HSC","1-0",1,0,"1",1,1,1,"H"
2011-05-07,2010,"Girondins Bordeaux","FC Sochaux","0-4",0,4,"1",1,4,-4,"D"
2011-05-07,2010,"Stade Brest","OGC Nice","0-0",0,0,"1",1,0,0,"D"
2011-05-07,2010,"SM Caen","RC Lens","1-1",1,1,"1",1,2,0,"D"
2011-05-07,2010,"FC Lorient","Toulouse FC","0-0",0,0,"1",1,0,0,"D"
2011-05-07,2010,"AS Monaco","Paris Saint-Germain","1-1",1,1,"1",1,2,0,"D"
2011-05-07,2010,"AS Nancy","Lille OSC","0-1",0,1,"1",1,1,-1,"D"
2011-05-08,2010,"Valenciennes FC","Stade Rennes","2-0",2,0,"1",1,2,2,"H"
2011-05-08,2010,"Olympique Lyon","Olympique Marseille","3-2",3,2,"1",1,5,1,"H"
2011-05-10,2010,"Paris Saint-Germain","AS Nancy","2-2",2,2,"1",1,4,0,"D"
2011-05-10,2010,"AS Saint-Etienne","Lille OSC","1-2",1,2,"1",1,3,-1,"D"
2011-05-11,2010,"AJ Auxerre","Olympique Lyon","4-0",4,0,"1",1,4,4,"H"
2011-05-11,2010,"RC Lens","Girondins Bordeaux","1-0",1,0,"1",1,1,1,"H"
2011-05-11,2010,"Montpellier HSC","FC Lorient","3-1",3,1,"1",1,4,2,"H"
2011-05-11,2010,"OGC Nice","AC Arles-Avignon","3-2",3,2,"1",1,5,1,"H"
2011-05-11,2010,"Stade Rennes","SM Caen","1-1",1,1,"1",1,2,0,"D"
2011-05-11,2010,"FC Sochaux","AS Monaco","3-0",3,0,"1",1,3,3,"H"
2011-05-11,2010,"Toulouse FC","Valenciennes FC","0-0",0,0,"1",1,0,0,"D"
2011-05-11,2010,"Olympique Marseille","Stade Brest","3-0",3,0,"1",1,3,3,"H"
2011-05-15,2010,"AC Arles-Avignon","Toulouse FC","1-0",1,0,"1",1,1,1,"H"
2011-05-15,2010,"SM Caen","Montpellier HSC","2-0",2,0,"1",1,2,2,"H"
2011-05-15,2010,"AS Monaco","RC Lens","1-1",1,1,"1",1,2,0,"D"
2011-05-15,2010,"AS Nancy","OGC Nice","3-0",3,0,"1",1,3,3,"H"
2011-05-15,2010,"AS Saint-Etienne","Stade Rennes","1-2",1,2,"1",1,3,-1,"D"
2011-05-15,2010,"Valenciennes FC","AJ Auxerre","1-1",1,1,"1",1,2,0,"D"
2011-05-15,2010,"FC Lorient","Olympique Marseille","2-2",2,2,"1",1,4,0,"D"
2011-05-16,2010,"Stade Brest","Olympique Lyon","1-1",1,1,"1",1,2,0,"D"
2011-05-18,2010,"Girondins Bordeaux","Paris Saint-Germain","1-0",1,0,"1",1,1,1,"H"
2011-05-18,2010,"Lille OSC","FC Sochaux","1-0",1,0,"1",1,1,1,"H"
2011-05-21,2010,"AJ Auxerre","Stade Brest","0-1",0,1,"1",1,1,-1,"D"
2011-05-21,2010,"RC Lens","AC Arles-Avignon","0-1",0,1,"1",1,1,-1,"D"
2011-05-21,2010,"Olympique Lyon","SM Caen","0-0",0,0,"1",1,0,0,"D"
2011-05-21,2010,"Olympique Marseille","Valenciennes FC","2-2",2,2,"1",1,4,0,"D"
2011-05-21,2010,"Montpellier HSC","AS Monaco","0-1",0,1,"1",1,1,-1,"D"
2011-05-21,2010,"OGC Nice","FC Lorient","2-0",2,0,"1",1,2,2,"H"
2011-05-21,2010,"Paris Saint-Germain","Lille OSC","2-2",2,2,"1",1,4,0,"D"
2011-05-21,2010,"Stade Rennes","AS Nancy","0-2",0,2,"1",1,2,-2,"D"
2011-05-21,2010,"FC Sochaux","AS Saint-Etienne","2-1",2,1,"1",1,3,1,"H"
2011-05-21,2010,"Toulouse FC","Girondins Bordeaux","2-0",2,0,"1",1,2,2,"H"
2011-05-29,2010,"AC Arles-Avignon","FC Sochaux","1-3",1,3,"1",1,4,-2,"D"
2011-05-29,2010,"Girondins Bordeaux","Montpellier HSC","2-0",2,0,"1",1,2,2,"H"
2011-05-29,2010,"Stade Brest","Toulouse FC","0-2",0,2,"1",1,2,-2,"D"
2011-05-29,2010,"SM Caen","Olympique Marseille","2-2",2,2,"1",1,4,0,"D"
2011-05-29,2010,"Lille OSC","Stade Rennes","3-2",3,2,"1",1,5,1,"H"
2011-05-29,2010,"FC Lorient","AJ Auxerre","1-2",1,2,"1",1,3,-1,"D"
2011-05-29,2010,"AS Monaco","Olympique Lyon","0-2",0,2,"1",1,2,-2,"D"
2011-05-29,2010,"AS Nancy","RC Lens","4-0",4,0,"1",1,4,4,"H"
2011-05-29,2010,"AS Saint-Etienne","Paris Saint-Germain","1-1",1,1,"1",1,2,0,"D"
2011-05-29,2010,"Valenciennes FC","OGC Nice","2-1",2,1,"1",1,3,1,"H"
2011-08-06,2011,"AC Ajaccio","Toulouse FC","0-2",0,2,"1",1,2,-2,"D"
2011-08-06,2011,"Stade Brest","Evian Thonon Gaillard","2-2",2,2,"1",1,4,0,"D"
2011-08-06,2011,"SM Caen","Valenciennes FC","1-0",1,0,"1",1,1,1,"H"
2011-08-06,2011,"Olympique Marseille","FC Sochaux","2-2",2,2,"1",1,4,0,"D"
2011-08-06,2011,"Montpellier HSC","AJ Auxerre","3-1",3,1,"1",1,4,2,"H"
2011-08-06,2011,"AS Nancy","Lille OSC","1-1",1,1,"1",1,2,0,"D"
2011-08-06,2011,"OGC Nice","Olympique Lyon","1-3",1,3,"1",1,4,-2,"D"
2011-08-06,2011,"Paris Saint-Germain","FC Lorient","0-1",0,1,"1",1,1,-1,"D"
2011-08-07,2011,"Dijon FCO","Stade Rennes","1-5",1,5,"1",1,6,-4,"D"
2011-08-07,2011,"Girondins Bordeaux","AS Saint-Etienne","1-2",1,2,"1",1,3,-1,"D"
2011-08-13,2011,"FC Lorient","Girondins Bordeaux","1-1",1,1,"1",1,2,0,"D"
2011-08-13,2011,"Olympique Lyon","AC Ajaccio","1-1",1,1,"1",1,2,0,"D"
2011-08-13,2011,"Stade Rennes","Paris Saint-Germain","1-1",1,1,"1",1,2,0,"D"
2011-08-13,2011,"FC Sochaux","SM Caen","1-2",1,2,"1",1,3,-1,"D"
2011-08-13,2011,"Toulouse FC","Dijon FCO","2-0",2,0,"1",1,2,2,"H"
2011-08-13,2011,"AS Saint-Etienne","AS Nancy","1-0",1,0,"1",1,1,1,"H"
2011-08-13,2011,"Valenciennes FC","Stade Brest","0-0",0,0,"1",1,0,0,"D"
2011-08-14,2011,"AJ Auxerre","Olympique Marseille","2-2",2,2,"1",1,4,0,"D"
2011-08-14,2011,"Evian Thonon Gaillard","OGC Nice","1-0",1,0,"1",1,1,1,"H"
2011-08-14,2011,"Lille OSC","Montpellier HSC","0-1",0,1,"1",1,1,-1,"D"
2011-08-20,2011,"Girondins Bordeaux","AJ Auxerre","1-1",1,1,"1",1,2,0,"D"
2011-08-20,2011,"Stade Brest","Olympique Lyon","1-1",1,1,"1",1,2,0,"D"
2011-08-20,2011,"SM Caen","Lille OSC","1-2",1,2,"1",1,3,-1,"D"
2011-08-20,2011,"Dijon FCO","FC Lorient","2-0",2,0,"1",1,2,2,"H"
2011-08-20,2011,"OGC Nice","Toulouse FC","1-1",1,1,"1",1,2,0,"D"
2011-08-20,2011,"AC Ajaccio","Evian Thonon Gaillard","1-1",1,1,"1",1,2,0,"D"
2011-08-21,2011,"Montpellier HSC","Stade Rennes","4-0",4,0,"1",1,4,4,"H"
2011-08-21,2011,"AS Nancy","FC Sochaux","1-2",1,2,"1",1,3,-1,"D"
2011-08-21,2011,"Paris Saint-Germain","Valenciennes FC","2-1",2,1,"1",1,3,1,"H"
2011-08-21,2011,"Olympique Marseille","AS Saint-Etienne","0-0",0,0,"1",1,0,0,"D"
2011-08-27,2011,"AJ Auxerre","AC Ajaccio","4-1",4,1,"1",1,5,3,"H"
2011-08-27,2011,"Evian Thonon Gaillard","Dijon FCO","0-1",0,1,"1",1,1,-1,"D"
2011-08-27,2011,"FC Lorient","AS Nancy","2-1",2,1,"1",1,3,1,"H"
2011-08-27,2011,"OGC Nice","Stade Brest","0-0",0,0,"1",1,0,0,"D"
2011-08-27,2011,"Valenciennes FC","Girondins Bordeaux","1-2",1,2,"1",1,3,-1,"D"
2011-08-27,2011,"Olympique Lyon","Montpellier HSC","2-1",2,1,"1",1,3,1,"H"
2011-08-28,2011,"Stade Rennes","SM Caen","3-2",3,2,"1",1,5,1,"H"
2011-08-28,2011,"FC Sochaux","AS Saint-Etienne","2-1",2,1,"1",1,3,1,"H"
2011-08-28,2011,"Toulouse FC","Paris Saint-Germain","1-3",1,3,"1",1,4,-2,"D"
2011-08-28,2011,"Lille OSC","Olympique Marseille","3-2",3,2,"1",1,5,1,"H"
2011-09-10,2011,"AC Ajaccio","Valenciennes FC","3-1",3,1,"1",1,4,2,"H"
2011-09-10,2011,"Girondins Bordeaux","Evian Thonon Gaillard","0-0",0,0,"1",1,0,0,"D"
2011-09-10,2011,"SM Caen","Toulouse FC","0-1",0,1,"1",1,1,-1,"D"
2011-09-10,2011,"Dijon FCO","Olympique Lyon","1-2",1,2,"1",1,3,-1,"D"
2011-09-10,2011,"AS Saint-Etienne","Lille OSC","1-3",1,3,"1",1,4,-2,"D"
2011-09-10,2011,"FC Sochaux","FC Lorient","1-1",1,1,"1",1,2,0,"D"
2011-09-10,2011,"Olympique Marseille","Stade Rennes","0-1",0,1,"1",1,1,-1,"D"
2011-09-11,2011,"Montpellier HSC","OGC Nice","1-0",1,0,"1",1,1,1,"H"
2011-09-11,2011,"AS Nancy","AJ Auxerre","0-0",0,0,"1",1,0,0,"D"
2011-09-11,2011,"Paris Saint-Germain","Stade Brest","1-0",1,0,"1",1,1,1,"H"
2011-09-17,2011,"AJ Auxerre","SM Caen","1-1",1,1,"1",1,2,0,"D"
2011-09-17,2011,"Stade Brest","Montpellier HSC","2-2",2,2,"1",1,4,0,"D"
2011-09-17,2011,"FC Lorient","AS Saint-Etienne","3-0",3,0,"1",1,3,3,"H"
2011-09-17,2011,"OGC Nice","AC Ajaccio","3-0",3,0,"1",1,3,3,"H"
2011-09-17,2011,"Toulouse FC","Girondins Bordeaux","3-2",3,2,"1",1,5,1,"H"
2011-09-17,2011,"Valenciennes FC","Dijon FCO","4-0",4,0,"1",1,4,4,"H"
2011-09-17,2011,"Lille OSC","FC Sochaux","2-2",2,2,"1",1,4,0,"D"
2011-09-18,2011,"Evian Thonon Gaillard","Paris Saint-Germain","2-2",2,2,"1",1,4,0,"D"
2011-09-18,2011,"Stade Rennes","AS Nancy","1-1",1,1,"1",1,2,0,"D"
2011-09-18,2011,"Olympique Lyon","Olympique Marseille","2-0",2,0,"1",1,2,2,"H"
2011-09-20,2011,"Girondins Bordeaux","Lille OSC","1-1",1,1,"1",1,2,0,"D"
2011-09-21,2011,"AC Ajaccio","Montpellier HSC","1-3",1,3,"1",1,4,-2,"D"
2011-09-21,2011,"SM Caen","Olympique Lyon","1-0",1,0,"1",1,1,1,"H"
2011-09-21,2011,"Dijon FCO","Stade Brest","1-0",1,0,"1",1,1,1,"H"
2011-09-21,2011,"FC Lorient","AJ Auxerre","1-1",1,1,"1",1,2,0,"D"
2011-09-21,2011,"Olympique Marseille","Evian Thonon Gaillard","2-0",2,0,"1",1,2,2,"H"
2011-09-21,2011,"AS Nancy","Valenciennes FC","1-1",1,1,"1",1,2,0,"D"
2011-09-21,2011,"Paris Saint-Germain","OGC Nice","2-1",2,1,"1",1,3,1,"H"
2011-09-21,2011,"FC Sochaux","Stade Rennes","2-6",2,6,"1",1,8,-4,"D"
2011-09-21,2011,"AS Saint-Etienne","Toulouse FC","1-1",1,1,"1",1,2,0,"D"
2011-09-24,2011,"Evian Thonon Gaillard","SM Caen","2-4",2,4,"1",1,6,-2,"D"
2011-09-24,2011,"Lille OSC","FC Lorient","1-1",1,1,"1",1,2,0,"D"
2011-09-24,2011,"Olympique Lyon","Girondins Bordeaux","3-1",3,1,"1",1,4,2,"H"
2011-09-24,2011,"OGC Nice","Dijon FCO","1-1",1,1,"1",1,2,0,"D"
2011-09-24,2011,"Toulouse FC","AS Nancy","1-0",1,0,"1",1,1,1,"H"
2011-09-24,2011,"Valenciennes FC","Olympique Marseille","1-1",1,1,"1",1,2,0,"D"
2011-09-24,2011,"Montpellier HSC","Paris Saint-Germain","0-3",0,3,"1",1,3,-3,"D"
2011-09-25,2011,"AJ Auxerre","FC Sochaux","4-1",4,1,"1",1,5,3,"H"
2011-09-25,2011,"Stade Brest","AC Ajaccio","1-1",1,1,"1",1,2,0,"D"
2011-09-25,2011,"Stade Rennes","AS Saint-Etienne","1-1",1,1,"1",1,2,0,"D"
2011-10-01,2011,"SM Caen","OGC Nice","1-1",1,1,"1",1,2,0,"D"
2011-10-01,2011,"Dijon FCO","AC Ajaccio","1-1",1,1,"1",1,2,0,"D"
2011-10-01,2011,"FC Lorient","Valenciennes FC","2-0",2,0,"1",1,2,2,"H"
2011-10-01,2011,"AS Nancy","Evian Thonon Gaillard","1-1",1,1,"1",1,2,0,"D"
2011-10-01,2011,"AS Saint-Etienne","AJ Auxerre","1-1",1,1,"1",1,2,0,"D"
2011-10-01,2011,"FC Sochaux","Toulouse FC","3-0",3,0,"1",1,3,3,"H"
2011-10-01,2011,"Girondins Bordeaux","Montpellier HSC","2-2",2,2,"1",1,4,0,"D"
2011-10-02,2011,"Lille OSC","Stade Rennes","2-0",2,0,"1",1,2,2,"H"
2011-10-02,2011,"Olympique Marseille","Stade Brest","1-1",1,1,"1",1,2,0,"D"
2011-10-02,2011,"Paris Saint-Germain","Olympique Lyon","2-0",2,0,"1",1,2,2,"H"
2011-10-15,2011,"AJ Auxerre","Lille OSC","1-3",1,3,"1",1,4,-2,"D"
2011-10-15,2011,"Stade Brest","SM Caen","1-1",1,1,"1",1,2,0,"D"
2011-10-15,2011,"Evian Thonon Gaillard","AS Saint-Etienne","1-2",1,2,"1",1,3,-1,"D"
2011-10-15,2011,"Olympique Lyon","AS Nancy","3-1",3,1,"1",1,4,2,"H"
2011-10-15,2011,"Montpellier HSC","Dijon FCO","5-3",5,3,"1",1,8,2,"H"
2011-10-15,2011,"Toulouse FC","Olympique Marseille","0-0",0,0,"1",1,0,0,"D"
2011-10-15,2011,"OGC Nice","Girondins Bordeaux","3-0",3,0,"1",1,3,3,"H"
2011-10-16,2011,"AC Ajaccio","Paris Saint-Germain","1-3",1,3,"1",1,4,-2,"D"
2011-10-16,2011,"Valenciennes FC","FC Sochaux","3-0",3,0,"1",1,3,3,"H"
2011-10-16,2011,"Stade Rennes","FC Lorient","2-0",2,0,"1",1,2,2,"H"
2011-10-22,2011,"Girondins Bordeaux","Stade Brest","1-1",1,1,"1",1,2,0,"D"
2011-10-22,2011,"SM Caen","Montpellier HSC","1-3",1,3,"1",1,4,-2,"D"
2011-10-22,2011,"Olympique Marseille","AC Ajaccio","2-0",2,0,"1",1,2,2,"H"
2011-10-22,2011,"AS Nancy","OGC Nice","1-0",1,0,"1",1,1,1,"H"
2011-10-22,2011,"AS Saint-Etienne","Valenciennes FC","1-0",1,0,"1",1,1,1,"H"
2011-10-22,2011,"FC Sochaux","Evian Thonon Gaillard","1-1",1,1,"1",1,2,0,"D"
2011-10-22,2011,"FC Lorient","Toulouse FC","0-0",0,0,"1",1,0,0,"D"
2011-10-23,2011,"AJ Auxerre","Stade Rennes","0-1",0,1,"1",1,1,-1,"D"
2011-10-23,2011,"Paris Saint-Germain","Dijon FCO","2-0",2,0,"1",1,2,2,"H"
2011-10-23,2011,"Lille OSC","Olympique Lyon","3-1",3,1,"1",1,4,2,"H"
2011-10-29,2011,"AC Ajaccio","Girondins Bordeaux","0-2",0,2,"1",1,2,-2,"D"
2011-10-29,2011,"Stade Brest","FC Lorient","3-1",3,1,"1",1,4,2,"H"
2011-10-29,2011,"Dijon FCO","Olympique Marseille","2-3",2,3,"1",1,5,-1,"D"
2011-10-29,2011,"Evian Thonon Gaillard","AJ Auxerre","3-1",3,1,"1",1,4,2,"H"
2011-10-29,2011,"Montpellier HSC","AS Nancy","2-0",2,0,"1",1,2,2,"H"
2011-10-29,2011,"Paris Saint-Germain","SM Caen","4-2",4,2,"1",1,6,2,"H"
2011-10-29,2011,"Olympique Lyon","AS Saint-Etienne","2-0",2,0,"1",1,2,2,"H"
2011-10-30,2011,"OGC Nice","FC Sochaux","1-1",1,1,"1",1,2,0,"D"
2011-10-30,2011,"Toulouse FC","Stade Rennes","1-0",1,0,"1",1,1,1,"H"
2011-10-30,2011,"Valenciennes FC","Lille OSC","0-0",0,0,"1",1,0,0,"D"
2011-11-05,2011,"Lille OSC","Evian Thonon Gaillard","1-1",1,1,"1",1,2,0,"D"
2011-11-06,2011,"SM Caen","Dijon FCO","3-0",3,0,"1",1,3,3,"H"
2011-11-06,2011,"FC Lorient","AC Ajaccio","2-0",2,0,"1",1,2,2,"H"
2011-11-06,2011,"Olympique Marseille","OGC Nice","2-0",2,0,"1",1,2,2,"H"
2011-11-06,2011,"AS Nancy","Stade Brest","2-1",2,1,"1",1,3,1,"H"
2011-11-06,2011,"Stade Rennes","Valenciennes FC","1-1",1,1,"1",1,2,0,"D"
2011-11-06,2011,"AS Saint-Etienne","Montpellier HSC","1-1",1,1,"1",1,2,0,"D"
2011-11-06,2011,"FC Sochaux","Olympique Lyon","2-1",2,1,"1",1,3,1,"H"
2011-11-06,2011,"AJ Auxerre","Toulouse FC","2-0",2,0,"1",1,2,2,"H"
2011-11-06,2011,"Girondins Bordeaux","Paris Saint-Germain","1-1",1,1,"1",1,2,0,"D"
2011-11-18,2011,"Olympique Lyon","Stade Rennes","1-2",1,2,"1",1,3,-1,"D"
2011-11-18,2011,"Toulouse FC","Lille OSC","0-0",0,0,"1",1,0,0,"D"
2011-11-19,2011,"AC Ajaccio","SM Caen","2-2",2,2,"1",1,4,0,"D"
2011-11-19,2011,"Dijon FCO","Girondins Bordeaux","2-0",2,0,"1",1,2,2,"H"
2011-11-19,2011,"Evian Thonon Gaillard","FC Lorient","2-1",2,1,"1",1,3,1,"H"
2011-11-19,2011,"OGC Nice","AS Saint-Etienne","0-2",0,2,"1",1,2,-2,"D"
2011-11-19,2011,"Montpellier HSC","Olympique Marseille","1-0",1,0,"1",1,1,1,"H"
2011-11-20,2011,"Stade Brest","FC Sochaux","2-0",2,0,"1",1,2,2,"H"
2011-11-20,2011,"Valenciennes FC","AJ Auxerre","2-1",2,1,"1",1,3,1,"H"
2011-11-20,2011,"Paris Saint-Germain","AS Nancy","0-1",0,1,"1",1,1,-1,"D"
2011-11-26,2011,"Girondins Bordeaux","SM Caen","2-0",2,0,"1",1,2,2,"H"
2011-11-26,2011,"AS Nancy","Dijon FCO","1-2",1,2,"1",1,3,-1,"D"
2011-11-26,2011,"Stade Rennes","Evian Thonon Gaillard","3-2",3,2,"1",1,5,1,"H"
2011-11-26,2011,"AS Saint-Etienne","AC Ajaccio","3-1",3,1,"1",1,4,2,"H"
2011-11-26,2011,"FC Sochaux","Montpellier HSC","1-3",1,3,"1",1,4,-2,"D"
2011-11-26,2011,"Toulouse FC","Valenciennes FC","2-0",2,0,"1",1,2,2,"H"
2011-11-26,2011,"Lille OSC","Stade Brest","2-0",2,0,"1",1,2,2,"H"
2011-11-27,2011,"AJ Auxerre","Olympique Lyon","0-3",0,3,"1",1,3,-3,"D"
2011-11-27,2011,"FC Lorient","OGC Nice","1-0",1,0,"1",1,1,1,"H"
2011-11-27,2011,"Olympique Marseille","Paris Saint-Germain","3-0",3,0,"1",1,3,3,"H"
2011-12-02,2011,"SM Caen","Olympique Marseille","1-2",1,2,"1",1,3,-1,"D"
2011-12-03,2011,"AC Ajaccio","Lille OSC","2-3",2,3,"1",1,5,-1,"D"
2011-12-03,2011,"Stade Brest","AS Saint-Etienne","2-2",2,2,"1",1,4,0,"D"
2011-12-03,2011,"Dijon FCO","FC Sochaux","0-0",0,0,"1",1,0,0,"D"
2011-12-03,2011,"Evian Thonon Gaillard","Valenciennes FC","2-1",2,1,"1",1,3,1,"H"
2011-12-03,2011,"Montpellier HSC","FC Lorient","4-0",4,0,"1",1,4,4,"H"
2011-12-03,2011,"OGC Nice","Stade Rennes","2-0",2,0,"1",1,2,2,"H"
2011-12-04,2011,"Girondins Bordeaux","AS Nancy","2-0",2,0,"1",1,2,2,"H"
2011-12-04,2011,"Paris Saint-Germain","AJ Auxerre","3-2",3,2,"1",1,5,1,"H"
2011-12-04,2011,"Olympique Lyon","Toulouse FC","3-2",3,2,"1",1,5,1,"H"
2011-12-10,2011,"AS Nancy","AC Ajaccio","2-2",2,2,"1",1,4,0,"D"
2011-12-10,2011,"Stade Rennes","Stade Brest","1-1",1,1,"1",1,2,0,"D"
2011-12-10,2011,"AS Saint-Etienne","SM Caen","2-0",2,0,"1",1,2,2,"H"
2011-12-10,2011,"FC Sochaux","Paris Saint-Germain","0-1",0,1,"1",1,1,-1,"D"
2011-12-10,2011,"Toulouse FC","Evian Thonon Gaillard","2-1",2,1,"1",1,3,1,"H"
2011-12-10,2011,"Valenciennes FC","Montpellier HSC","1-0",1,0,"1",1,1,1,"H"
2011-12-10,2011,"Olympique Marseille","Girondins Bordeaux","0-0",0,0,"1",1,0,0,"D"
2011-12-11,2011,"AJ Auxerre","OGC Nice","2-1",2,1,"1",1,3,1,"H"
2011-12-11,2011,"Lille OSC","Dijon FCO","2-0",2,0,"1",1,2,2,"H"
2011-12-11,2011,"FC Lorient","Olympique Lyon","0-1",0,1,"1",1,1,-1,"D"
2011-12-17,2011,"Stade Brest","AJ Auxerre","1-0",1,0,"1",1,1,1,"H"
2011-12-17,2011,"SM Caen","AS Nancy","1-2",1,2,"1",1,3,-1,"D"
2011-12-17,2011,"Dijon FCO","AS Saint-Etienne","1-2",1,2,"1",1,3,-1,"D"
2011-12-17,2011,"Olympique Marseille","FC Lorient","2-1",2,1,"1",1,3,1,"H"
2011-12-17,2011,"Montpellier HSC","Toulouse FC","1-1",1,1,"1",1,2,0,"D"
2011-12-17,2011,"OGC Nice","Valenciennes FC","2-0",2,0,"1",1,2,2,"H"
2011-12-17,2011,"Olympique Lyon","Evian Thonon Gaillard","2-1",2,1,"1",1,3,1,"H"
2011-12-18,2011,"AC Ajaccio","Stade Rennes","1-0",1,0,"1",1,1,1,"H"
2011-12-18,2011,"Girondins Bordeaux","FC Sochaux","1-0",1,0,"1",1,1,1,"H"
2011-12-18,2011,"Paris Saint-Germain","Lille OSC","0-0",0,0,"1",1,0,0,"D"
2011-12-20,2011,"AS Nancy","Olympique Marseille","1-3",1,3,"1",1,4,-2,"D"
2011-12-21,2011,"AJ Auxerre","Dijon FCO","2-2",2,2,"1",1,4,0,"D"
2011-12-21,2011,"Evian Thonon Gaillard","Montpellier HSC","4-2",4,2,"1",1,6,2,"H"
2011-12-21,2011,"Lille OSC","OGC Nice","4-4",4,4,"1",1,8,0,"D"
2011-12-21,2011,"FC Lorient","SM Caen","0-0",0,0,"1",1,0,0,"D"
2011-12-21,2011,"Stade Rennes","Girondins Bordeaux","1-0",1,0,"1",1,1,1,"H"
2011-12-21,2011,"FC Sochaux","AC Ajaccio","0-2",0,2,"1",1,2,-2,"D"
2011-12-21,2011,"Toulouse FC","Stade Brest","0-0",0,0,"1",1,0,0,"D"
2011-12-21,2011,"Valenciennes FC","Olympique Lyon","1-0",1,0,"1",1,1,1,"H"
2011-12-21,2011,"AS Saint-Etienne","Paris Saint-Germain","0-1",0,1,"1",1,1,-1,"D"
2012-01-14,2011,"AC Ajaccio","AJ Auxerre","2-1",2,1,"1",1,3,1,"H"
2012-01-14,2011,"Dijon FCO","Evian Thonon Gaillard","3-1",3,1,"1",1,4,2,"H"
2012-01-14,2011,"AS Nancy","FC Lorient","2-2",2,2,"1",1,4,0,"D"
2012-01-14,2011,"Montpellier HSC","Olympique Lyon","1-0",1,0,"1",1,1,1,"H"
2012-01-14,2011,"Stade Brest","OGC Nice","1-0",1,0,"1",1,1,1,"H"
2012-01-14,2011,"SM Caen","Stade Rennes","0-2",0,2,"1",1,2,-2,"D"
2012-01-14,2011,"AS Saint-Etienne","FC Sochaux","1-0",1,0,"1",1,1,1,"H"
2012-01-14,2011,"Paris Saint-Germain","Toulouse FC","3-1",3,1,"1",1,4,2,"H"
2012-01-14,2011,"Girondins Bordeaux","Valenciennes FC","2-1",2,1,"1",1,3,1,"H"
2012-01-15,2011,"Olympique Marseille","Lille OSC","2-0",2,0,"1",1,2,2,"H"
2012-01-28,2011,"Toulouse FC","SM Caen","1-0",1,0,"1",1,1,1,"H"
2012-01-28,2011,"Olympique Lyon","Dijon FCO","3-1",3,1,"1",1,4,2,"H"
2012-01-28,2011,"OGC Nice","Montpellier HSC","0-1",0,1,"1",1,1,-1,"D"
2012-01-28,2011,"AJ Auxerre","AS Nancy","1-3",1,3,"1",1,4,-2,"D"
2012-01-28,2011,"Stade Brest","Paris Saint-Germain","0-1",0,1,"1",1,1,-1,"D"
2012-01-28,2011,"FC Lorient","FC Sochaux","1-1",1,1,"1",1,2,0,"D"
2012-01-28,2011,"Lille OSC","AS Saint-Etienne","3-0",3,0,"1",1,3,3,"H"
2012-01-29,2011,"Valenciennes FC","AC Ajaccio","1-2",1,2,"1",1,3,-1,"D"
2012-01-29,2011,"Evian Thonon Gaillard","Girondins Bordeaux","0-0",0,0,"1",1,0,0,"D"
2012-01-29,2011,"Stade Rennes","Olympique Marseille","1-2",1,2,"1",1,3,-1,"D"
2012-02-04,2011,"AS Nancy","Stade Rennes","0-0",0,0,"1",1,0,0,"D"
2012-02-04,2011,"Dijon FCO","Valenciennes FC","1-2",1,2,"1",1,3,-1,"D"
2012-02-04,2011,"Montpellier HSC","Stade Brest","1-0",1,0,"1",1,1,1,"H"
2012-02-04,2011,"Paris Saint-Germain","Evian Thonon Gaillard","3-1",3,1,"1",1,4,2,"H"
2012-02-04,2011,"AC Ajaccio","OGC Nice","1-1",1,1,"1",1,2,0,"D"
2012-02-04,2011,"Girondins Bordeaux","Toulouse FC","2-0",2,0,"1",1,2,2,"H"
2012-02-05,2011,"Olympique Marseille","Olympique Lyon","2-2",2,2,"1",1,4,0,"D"
2012-02-11,2011,"Montpellier HSC","AC Ajaccio","3-0",3,0,"1",1,3,3,"H"
2012-02-11,2011,"Olympique Lyon","SM Caen","1-2",1,2,"1",1,3,-1,"D"
2012-02-11,2011,"AJ Auxerre","FC Lorient","1-1",1,1,"1",1,2,0,"D"
2012-02-11,2011,"Valenciennes FC","AS Nancy","1-0",1,0,"1",1,1,1,"H"
2012-02-11,2011,"Stade Rennes","FC Sochaux","1-0",1,0,"1",1,1,1,"H"
2012-02-11,2011,"Stade Brest","Dijon FCO","1-1",1,1,"1",1,2,0,"D"
2012-02-12,2011,"Lille OSC","Girondins Bordeaux","4-5",4,5,"1",1,9,-1,"D"
2012-02-12,2011,"OGC Nice","Paris Saint-Germain","0-0",0,0,"1",1,0,0,"D"
2012-02-12,2011,"Toulouse FC","AS Saint-Etienne","0-1",0,1,"1",1,1,-1,"D"
2012-02-18,2011,"FC Sochaux","AJ Auxerre","0-0",0,0,"1",1,0,0,"D"
2012-02-18,2011,"AC Ajaccio","Stade Brest","0-0",0,0,"1",1,0,0,"D"
2012-02-18,2011,"SM Caen","Evian Thonon Gaillard","2-2",2,2,"1",1,4,0,"D"
2012-02-18,2011,"FC Lorient","Lille OSC","0-1",0,1,"1",1,1,-1,"D"
2012-02-18,2011,"Dijon FCO","OGC Nice","3-0",3,0,"1",1,3,3,"H"
2012-02-18,2011,"AS Nancy","Toulouse FC","0-3",0,3,"1",1,3,-3,"D"
2012-02-18,2011,"Olympique Marseille","Valenciennes FC","1-1",1,1,"1",1,2,0,"D"
2012-02-19,2011,"Girondins Bordeaux","Olympique Lyon","1-0",1,0,"1",1,1,1,"H"
2012-02-19,2011,"AS Saint-Etienne","Stade Rennes","4-0",4,0,"1",1,4,4,"H"
2012-02-19,2011,"Paris Saint-Germain","Montpellier HSC","2-2",2,2,"1",1,4,0,"D"
2012-02-22,2011,"SM Caen","AJ Auxerre","2-1",2,1,"1",1,3,1,"H"
2012-02-22,2011,"FC Sochaux","Lille OSC","0-1",0,1,"1",1,1,-1,"D"
2012-02-22,2011,"AS Saint-Etienne","FC Lorient","4-2",4,2,"1",1,6,2,"H"
2012-02-25,2011,"Montpellier HSC","Girondins Bordeaux","1-0",1,0,"1",1,1,1,"H"
2012-02-25,2011,"OGC Nice","SM Caen","1-0",1,0,"1",1,1,1,"H"
2012-02-25,2011,"AC Ajaccio","Dijon FCO","2-1",2,1,"1",1,3,1,"H"
2012-02-25,2011,"Valenciennes FC","FC Lorient","2-0",2,0,"1",1,2,2,"H"
2012-02-25,2011,"Evian Thonon Gaillard","AS Nancy","2-0",2,0,"1",1,2,2,"H"
2012-02-25,2011,"AJ Auxerre","AS Saint-Etienne","0-0",0,0,"1",1,0,0,"D"
2012-02-25,2011,"Olympique Lyon","Paris Saint-Germain","4-4",4,4,"1",1,8,0,"D"
2012-02-26,2011,"Stade Brest","Olympique Marseille","1-0",1,0,"1",1,1,1,"H"
2012-02-26,2011,"Toulouse FC","FC Sochaux","2-0",2,0,"1",1,2,2,"H"
2012-02-26,2011,"Stade Rennes","Lille OSC","1-1",1,1,"1",1,2,0,"D"
2012-03-03,2011,"Lille OSC","AJ Auxerre","2-2",2,2,"1",1,4,0,"D"
2012-03-03,2011,"AS Saint-Etienne","Evian Thonon Gaillard","0-2",0,2,"1",1,2,-2,"D"
2012-03-03,2011,"AS Nancy","Olympique Lyon","2-0",2,0,"1",1,2,2,"H"
2012-03-03,2011,"Dijon FCO","Montpellier HSC","1-1",1,1,"1",1,2,0,"D"
2012-03-03,2011,"Olympique Marseille","Toulouse FC","0-1",0,1,"1",1,1,-1,"D"
2012-03-03,2011,"FC Sochaux","Valenciennes FC","1-1",1,1,"1",1,2,0,"D"
2012-03-03,2011,"Girondins Bordeaux","OGC Nice","1-2",1,2,"1",1,3,-1,"D"
2012-03-04,2011,"Paris Saint-Germain","AC Ajaccio","4-1",4,1,"1",1,5,3,"H"
2012-03-04,2011,"SM Caen","Stade Brest","0-0",0,0,"1",1,0,0,"D"
2012-03-04,2011,"FC Lorient","Stade Rennes","0-2",0,2,"1",1,2,-2,"D"
2012-03-06,2011,"Evian Thonon Gaillard","Olympique Marseille","2-0",2,0,"1",1,2,2,"H"
2012-03-09,2011,"AC Ajaccio","Olympique Marseille","1-0",1,0,"1",1,1,1,"H"
2012-03-10,2011,"Stade Brest","Girondins Bordeaux","0-2",0,2,"1",1,2,-2,"D"
2012-03-10,2011,"Toulouse FC","FC Lorient","1-1",1,1,"1",1,2,0,"D"
2012-03-10,2011,"OGC Nice","AS Nancy","1-1",1,1,"1",1,2,0,"D"
2012-03-10,2011,"Valenciennes FC","AS Saint-Etienne","1-2",1,2,"1",1,3,-1,"D"
2012-03-10,2011,"Evian Thonon Gaillard","FC Sochaux","2-3",2,3,"1",1,5,-1,"D"
2012-03-10,2011,"Olympique Lyon","Lille OSC","2-1",2,1,"1",1,3,1,"H"
2012-03-11,2011,"Stade Rennes","AJ Auxerre","1-1",1,1,"1",1,2,0,"D"
2012-03-11,2011,"Dijon FCO","Paris Saint-Germain","1-2",1,2,"1",1,3,-1,"D"
2012-03-11,2011,"Montpellier HSC","SM Caen","3-0",3,0,"1",1,3,3,"H"
2012-03-17,2011,"Girondins Bordeaux","AC Ajaccio","1-1",1,1,"1",1,2,0,"D"
2012-03-17,2011,"FC Lorient","Stade Brest","2-1",2,1,"1",1,3,1,"H"
2012-03-17,2011,"Olympique Marseille","Dijon FCO","1-2",1,2,"1",1,3,-1,"D"
2012-03-17,2011,"AJ Auxerre","Evian Thonon Gaillard","0-2",0,2,"1",1,2,-2,"D"
2012-03-17,2011,"AS Nancy","Montpellier HSC","1-0",1,0,"1",1,1,1,"H"
2012-03-17,2011,"SM Caen","Paris Saint-Germain","2-2",2,2,"1",1,4,0,"D"
2012-03-17,2011,"AS Saint-Etienne","Olympique Lyon","0-1",0,1,"1",1,1,-1,"D"
2012-03-18,2011,"FC Sochaux","OGC Nice","2-0",2,0,"1",1,2,2,"H"
2012-03-18,2011,"Stade Rennes","Toulouse FC","0-1",0,1,"1",1,1,-1,"D"
2012-03-18,2011,"Lille OSC","Valenciennes FC","4-0",4,0,"1",1,4,4,"H"
2012-03-24,2011,"Evian Thonon Gaillard","Lille OSC","0-3",0,3,"1",1,3,-3,"D"
2012-03-24,2011,"AC Ajaccio","FC Lorient","1-1",1,1,"1",1,2,0,"D"
2012-03-24,2011,"OGC Nice","Olympique Marseille","1-1",1,1,"1",1,2,0,"D"
2012-03-24,2011,"Stade Brest","AS Nancy","0-1",0,1,"1",1,1,-1,"D"
2012-03-24,2011,"Montpellier HSC","AS Saint-Etienne","1-0",1,0,"1",1,1,1,"H"
2012-03-24,2011,"Olympique Lyon","FC Sochaux","2-1",2,1,"1",1,3,1,"H"
2012-03-24,2011,"Valenciennes FC","Stade Rennes","1-0",1,0,"1",1,1,1,"H"
2012-03-25,2011,"Toulouse FC","AJ Auxerre","1-0",1,0,"1",1,1,1,"H"
2012-03-25,2011,"Dijon FCO","SM Caen","2-0",2,0,"1",1,2,2,"H"
2012-03-25,2011,"Paris Saint-Germain","Girondins Bordeaux","1-1",1,1,"1",1,2,0,"D"
2012-03-31,2011,"FC Sochaux","Stade Brest","2-1",2,1,"1",1,3,1,"H"
2012-03-31,2011,"Girondins Bordeaux","Dijon FCO","1-1",1,1,"1",1,2,0,"D"
2012-03-31,2011,"FC Lorient","Evian Thonon Gaillard","0-1",0,1,"1",1,1,-1,"D"
2012-03-31,2011,"AS Saint-Etienne","OGC Nice","2-3",2,3,"1",1,5,-1,"D"
2012-03-31,2011,"AJ Auxerre","Valenciennes FC","2-0",2,0,"1",1,2,2,"H"
2012-03-31,2011,"AS Nancy","Paris Saint-Germain","2-1",2,1,"1",1,3,1,"H"
2012-04-01,2011,"SM Caen","AC Ajaccio","0-0",0,0,"1",1,0,0,"D"
2012-04-01,2011,"Lille OSC","Toulouse FC","2-1",2,1,"1",1,3,1,"H"
2012-04-01,2011,"Stade Rennes","Olympique Lyon","1-1",1,1,"1",1,2,0,"D"
2012-04-07,2011,"Stade Brest","Lille OSC","3-1",3,1,"1",1,4,2,"H"
2012-04-07,2011,"Dijon FCO","AS Nancy","0-2",0,2,"1",1,2,-2,"D"
2012-04-07,2011,"Evian Thonon Gaillard","Stade Rennes","1-3",1,3,"1",1,4,-2,"D"
2012-04-07,2011,"AC Ajaccio","AS Saint-Etienne","1-1",1,1,"1",1,2,0,"D"
2012-04-07,2011,"Montpellier HSC","FC Sochaux","2-1",2,1,"1",1,3,1,"H"
2012-04-07,2011,"Valenciennes FC","Toulouse FC","2-0",2,0,"1",1,2,2,"H"
2012-04-07,2011,"Olympique Lyon","AJ Auxerre","2-1",2,1,"1",1,3,1,"H"
2012-04-08,2011,"SM Caen","Girondins Bordeaux","1-0",1,0,"1",1,1,1,"H"
2012-04-08,2011,"OGC Nice","FC Lorient","2-0",2,0,"1",1,2,2,"H"
2012-04-08,2011,"Paris Saint-Germain","Olympique Marseille","2-1",2,1,"1",1,3,1,"H"
2012-04-11,2011,"Olympique Marseille","Montpellier HSC","1-3",1,3,"1",1,4,-2,"D"
2012-04-15,2011,"Lille OSC","AC Ajaccio","4-1",4,1,"1",1,5,3,"H"
2012-04-15,2011,"AS Nancy","Girondins Bordeaux","2-2",2,2,"1",1,4,0,"D"
2012-04-15,2011,"AS Saint-Etienne","Stade Brest","2-1",2,1,"1",1,3,1,"H"
2012-04-15,2011,"FC Sochaux","Dijon FCO","1-0",1,0,"1",1,1,1,"H"
2012-04-15,2011,"Valenciennes FC","Evian Thonon Gaillard","0-3",0,3,"1",1,3,-3,"D"
2012-04-15,2011,"FC Lorient","Montpellier HSC","2-1",2,1,"1",1,3,1,"H"
2012-04-15,2011,"AJ Auxerre","Paris Saint-Germain","1-1",1,1,"1",1,2,0,"D"
2012-04-16,2011,"Stade Rennes","OGC Nice","3-1",3,1,"1",1,4,2,"H"
2012-04-18,2011,"Olympique Marseille","SM Caen","1-1",1,1,"1",1,2,0,"D"
2012-04-18,2011,"Toulouse FC","Olympique Lyon","3-0",3,0,"1",1,3,3,"H"
2012-04-21,2011,"OGC Nice","AJ Auxerre","1-0",1,0,"1",1,1,1,"H"
2012-04-21,2011,"Dijon FCO","Lille OSC","0-2",0,2,"1",1,2,-2,"D"
2012-04-21,2011,"Stade Brest","Stade Rennes","0-1",0,1,"1",1,1,-1,"D"
2012-04-21,2011,"SM Caen","AS Saint-Etienne","1-4",1,4,"1",1,5,-3,"D"
2012-04-21,2011,"Evian Thonon Gaillard","Toulouse FC","2-1",2,1,"1",1,3,1,"H"
2012-04-21,2011,"Montpellier HSC","Valenciennes FC","1-0",1,0,"1",1,1,1,"H"
2012-04-21,2011,"Girondins Bordeaux","Olympique Marseille","2-1",2,1,"1",1,3,1,"H"
2012-04-22,2011,"AC Ajaccio","AS Nancy","0-0",0,0,"1",1,0,0,"D"
2012-04-22,2011,"Paris Saint-Germain","FC Sochaux","6-1",6,1,"1",1,7,5,"H"
2012-04-22,2011,"Olympique Lyon","FC Lorient","3-2",3,2,"1",1,5,1,"H"
2012-04-27,2011,"Toulouse FC","Montpellier HSC","0-1",0,1,"1",1,1,-1,"D"
2012-04-27,2011,"FC Lorient","Olympique Marseille","2-1",2,1,"1",1,3,1,"H"
2012-04-29,2011,"Stade Rennes","AC Ajaccio","3-1",3,1,"1",1,4,2,"H"
2012-04-29,2011,"FC Sochaux","Girondins Bordeaux","0-3",0,3,"1",1,3,-3,"D"
2012-04-29,2011,"AJ Auxerre","Stade Brest","4-0",4,0,"1",1,4,4,"H"
2012-04-29,2011,"AS Nancy","SM Caen","1-1",1,1,"1",1,2,0,"D"
2012-04-29,2011,"AS Saint-Etienne","Dijon FCO","1-0",1,0,"1",1,1,1,"H"
2012-04-29,2011,"Valenciennes FC","OGC Nice","2-0",2,0,"1",1,2,2,"H"
2012-04-29,2011,"Lille OSC","Paris Saint-Germain","2-1",2,1,"1",1,3,1,"H"
2012-05-01,2011,"Montpellier HSC","Evian Thonon Gaillard","2-2",2,2,"1",1,4,0,"D"
2012-05-02,2011,"OGC Nice","Lille OSC","0-1",0,1,"1",1,1,-1,"D"
2012-05-02,2011,"SM Caen","FC Lorient","1-0",1,0,"1",1,1,1,"H"
2012-05-02,2011,"Olympique Marseille","AS Nancy","1-0",1,0,"1",1,1,1,"H"
2012-05-02,2011,"Girondins Bordeaux","Stade Rennes","2-0",2,0,"1",1,2,2,"H"
2012-05-02,2011,"AC Ajaccio","FC Sochaux","2-1",2,1,"1",1,3,1,"H"
2012-05-02,2011,"Stade Brest","Toulouse FC","0-0",0,0,"1",1,0,0,"D"
2012-05-02,2011,"Olympique Lyon","Valenciennes FC","4-1",4,1,"1",1,5,3,"H"
2012-05-02,2011,"Paris Saint-Germain","AS Saint-Etienne","2-0",2,0,"1",1,2,2,"H"
2012-05-03,2011,"Dijon FCO","AJ Auxerre","0-2",0,2,"1",1,2,-2,"D"
2012-05-06,2011,"Evian Thonon Gaillard","AC Ajaccio","2-1",2,1,"1",1,3,1,"H"
2012-05-06,2011,"Olympique Lyon","Stade Brest","1-1",1,1,"1",1,2,0,"D"
2012-05-06,2011,"Valenciennes FC","Paris Saint-Germain","3-4",3,4,"1",1,7,-1,"D"
2012-05-07,2011,"AJ Auxerre","Girondins Bordeaux","2-4",2,4,"1",1,6,-2,"D"
2012-05-07,2011,"Lille OSC","SM Caen","3-0",3,0,"1",1,3,3,"H"
2012-05-07,2011,"FC Lorient","Dijon FCO","0-0",0,0,"1",1,0,0,"D"
2012-05-07,2011,"AS Saint-Etienne","Olympique Marseille","0-0",0,0,"1",1,0,0,"D"
2012-05-07,2011,"FC Sochaux","AS Nancy","1-0",1,0,"1",1,1,1,"H"
2012-05-07,2011,"Toulouse FC","OGC Nice","0-0",0,0,"1",1,0,0,"D"
2012-05-07,2011,"Stade Rennes","Montpellier HSC","0-2",0,2,"1",1,2,-2,"D"
2012-05-10,2011,"Evian Thonon Gaillard","Olympique Lyon","1-3",1,3,"1",1,4,-2,"D"
2012-05-13,2011,"Olympique Marseille","AJ Auxerre","3-0",3,0,"1",1,3,3,"H"
2012-05-13,2011,"OGC Nice","Evian Thonon Gaillard","1-1",1,1,"1",1,2,0,"D"
2012-05-13,2011,"Montpellier HSC","Lille OSC","1-0",1,0,"1",1,1,1,"H"
2012-05-13,2011,"Girondins Bordeaux","FC Lorient","1-0",1,0,"1",1,1,1,"H"
2012-05-13,2011,"AC Ajaccio","Olympique Lyon","1-1",1,1,"1",1,2,0,"D"
2012-05-13,2011,"Paris Saint-Germain","Stade Rennes","3-0",3,0,"1",1,3,3,"H"
2012-05-13,2011,"SM Caen","FC Sochaux","1-3",1,3,"1",1,4,-2,"D"
2012-05-13,2011,"Dijon FCO","Toulouse FC","1-1",1,1,"1",1,2,0,"D"
2012-05-13,2011,"Stade Brest","Valenciennes FC","1-0",1,0,"1",1,1,1,"H"
2012-05-13,2011,"AS Nancy","AS Saint-Etienne","3-2",3,2,"1",1,5,1,"H"
2012-05-20,2011,"Toulouse FC","AC Ajaccio","0-2",0,2,"1",1,2,-2,"D"
2012-05-20,2011,"AS Saint-Etienne","Girondins Bordeaux","2-3",2,3,"1",1,5,-1,"D"
2012-05-20,2011,"Evian Thonon Gaillard","Stade Brest","0-1",0,1,"1",1,1,-1,"D"
2012-05-20,2011,"Valenciennes FC","SM Caen","3-1",3,1,"1",1,4,2,"H"
2012-05-20,2011,"Stade Rennes","Dijon FCO","5-0",5,0,"1",1,5,5,"H"
2012-05-20,2011,"FC Sochaux","Olympique Marseille","1-0",1,0,"1",1,1,1,"H"
2012-05-20,2011,"AJ Auxerre","Montpellier HSC","1-2",1,2,"1",1,3,-1,"D"
2012-05-20,2011,"Lille OSC","AS Nancy","4-1",4,1,"1",1,5,3,"H"
2012-05-20,2011,"Olympique Lyon","OGC Nice","3-4",3,4,"1",1,7,-1,"D"
2012-05-20,2011,"FC Lorient","Paris Saint-Germain","1-2",1,2,"1",1,3,-1,"D"
2012-08-10,2012,"Montpellier HSC","Toulouse FC","1-1",1,1,"1",1,2,0,"D"
2012-08-11,2012,"AS Nancy","Stade Brest","1-0",1,0,"1",1,1,1,"H"
2012-08-11,2012,"AS Saint-Etienne","Lille OSC","1-2",1,2,"1",1,3,-1,"D"
2012-08-11,2012,"ESTAC Troyes","Valenciennes FC","0-1",0,1,"1",1,1,-1,"D"
2012-08-11,2012,"Evian Thonon Gaillard","Girondins Bordeaux","2-3",2,3,"1",1,5,-1,"D"
2012-08-11,2012,"FC Sochaux","SC Bastia","2-3",2,3,"1",1,5,-1,"D"
2012-08-11,2012,"OGC Nice","AC Ajaccio","0-1",0,1,"1",1,1,-1,"D"
2012-08-11,2012,"Paris Saint-Germain","FC Lorient","2-2",2,2,"1",1,4,0,"D"
2012-08-11,2012,"Stade Rennes","Olympique Lyon","0-1",0,1,"1",1,1,-1,"D"
2012-08-12,2012,"Stade Reims","Olympique Marseille","0-1",0,1,"1",1,1,-1,"D"
2012-08-17,2012,"Lille OSC","AS Nancy","1-1",1,1,"1",1,2,0,"D"
2012-08-18,2012,"Olympique Lyon","ESTAC Troyes","4-1",4,1,"1",1,5,3,"H"
2012-08-18,2012,"FC Lorient","Montpellier HSC","2-1",2,1,"1",1,3,1,"H"
2012-08-18,2012,"SC Bastia","Stade Reims","2-1",2,1,"1",1,3,1,"H"
2012-08-18,2012,"Stade Brest","Evian Thonon Gaillard","1-0",1,0,"1",1,1,1,"H"
2012-08-18,2012,"Toulouse FC","AS Saint-Etienne","2-1",2,1,"1",1,3,1,"H"
2012-08-18,2012,"Valenciennes FC","OGC Nice","0-0",0,0,"1",1,0,0,"D"
2012-08-19,2012,"Girondins Bordeaux","Stade Rennes","1-0",1,0,"1",1,1,1,"H"
2012-08-19,2012,"Olympique Marseille","FC Sochaux","2-0",2,0,"1",1,2,2,"H"
2012-08-19,2012,"AC Ajaccio","Paris Saint-Germain","0-0",0,0,"1",1,0,0,"D"
2012-08-24,2012,"Evian Thonon Gaillard","Olympique Lyon","1-1",1,1,"1",1,2,0,"D"
2012-08-25,2012,"OGC Nice","Lille OSC","2-2",2,2,"1",1,4,0,"D"
2012-08-25,2012,"AS Nancy","Toulouse FC","0-1",0,1,"1",1,1,-1,"D"
2012-08-25,2012,"ESTAC Troyes","FC Lorient","2-2",2,2,"1",1,4,0,"D"
2012-08-25,2012,"Stade Reims","FC Sochaux","1-0",1,0,"1",1,1,1,"H"
2012-08-25,2012,"Stade Rennes","SC Bastia","3-2",3,2,"1",1,5,1,"H"
2012-08-25,2012,"Valenciennes FC","AC Ajaccio","3-0",3,0,"1",1,3,3,"H"
2012-08-26,2012,"AS Saint-Etienne","Stade Brest","4-0",4,0,"1",1,4,4,"H"
2012-08-26,2012,"Montpellier HSC","Olympique Marseille","0-1",0,1,"1",1,1,-1,"D"
2012-08-26,2012,"Paris Saint-Germain","Girondins Bordeaux","0-0",0,0,"1",1,0,0,"D"
2012-09-01,2012,"Olympique Lyon","Valenciennes FC","3-2",3,2,"1",1,5,1,"H"
2012-09-01,2012,"AC Ajaccio","Evian Thonon Gaillard","2-0",2,0,"1",1,2,2,"H"
2012-09-01,2012,"FC Lorient","AS Nancy","3-0",3,0,"1",1,3,3,"H"
2012-09-01,2012,"FC Sochaux","Montpellier HSC","1-3",1,3,"1",1,4,-2,"D"
2012-09-01,2012,"SC Bastia","AS Saint-Etienne","0-3",0,3,"1",1,3,-3,"D"
2012-09-01,2012,"Stade Brest","ESTAC Troyes","2-1",2,1,"1",1,3,1,"H"
2012-09-01,2012,"Toulouse FC","Stade Reims","1-1",1,1,"1",1,2,0,"D"
2012-09-02,2012,"Girondins Bordeaux","OGC Nice","1-1",1,1,"1",1,2,0,"D"
2012-09-02,2012,"Olympique Marseille","Stade Rennes","3-1",3,1,"1",1,4,2,"H"
2012-09-02,2012,"Lille OSC","Paris Saint-Germain","1-2",1,2,"1",1,3,-1,"D"
2012-09-14,2012,"Paris Saint-Germain","Toulouse FC","2-0",2,0,"1",1,2,2,"H"
2012-09-14,2012,"Stade Reims","Montpellier HSC","3-1",3,1,"1",1,4,2,"H"
2012-09-15,2012,"ESTAC Troyes","Lille OSC","1-1",1,1,"1",1,2,0,"D"
2012-09-15,2012,"AS Saint-Etienne","FC Sochaux","0-1",0,1,"1",1,1,-1,"D"
2012-09-15,2012,"Evian Thonon Gaillard","SC Bastia","3-0",3,0,"1",1,3,3,"H"
2012-09-15,2012,"OGC Nice","Stade Brest","4-2",4,2,"1",1,6,2,"H"
2012-09-15,2012,"Valenciennes FC","Girondins Bordeaux","0-0",0,0,"1",1,0,0,"D"
2012-09-16,2012,"Stade Rennes","FC Lorient","1-2",1,2,"1",1,3,-1,"D"
2012-09-16,2012,"Olympique Lyon","AC Ajaccio","2-0",2,0,"1",1,2,2,"H"
2012-09-16,2012,"AS Nancy","Olympique Marseille","0-1",0,1,"1",1,1,-1,"D"
2012-09-21,2012,"Montpellier HSC","AS Saint-Etienne","1-1",1,1,"1",1,2,0,"D"
2012-09-22,2012,"SC Bastia","Paris Saint-Germain","0-4",0,4,"1",1,4,-4,"D"
2012-09-22,2012,"FC Lorient","OGC Nice","1-1",1,1,"1",1,2,0,"D"
2012-09-22,2012,"FC Sochaux","ESTAC Troyes","3-1",3,1,"1",1,4,2,"H"
2012-09-22,2012,"Stade Brest","Valenciennes FC","2-1",2,1,"1",1,3,1,"H"
2012-09-22,2012,"Stade Reims","AS Nancy","2-0",2,0,"1",1,2,2,"H"
2012-09-22,2012,"Toulouse FC","Stade Rennes","2-2",2,2,"1",1,4,0,"D"
2012-09-23,2012,"Girondins Bordeaux","AC Ajaccio","2-2",2,2,"1",1,4,0,"D"
2012-09-23,2012,"Olympique Marseille","Evian Thonon Gaillard","1-0",1,0,"1",1,1,1,"H"
2012-09-23,2012,"Lille OSC","Olympique Lyon","1-1",1,1,"1",1,2,0,"D"
2012-09-28,2012,"Stade Rennes","Lille OSC","2-0",2,0,"1",1,2,2,"H"
2012-09-29,2012,"Paris Saint-Germain","FC Sochaux","2-0",2,0,"1",1,2,2,"H"
2012-09-29,2012,"AC Ajaccio","Stade Brest","1-0",1,0,"1",1,1,1,"H"
2012-09-29,2012,"AS Nancy","Montpellier HSC","0-2",0,2,"1",1,2,-2,"D"
2012-09-29,2012,"ESTAC Troyes","Toulouse FC","0-2",0,2,"1",1,2,-2,"D"
2012-09-29,2012,"Evian Thonon Gaillard","FC Lorient","1-1",1,1,"1",1,2,0,"D"
2012-09-29,2012,"OGC Nice","SC Bastia","2-2",2,2,"1",1,4,0,"D"
2012-09-30,2012,"Valenciennes FC","Olympique Marseille","4-1",4,1,"1",1,5,3,"H"
2012-09-30,2012,"AS Saint-Etienne","Stade Reims","0-0",0,0,"1",1,0,0,"D"
2012-09-30,2012,"Olympique Lyon","Girondins Bordeaux","0-2",0,2,"1",1,2,-2,"D"
2012-10-05,2012,"AS Saint-Etienne","AS Nancy","4-0",4,0,"1",1,4,4,"H"
2012-10-06,2012,"Montpellier HSC","Evian Thonon Gaillard","2-3",2,3,"1",1,5,-1,"D"
2012-10-06,2012,"FC Sochaux","Stade Rennes","0-1",0,1,"1",1,1,-1,"D"
2012-10-06,2012,"Lille OSC","AC Ajaccio","2-0",2,0,"1",1,2,2,"H"
2012-10-06,2012,"SC Bastia","ESTAC Troyes","3-2",3,2,"1",1,5,1,"H"
2012-10-06,2012,"Stade Reims","OGC Nice","3-1",3,1,"1",1,4,2,"H"
2012-10-06,2012,"Toulouse FC","Valenciennes FC","2-2",2,2,"1",1,4,0,"D"
2012-10-07,2012,"Stade Brest","Girondins Bordeaux","1-1",1,1,"1",1,2,0,"D"
2012-10-07,2012,"FC Lorient","Olympique Lyon","1-1",1,1,"1",1,2,0,"D"
2012-10-07,2012,"Olympique Marseille","Paris Saint-Germain","2-2",2,2,"1",1,4,0,"D"
2012-10-19,2012,"Girondins Bordeaux","Lille OSC","1-1",1,1,"1",1,2,0,"D"
2012-10-20,2012,"Paris Saint-Germain","Stade Reims","1-0",1,0,"1",1,1,1,"H"
2012-10-20,2012,"AS Nancy","FC Sochaux","1-1",1,1,"1",1,2,0,"D"
2012-10-20,2012,"Evian Thonon Gaillard","Toulouse FC","0-4",0,4,"1",1,4,-4,"D"
2012-10-20,2012,"OGC Nice","AS Saint-Etienne","1-1",1,1,"1",1,2,0,"D"
2012-10-20,2012,"Stade Rennes","Montpellier HSC","2-1",2,1,"1",1,3,1,"H"
2012-10-20,2012,"Valenciennes FC","FC Lorient","6-1",6,1,"1",1,7,5,"H"
2012-10-21,2012,"AC Ajaccio","SC Bastia","0-0",0,0,"1",1,0,0,"D"
2012-10-21,2012,"Olympique Lyon","Stade Brest","1-0",1,0,"1",1,1,1,"H"
2012-10-21,2012,"ESTAC Troyes","Olympique Marseille","1-0",1,0,"1",1,1,1,"H"
2012-10-26,2012,"AS Saint-Etienne","Stade Rennes","2-0",2,0,"1",1,2,2,"H"
2012-10-27,2012,"Lille OSC","Valenciennes FC","2-1",2,1,"1",1,3,1,"H"
2012-10-27,2012,"AS Nancy","Paris Saint-Germain","0-1",0,1,"1",1,1,-1,"D"
2012-10-27,2012,"Montpellier HSC","OGC Nice","3-1",3,1,"1",1,4,2,"H"
2012-10-27,2012,"Stade Reims","ESTAC Troyes","1-1",1,1,"1",1,2,0,"D"
2012-10-27,2012,"Toulouse FC","Stade Brest","3-1",3,1,"1",1,4,2,"H"
2012-10-28,2012,"FC Lorient","AC Ajaccio","4-4",4,4,"1",1,8,0,"D"
2012-10-28,2012,"SC Bastia","Girondins Bordeaux","3-1",3,1,"1",1,4,2,"H"
2012-11-02,2012,"Stade Brest","FC Lorient","2-0",2,0,"1",1,2,2,"H"
2012-11-03,2012,"Paris Saint-Germain","AS Saint-Etienne","1-2",1,2,"1",1,3,-1,"D"
2012-11-03,2012,"ESTAC Troyes","Montpellier HSC","1-1",1,1,"1",1,2,0,"D"
2012-11-03,2012,"Evian Thonon Gaillard","Lille OSC","0-2",0,2,"1",1,2,-2,"D"
2012-11-03,2012,"OGC Nice","AS Nancy","2-1",2,1,"1",1,3,1,"H"
2012-11-03,2012,"Stade Rennes","Stade Reims","1-0",1,0,"1",1,1,1,"H"
2012-11-03,2012,"Valenciennes FC","FC Sochaux","3-1",3,1,"1",1,4,2,"H"
2012-11-04,2012,"AC Ajaccio","Olympique Marseille","0-2",0,2,"1",1,2,-2,"D"
2012-11-04,2012,"Olympique Lyon","SC Bastia","5-2",5,2,"1",1,7,3,"H"
2012-11-04,2012,"Girondins Bordeaux","Toulouse FC","1-0",1,0,"1",1,1,1,"H"
2012-11-07,2012,"FC Sochaux","Evian Thonon Gaillard","2-1",2,1,"1",1,3,1,"H"
2012-11-09,2012,"AS Nancy","Stade Rennes","1-3",1,3,"1",1,4,-2,"D"
2012-11-10,2012,"Lille OSC","Stade Brest","1-0",1,0,"1",1,1,1,"H"
2012-11-10,2012,"AS Saint-Etienne","ESTAC Troyes","2-0",2,0,"1",1,2,2,"H"
2012-11-10,2012,"SC Bastia","Valenciennes FC","2-3",2,3,"1",1,5,-1,"D"
2012-11-10,2012,"Stade Reims","Evian Thonon Gaillard","1-2",1,2,"1",1,3,-1,"D"
2012-11-10,2012,"Toulouse FC","AC Ajaccio","2-4",2,4,"1",1,6,-2,"D"
2012-11-11,2012,"Olympique Marseille","OGC Nice","2-2",2,2,"1",1,4,0,"D"
2012-11-11,2012,"FC Lorient","Girondins Bordeaux","0-4",0,4,"1",1,4,-4,"D"
2012-11-11,2012,"FC Sochaux","Olympique Lyon","1-1",1,1,"1",1,2,0,"D"
2012-11-11,2012,"Montpellier HSC","Paris Saint-Germain","1-1",1,1,"1",1,2,0,"D"
2012-11-16,2012,"FC Lorient","Lille OSC","2-0",2,0,"1",1,2,2,"H"
2012-11-17,2012,"Paris Saint-Germain","Stade Rennes","1-2",1,2,"1",1,3,-1,"D"
2012-11-17,2012,"AC Ajaccio","FC Sochaux","0-1",0,1,"1",1,1,-1,"D"
2012-11-17,2012,"ESTAC Troyes","AS Nancy","3-3",3,3,"1",1,6,0,"D"
2012-11-17,2012,"Evian Thonon Gaillard","AS Saint-Etienne","2-2",2,2,"1",1,4,0,"D"
2012-11-17,2012,"Stade Brest","SC Bastia","3-0",3,0,"1",1,3,3,"H"
2012-11-17,2012,"Valenciennes FC","Montpellier HSC","1-1",1,1,"1",1,2,0,"D"
2012-11-18,2012,"Olympique Lyon","Stade Reims","3-0",3,0,"1",1,3,3,"H"
2012-11-18,2012,"OGC Nice","Toulouse FC","1-0",1,0,"1",1,1,1,"H"
2012-11-18,2012,"Girondins Bordeaux","Olympique Marseille","1-0",1,0,"1",1,1,1,"H"
2012-11-23,2012,"AS Saint-Etienne","Valenciennes FC","1-0",1,0,"1",1,1,1,"H"
2012-11-24,2012,"Paris Saint-Germain","ESTAC Troyes","4-0",4,0,"1",1,4,4,"H"
2012-11-24,2012,"AS Nancy","AC Ajaccio","1-1",1,1,"1",1,2,0,"D"
2012-11-24,2012,"FC Sochaux","OGC Nice","0-1",0,1,"1",1,1,-1,"D"
2012-11-24,2012,"SC Bastia","FC Lorient","2-1",2,1,"1",1,3,1,"H"
2012-11-24,2012,"Stade Reims","Stade Brest","0-0",0,0,"1",1,0,0,"D"
2012-11-24,2012,"Stade Rennes","Evian Thonon Gaillard","0-1",0,1,"1",1,1,-1,"D"
2012-11-25,2012,"Montpellier HSC","Girondins Bordeaux","1-0",1,0,"1",1,1,1,"H"
2012-11-25,2012,"Toulouse FC","Olympique Lyon","3-0",3,0,"1",1,3,3,"H"
2012-11-25,2012,"Olympique Marseille","Lille OSC","1-0",1,0,"1",1,1,1,"H"
2012-11-28,2012,"Olympique Marseille","Olympique Lyon","1-4",1,4,"1",1,5,-3,"D"
2012-11-30,2012,"AC Ajaccio","AS Saint-Etienne","0-0",0,0,"1",1,0,0,"D"
2012-12-01,2012,"Olympique Lyon","Montpellier HSC","1-0",1,0,"1",1,1,1,"H"
2012-12-01,2012,"Evian Thonon Gaillard","AS Nancy","1-1",1,1,"1",1,2,0,"D"
2012-12-01,2012,"Girondins Bordeaux","FC Sochaux","2-2",2,2,"1",1,4,0,"D"
2012-12-01,2012,"Lille OSC","SC Bastia","0-0",0,0,"1",1,0,0,"D"
2012-12-01,2012,"OGC Nice","Paris Saint-Germain","2-1",2,1,"1",1,3,1,"H"
2012-12-01,2012,"Valenciennes FC","Stade Reims","1-0",1,0,"1",1,1,1,"H"
2012-12-02,2012,"Stade Brest","Olympique Marseille","1-2",1,2,"1",1,3,-1,"D"
2012-12-02,2012,"ESTAC Troyes","Stade Rennes","2-3",2,3,"1",1,5,-1,"D"
2012-12-02,2012,"FC Lorient","Toulouse FC","1-0",1,0,"1",1,1,1,"H"
2012-12-07,2012,"Toulouse FC","SC Bastia","0-0",0,0,"1",1,0,0,"D"
2012-12-08,2012,"Paris Saint-Germain","Evian Thonon Gaillard","4-0",4,0,"1",1,4,4,"H"
2012-12-08,2012,"AS Nancy","Valenciennes FC","1-1",1,1,"1",1,2,0,"D"
2012-12-08,2012,"ESTAC Troyes","OGC Nice","1-1",1,1,"1",1,2,0,"D"
2012-12-08,2012,"FC Sochaux","Lille OSC","1-1",1,1,"1",1,2,0,"D"
2012-12-08,2012,"Montpellier HSC","AC Ajaccio","3-0",3,0,"1",1,3,3,"H"
2012-12-08,2012,"Stade Rennes","Stade Brest","2-2",2,2,"1",1,4,0,"D"
2012-12-09,2012,"Stade Reims","Girondins Bordeaux","0-0",0,0,"1",1,0,0,"D"
2012-12-09,2012,"Olympique Marseille","FC Lorient","0-3",0,3,"1",1,3,-3,"D"
2012-12-09,2012,"AS Saint-Etienne","Olympique Lyon","0-1",0,1,"1",1,1,-1,"D"
2012-12-11,2012,"OGC Nice","Stade Rennes","1-0",1,0,"1",1,1,1,"H"
2012-12-11,2012,"Valenciennes FC","Paris Saint-Germain","0-4",0,4,"1",1,4,-4,"D"
2012-12-11,2012,"Lille OSC","Toulouse FC","2-0",2,0,"1",1,2,2,"H"
2012-12-12,2012,"AC Ajaccio","Stade Reims","2-0",2,0,"1",1,2,2,"H"
2012-12-12,2012,"Evian Thonon Gaillard","ESTAC Troyes","2-0",2,0,"1",1,2,2,"H"
2012-12-12,2012,"FC Lorient","FC Sochaux","2-0",2,0,"1",1,2,2,"H"
2012-12-12,2012,"Olympique Lyon","AS Nancy","1-1",1,1,"1",1,2,0,"D"
2012-12-12,2012,"Stade Brest","Montpellier HSC","1-2",1,2,"1",1,3,-1,"D"
2012-12-12,2012,"SC Bastia","Olympique Marseille","1-2",1,2,"1",1,3,-1,"D"
2012-12-13,2012,"Girondins Bordeaux","AS Saint-Etienne","0-0",0,0,"1",1,0,0,"D"
2012-12-14,2012,"Stade Rennes","Valenciennes FC","2-0",2,0,"1",1,2,2,"H"
2012-12-15,2012,"Toulouse FC","Olympique Marseille","0-1",0,1,"1",1,1,-1,"D"
2012-12-15,2012,"ESTAC Troyes","AC Ajaccio","3-2",3,2,"1",1,5,1,"H"
2012-12-15,2012,"FC Sochaux","Stade Brest","1-2",1,2,"1",1,3,-1,"D"
2012-12-15,2012,"Montpellier HSC","SC Bastia","4-0",4,0,"1",1,4,4,"H"
2012-12-15,2012,"OGC Nice","Evian Thonon Gaillard","3-2",3,2,"1",1,5,1,"H"
2012-12-15,2012,"Stade Reims","Lille OSC","1-1",1,1,"1",1,2,0,"D"
2012-12-16,2012,"AS Nancy","Girondins Bordeaux","1-1",1,1,"1",1,2,0,"D"
2012-12-16,2012,"AS Saint-Etienne","FC Lorient","0-2",0,2,"1",1,2,-2,"D"
2012-12-16,2012,"Paris Saint-Germain","Olympique Lyon","1-0",1,0,"1",1,1,1,"H"
2012-12-21,2012,"Stade Brest","Paris Saint-Germain","0-3",0,3,"1",1,3,-3,"D"
2012-12-22,2012,"Lille OSC","Montpellier HSC","4-1",4,1,"1",1,5,3,"H"
2012-12-22,2012,"AC Ajaccio","Stade Rennes","2-4",2,4,"1",1,6,-2,"D"
2012-12-22,2012,"FC Lorient","Stade Reims","2-2",2,2,"1",1,4,0,"D"
2012-12-22,2012,"Girondins Bordeaux","ESTAC Troyes","0-0",0,0,"1",1,0,0,"D"
2012-12-22,2012,"Olympique Lyon","OGC Nice","3-0",3,0,"1",1,3,3,"H"
2012-12-22,2012,"SC Bastia","AS Nancy","4-2",4,2,"1",1,6,2,"H"
2012-12-23,2012,"Valenciennes FC","Evian Thonon Gaillard","2-1",2,1,"1",1,3,1,"H"
2012-12-23,2012,"Toulouse FC","FC Sochaux","2-0",2,0,"1",1,2,2,"H"
2012-12-23,2012,"Olympique Marseille","AS Saint-Etienne","1-0",1,0,"1",1,1,1,"H"
2013-01-11,2012,"AS Saint-Etienne","Toulouse FC","2-2",2,2,"1",1,4,0,"D"
2013-01-11,2012,"Paris Saint-Germain","AC Ajaccio","0-0",0,0,"1",1,0,0,"D"
2013-01-12,2012,"ESTAC Troyes","Olympique Lyon","1-2",1,2,"1",1,3,-1,"D"
2013-01-12,2012,"AS Nancy","Lille OSC","2-2",2,2,"1",1,4,0,"D"
2013-01-12,2012,"Evian Thonon Gaillard","Stade Brest","0-2",0,2,"1",1,2,-2,"D"
2013-01-12,2012,"Montpellier HSC","FC Lorient","2-0",2,0,"1",1,2,2,"H"
2013-01-12,2012,"Stade Rennes","Girondins Bordeaux","0-2",0,2,"1",1,2,-2,"D"
2013-01-13,2012,"Stade Reims","SC Bastia","1-2",1,2,"1",1,3,-1,"D"
2013-01-13,2012,"OGC Nice","Valenciennes FC","5-0",5,0,"1",1,5,5,"H"
2013-01-13,2012,"FC Sochaux","Olympique Marseille","3-1",3,1,"1",1,4,2,"H"
2013-01-18,2012,"Olympique Lyon","Evian Thonon Gaillard","0-0",0,0,"1",1,0,0,"D"
2013-01-19,2012,"FC Sochaux","Stade Reims","1-0",1,0,"1",1,1,1,"H"
2013-01-19,2012,"Olympique Marseille","Montpellier HSC","3-2",3,2,"1",1,5,1,"H"
2013-01-19,2012,"AC Ajaccio","Valenciennes FC","1-1",1,1,"1",1,2,0,"D"
2013-01-19,2012,"FC Lorient","ESTAC Troyes","3-2",3,2,"1",1,5,1,"H"
2013-01-19,2012,"Stade Brest","AS Saint-Etienne","0-1",0,1,"1",1,1,-1,"D"
2013-01-19,2012,"Toulouse FC","AS Nancy","2-1",2,1,"1",1,3,1,"H"
2013-01-20,2012,"SC Bastia","Stade Rennes","0-2",0,2,"1",1,2,-2,"D"
2013-01-20,2012,"Lille OSC","OGC Nice","0-2",0,2,"1",1,2,-2,"D"
2013-01-20,2012,"Girondins Bordeaux","Paris Saint-Germain","0-1",0,1,"1",1,1,-1,"D"
2013-01-25,2012,"Valenciennes FC","Olympique Lyon","0-2",0,2,"1",1,2,-2,"D"
2013-01-26,2012,"Stade Rennes","Olympique Marseille","2-2",2,2,"1",1,4,0,"D"
2013-01-26,2012,"AS Nancy","FC Lorient","2-1",2,1,"1",1,3,1,"H"
2013-01-26,2012,"ESTAC Troyes","Stade Brest","2-1",2,1,"1",1,3,1,"H"
2013-01-26,2012,"Evian Thonon Gaillard","AC Ajaccio","1-1",1,1,"1",1,2,0,"D"
2013-01-26,2012,"Montpellier HSC","FC Sochaux","2-0",2,0,"1",1,2,2,"H"
2013-01-26,2012,"Stade Reims","Toulouse FC","1-1",1,1,"1",1,2,0,"D"
2013-01-27,2012,"AS Saint-Etienne","SC Bastia","3-0",3,0,"1",1,3,3,"H"
2013-01-27,2012,"OGC Nice","Girondins Bordeaux","0-1",0,1,"1",1,1,-1,"D"
2013-01-27,2012,"Paris Saint-Germain","Lille OSC","1-0",1,0,"1",1,1,1,"H"
2013-02-01,2012,"Toulouse FC","Paris Saint-Germain","0-4",0,4,"1",1,4,-4,"D"
2013-02-02,2012,"FC Lorient","Stade Rennes","2-2",2,2,"1",1,4,0,"D"
2013-02-02,2012,"FC Sochaux","AS Saint-Etienne","1-2",1,2,"1",1,3,-1,"D"
2013-02-02,2012,"Girondins Bordeaux","Valenciennes FC","2-0",2,0,"1",1,2,2,"H"
2013-02-02,2012,"Lille OSC","ESTAC Troyes","1-1",1,1,"1",1,2,0,"D"
2013-02-02,2012,"SC Bastia","Evian Thonon Gaillard","0-0",0,0,"1",1,0,0,"D"
2013-02-02,2012,"Stade Brest","OGC Nice","0-2",0,2,"1",1,2,-2,"D"
2013-02-03,2012,"AC Ajaccio","Olympique Lyon","3-1",3,1,"1",1,4,2,"H"
2013-02-03,2012,"Montpellier HSC","Stade Reims","3-1",3,1,"1",1,4,2,"H"
2013-02-03,2012,"Olympique Marseille","AS Nancy","0-1",0,1,"1",1,1,-1,"D"
2013-02-08,2012,"Paris Saint-Germain","SC Bastia","3-1",3,1,"1",1,4,2,"H"
2013-02-09,2012,"AS Saint-Etienne","Montpellier HSC","4-1",4,1,"1",1,5,3,"H"
2013-02-09,2012,"AC Ajaccio","Girondins Bordeaux","1-0",1,0,"1",1,1,1,"H"
2013-02-09,2012,"AS Nancy","Stade Reims","1-2",1,2,"1",1,3,-1,"D"
2013-02-09,2012,"ESTAC Troyes","FC Sochaux","0-0",0,0,"1",1,0,0,"D"
2013-02-09,2012,"OGC Nice","FC Lorient","1-1",1,1,"1",1,2,0,"D"
2013-02-09,2012,"Valenciennes FC","Stade Brest","2-1",2,1,"1",1,3,1,"H"
2013-02-10,2012,"Evian Thonon Gaillard","Olympique Marseille","1-1",1,1,"1",1,2,0,"D"
2013-02-10,2012,"Stade Rennes","Toulouse FC","2-0",2,0,"1",1,2,2,"H"
2013-02-10,2012,"Olympique Lyon","Lille OSC","1-3",1,3,"1",1,4,-2,"D"
2013-02-15,2012,"Lille OSC","Stade Rennes","2-0",2,0,"1",1,2,2,"H"
2013-02-16,2012,"Olympique Marseille","Valenciennes FC","1-0",1,0,"1",1,1,1,"H"
2013-02-16,2012,"FC Lorient","Evian Thonon Gaillard","2-1",2,1,"1",1,3,1,"H"
2013-02-16,2012,"Montpellier HSC","AS Nancy","1-0",1,0,"1",1,1,1,"H"
2013-02-16,2012,"SC Bastia","OGC Nice","0-1",0,1,"1",1,1,-1,"D"
2013-02-16,2012,"Stade Brest","AC Ajaccio","1-1",1,1,"1",1,2,0,"D"
2013-02-16,2012,"Toulouse FC","ESTAC Troyes","2-2",2,2,"1",1,4,0,"D"
2013-02-17,2012,"Girondins Bordeaux","Olympique Lyon","0-4",0,4,"1",1,4,-4,"D"
2013-02-17,2012,"Stade Reims","AS Saint-Etienne","1-1",1,1,"1",1,2,0,"D"
2013-02-17,2012,"FC Sochaux","Paris Saint-Germain","3-2",3,2,"1",1,5,1,"H"
2013-02-22,2012,"OGC Nice","Stade Reims","2-0",2,0,"1",1,2,2,"H"
2013-02-23,2012,"Stade Rennes","FC Sochaux","2-2",2,2,"1",1,4,0,"D"
2013-02-23,2012,"AC Ajaccio","Lille OSC","1-3",1,3,"1",1,4,-2,"D"
2013-02-23,2012,"AS Nancy","AS Saint-Etienne","0-3",0,3,"1",1,3,-3,"D"
2013-02-23,2012,"ESTAC Troyes","SC Bastia","0-0",0,0,"1",1,0,0,"D"
2013-02-23,2012,"Evian Thonon Gaillard","Montpellier HSC","0-1",0,1,"1",1,1,-1,"D"
2013-02-23,2012,"Valenciennes FC","Toulouse FC","0-0",0,0,"1",1,0,0,"D"
2013-02-24,2012,"Olympique Lyon","FC Lorient","3-1",3,1,"1",1,4,2,"H"
2013-02-24,2012,"Girondins Bordeaux","Stade Brest","0-2",0,2,"1",1,2,-2,"D"
2013-02-24,2012,"Paris Saint-Germain","Olympique Marseille","2-0",2,0,"1",1,2,2,"H"
2013-03-01,2012,"Montpellier HSC","Stade Rennes","2-0",2,0,"1",1,2,2,"H"
2013-03-02,2012,"Stade Reims","Paris Saint-Germain","1-0",1,0,"1",1,1,1,"H"
2013-03-02,2012,"AS Saint-Etienne","OGC Nice","4-0",4,0,"1",1,4,4,"H"
2013-03-02,2012,"FC Lorient","Valenciennes FC","1-1",1,1,"1",1,2,0,"D"
2013-03-02,2012,"FC Sochaux","AS Nancy","1-2",1,2,"1",1,3,-1,"D"
2013-03-02,2012,"SC Bastia","AC Ajaccio","1-0",1,0,"1",1,1,1,"H"
2013-03-02,2012,"Toulouse FC","Evian Thonon Gaillard","0-0",0,0,"1",1,0,0,"D"
2013-03-03,2012,"Stade Brest","Olympique Lyon","1-1",1,1,"1",1,2,0,"D"
2013-03-03,2012,"Olympique Marseille","ESTAC Troyes","2-1",2,1,"1",1,3,1,"H"
2013-03-03,2012,"Lille OSC","Girondins Bordeaux","2-1",2,1,"1",1,3,1,"H"
2013-03-08,2012,"Stade Rennes","AS Saint-Etienne","2-2",2,2,"1",1,4,0,"D"
2013-03-09,2012,"Paris Saint-Germain","AS Nancy","2-1",2,1,"1",1,3,1,"H"
2013-03-09,2012,"AC Ajaccio","FC Lorient","1-0",1,0,"1",1,1,1,"H"
2013-03-09,2012,"ESTAC Troyes","Stade Reims","4-2",4,2,"1",1,6,2,"H"
2013-03-09,2012,"Evian Thonon Gaillard","FC Sochaux","5-1",5,1,"1",1,6,4,"H"
2013-03-09,2012,"Stade Brest","Toulouse FC","0-1",0,1,"1",1,1,-1,"D"
2013-03-09,2012,"Valenciennes FC","Lille OSC","1-3",1,3,"1",1,4,-2,"D"
2013-03-10,2012,"OGC Nice","Montpellier HSC","2-0",2,0,"1",1,2,2,"H"
2013-03-10,2012,"Girondins Bordeaux","SC Bastia","1-0",1,0,"1",1,1,1,"H"
2013-03-10,2012,"Olympique Lyon","Olympique Marseille","0-0",0,0,"1",1,0,0,"D"
2013-03-15,2012,"Olympique Marseille","AC Ajaccio","0-0",0,0,"1",1,0,0,"D"
2013-03-16,2012,"SC Bastia","Olympique Lyon","4-1",4,1,"1",1,5,3,"H"
2013-03-16,2012,"FC Lorient","Stade Brest","4-0",4,0,"1",1,4,4,"H"
2013-03-16,2012,"FC Sochaux","Valenciennes FC","1-1",1,1,"1",1,2,0,"D"
2013-03-16,2012,"Lille OSC","Evian Thonon Gaillard","1-2",1,2,"1",1,3,-1,"D"
2013-03-16,2012,"Montpellier HSC","ESTAC Troyes","1-1",1,1,"1",1,2,0,"D"
2013-03-16,2012,"Stade Reims","Stade Rennes","1-0",1,0,"1",1,1,1,"H"
2013-03-17,2012,"AS Nancy","OGC Nice","1-0",1,0,"1",1,1,1,"H"
2013-03-17,2012,"Toulouse FC","Girondins Bordeaux","0-0",0,0,"1",1,0,0,"D"
2013-03-17,2012,"AS Saint-Etienne","Paris Saint-Germain","2-2",2,2,"1",1,4,0,"D"
2013-03-29,2012,"Paris Saint-Germain","Montpellier HSC","1-0",1,0,"1",1,1,1,"H"
2013-03-30,2012,"ESTAC Troyes","AS Saint-Etienne","2-2",2,2,"1",1,4,0,"D"
2013-03-30,2012,"AC Ajaccio","Toulouse FC","2-3",2,3,"1",1,5,-1,"D"
2013-03-30,2012,"Evian Thonon Gaillard","Stade Reims","2-2",2,2,"1",1,4,0,"D"
2013-03-30,2012,"Girondins Bordeaux","FC Lorient","1-1",1,1,"1",1,2,0,"D"
2013-03-30,2012,"Stade Rennes","AS Nancy","0-2",0,2,"1",1,2,-2,"D"
2013-03-30,2012,"Valenciennes FC","SC Bastia","3-4",3,4,"1",1,7,-1,"D"
2013-03-31,2012,"OGC Nice","Olympique Marseille","0-1",0,1,"1",1,1,-1,"D"
2013-03-31,2012,"Stade Brest","Lille OSC","1-2",1,2,"1",1,3,-1,"D"
2013-03-31,2012,"Olympique Lyon","FC Sochaux","1-2",1,2,"1",1,3,-1,"D"
2013-04-05,2012,"Olympique Marseille","Girondins Bordeaux","1-0",1,0,"1",1,1,1,"H"
2013-04-06,2012,"Stade Rennes","Paris Saint-Germain","0-2",0,2,"1",1,2,-2,"D"
2013-04-06,2012,"AS Nancy","ESTAC Troyes","1-0",1,0,"1",1,1,1,"H"
2013-04-06,2012,"FC Sochaux","AC Ajaccio","0-0",0,0,"1",1,0,0,"D"
2013-04-06,2012,"Montpellier HSC","Valenciennes FC","3-1",3,1,"1",1,4,2,"H"
2013-04-06,2012,"SC Bastia","Stade Brest","4-0",4,0,"1",1,4,4,"H"
2013-04-06,2012,"Toulouse FC","OGC Nice","3-4",3,4,"1",1,7,-1,"D"
2013-04-07,2012,"AS Saint-Etienne","Evian Thonon Gaillard","1-0",1,0,"1",1,1,1,"H"
2013-04-07,2012,"Stade Reims","Olympique Lyon","1-0",1,0,"1",1,1,1,"H"
2013-04-07,2012,"Lille OSC","FC Lorient","5-0",5,0,"1",1,5,5,"H"
2013-04-12,2012,"Valenciennes FC","AS Saint-Etienne","0-0",0,0,"1",1,0,0,"D"
2013-04-13,2012,"ESTAC Troyes","Paris Saint-Germain","0-1",0,1,"1",1,1,-1,"D"
2013-04-13,2012,"AC Ajaccio","AS Nancy","1-1",1,1,"1",1,2,0,"D"
2013-04-13,2012,"Evian Thonon Gaillard","Stade Rennes","4-2",4,2,"1",1,6,2,"H"
2013-04-13,2012,"FC Lorient","SC Bastia","4-1",4,1,"1",1,5,3,"H"
2013-04-13,2012,"Girondins Bordeaux","Montpellier HSC","4-2",4,2,"1",1,6,2,"H"
2013-04-13,2012,"Stade Brest","Stade Reims","0-2",0,2,"1",1,2,-2,"D"
2013-04-14,2012,"OGC Nice","FC Sochaux","3-0",3,0,"1",1,3,3,"H"
2013-04-14,2012,"Olympique Lyon","Toulouse FC","3-1",3,1,"1",1,4,2,"H"
2013-04-14,2012,"Lille OSC","Olympique Marseille","0-0",0,0,"1",1,0,0,"D"
2013-04-19,2012,"Montpellier HSC","Olympique Lyon","1-2",1,2,"1",1,3,-1,"D"
2013-04-20,2012,"Olympique Marseille","Stade Brest","1-0",1,0,"1",1,1,1,"H"
2013-04-21,2012,"SC Bastia","Lille OSC","1-2",1,2,"1",1,3,-1,"D"
2013-04-21,2012,"AS Nancy","Evian Thonon Gaillard","3-1",3,1,"1",1,4,2,"H"
2013-04-21,2012,"FC Sochaux","Girondins Bordeaux","2-2",2,2,"1",1,4,0,"D"
2013-04-21,2012,"Stade Reims","Valenciennes FC","0-1",0,1,"1",1,1,-1,"D"
2013-04-21,2012,"Toulouse FC","FC Lorient","0-1",0,1,"1",1,1,-1,"D"
2013-04-21,2012,"Paris Saint-Germain","OGC Nice","3-0",3,0,"1",1,3,3,"H"
2013-04-24,2012,"AS Saint-Etienne","AC Ajaccio","4-2",4,2,"1",1,6,2,"H"
2013-04-24,2012,"Stade Rennes","ESTAC Troyes","1-2",1,2,"1",1,3,-1,"D"
2013-04-26,2012,"Lille OSC","FC Sochaux","3-3",3,3,"1",1,6,0,"D"
2013-04-27,2012,"FC Lorient","Olympique Marseille","0-1",0,1,"1",1,1,-1,"D"
2013-04-27,2012,"AC Ajaccio","Montpellier HSC","2-1",2,1,"1",1,3,1,"H"
2013-04-27,2012,"Girondins Bordeaux","Stade Reims","0-0",0,0,"1",1,0,0,"D"
2013-04-27,2012,"SC Bastia","Toulouse FC","0-0",0,0,"1",1,0,0,"D"
2013-04-27,2012,"Stade Brest","Stade Rennes","0-2",0,2,"1",1,2,-2,"D"
2013-04-27,2012,"Valenciennes FC","AS Nancy","0-0",0,0,"1",1,0,0,"D"
2013-04-28,2012,"Olympique Lyon","AS Saint-Etienne","1-1",1,1,"1",1,2,0,"D"
2013-04-28,2012,"OGC Nice","ESTAC Troyes","3-1",3,1,"1",1,4,2,"H"
2013-04-28,2012,"Evian Thonon Gaillard","Paris Saint-Germain","0-1",0,1,"1",1,1,-1,"D"
2013-05-03,2012,"AS Saint-Etienne","Girondins Bordeaux","0-0",0,0,"1",1,0,0,"D"
2013-05-04,2012,"Olympique Marseille","SC Bastia","2-1",2,1,"1",1,3,1,"H"
2013-05-04,2012,"ESTAC Troyes","Evian Thonon Gaillard","1-0",1,0,"1",1,1,1,"H"
2013-05-04,2012,"FC Sochaux","FC Lorient","1-0",1,0,"1",1,1,1,"H"
2013-05-04,2012,"Montpellier HSC","Stade Brest","2-1",2,1,"1",1,3,1,"H"
2013-05-04,2012,"Stade Reims","AC Ajaccio","1-1",1,1,"1",1,2,0,"D"
2013-05-04,2012,"Toulouse FC","Lille OSC","4-2",4,2,"1",1,6,2,"H"
2013-05-05,2012,"Stade Rennes","OGC Nice","0-3",0,3,"1",1,3,-3,"D"
2013-05-05,2012,"AS Nancy","Olympique Lyon","0-3",0,3,"1",1,3,-3,"D"
2013-05-05,2012,"Paris Saint-Germain","Valenciennes FC","1-1",1,1,"1",1,2,0,"D"
2013-05-10,2012,"Lille OSC","Stade Reims","3-0",3,0,"1",1,3,3,"H"
2013-05-11,2012,"Olympique Marseille","Toulouse FC","2-1",2,1,"1",1,3,1,"H"
2013-05-11,2012,"AC Ajaccio","ESTAC Troyes","0-1",0,1,"1",1,1,-1,"D"
2013-05-11,2012,"Girondins Bordeaux","AS Nancy","3-2",3,2,"1",1,5,1,"H"
2013-05-11,2012,"SC Bastia","Montpellier HSC","3-1",3,1,"1",1,4,2,"H"
2013-05-11,2012,"Stade Brest","FC Sochaux","0-2",0,2,"1",1,2,-2,"D"
2013-05-11,2012,"Valenciennes FC","Stade Rennes","4-1",4,1,"1",1,5,3,"H"
2013-05-12,2012,"FC Lorient","AS Saint-Etienne","3-1",3,1,"1",1,4,2,"H"
2013-05-12,2012,"Evian Thonon Gaillard","OGC Nice","4-0",4,0,"1",1,4,4,"H"
2013-05-12,2012,"Olympique Lyon","Paris Saint-Germain","0-1",0,1,"1",1,1,-1,"D"
2013-05-18,2012,"AS Nancy","SC Bastia","1-2",1,2,"1",1,3,-1,"D"
2013-05-18,2012,"AS Saint-Etienne","Olympique Marseille","2-0",2,0,"1",1,2,2,"H"
2013-05-18,2012,"ESTAC Troyes","Girondins Bordeaux","1-0",1,0,"1",1,1,1,"H"
2013-05-18,2012,"Evian Thonon Gaillard","Valenciennes FC","2-0",2,0,"1",1,2,2,"H"
2013-05-18,2012,"FC Sochaux","Toulouse FC","1-2",1,2,"1",1,3,-1,"D"
2013-05-18,2012,"Montpellier HSC","Lille OSC","0-0",0,0,"1",1,0,0,"D"
2013-05-18,2012,"Paris Saint-Germain","Stade Brest","3-1",3,1,"1",1,4,2,"H"
2013-05-18,2012,"Stade Reims","FC Lorient","1-0",1,0,"1",1,1,1,"H"
2013-05-18,2012,"Stade Rennes","AC Ajaccio","1-1",1,1,"1",1,2,0,"D"
2013-05-19,2012,"OGC Nice","Olympique Lyon","1-1",1,1,"1",1,2,0,"D"
2013-05-26,2012,"AC Ajaccio","OGC Nice","0-2",0,2,"1",1,2,-2,"D"
2013-05-26,2012,"FC Lorient","Paris Saint-Germain","1-3",1,3,"1",1,4,-2,"D"
2013-05-26,2012,"Girondins Bordeaux","Evian Thonon Gaillard","2-1",2,1,"1",1,3,1,"H"
2013-05-26,2012,"Lille OSC","AS Saint-Etienne","1-1",1,1,"1",1,2,0,"D"
2013-05-26,2012,"Olympique Marseille","Stade Reims","0-0",0,0,"1",1,0,0,"D"
2013-05-26,2012,"Olympique Lyon","Stade Rennes","2-0",2,0,"1",1,2,2,"H"
2013-05-26,2012,"SC Bastia","FC Sochaux","0-0",0,0,"1",1,0,0,"D"
2013-05-26,2012,"Stade Brest","AS Nancy","1-2",1,2,"1",1,3,-1,"D"
2013-05-26,2012,"Toulouse FC","Montpellier HSC","2-0",2,0,"1",1,2,2,"H"
2013-05-26,2012,"Valenciennes FC","ESTAC Troyes","2-1",2,1,"1",1,3,1,"H"
2013-08-09,2013,"Montpellier HSC","Paris Saint-Germain","1-1",1,1,"1",1,2,0,"D"
2013-08-10,2013,"Girondins Bordeaux","AS Monaco","0-2",0,2,"1",1,2,-2,"D"
2013-08-10,2013,"Evian Thonon Gaillard","FC Sochaux","1-1",1,1,"1",1,2,0,"D"
2013-08-10,2013,"Lille OSC","FC Lorient","1-0",1,0,"1",1,1,1,"H"
2013-08-10,2013,"Olympique Lyon","OGC Nice","4-0",4,0,"1",1,4,4,"H"
2013-08-10,2013,"FC Nantes","SC Bastia","0-0",0,0,"1",1,0,0,"D"
2013-08-10,2013,"Stade Rennes","Stade Reims","2-1",2,1,"1",1,3,1,"H"
2013-08-10,2013,"Valenciennes FC","Toulouse FC","3-0",3,0,"1",1,3,3,"H"
2013-08-11,2013,"AC Ajaccio","AS Saint-Etienne","0-1",0,1,"1",1,1,-1,"D"
2013-08-11,2013,"EA Guingamp","Olympique Marseille","1-3",1,3,"1",1,4,-2,"D"
2013-08-16,2013,"FC Sochaux","Olympique Lyon","1-3",1,3,"1",1,4,-2,"D"
2013-08-17,2013,"Olympique Marseille","Evian Thonon Gaillard","2-0",2,0,"1",1,2,2,"H"
2013-08-17,2013,"SC Bastia","Valenciennes FC","2-0",2,0,"1",1,2,2,"H"
2013-08-17,2013,"OGC Nice","Stade Rennes","2-1",2,1,"1",1,3,1,"H"
2013-08-17,2013,"Stade Reims","Lille OSC","2-1",2,1,"1",1,3,1,"H"
2013-08-17,2013,"AS Saint-Etienne","EA Guingamp","1-0",1,0,"1",1,1,1,"H"
2013-08-17,2013,"Toulouse FC","Girondins Bordeaux","1-1",1,1,"1",1,2,0,"D"
2013-08-18,2013,"AS Monaco","Montpellier HSC","4-1",4,1,"1",1,5,3,"H"
2013-08-18,2013,"FC Lorient","FC Nantes","2-1",2,1,"1",1,3,1,"H"
2013-08-18,2013,"Paris Saint-Germain","AC Ajaccio","1-1",1,1,"1",1,2,0,"D"
2013-08-23,2013,"AS Monaco","Toulouse FC","0-0",0,0,"1",1,0,0,"D"
2013-08-24,2013,"Valenciennes FC","Olympique Marseille","0-1",0,1,"1",1,1,-1,"D"
2013-08-24,2013,"Girondins Bordeaux","SC Bastia","1-0",1,0,"1",1,1,1,"H"
2013-08-24,2013,"Evian Thonon Gaillard","Stade Rennes","1-2",1,2,"1",1,3,-1,"D"
2013-08-24,2013,"EA Guingamp","FC Lorient","2-0",2,0,"1",1,2,2,"H"
2013-08-24,2013,"Olympique Lyon","Stade Reims","0-1",0,1,"1",1,1,-1,"D"
2013-08-24,2013,"Montpellier HSC","FC Sochaux","2-1",2,1,"1",1,3,1,"H"
2013-08-25,2013,"Lille OSC","AS Saint-Etienne","1-0",1,0,"1",1,1,1,"H"
2013-08-25,2013,"AC Ajaccio","OGC Nice","0-0",0,0,"1",1,0,0,"D"
2013-08-25,2013,"FC Nantes","Paris Saint-Germain","1-2",1,2,"1",1,3,-1,"D"
2013-08-31,2013,"Evian Thonon Gaillard","Olympique Lyon","2-1",2,1,"1",1,3,1,"H"
2013-08-31,2013,"Paris Saint-Germain","EA Guingamp","2-0",2,0,"1",1,2,2,"H"
2013-08-31,2013,"SC Bastia","Toulouse FC","2-1",2,1,"1",1,3,1,"H"
2013-08-31,2013,"FC Lorient","Valenciennes FC","1-0",1,0,"1",1,1,1,"H"
2013-08-31,2013,"Stade Reims","FC Nantes","0-0",0,0,"1",1,0,0,"D"
2013-08-31,2013,"Stade Rennes","Lille OSC","0-0",0,0,"1",1,0,0,"D"
2013-08-31,2013,"FC Sochaux","AC Ajaccio","0-0",0,0,"1",1,0,0,"D"
2013-09-01,2013,"AS Saint-Etienne","Girondins Bordeaux","2-1",2,1,"1",1,3,1,"H"
2013-09-01,2013,"OGC Nice","Montpellier HSC","2-2",2,2,"1",1,4,0,"D"
2013-09-01,2013,"Olympique Marseille","AS Monaco","1-2",1,2,"1",1,3,-1,"D"
2013-09-13,2013,"Girondins Bordeaux","Paris Saint-Germain","0-2",0,2,"1",1,2,-2,"D"
2013-09-14,2013,"Toulouse FC","Olympique Marseille","1-1",1,1,"1",1,2,0,"D"
2013-09-14,2013,"AC Ajaccio","Evian Thonon Gaillard","2-3",2,3,"1",1,5,-1,"D"
2013-09-14,2013,"EA Guingamp","SC Bastia","1-1",1,1,"1",1,2,0,"D"
2013-09-14,2013,"Montpellier HSC","Stade Reims","0-0",0,0,"1",1,0,0,"D"
2013-09-14,2013,"FC Nantes","FC Sochaux","1-0",1,0,"1",1,1,1,"H"
2013-09-14,2013,"Valenciennes FC","AS Saint-Etienne","1-3",1,3,"1",1,4,-2,"D"
2013-09-15,2013,"AS Monaco","FC Lorient","1-0",1,0,"1",1,1,1,"H"
2013-09-15,2013,"Lille OSC","OGC Nice","0-2",0,2,"1",1,2,-2,"D"
2013-09-15,2013,"Olympique Lyon","Stade Rennes","0-0",0,0,"1",1,0,0,"D"
2013-09-20,2013,"AS Saint-Etienne","Toulouse FC","1-2",1,2,"1",1,3,-1,"D"
2013-09-21,2013,"SC Bastia","Olympique Marseille","0-0",0,0,"1",1,0,0,"D"
2013-09-21,2013,"Evian Thonon Gaillard","Montpellier HSC","2-2",2,2,"1",1,4,0,"D"
2013-09-21,2013,"Stade Reims","EA Guingamp","1-1",1,1,"1",1,2,0,"D"
2013-09-21,2013,"Stade Rennes","AC Ajaccio","2-0",2,0,"1",1,2,2,"H"
2013-09-21,2013,"FC Sochaux","Lille OSC","0-2",0,2,"1",1,2,-2,"D"
2013-09-22,2013,"FC Lorient","Girondins Bordeaux","3-3",3,3,"1",1,6,0,"D"
2013-09-22,2013,"Olympique Lyon","FC Nantes","3-1",3,1,"1",1,4,2,"H"
2013-09-22,2013,"OGC Nice","Valenciennes FC","4-0",4,0,"1",1,4,4,"H"
2013-09-22,2013,"Paris Saint-Germain","AS Monaco","1-1",1,1,"1",1,2,0,"D"
2013-09-24,2013,"Lille OSC","Evian Thonon Gaillard","3-0",3,0,"1",1,3,3,"H"
2013-09-24,2013,"Olympique Marseille","AS Saint-Etienne","2-1",2,1,"1",1,3,1,"H"
2013-09-25,2013,"AC Ajaccio","Olympique Lyon","2-1",2,1,"1",1,3,1,"H"
2013-09-25,2013,"Girondins Bordeaux","Stade Reims","0-0",0,0,"1",1,0,0,"D"
2013-09-25,2013,"EA Guingamp","FC Sochaux","5-1",5,1,"1",1,6,4,"H"
2013-09-25,2013,"FC Nantes","OGC Nice","2-0",2,0,"1",1,2,2,"H"
2013-09-25,2013,"Toulouse FC","FC Lorient","1-0",1,0,"1",1,1,1,"H"
2013-09-25,2013,"Valenciennes FC","Paris Saint-Germain","0-1",0,1,"1",1,1,-1,"D"
2013-09-25,2013,"AS Monaco","SC Bastia","3-0",3,0,"1",1,3,3,"H"
2013-09-26,2013,"Montpellier HSC","Stade Rennes","0-0",0,0,"1",1,0,0,"D"
2013-09-28,2013,"FC Lorient","Olympique Marseille","0-2",0,2,"1",1,2,-2,"D"
2013-09-28,2013,"Paris Saint-Germain","Toulouse FC","2-0",2,0,"1",1,2,2,"H"
2013-09-28,2013,"Evian Thonon Gaillard","Girondins Bordeaux","1-1",1,1,"1",1,2,0,"D"
2013-09-28,2013,"Olympique Lyon","Lille OSC","0-0",0,0,"1",1,0,0,"D"
2013-09-28,2013,"OGC Nice","EA Guingamp","1-0",1,0,"1",1,1,1,"H"
2013-09-28,2013,"AS Saint-Etienne","SC Bastia","2-2",2,2,"1",1,4,0,"D"
2013-09-28,2013,"FC Sochaux","Valenciennes FC","2-0",2,0,"1",1,2,2,"H"
2013-09-29,2013,"Stade Rennes","FC Nantes","1-3",1,3,"1",1,4,-2,"D"
2013-09-29,2013,"AC Ajaccio","Montpellier HSC","1-1",1,1,"1",1,2,0,"D"
2013-09-29,2013,"Stade Reims","AS Monaco","1-1",1,1,"1",1,2,0,"D"
2013-10-04,2013,"SC Bastia","FC Lorient","4-1",4,1,"1",1,5,3,"H"
2013-10-05,2013,"AS Monaco","AS Saint-Etienne","2-1",2,1,"1",1,3,1,"H"
2013-10-05,2013,"EA Guingamp","Stade Rennes","2-0",2,0,"1",1,2,2,"H"
2013-10-05,2013,"Lille OSC","AC Ajaccio","3-0",3,0,"1",1,3,3,"H"
2013-10-05,2013,"FC Nantes","Evian Thonon Gaillard","3-0",3,0,"1",1,3,3,"H"
2013-10-05,2013,"Toulouse FC","OGC Nice","1-0",1,0,"1",1,1,1,"H"
2013-10-05,2013,"Valenciennes FC","Stade Reims","1-1",1,1,"1",1,2,0,"D"
2013-10-06,2013,"Montpellier HSC","Olympique Lyon","5-1",5,1,"1",1,6,4,"H"
2013-10-06,2013,"Girondins Bordeaux","FC Sochaux","4-1",4,1,"1",1,5,3,"H"
2013-10-06,2013,"Olympique Marseille","Paris Saint-Germain","1-2",1,2,"1",1,3,-1,"D"
2013-10-18,2013,"OGC Nice","Olympique Marseille","1-0",1,0,"1",1,1,1,"H"
2013-10-18,2013,"Stade Reims","Toulouse FC","1-2",1,2,"1",1,3,-1,"D"
2013-10-19,2013,"Paris Saint-Germain","SC Bastia","4-0",4,0,"1",1,4,4,"H"
2013-10-19,2013,"AC Ajaccio","FC Nantes","0-1",0,1,"1",1,1,-1,"D"
2013-10-19,2013,"Evian Thonon Gaillard","EA Guingamp","1-2",1,2,"1",1,3,-1,"D"
2013-10-19,2013,"Montpellier HSC","Lille OSC","0-1",0,1,"1",1,1,-1,"D"
2013-10-19,2013,"Stade Rennes","Valenciennes FC","2-2",2,2,"1",1,4,0,"D"
2013-10-20,2013,"FC Sochaux","AS Monaco","2-2",2,2,"1",1,4,0,"D"
2013-10-20,2013,"AS Saint-Etienne","FC Lorient","3-2",3,2,"1",1,5,1,"H"
2013-10-20,2013,"Olympique Lyon","Girondins Bordeaux","1-1",1,1,"1",1,2,0,"D"
2013-10-25,2013,"FC Nantes","Lille OSC","0-1",0,1,"1",1,1,-1,"D"
2013-10-26,2013,"Olympique Marseille","Stade Reims","2-3",2,3,"1",1,5,-1,"D"
2013-10-26,2013,"SC Bastia","OGC Nice","1-0",1,0,"1",1,1,1,"H"
2013-10-26,2013,"EA Guingamp","AC Ajaccio","2-1",2,1,"1",1,3,1,"H"
2013-10-26,2013,"FC Lorient","FC Sochaux","2-1",2,1,"1",1,3,1,"H"
2013-10-26,2013,"Toulouse FC","Stade Rennes","0-5",0,5,"1",1,5,-5,"D"
2013-10-26,2013,"Valenciennes FC","Evian Thonon Gaillard","0-1",0,1,"1",1,1,-1,"D"
2013-10-27,2013,"Girondins Bordeaux","Montpellier HSC","2-0",2,0,"1",1,2,2,"H"
2013-10-27,2013,"AS Monaco","Olympique Lyon","2-1",2,1,"1",1,3,1,"H"
2013-10-27,2013,"AS Saint-Etienne","Paris Saint-Germain","2-2",2,2,"1",1,4,0,"D"
2013-11-01,2013,"Paris Saint-Germain","FC Lorient","4-0",4,0,"1",1,4,4,"H"
2013-11-02,2013,"Stade Rennes","Olympique Marseille","1-1",1,1,"1",1,2,0,"D"
2013-11-02,2013,"AC Ajaccio","Valenciennes FC","1-3",1,3,"1",1,4,-2,"D"
2013-11-02,2013,"Evian Thonon Gaillard","Toulouse FC","2-1",2,1,"1",1,3,1,"H"
2013-11-02,2013,"Olympique Lyon","EA Guingamp","2-0",2,0,"1",1,2,2,"H"
2013-11-02,2013,"Stade Reims","SC Bastia","4-2",4,2,"1",1,6,2,"H"
2013-11-02,2013,"FC Sochaux","AS Saint-Etienne","0-0",0,0,"1",1,0,0,"D"
2013-11-03,2013,"OGC Nice","Girondins Bordeaux","1-2",1,2,"1",1,3,-1,"D"
2013-11-03,2013,"Montpellier HSC","FC Nantes","1-1",1,1,"1",1,2,0,"D"
2013-11-03,2013,"Lille OSC","AS Monaco","2-0",2,0,"1",1,2,2,"H"
2013-11-08,2013,"AS Monaco","Evian Thonon Gaillard","1-1",1,1,"1",1,2,0,"D"
2013-11-09,2013,"Paris Saint-Germain","OGC Nice","3-1",3,1,"1",1,4,2,"H"
2013-11-09,2013,"SC Bastia","Stade Rennes","1-0",1,0,"1",1,1,1,"H"
2013-11-09,2013,"EA Guingamp","Lille OSC","0-0",0,0,"1",1,0,0,"D"
2013-11-09,2013,"FC Lorient","Stade Reims","0-0",0,0,"1",1,0,0,"D"
2013-11-09,2013,"Toulouse FC","AC Ajaccio","1-1",1,1,"1",1,2,0,"D"
2013-11-09,2013,"Valenciennes FC","Montpellier HSC","1-1",1,1,"1",1,2,0,"D"
2013-11-10,2013,"Girondins Bordeaux","FC Nantes","0-3",0,3,"1",1,3,-3,"D"
2013-11-10,2013,"Olympique Marseille","FC Sochaux","2-1",2,1,"1",1,3,1,"H"
2013-11-10,2013,"AS Saint-Etienne","Olympique Lyon","1-2",1,2,"1",1,3,-1,"D"
2013-11-22,2013,"AC Ajaccio","Olympique Marseille","1-3",1,3,"1",1,4,-2,"D"
2013-11-23,2013,"Stade Reims","Paris Saint-Germain","0-3",0,3,"1",1,3,-3,"D"
2013-11-23,2013,"Evian Thonon Gaillard","FC Lorient","0-4",0,4,"1",1,4,-4,"D"
2013-11-23,2013,"Olympique Lyon","Valenciennes FC","1-1",1,1,"1",1,2,0,"D"
2013-11-23,2013,"Montpellier HSC","EA Guingamp","1-1",1,1,"1",1,2,0,"D"
2013-11-23,2013,"Stade Rennes","Girondins Bordeaux","1-1",1,1,"1",1,2,0,"D"
2013-11-23,2013,"FC Sochaux","SC Bastia","1-1",1,1,"1",1,2,0,"D"
2013-11-24,2013,"Lille OSC","Toulouse FC","1-0",1,0,"1",1,1,1,"H"
2013-11-24,2013,"OGC Nice","AS Saint-Etienne","0-1",0,1,"1",1,1,-1,"D"
2013-11-24,2013,"FC Nantes","AS Monaco","0-1",0,1,"1",1,1,-1,"D"
2013-11-29,2013,"Olympique Marseille","Montpellier HSC","2-0",2,0,"1",1,2,2,"H"
2013-11-30,2013,"AS Saint-Etienne","Stade Reims","4-0",4,0,"1",1,4,4,"H"
2013-11-30,2013,"AS Monaco","Stade Rennes","2-0",2,0,"1",1,2,2,"H"
2013-11-30,2013,"EA Guingamp","FC Nantes","1-0",1,0,"1",1,1,1,"H"
2013-11-30,2013,"FC Lorient","OGC Nice","3-0",3,0,"1",1,3,3,"H"
2013-11-30,2013,"Toulouse FC","FC Sochaux","5-1",5,1,"1",1,6,4,"H"
2013-11-30,2013,"Valenciennes FC","Lille OSC","0-1",0,1,"1",1,1,-1,"D"
2013-12-01,2013,"Girondins Bordeaux","AC Ajaccio","4-0",4,0,"1",1,4,4,"H"
2013-12-01,2013,"SC Bastia","Evian Thonon Gaillard","2-0",2,0,"1",1,2,2,"H"
2013-12-01,2013,"Paris Saint-Germain","Olympique Lyon","4-0",4,0,"1",1,4,4,"H"
2013-12-03,2013,"Lille OSC","Olympique Marseille","1-0",1,0,"1",1,1,1,"H"
2013-12-03,2013,"FC Nantes","Valenciennes FC","2-1",2,1,"1",1,3,1,"H"
2013-12-03,2013,"OGC Nice","AS Monaco","0-3",0,3,"1",1,3,-3,"D"
2013-12-04,2013,"AC Ajaccio","SC Bastia","1-1",1,1,"1",1,2,0,"D"
2013-12-04,2013,"EA Guingamp","Girondins Bordeaux","0-1",0,1,"1",1,1,-1,"D"
2013-12-04,2013,"Montpellier HSC","FC Lorient","0-2",0,2,"1",1,2,-2,"D"
2013-12-04,2013,"Stade Rennes","AS Saint-Etienne","3-1",3,1,"1",1,4,2,"H"
2013-12-04,2013,"FC Sochaux","Stade Reims","0-2",0,2,"1",1,2,-2,"D"
2013-12-04,2013,"Evian Thonon Gaillard","Paris Saint-Germain","2-0",2,0,"1",1,2,2,"H"
2013-12-05,2013,"Olympique Lyon","Toulouse FC","1-1",1,1,"1",1,2,0,"D"
2013-12-06,2013,"Olympique Marseille","FC Nantes","0-1",0,1,"1",1,1,-1,"D"
2013-12-07,2013,"Paris Saint-Germain","FC Sochaux","5-0",5,0,"1",1,5,5,"H"
2013-12-07,2013,"FC Lorient","Stade Rennes","2-0",2,0,"1",1,2,2,"H"
2013-12-07,2013,"Stade Reims","OGC Nice","1-0",1,0,"1",1,1,1,"H"
2013-12-07,2013,"Valenciennes FC","EA Guingamp","1-1",1,1,"1",1,2,0,"D"
2013-12-08,2013,"Girondins Bordeaux","Lille OSC","1-0",1,0,"1",1,1,1,"H"
2013-12-08,2013,"SC Bastia","Olympique Lyon","1-3",1,3,"1",1,4,-2,"D"
2013-12-08,2013,"Toulouse FC","Montpellier HSC","1-1",1,1,"1",1,2,0,"D"
2013-12-08,2013,"AS Monaco","AC Ajaccio","1-0",1,0,"1",1,1,1,"H"
2013-12-13,2013,"Montpellier HSC","AS Saint-Etienne","0-1",0,1,"1",1,1,-1,"D"
2013-12-14,2013,"Stade Rennes","Paris Saint-Germain","1-3",1,3,"1",1,4,-2,"D"
2013-12-14,2013,"AC Ajaccio","FC Lorient","1-2",1,2,"1",1,3,-1,"D"
2013-12-14,2013,"Evian Thonon Gaillard","Stade Reims","1-1",1,1,"1",1,2,0,"D"
2013-12-14,2013,"EA Guingamp","AS Monaco","0-2",0,2,"1",1,2,-2,"D"
2013-12-14,2013,"FC Nantes","Toulouse FC","1-2",1,2,"1",1,3,-1,"D"
2013-12-14,2013,"OGC Nice","FC Sochaux","1-0",1,0,"1",1,1,1,"H"
2013-12-15,2013,"Girondins Bordeaux","Valenciennes FC","2-1",2,1,"1",1,3,1,"H"
2013-12-15,2013,"Lille OSC","SC Bastia","2-1",2,1,"1",1,3,1,"H"
2013-12-15,2013,"Olympique Lyon","Olympique Marseille","2-2",2,2,"1",1,4,0,"D"
2013-12-20,2013,"AS Monaco","Valenciennes FC","1-2",1,2,"1",1,3,-1,"D"
2013-12-21,2013,"AS Saint-Etienne","FC Nantes","2-0",2,0,"1",1,2,2,"H"
2013-12-21,2013,"SC Bastia","Montpellier HSC","0-0",0,0,"1",1,0,0,"D"
2013-12-21,2013,"OGC Nice","Evian Thonon Gaillard","3-1",3,1,"1",1,4,2,"H"
2013-12-21,2013,"Stade Reims","AC Ajaccio","4-1",4,1,"1",1,5,3,"H"
2013-12-21,2013,"FC Sochaux","Stade Rennes","2-1",2,1,"1",1,3,1,"H"
2013-12-21,2013,"Toulouse FC","EA Guingamp","0-0",0,0,"1",1,0,0,"D"
2013-12-22,2013,"Olympique Marseille","Girondins Bordeaux","2-2",2,2,"1",1,4,0,"D"
2013-12-22,2013,"FC Lorient","Olympique Lyon","2-2",2,2,"1",1,4,0,"D"
2013-12-22,2013,"Paris Saint-Germain","Lille OSC","2-2",2,2,"1",1,4,0,"D"
2014-01-08,2013,"AS Saint-Etienne","Evian Thonon Gaillard","1-0",1,0,"1",1,1,1,"H"
2014-01-10,2013,"Montpellier HSC","AS Monaco","1-1",1,1,"1",1,2,0,"D"
2014-01-11,2013,"AC Ajaccio","Paris Saint-Germain","1-2",1,2,"1",1,3,-1,"D"
2014-01-11,2013,"Girondins Bordeaux","Toulouse FC","0-1",0,1,"1",1,1,-1,"D"
2014-01-11,2013,"EA Guingamp","AS Saint-Etienne","0-0",0,0,"1",1,0,0,"D"
2014-01-11,2013,"Olympique Lyon","FC Sochaux","2-0",2,0,"1",1,2,2,"H"
2014-01-11,2013,"Stade Rennes","OGC Nice","0-0",0,0,"1",1,0,0,"D"
2014-01-11,2013,"Valenciennes FC","SC Bastia","3-2",3,2,"1",1,5,1,"H"
2014-01-12,2013,"FC Nantes","FC Lorient","1-0",1,0,"1",1,1,1,"H"
2014-01-12,2013,"Evian Thonon Gaillard","Olympique Marseille","1-2",1,2,"1",1,3,-1,"D"
2014-01-12,2013,"Lille OSC","Stade Reims","1-2",1,2,"1",1,3,-1,"D"
2014-01-17,2013,"AS Saint-Etienne","Lille OSC","2-0",2,0,"1",1,2,2,"H"
2014-01-18,2013,"SC Bastia","Girondins Bordeaux","1-0",1,0,"1",1,1,1,"H"
2014-01-18,2013,"FC Lorient","EA Guingamp","2-0",2,0,"1",1,2,2,"H"
2014-01-18,2013,"OGC Nice","AC Ajaccio","2-0",2,0,"1",1,2,2,"H"
2014-01-18,2013,"Stade Rennes","Evian Thonon Gaillard","0-0",0,0,"1",1,0,0,"D"
2014-01-18,2013,"FC Sochaux","Montpellier HSC","0-2",0,2,"1",1,2,-2,"D"
2014-01-19,2013,"Stade Reims","Olympique Lyon","0-2",0,2,"1",1,2,-2,"D"
2014-01-19,2013,"Toulouse FC","AS Monaco","0-2",0,2,"1",1,2,-2,"D"
2014-01-19,2013,"Paris Saint-Germain","FC Nantes","5-0",5,0,"1",1,5,5,"H"
2014-01-24,2013,"Lille OSC","Stade Rennes","1-1",1,1,"1",1,2,0,"D"
2014-01-25,2013,"EA Guingamp","Paris Saint-Germain","1-1",1,1,"1",1,2,0,"D"
2014-01-25,2013,"AC Ajaccio","FC Sochaux","1-1",1,1,"1",1,2,0,"D"
2014-01-25,2013,"Montpellier HSC","OGC Nice","3-1",3,1,"1",1,4,2,"H"
2014-01-25,2013,"FC Nantes","Stade Reims","0-0",0,0,"1",1,0,0,"D"
2014-01-25,2013,"Valenciennes FC","FC Lorient","1-1",1,1,"1",1,2,0,"D"
2014-01-26,2013,"Olympique Lyon","Evian Thonon Gaillard","3-0",3,0,"1",1,3,3,"H"
2014-01-26,2013,"Girondins Bordeaux","AS Saint-Etienne","2-0",2,0,"1",1,2,2,"H"
2014-01-26,2013,"AS Monaco","Olympique Marseille","2-0",2,0,"1",1,2,2,"H"
2014-01-29,2013,"Olympique Marseille","Valenciennes FC","2-1",2,1,"1",1,3,1,"H"
2014-01-31,2013,"Paris Saint-Germain","Girondins Bordeaux","2-0",2,0,"1",1,2,2,"H"
2014-02-01,2013,"FC Lorient","AS Monaco","2-2",2,2,"1",1,4,0,"D"
2014-02-01,2013,"SC Bastia","EA Guingamp","3-2",3,2,"1",1,5,1,"H"
2014-02-01,2013,"Evian Thonon Gaillard","AC Ajaccio","1-1",1,1,"1",1,2,0,"D"
2014-02-01,2013,"Stade Reims","Montpellier HSC","2-4",2,4,"1",1,6,-2,"D"
2014-02-01,2013,"AS Saint-Etienne","Valenciennes FC","3-0",3,0,"1",1,3,3,"H"
2014-02-01,2013,"FC Sochaux","FC Nantes","1-0",1,0,"1",1,1,1,"H"
2014-02-02,2013,"OGC Nice","Lille OSC","1-0",1,0,"1",1,1,1,"H"
2014-02-02,2013,"Stade Rennes","Olympique Lyon","2-0",2,0,"1",1,2,2,"H"
2014-02-02,2013,"Olympique Marseille","Toulouse FC","2-2",2,2,"1",1,4,0,"D"
2014-02-07,2013,"Toulouse FC","AS Saint-Etienne","0-0",0,0,"1",1,0,0,"D"
2014-02-08,2013,"Olympique Marseille","SC Bastia","3-0",3,0,"1",1,3,3,"H"
2014-02-08,2013,"AC Ajaccio","Stade Rennes","3-1",3,1,"1",1,4,2,"H"
2014-02-08,2013,"EA Guingamp","Stade Reims","1-2",1,2,"1",1,3,-1,"D"
2014-02-08,2013,"Lille OSC","FC Sochaux","2-0",2,0,"1",1,2,2,"H"
2014-02-08,2013,"Montpellier HSC","Evian Thonon Gaillard","1-1",1,1,"1",1,2,0,"D"
2014-02-08,2013,"Valenciennes FC","OGC Nice","2-1",2,1,"1",1,3,1,"H"
2014-02-09,2013,"FC Nantes","Olympique Lyon","1-2",1,2,"1",1,3,-1,"D"
2014-02-09,2013,"AS Monaco","Paris Saint-Germain","1-1",1,1,"1",1,2,0,"D"
2014-02-11,2013,"Toulouse FC","SC Bastia","1-3",1,3,"1",1,4,-2,"D"
2014-02-14,2013,"Paris Saint-Germain","Valenciennes FC","3-0",3,0,"1",1,3,3,"H"
2014-02-15,2013,"SC Bastia","AS Monaco","0-2",0,2,"1",1,2,-2,"D"
2014-02-15,2013,"FC Lorient","Toulouse FC","1-3",1,3,"1",1,4,-2,"D"
2014-02-15,2013,"OGC Nice","FC Nantes","0-0",0,0,"1",1,0,0,"D"
2014-02-15,2013,"Stade Reims","Girondins Bordeaux","1-0",1,0,"1",1,1,1,"H"
2014-02-15,2013,"Stade Rennes","Montpellier HSC","2-2",2,2,"1",1,4,0,"D"
2014-02-15,2013,"FC Sochaux","EA Guingamp","1-0",1,0,"1",1,1,1,"H"
2014-02-16,2013,"Olympique Lyon","AC Ajaccio","3-1",3,1,"1",1,4,2,"H"
2014-02-16,2013,"Evian Thonon Gaillard","Lille OSC","2-2",2,2,"1",1,4,0,"D"
2014-02-16,2013,"AS Saint-Etienne","Olympique Marseille","1-1",1,1,"1",1,2,0,"D"
2014-02-21,2013,"AS Monaco","Stade Reims","3-2",3,2,"1",1,5,1,"H"
2014-02-22,2013,"Olympique Marseille","FC Lorient","1-0",1,0,"1",1,1,1,"H"
2014-02-22,2013,"SC Bastia","AS Saint-Etienne","0-2",0,2,"1",1,2,-2,"D"
2014-02-22,2013,"Girondins Bordeaux","Evian Thonon Gaillard","2-1",2,1,"1",1,3,1,"H"
2014-02-22,2013,"EA Guingamp","OGC Nice","1-0",1,0,"1",1,1,1,"H"
2014-02-22,2013,"Montpellier HSC","AC Ajaccio","2-0",2,0,"1",1,2,2,"H"
2014-02-22,2013,"Valenciennes FC","FC Sochaux","2-2",2,2,"1",1,4,0,"D"
2014-02-23,2013,"Toulouse FC","Paris Saint-Germain","2-4",2,4,"1",1,6,-2,"D"
2014-02-23,2013,"FC Nantes","Stade Rennes","0-3",0,3,"1",1,3,-3,"D"
2014-02-23,2013,"Lille OSC","Olympique Lyon","0-0",0,0,"1",1,0,0,"D"
2014-02-25,2013,"Girondins Bordeaux","FC Lorient","3-2",3,2,"1",1,5,1,"H"
2014-02-28,2013,"Evian Thonon Gaillard","FC Nantes","2-0",2,0,"1",1,2,2,"H"
2014-03-01,2013,"AS Saint-Etienne","AS Monaco","2-0",2,0,"1",1,2,2,"H"
2014-03-01,2013,"FC Lorient","SC Bastia","1-1",1,1,"1",1,2,0,"D"
2014-03-01,2013,"OGC Nice","Toulouse FC","0-2",0,2,"1",1,2,-2,"D"
2014-03-01,2013,"Stade Reims","Valenciennes FC","3-1",3,1,"1",1,4,2,"H"
2014-03-01,2013,"Stade Rennes","EA Guingamp","0-2",0,2,"1",1,2,-2,"D"
2014-03-01,2013,"FC Sochaux","Girondins Bordeaux","2-0",2,0,"1",1,2,2,"H"
2014-03-02,2013,"AC Ajaccio","Lille OSC","2-3",2,3,"1",1,5,-1,"D"
2014-03-02,2013,"Olympique Lyon","Montpellier HSC","0-0",0,0,"1",1,0,0,"D"
2014-03-02,2013,"Paris Saint-Germain","Olympique Marseille","2-0",2,0,"1",1,2,2,"H"
2014-03-07,2013,"Olympique Marseille","OGC Nice","0-1",0,1,"1",1,1,-1,"D"
2014-03-08,2013,"SC Bastia","Paris Saint-Germain","0-3",0,3,"1",1,3,-3,"D"
2014-03-08,2013,"EA Guingamp","Evian Thonon Gaillard","0-1",0,1,"1",1,1,-1,"D"
2014-03-08,2013,"AS Monaco","FC Sochaux","2-1",2,1,"1",1,3,1,"H"
2014-03-08,2013,"FC Nantes","AC Ajaccio","2-2",2,2,"1",1,4,0,"D"
2014-03-08,2013,"Toulouse FC","Stade Reims","3-2",3,2,"1",1,5,1,"H"
2014-03-08,2013,"Valenciennes FC","Stade Rennes","2-1",2,1,"1",1,3,1,"H"
2014-03-09,2013,"Lille OSC","Montpellier HSC","2-0",2,0,"1",1,2,2,"H"
2014-03-09,2013,"FC Lorient","AS Saint-Etienne","1-0",1,0,"1",1,1,1,"H"
2014-03-09,2013,"Girondins Bordeaux","Olympique Lyon","1-2",1,2,"1",1,3,-1,"D"
2014-03-14,2013,"Stade Reims","Olympique Marseille","1-1",1,1,"1",1,2,0,"D"
2014-03-15,2013,"Lille OSC","FC Nantes","0-0",0,0,"1",1,0,0,"D"
2014-03-15,2013,"AC Ajaccio","EA Guingamp","1-2",1,2,"1",1,3,-1,"D"
2014-03-15,2013,"Evian Thonon Gaillard","Valenciennes FC","0-1",0,1,"1",1,1,-1,"D"
2014-03-15,2013,"OGC Nice","SC Bastia","2-0",2,0,"1",1,2,2,"H"
2014-03-15,2013,"Stade Rennes","Toulouse FC","2-3",2,3,"1",1,5,-1,"D"
2014-03-15,2013,"FC Sochaux","FC Lorient","2-0",2,0,"1",1,2,2,"H"
2014-03-16,2013,"Montpellier HSC","Girondins Bordeaux","1-1",1,1,"1",1,2,0,"D"
2014-03-16,2013,"Olympique Lyon","AS Monaco","2-3",2,3,"1",1,5,-1,"D"
2014-03-16,2013,"Paris Saint-Germain","AS Saint-Etienne","2-0",2,0,"1",1,2,2,"H"
2014-03-21,2013,"FC Lorient","Paris Saint-Germain","0-1",0,1,"1",1,1,-1,"D"
2014-03-22,2013,"Olympique Marseille","Stade Rennes","0-1",0,1,"1",1,1,-1,"D"
2014-03-22,2013,"SC Bastia","Stade Reims","2-0",2,0,"1",1,2,2,"H"
2014-03-22,2013,"Girondins Bordeaux","OGC Nice","1-1",1,1,"1",1,2,0,"D"
2014-03-22,2013,"FC Nantes","Montpellier HSC","2-1",2,1,"1",1,3,1,"H"
2014-03-22,2013,"Toulouse FC","Evian Thonon Gaillard","1-1",1,1,"1",1,2,0,"D"
2014-03-22,2013,"Valenciennes FC","AC Ajaccio","2-3",2,3,"1",1,5,-1,"D"
2014-03-23,2013,"AS Saint-Etienne","FC Sochaux","3-1",3,1,"1",1,4,2,"H"
2014-03-23,2013,"EA Guingamp","Olympique Lyon","0-1",0,1,"1",1,1,-1,"D"
2014-03-23,2013,"AS Monaco","Lille OSC","1-1",1,1,"1",1,2,0,"D"
2014-03-28,2013,"OGC Nice","Paris Saint-Germain","0-1",0,1,"1",1,1,-1,"D"
2014-03-29,2013,"FC Sochaux","Olympique Marseille","1-1",1,1,"1",1,2,0,"D"
2014-03-29,2013,"AC Ajaccio","Toulouse FC","2-2",2,2,"1",1,4,0,"D"
2014-03-29,2013,"Evian Thonon Gaillard","AS Monaco","1-0",1,0,"1",1,1,1,"H"
2014-03-29,2013,"Montpellier HSC","Valenciennes FC","0-0",0,0,"1",1,0,0,"D"
2014-03-29,2013,"FC Nantes","Girondins Bordeaux","0-0",0,0,"1",1,0,0,"D"
2014-03-29,2013,"Stade Reims","FC Lorient","1-1",1,1,"1",1,2,0,"D"
2014-03-30,2013,"Stade Rennes","SC Bastia","3-0",3,0,"1",1,3,3,"H"
2014-03-30,2013,"Lille OSC","EA Guingamp","1-0",1,0,"1",1,1,1,"H"
2014-03-30,2013,"Olympique Lyon","AS Saint-Etienne","1-2",1,2,"1",1,3,-1,"D"
2014-04-04,2013,"Olympique Marseille","AC Ajaccio","3-1",3,1,"1",1,4,2,"H"
2014-04-05,2013,"Paris Saint-Germain","Stade Reims","3-0",3,0,"1",1,3,3,"H"
2014-04-05,2013,"SC Bastia","FC Sochaux","2-2",2,2,"1",1,4,0,"D"
2014-04-05,2013,"Girondins Bordeaux","Stade Rennes","2-2",2,2,"1",1,4,0,"D"
2014-04-05,2013,"EA Guingamp","Montpellier HSC","1-2",1,2,"1",1,3,-1,"D"
2014-04-05,2013,"FC Lorient","Evian Thonon Gaillard","1-1",1,1,"1",1,2,0,"D"
2014-04-05,2013,"Toulouse FC","Lille OSC","1-2",1,2,"1",1,3,-1,"D"
2014-04-06,2013,"AS Saint-Etienne","OGC Nice","1-1",1,1,"1",1,2,0,"D"
2014-04-06,2013,"Valenciennes FC","Olympique Lyon","1-2",1,2,"1",1,3,-1,"D"
2014-04-06,2013,"AS Monaco","FC Nantes","3-1",3,1,"1",1,4,2,"H"
2014-04-11,2013,"Montpellier HSC","Olympique Marseille","2-3",2,3,"1",1,5,-1,"D"
2014-04-12,2013,"Lille OSC","Valenciennes FC","1-0",1,0,"1",1,1,1,"H"
2014-04-12,2013,"AC Ajaccio","Girondins Bordeaux","1-1",1,1,"1",1,2,0,"D"
2014-04-12,2013,"Evian Thonon Gaillard","SC Bastia","2-1",2,1,"1",1,3,1,"H"
2014-04-12,2013,"OGC Nice","FC Lorient","1-2",1,2,"1",1,3,-1,"D"
2014-04-12,2013,"Stade Rennes","AS Monaco","0-1",0,1,"1",1,1,-1,"D"
2014-04-12,2013,"FC Sochaux","Toulouse FC","2-0",2,0,"1",1,2,2,"H"
2014-04-13,2013,"FC Nantes","EA Guingamp","1-0",1,0,"1",1,1,1,"H"
2014-04-13,2013,"Stade Reims","AS Saint-Etienne","2-2",2,2,"1",1,4,0,"D"
2014-04-13,2013,"Olympique Lyon","Paris Saint-Germain","1-0",1,0,"1",1,1,1,"H"
2014-04-18,2013,"AS Saint-Etienne","Stade Rennes","0-0",0,0,"1",1,0,0,"D"
2014-04-20,2013,"AS Monaco","OGC Nice","1-0",1,0,"1",1,1,1,"H"
2014-04-20,2013,"SC Bastia","AC Ajaccio","2-1",2,1,"1",1,3,1,"H"
2014-04-20,2013,"Girondins Bordeaux","EA Guingamp","5-1",5,1,"1",1,6,4,"H"
2014-04-20,2013,"FC Lorient","Montpellier HSC","4-4",4,4,"1",1,8,0,"D"
2014-04-20,2013,"Stade Reims","FC Sochaux","0-1",0,1,"1",1,1,-1,"D"
2014-04-20,2013,"Valenciennes FC","FC Nantes","2-6",2,6,"1",1,8,-4,"D"
2014-04-20,2013,"Olympique Marseille","Lille OSC","0-0",0,0,"1",1,0,0,"D"
2014-04-23,2013,"Paris Saint-Germain","Evian Thonon Gaillard","1-0",1,0,"1",1,1,1,"H"
2014-04-23,2013,"Toulouse FC","Olympique Lyon","0-0",0,0,"1",1,0,0,"D"
2014-04-25,2013,"FC Nantes","Olympique Marseille","1-1",1,1,"1",1,2,0,"D"
2014-04-26,2013,"AC Ajaccio","AS Monaco","1-4",1,4,"1",1,5,-3,"D"
2014-04-26,2013,"Evian Thonon Gaillard","AS Saint-Etienne","1-2",1,2,"1",1,3,-1,"D"
2014-04-26,2013,"EA Guingamp","Valenciennes FC","1-0",1,0,"1",1,1,1,"H"
2014-04-26,2013,"Montpellier HSC","Toulouse FC","2-1",2,1,"1",1,3,1,"H"
2014-04-26,2013,"OGC Nice","Stade Reims","1-0",1,0,"1",1,1,1,"H"
2014-04-26,2013,"Stade Rennes","FC Lorient","1-1",1,1,"1",1,2,0,"D"
2014-04-27,2013,"FC Sochaux","Paris Saint-Germain","1-1",1,1,"1",1,2,0,"D"
2014-04-27,2013,"Olympique Lyon","SC Bastia","4-1",4,1,"1",1,5,3,"H"
2014-04-27,2013,"Lille OSC","Girondins Bordeaux","2-1",2,1,"1",1,3,1,"H"
2014-05-02,2013,"SC Bastia","Lille OSC","1-1",1,1,"1",1,2,0,"D"
2014-05-04,2013,"AS Saint-Etienne","Montpellier HSC","2-0",2,0,"1",1,2,2,"H"
2014-05-04,2013,"FC Lorient","AC Ajaccio","1-0",1,0,"1",1,1,1,"H"
2014-05-04,2013,"Stade Reims","Evian Thonon Gaillard","1-0",1,0,"1",1,1,1,"H"
2014-05-04,2013,"FC Sochaux","OGC Nice","2-0",2,0,"1",1,2,2,"H"
2014-05-04,2013,"Toulouse FC","FC Nantes","1-1",1,1,"1",1,2,0,"D"
2014-05-04,2013,"Valenciennes FC","Girondins Bordeaux","0-1",0,1,"1",1,1,-1,"D"
2014-05-04,2013,"Olympique Marseille","Olympique Lyon","4-2",4,2,"1",1,6,2,"H"
2014-05-07,2013,"AS Monaco","EA Guingamp","1-1",1,1,"1",1,2,0,"D"
2014-05-07,2013,"Paris Saint-Germain","Stade Rennes","1-2",1,2,"1",1,3,-1,"D"
2014-05-10,2013,"AC Ajaccio","Stade Reims","2-1",2,1,"1",1,3,1,"H"
2014-05-10,2013,"Girondins Bordeaux","Olympique Marseille","1-1",1,1,"1",1,2,0,"D"
2014-05-10,2013,"Evian Thonon Gaillard","OGC Nice","2-0",2,0,"1",1,2,2,"H"
2014-05-10,2013,"EA Guingamp","Toulouse FC","2-0",2,0,"1",1,2,2,"H"
2014-05-10,2013,"Lille OSC","Paris Saint-Germain","1-3",1,3,"1",1,4,-2,"D"
2014-05-10,2013,"Olympique Lyon","FC Lorient","0-1",0,1,"1",1,1,-1,"D"
2014-05-10,2013,"Montpellier HSC","SC Bastia","0-2",0,2,"1",1,2,-2,"D"
2014-05-10,2013,"FC Nantes","AS Saint-Etienne","1-3",1,3,"1",1,4,-2,"D"
2014-05-10,2013,"Stade Rennes","FC Sochaux","1-2",1,2,"1",1,3,-1,"D"
2014-05-10,2013,"Valenciennes FC","AS Monaco","1-2",1,2,"1",1,3,-1,"D"
2014-05-17,2013,"SC Bastia","FC Nantes","0-0",0,0,"1",1,0,0,"D"
2014-05-17,2013,"FC Lorient","Lille OSC","1-4",1,4,"1",1,5,-3,"D"
2014-05-17,2013,"Olympique Marseille","EA Guingamp","1-0",1,0,"1",1,1,1,"H"
2014-05-17,2013,"AS Monaco","Girondins Bordeaux","1-1",1,1,"1",1,2,0,"D"
2014-05-17,2013,"OGC Nice","Olympique Lyon","0-1",0,1,"1",1,1,-1,"D"
2014-05-17,2013,"Paris Saint-Germain","Montpellier HSC","4-0",4,0,"1",1,4,4,"H"
2014-05-17,2013,"Stade Reims","Stade Rennes","1-3",1,3,"1",1,4,-2,"D"
2014-05-17,2013,"AS Saint-Etienne","AC Ajaccio","3-1",3,1,"1",1,4,2,"H"
2014-05-17,2013,"FC Sochaux","Evian Thonon Gaillard","0-3",0,3,"1",1,3,-3,"D"
2014-05-17,2013,"Toulouse FC","Valenciennes FC","3-1",3,1,"1",1,4,2,"H"
2014-08-08,2014,"Stade Reims","Paris Saint-Germain","2-2",2,2,"1",1,4,0,"D"
2014-08-09,2014,"SC Bastia","Olympique Marseille","3-3",3,3,"1",1,6,0,"D"
2014-08-09,2014,"Evian Thonon Gaillard","SM Caen","0-3",0,3,"1",1,3,-3,"D"
2014-08-09,2014,"EA Guingamp","AS Saint-Etienne","0-2",0,2,"1",1,2,-2,"D"
2014-08-09,2014,"Lille OSC","FC Metz","0-0",0,0,"1",1,0,0,"D"
2014-08-09,2014,"Montpellier HSC","Girondins Bordeaux","0-1",0,1,"1",1,1,-1,"D"
2014-08-09,2014,"FC Nantes","RC Lens","1-0",1,0,"1",1,1,1,"H"
2014-08-09,2014,"OGC Nice","Toulouse FC","3-2",3,2,"1",1,5,1,"H"
2014-08-10,2014,"Olympique Lyon","Stade Rennes","2-0",2,0,"1",1,2,2,"H"
2014-08-10,2014,"AS Monaco","FC Lorient","1-2",1,2,"1",1,3,-1,"D"
2014-08-15,2014,"SM Caen","Lille OSC","0-1",0,1,"1",1,1,-1,"D"
2014-08-16,2014,"Paris Saint-Germain","SC Bastia","2-0",2,0,"1",1,2,2,"H"
2014-08-16,2014,"RC Lens","EA Guingamp","0-1",0,1,"1",1,1,-1,"D"
2014-08-16,2014,"FC Lorient","OGC Nice","0-0",0,0,"1",1,0,0,"D"
2014-08-16,2014,"FC Metz","FC Nantes","1-1",1,1,"1",1,2,0,"D"
2014-08-16,2014,"Stade Rennes","Evian Thonon Gaillard","6-2",6,2,"1",1,8,4,"H"
2014-08-16,2014,"Toulouse FC","Olympique Lyon","2-1",2,1,"1",1,3,1,"H"
2014-08-17,2014,"Olympique Marseille","Montpellier HSC","0-2",0,2,"1",1,2,-2,"D"
2014-08-17,2014,"AS Saint-Etienne","Stade Reims","3-1",3,1,"1",1,4,2,"H"
2014-08-17,2014,"Girondins Bordeaux","AS Monaco","4-1",4,1,"1",1,5,3,"H"
2014-08-22,2014,"Evian Thonon Gaillard","Paris Saint-Germain","0-0",0,0,"1",1,0,0,"D"
2014-08-23,2014,"EA Guingamp","Olympique Marseille","0-1",0,1,"1",1,1,-1,"D"
2014-08-23,2014,"SC Bastia","Toulouse FC","1-0",1,0,"1",1,1,1,"H"
2014-08-23,2014,"Lille OSC","FC Lorient","2-0",2,0,"1",1,2,2,"H"
2014-08-23,2014,"Montpellier HSC","FC Metz","2-0",2,0,"1",1,2,2,"H"
2014-08-23,2014,"OGC Nice","Girondins Bordeaux","1-3",1,3,"1",1,4,-2,"D"
2014-08-23,2014,"Stade Reims","SM Caen","0-2",0,2,"1",1,2,-2,"D"
2014-08-24,2014,"Olympique Lyon","RC Lens","0-1",0,1,"1",1,1,-1,"D"
2014-08-24,2014,"AS Saint-Etienne","Stade Rennes","0-0",0,0,"1",1,0,0,"D"
2014-08-24,2014,"FC Nantes","AS Monaco","0-1",0,1,"1",1,1,-1,"D"
2014-08-29,2014,"Olympique Marseille","OGC Nice","4-0",4,0,"1",1,4,4,"H"
2014-08-30,2014,"AS Monaco","Lille OSC","1-1",1,1,"1",1,2,0,"D"
2014-08-30,2014,"SM Caen","Stade Rennes","0-1",0,1,"1",1,1,-1,"D"
2014-08-30,2014,"RC Lens","Stade Reims","4-2",4,2,"1",1,6,2,"H"
2014-08-30,2014,"FC Lorient","EA Guingamp","4-0",4,0,"1",1,4,4,"H"
2014-08-30,2014,"FC Nantes","Montpellier HSC","1-0",1,0,"1",1,1,1,"H"
2014-08-30,2014,"Toulouse FC","Evian Thonon Gaillard","1-0",1,0,"1",1,1,1,"H"
2014-08-31,2014,"Girondins Bordeaux","SC Bastia","1-1",1,1,"1",1,2,0,"D"
2014-08-31,2014,"FC Metz","Olympique Lyon","2-1",2,1,"1",1,3,1,"H"
2014-08-31,2014,"Paris Saint-Germain","AS Saint-Etienne","5-0",5,0,"1",1,5,5,"H"
2014-09-12,2014,"Olympique Lyon","AS Monaco","2-1",2,1,"1",1,3,1,"H"
2014-09-13,2014,"Stade Rennes","Paris Saint-Germain","1-1",1,1,"1",1,2,0,"D"
2014-09-13,2014,"SC Bastia","RC Lens","1-1",1,1,"1",1,2,0,"D"
2014-09-13,2014,"Montpellier HSC","FC Lorient","1-0",1,0,"1",1,1,1,"H"
2014-09-13,2014,"OGC Nice","FC Metz","1-0",1,0,"1",1,1,1,"H"
2014-09-13,2014,"Stade Reims","Toulouse FC","2-0",2,0,"1",1,2,2,"H"
2014-09-13,2014,"AS Saint-Etienne","SM Caen","1-0",1,0,"1",1,1,1,"H"
2014-09-14,2014,"Lille OSC","FC Nantes","2-0",2,0,"1",1,2,2,"H"
2014-09-14,2014,"EA Guingamp","Girondins Bordeaux","2-1",2,1,"1",1,3,1,"H"
2014-09-14,2014,"Evian Thonon Gaillard","Olympique Marseille","1-3",1,3,"1",1,4,-2,"D"
2014-09-19,2014,"Girondins Bordeaux","Evian Thonon Gaillard","2-1",2,1,"1",1,3,1,"H"
2014-09-20,2014,"Olympique Marseille","Stade Rennes","3-0",3,0,"1",1,3,3,"H"
2014-09-20,2014,"FC Lorient","Stade Reims","0-1",0,1,"1",1,1,-1,"D"
2014-09-20,2014,"FC Metz","SC Bastia","3-1",3,1,"1",1,4,2,"H"
2014-09-20,2014,"FC Nantes","OGC Nice","2-1",2,1,"1",1,3,1,"H"
2014-09-20,2014,"Toulouse FC","SM Caen","3-3",3,3,"1",1,6,0,"D"
2014-09-21,2014,"Lille OSC","Montpellier HSC","0-0",0,0,"1",1,0,0,"D"
2014-09-21,2014,"RC Lens","AS Saint-Etienne","0-1",0,1,"1",1,1,-1,"D"
2014-09-21,2014,"AS Monaco","EA Guingamp","1-0",1,0,"1",1,1,1,"H"
2014-09-21,2014,"Paris Saint-Germain","Olympique Lyon","1-1",1,1,"1",1,2,0,"D"
2014-09-23,2014,"Stade Reims","Olympique Marseille","0-5",0,5,"1",1,5,-5,"D"
2014-09-23,2014,"Stade Rennes","Toulouse FC","0-3",0,3,"1",1,3,-3,"D"
2014-09-24,2014,"SC Bastia","FC Nantes","0-0",0,0,"1",1,0,0,"D"
2014-09-24,2014,"Evian Thonon Gaillard","RC Lens","2-1",2,1,"1",1,3,1,"H"
2014-09-24,2014,"EA Guingamp","FC Metz","0-1",0,1,"1",1,1,-1,"D"
2014-09-24,2014,"Olympique Lyon","FC Lorient","4-0",4,0,"1",1,4,4,"H"
2014-09-24,2014,"Montpellier HSC","AS Monaco","0-1",0,1,"1",1,1,-1,"D"
2014-09-24,2014,"OGC Nice","Lille OSC","1-0",1,0,"1",1,1,1,"H"
2014-09-24,2014,"SM Caen","Paris Saint-Germain","0-2",0,2,"1",1,2,-2,"D"
2014-09-25,2014,"AS Saint-Etienne","Girondins Bordeaux","1-1",1,1,"1",1,2,0,"D"
2014-09-27,2014,"AS Monaco","OGC Nice","0-1",0,1,"1",1,1,-1,"D"
2014-09-27,2014,"Toulouse FC","Paris Saint-Germain","1-1",1,1,"1",1,2,0,"D"
2014-09-27,2014,"Lille OSC","SC Bastia","1-0",1,0,"1",1,1,1,"H"
2014-09-27,2014,"FC Lorient","Evian Thonon Gaillard","0-2",0,2,"1",1,2,-2,"D"
2014-09-27,2014,"FC Metz","Stade Reims","3-0",3,0,"1",1,3,3,"H"
2014-09-27,2014,"Montpellier HSC","EA Guingamp","2-1",2,1,"1",1,3,1,"H"
2014-09-28,2014,"Girondins Bordeaux","Stade Rennes","2-1",2,1,"1",1,3,1,"H"
2014-09-28,2014,"RC Lens","SM Caen","0-0",0,0,"1",1,0,0,"D"
2014-09-28,2014,"FC Nantes","Olympique Lyon","1-1",1,1,"1",1,2,0,"D"
2014-09-28,2014,"Olympique Marseille","AS Saint-Etienne","2-1",2,1,"1",1,3,1,"H"
2014-10-03,2014,"Stade Reims","Girondins Bordeaux","1-0",1,0,"1",1,1,1,"H"
2014-10-04,2014,"SM Caen","Olympique Marseille","1-2",1,2,"1",1,3,-1,"D"
2014-10-04,2014,"SC Bastia","FC Lorient","0-2",0,2,"1",1,2,-2,"D"
2014-10-04,2014,"Evian Thonon Gaillard","FC Metz","3-0",3,0,"1",1,3,3,"H"
2014-10-04,2014,"OGC Nice","Montpellier HSC","1-1",1,1,"1",1,2,0,"D"
2014-10-04,2014,"Stade Rennes","RC Lens","2-0",2,0,"1",1,2,2,"H"
2014-10-05,2014,"AS Saint-Etienne","Toulouse FC","0-1",0,1,"1",1,1,-1,"D"
2014-10-05,2014,"EA Guingamp","FC Nantes","0-1",0,1,"1",1,1,-1,"D"
2014-10-05,2014,"Olympique Lyon","Lille OSC","3-0",3,0,"1",1,3,3,"H"
2014-10-05,2014,"Paris Saint-Germain","AS Monaco","1-1",1,1,"1",1,2,0,"D"
2014-10-17,2014,"RC Lens","Paris Saint-Germain","1-3",1,3,"1",1,4,-2,"D"
2014-10-18,2014,"FC Lorient","AS Saint-Etienne","0-1",0,1,"1",1,1,-1,"D"
2014-10-18,2014,"Lille OSC","EA Guingamp","1-2",1,2,"1",1,3,-1,"D"
2014-10-18,2014,"FC Metz","Stade Rennes","0-0",0,0,"1",1,0,0,"D"
2014-10-18,2014,"AS Monaco","Evian Thonon Gaillard","2-0",2,0,"1",1,2,2,"H"
2014-10-18,2014,"FC Nantes","Stade Reims","1-1",1,1,"1",1,2,0,"D"
2014-10-18,2014,"OGC Nice","SC Bastia","0-1",0,1,"1",1,1,-1,"D"
2014-10-19,2014,"Olympique Marseille","Toulouse FC","2-0",2,0,"1",1,2,2,"H"
2014-10-19,2014,"Girondins Bordeaux","SM Caen","1-1",1,1,"1",1,2,0,"D"
2014-10-19,2014,"Olympique Lyon","Montpellier HSC","5-1",5,1,"1",1,6,4,"H"
2014-10-24,2014,"Toulouse FC","RC Lens","0-2",0,2,"1",1,2,-2,"D"
2014-10-25,2014,"Paris Saint-Germain","Girondins Bordeaux","3-0",3,0,"1",1,3,3,"H"
2014-10-25,2014,"SC Bastia","AS Monaco","1-3",1,3,"1",1,4,-2,"D"
2014-10-25,2014,"SM Caen","FC Lorient","2-1",2,1,"1",1,3,1,"H"
2014-10-25,2014,"Evian Thonon Gaillard","FC Nantes","0-2",0,2,"1",1,2,-2,"D"
2014-10-25,2014,"Stade Reims","Montpellier HSC","1-0",1,0,"1",1,1,1,"H"
2014-10-26,2014,"Stade Rennes","Lille OSC","2-0",2,0,"1",1,2,2,"H"
2014-10-26,2014,"EA Guingamp","OGC Nice","2-7",2,7,"1",1,9,-5,"D"
2014-10-26,2014,"AS Saint-Etienne","FC Metz","1-0",1,0,"1",1,1,1,"H"
2014-10-26,2014,"Olympique Lyon","Olympique Marseille","1-0",1,0,"1",1,1,1,"H"
2014-10-31,2014,"AS Monaco","Stade Reims","1-1",1,1,"1",1,2,0,"D"
2014-11-01,2014,"FC Lorient","Paris Saint-Germain","1-2",1,2,"1",1,3,-1,"D"
2014-11-01,2014,"EA Guingamp","SC Bastia","1-0",1,0,"1",1,1,1,"H"
2014-11-01,2014,"Lille OSC","AS Saint-Etienne","1-1",1,1,"1",1,2,0,"D"
2014-11-01,2014,"FC Metz","SM Caen","3-2",3,2,"1",1,5,1,"H"
2014-11-01,2014,"Montpellier HSC","Evian Thonon Gaillard","2-0",2,0,"1",1,2,2,"H"
2014-11-01,2014,"OGC Nice","Olympique Lyon","1-3",1,3,"1",1,4,-2,"D"
2014-11-02,2014,"FC Nantes","Stade Rennes","1-1",1,1,"1",1,2,0,"D"
2014-11-02,2014,"Girondins Bordeaux","Toulouse FC","2-1",2,1,"1",1,3,1,"H"
2014-11-02,2014,"Olympique Marseille","RC Lens","2-1",2,1,"1",1,3,1,"H"
2014-11-07,2014,"Stade Rennes","FC Lorient","1-0",1,0,"1",1,1,1,"H"
2014-11-08,2014,"RC Lens","Girondins Bordeaux","1-2",1,2,"1",1,3,-1,"D"
2014-11-08,2014,"SC Bastia","Montpellier HSC","2-0",2,0,"1",1,2,2,"H"
2014-11-08,2014,"SM Caen","FC Nantes","1-2",1,2,"1",1,3,-1,"D"
2014-11-08,2014,"Evian Thonon Gaillard","OGC Nice","1-0",1,0,"1",1,1,1,"H"
2014-11-08,2014,"Toulouse FC","FC Metz","3-0",3,0,"1",1,3,3,"H"
2014-11-09,2014,"Olympique Lyon","EA Guingamp","3-1",3,1,"1",1,4,2,"H"
2014-11-09,2014,"Stade Reims","Lille OSC","2-0",2,0,"1",1,2,2,"H"
2014-11-09,2014,"AS Saint-Etienne","AS Monaco","1-1",1,1,"1",1,2,0,"D"
2014-11-09,2014,"Paris Saint-Germain","Olympique Marseille","2-0",2,0,"1",1,2,2,"H"
2014-11-21,2014,"FC Metz","Paris Saint-Germain","2-3",2,3,"1",1,5,-1,"D"
2014-11-22,2014,"SC Bastia","Olympique Lyon","0-0",0,0,"1",1,0,0,"D"
2014-11-22,2014,"EA Guingamp","Stade Rennes","0-1",0,1,"1",1,1,-1,"D"
2014-11-22,2014,"FC Lorient","RC Lens","1-0",1,0,"1",1,1,1,"H"
2014-11-22,2014,"AS Monaco","SM Caen","2-2",2,2,"1",1,4,0,"D"
2014-11-22,2014,"OGC Nice","Stade Reims","0-0",0,0,"1",1,0,0,"D"
2014-11-23,2014,"FC Nantes","AS Saint-Etienne","0-0",0,0,"1",1,0,0,"D"
2014-11-23,2014,"Montpellier HSC","Toulouse FC","2-0",2,0,"1",1,2,2,"H"
2014-11-23,2014,"Olympique Marseille","Girondins Bordeaux","3-1",3,1,"1",1,4,2,"H"
2014-11-28,2014,"Olympique Marseille","FC Nantes","2-0",2,0,"1",1,2,2,"H"
2014-11-29,2014,"Paris Saint-Germain","OGC Nice","1-0",1,0,"1",1,1,1,"H"
2014-11-29,2014,"SM Caen","Montpellier HSC","1-1",1,1,"1",1,2,0,"D"
2014-11-29,2014,"RC Lens","FC Metz","2-0",2,0,"1",1,2,2,"H"
2014-11-29,2014,"Stade Reims","SC Bastia","2-1",2,1,"1",1,3,1,"H"
2014-11-29,2014,"Stade Rennes","AS Monaco","2-0",2,0,"1",1,2,2,"H"
2014-11-29,2014,"Toulouse FC","FC Lorient","2-3",2,3,"1",1,5,-1,"D"
2014-11-30,2014,"Girondins Bordeaux","Lille OSC","1-0",1,0,"1",1,1,1,"H"
2014-11-30,2014,"Evian Thonon Gaillard","EA Guingamp","2-0",2,0,"1",1,2,2,"H"
2014-11-30,2014,"AS Saint-Etienne","Olympique Lyon","3-0",3,0,"1",1,3,3,"H"
2014-12-02,2014,"FC Lorient","Olympique Marseille","1-1",1,1,"1",1,2,0,"D"
2014-12-02,2014,"FC Nantes","Toulouse FC","1-2",1,2,"1",1,3,-1,"D"
2014-12-02,2014,"AS Monaco","RC Lens","2-0",2,0,"1",1,2,2,"H"
2014-12-03,2014,"SC Bastia","Evian Thonon Gaillard","1-2",1,2,"1",1,3,-1,"D"
2014-12-03,2014,"EA Guingamp","SM Caen","5-1",5,1,"1",1,6,4,"H"
2014-12-03,2014,"FC Metz","Girondins Bordeaux","0-0",0,0,"1",1,0,0,"D"
2014-12-03,2014,"Montpellier HSC","AS Saint-Etienne","0-2",0,2,"1",1,2,-2,"D"
2014-12-03,2014,"OGC Nice","Stade Rennes","1-2",1,2,"1",1,3,-1,"D"
2014-12-03,2014,"Lille OSC","Paris Saint-Germain","1-1",1,1,"1",1,2,0,"D"
2014-12-04,2014,"Olympique Lyon","Stade Reims","2-1",2,1,"1",1,3,1,"H"
2014-12-05,2014,"Toulouse FC","AS Monaco","0-2",0,2,"1",1,2,-2,"D"
2014-12-06,2014,"Paris Saint-Germain","FC Nantes","2-1",2,1,"1",1,3,1,"H"
2014-12-06,2014,"Girondins Bordeaux","FC Lorient","3-2",3,2,"1",1,5,1,"H"
2014-12-06,2014,"SM Caen","OGC Nice","2-3",2,3,"1",1,5,-1,"D"
2014-12-06,2014,"Stade Rennes","Montpellier HSC","0-4",0,4,"1",1,4,-4,"D"
2014-12-06,2014,"AS Saint-Etienne","SC Bastia","1-0",1,0,"1",1,1,1,"H"
2014-12-07,2014,"Evian Thonon Gaillard","Olympique Lyon","2-3",2,3,"1",1,5,-1,"D"
2014-12-07,2014,"RC Lens","Lille OSC","1-1",1,1,"1",1,2,0,"D"
2014-12-07,2014,"Stade Reims","EA Guingamp","2-3",2,3,"1",1,5,-1,"D"
2014-12-07,2014,"Olympique Marseille","FC Metz","3-1",3,1,"1",1,4,2,"H"
2014-12-12,2014,"Olympique Lyon","SM Caen","3-0",3,0,"1",1,3,3,"H"
2014-12-13,2014,"FC Nantes","Girondins Bordeaux","2-1",2,1,"1",1,3,1,"H"
2014-12-13,2014,"SC Bastia","Stade Rennes","2-0",2,0,"1",1,2,2,"H"
2014-12-13,2014,"FC Lorient","FC Metz","3-1",3,1,"1",1,4,2,"H"
2014-12-13,2014,"Montpellier HSC","RC Lens","3-3",3,3,"1",1,6,0,"D"
2014-12-13,2014,"Stade Reims","Evian Thonon Gaillard","3-2",3,2,"1",1,5,1,"H"
2014-12-14,2014,"OGC Nice","AS Saint-Etienne","0-0",0,0,"1",1,0,0,"D"
2014-12-14,2014,"EA Guingamp","Paris Saint-Germain","1-0",1,0,"1",1,1,1,"H"
2014-12-14,2014,"Lille OSC","Toulouse FC","3-0",3,0,"1",1,3,3,"H"
2014-12-14,2014,"AS Monaco","Olympique Marseille","1-0",1,0,"1",1,1,1,"H"
2014-12-19,2014,"RC Lens","OGC Nice","2-0",2,0,"1",1,2,2,"H"
2014-12-20,2014,"Paris Saint-Germain","Montpellier HSC","0-0",0,0,"1",1,0,0,"D"
2014-12-20,2014,"SM Caen","SC Bastia","1-1",1,1,"1",1,2,0,"D"
2014-12-20,2014,"FC Lorient","FC Nantes","1-2",1,2,"1",1,3,-1,"D"
2014-12-20,2014,"FC Metz","AS Monaco","0-1",0,1,"1",1,1,-1,"D"
2014-12-20,2014,"Stade Rennes","Stade Reims","1-3",1,3,"1",1,4,-2,"D"
2014-12-20,2014,"Toulouse FC","EA Guingamp","1-1",1,1,"1",1,2,0,"D"
2014-12-21,2014,"Olympique Marseille","Lille OSC","2-1",2,1,"1",1,3,1,"H"
2014-12-21,2014,"AS Saint-Etienne","Evian Thonon Gaillard","3-0",3,0,"1",1,3,3,"H"
2014-12-21,2014,"Girondins Bordeaux","Olympique Lyon","0-5",0,5,"1",1,5,-5,"D"
2015-01-07,2014,"Lille OSC","Evian Thonon Gaillard","1-0",1,0,"1",1,1,1,"H"
2015-01-09,2014,"Montpellier HSC","Olympique Marseille","2-1",2,1,"1",1,3,1,"H"
2015-01-10,2014,"SC Bastia","Paris Saint-Germain","4-2",4,2,"1",1,6,2,"H"
2015-01-10,2014,"Lille OSC","SM Caen","1-0",1,0,"1",1,1,1,"H"
2015-01-10,2014,"EA Guingamp","RC Lens","2-0",2,0,"1",1,2,2,"H"
2015-01-10,2014,"OGC Nice","FC Lorient","3-1",3,1,"1",1,4,2,"H"
2015-01-10,2014,"Evian Thonon Gaillard","Stade Rennes","1-1",1,1,"1",1,2,0,"D"
2015-01-10,2014,"Stade Reims","AS Saint-Etienne","1-2",1,2,"1",1,3,-1,"D"
2015-01-11,2014,"FC Nantes","FC Metz","0-0",0,0,"1",1,0,0,"D"
2015-01-11,2014,"Olympique Lyon","Toulouse FC","3-0",3,0,"1",1,3,3,"H"
2015-01-11,2014,"AS Monaco","Girondins Bordeaux","0-0",0,0,"1",1,0,0,"D"
2015-01-16,2014,"Girondins Bordeaux","OGC Nice","1-2",1,2,"1",1,3,-1,"D"
2015-01-17,2014,"RC Lens","Olympique Lyon","0-2",0,2,"1",1,2,-2,"D"
2015-01-17,2014,"Toulouse FC","SC Bastia","1-1",1,1,"1",1,2,0,"D"
2015-01-17,2014,"FC Lorient","Lille OSC","1-0",1,0,"1",1,1,1,"H"
2015-01-17,2014,"FC Metz","Montpellier HSC","2-3",2,3,"1",1,5,-1,"D"
2015-01-17,2014,"AS Monaco","FC Nantes","1-0",1,0,"1",1,1,1,"H"
2015-01-17,2014,"SM Caen","Stade Reims","4-1",4,1,"1",1,5,3,"H"
2015-01-18,2014,"Paris Saint-Germain","Evian Thonon Gaillard","4-2",4,2,"1",1,6,2,"H"
2015-01-18,2014,"Stade Rennes","AS Saint-Etienne","0-0",0,0,"1",1,0,0,"D"
2015-01-18,2014,"Olympique Marseille","EA Guingamp","2-1",2,1,"1",1,3,1,"H"
2015-01-23,2014,"OGC Nice","Olympique Marseille","2-1",2,1,"1",1,3,1,"H"
2015-01-24,2014,"Lille OSC","AS Monaco","0-1",0,1,"1",1,1,-1,"D"
2015-01-24,2014,"SC Bastia","Girondins Bordeaux","0-0",0,0,"1",1,0,0,"D"
2015-01-24,2014,"EA Guingamp","FC Lorient","3-2",3,2,"1",1,5,1,"H"
2015-01-24,2014,"Montpellier HSC","FC Nantes","4-0",4,0,"1",1,4,4,"H"
2015-01-25,2014,"Olympique Lyon","FC Metz","2-0",2,0,"1",1,2,2,"H"
2015-01-25,2014,"Evian Thonon Gaillard","Toulouse FC","1-0",1,0,"1",1,1,1,"H"
2015-01-25,2014,"Stade Rennes","SM Caen","1-4",1,4,"1",1,5,-3,"D"
2015-01-25,2014,"Stade Reims","RC Lens","0-0",0,0,"1",1,0,0,"D"
2015-01-25,2014,"AS Saint-Etienne","Paris Saint-Germain","0-1",0,1,"1",1,1,-1,"D"
2015-01-30,2014,"Paris Saint-Germain","Stade Rennes","1-0",1,0,"1",1,1,1,"H"
2015-01-31,2014,"Olympique Marseille","Evian Thonon Gaillard","1-0",1,0,"1",1,1,1,"H"
2015-01-31,2014,"RC Lens","SC Bastia","1-1",1,1,"1",1,2,0,"D"
2015-01-31,2014,"FC Nantes","Lille OSC","1-1",1,1,"1",1,2,0,"D"
2015-01-31,2014,"FC Lorient","Montpellier HSC","0-0",0,0,"1",1,0,0,"D"
2015-01-31,2014,"FC Metz","OGC Nice","0-0",0,0,"1",1,0,0,"D"
2015-01-31,2014,"Toulouse FC","Stade Reims","1-0",1,0,"1",1,1,1,"H"
2015-02-01,2014,"SM Caen","AS Saint-Etienne","1-0",1,0,"1",1,1,1,"H"
2015-02-01,2014,"Girondins Bordeaux","EA Guingamp","1-1",1,1,"1",1,2,0,"D"
2015-02-01,2014,"AS Monaco","Olympique Lyon","0-0",0,0,"1",1,0,0,"D"
2015-02-06,2014,"AS Saint-Etienne","RC Lens","3-3",3,3,"1",1,6,0,"D"
2015-02-07,2014,"Stade Rennes","Olympique Marseille","1-1",1,1,"1",1,2,0,"D"
2015-02-07,2014,"Evian Thonon Gaillard","Girondins Bordeaux","0-1",0,1,"1",1,1,-1,"D"
2015-02-07,2014,"Montpellier HSC","Lille OSC","1-2",1,2,"1",1,3,-1,"D"
2015-02-07,2014,"Stade Reims","FC Lorient","1-3",1,3,"1",1,4,-2,"D"
2015-02-07,2014,"SC Bastia","FC Metz","2-0",2,0,"1",1,2,2,"H"
2015-02-07,2014,"SM Caen","Toulouse FC","2-0",2,0,"1",1,2,2,"H"
2015-02-08,2014,"EA Guingamp","AS Monaco","1-0",1,0,"1",1,1,1,"H"
2015-02-08,2014,"OGC Nice","FC Nantes","0-0",0,0,"1",1,0,0,"D"
2015-02-08,2014,"Olympique Lyon","Paris Saint-Germain","1-1",1,1,"1",1,2,0,"D"
2015-02-13,2014,"Olympique Marseille","Stade Reims","2-2",2,2,"1",1,4,0,"D"
2015-02-14,2014,"Paris Saint-Germain","SM Caen","2-2",2,2,"1",1,4,0,"D"
2015-02-14,2014,"FC Nantes","SC Bastia","0-2",0,2,"1",1,2,-2,"D"
2015-02-14,2014,"RC Lens","Evian Thonon Gaillard","0-2",0,2,"1",1,2,-2,"D"
2015-02-14,2014,"Lille OSC","OGC Nice","0-0",0,0,"1",1,0,0,"D"
2015-02-14,2014,"Toulouse FC","Stade Rennes","2-1",2,1,"1",1,3,1,"H"
2015-02-15,2014,"Girondins Bordeaux","AS Saint-Etienne","1-0",1,0,"1",1,1,1,"H"
2015-02-15,2014,"FC Metz","EA Guingamp","0-2",0,2,"1",1,2,-2,"D"
2015-02-15,2014,"FC Lorient","Olympique Lyon","1-1",1,1,"1",1,2,0,"D"
2015-02-20,2014,"OGC Nice","AS Monaco","0-1",0,1,"1",1,1,-1,"D"
2015-02-21,2014,"Paris Saint-Germain","Toulouse FC","3-1",3,1,"1",1,4,2,"H"
2015-02-21,2014,"Stade Rennes","Girondins Bordeaux","1-1",1,1,"1",1,2,0,"D"
2015-02-21,2014,"SM Caen","RC Lens","4-1",4,1,"1",1,5,3,"H"
2015-02-21,2014,"SC Bastia","Lille OSC","2-1",2,1,"1",1,3,1,"H"
2015-02-22,2014,"EA Guingamp","Montpellier HSC","0-2",0,2,"1",1,2,-2,"D"
2015-02-22,2014,"Stade Reims","FC Metz","0-0",0,0,"1",1,0,0,"D"
2015-02-22,2014,"Olympique Lyon","FC Nantes","1-0",1,0,"1",1,1,1,"H"
2015-02-22,2014,"AS Saint-Etienne","Olympique Marseille","2-2",2,2,"1",1,4,0,"D"
2015-02-27,2014,"Olympique Marseille","SM Caen","2-3",2,3,"1",1,5,-1,"D"
2015-02-28,2014,"Lille OSC","Olympique Lyon","2-1",2,1,"1",1,3,1,"H"
2015-02-28,2014,"FC Lorient","SC Bastia","2-0",2,0,"1",1,2,2,"H"
2015-02-28,2014,"FC Metz","Evian Thonon Gaillard","1-2",1,2,"1",1,3,-1,"D"
2015-02-28,2014,"Girondins Bordeaux","Stade Reims","1-1",1,1,"1",1,2,0,"D"
2015-02-28,2014,"RC Lens","Stade Rennes","0-1",0,1,"1",1,1,-1,"D"
2015-02-28,2014,"Toulouse FC","AS Saint-Etienne","1-1",1,1,"1",1,2,0,"D"
2015-03-01,2014,"FC Nantes","EA Guingamp","1-0",1,0,"1",1,1,1,"H"
2015-03-01,2014,"Montpellier HSC","OGC Nice","2-1",2,1,"1",1,3,1,"H"
2015-03-01,2014,"AS Monaco","Paris Saint-Germain","0-0",0,0,"1",1,0,0,"D"
2015-03-04,2014,"Evian Thonon Gaillard","FC Lorient","1-0",1,0,"1",1,1,1,"H"
2015-03-06,2014,"Toulouse FC","Olympique Marseille","1-6",1,6,"1",1,7,-5,"D"
2015-03-07,2014,"Paris Saint-Germain","RC Lens","4-1",4,1,"1",1,5,3,"H"
2015-03-07,2014,"SM Caen","Girondins Bordeaux","1-2",1,2,"1",1,3,-1,"D"
2015-03-07,2014,"Stade Rennes","FC Metz","1-0",1,0,"1",1,1,1,"H"
2015-03-07,2014,"Evian Thonon Gaillard","AS Monaco","1-3",1,3,"1",1,4,-2,"D"
2015-03-07,2014,"Stade Reims","FC Nantes","3-1",3,1,"1",1,4,2,"H"
2015-03-07,2014,"SC Bastia","OGC Nice","2-1",2,1,"1",1,3,1,"H"
2015-03-08,2014,"AS Saint-Etienne","FC Lorient","2-0",2,0,"1",1,2,2,"H"
2015-03-08,2014,"EA Guingamp","Lille OSC","0-1",0,1,"1",1,1,-1,"D"
2015-03-08,2014,"Montpellier HSC","Olympique Lyon","1-5",1,5,"1",1,6,-4,"D"
2015-03-13,2014,"AS Monaco","SC Bastia","3-0",3,0,"1",1,3,3,"H"
2015-03-13,2014,"OGC Nice","EA Guingamp","1-2",1,2,"1",1,3,-1,"D"
2015-03-14,2014,"FC Metz","AS Saint-Etienne","2-3",2,3,"1",1,5,-1,"D"
2015-03-14,2014,"FC Lorient","SM Caen","2-1",2,1,"1",1,3,1,"H"
2015-03-14,2014,"FC Nantes","Evian Thonon Gaillard","2-1",2,1,"1",1,3,1,"H"
2015-03-14,2014,"Montpellier HSC","Stade Reims","3-1",3,1,"1",1,4,2,"H"
2015-03-14,2014,"RC Lens","Toulouse FC","1-0",1,0,"1",1,1,1,"H"
2015-03-15,2014,"Lille OSC","Stade Rennes","3-0",3,0,"1",1,3,3,"H"
2015-03-15,2014,"Girondins Bordeaux","Paris Saint-Germain","3-2",3,2,"1",1,5,1,"H"
2015-03-15,2014,"Olympique Marseille","Olympique Lyon","0-0",0,0,"1",1,0,0,"D"
2015-03-20,2014,"Paris Saint-Germain","FC Lorient","3-1",3,1,"1",1,4,2,"H"
2015-03-21,2014,"Olympique Lyon","OGC Nice","1-2",1,2,"1",1,3,-1,"D"
2015-03-21,2014,"Toulouse FC","Girondins Bordeaux","2-1",2,1,"1",1,3,1,"H"
2015-03-21,2014,"SC Bastia","EA Guingamp","0-0",0,0,"1",1,0,0,"D"
2015-03-21,2014,"SM Caen","FC Metz","0-0",0,0,"1",1,0,0,"D"
2015-03-21,2014,"Evian Thonon Gaillard","Montpellier HSC","1-0",1,0,"1",1,1,1,"H"
2015-03-21,2014,"Stade Rennes","FC Nantes","0-0",0,0,"1",1,0,0,"D"
2015-03-22,2014,"AS Saint-Etienne","Lille OSC","2-0",2,0,"1",1,2,2,"H"
2015-03-22,2014,"Stade Reims","AS Monaco","1-3",1,3,"1",1,4,-2,"D"
2015-03-22,2014,"RC Lens","Olympique Marseille","0-4",0,4,"1",1,4,-4,"D"
2015-04-03,2014,"AS Monaco","AS Saint-Etienne","1-1",1,1,"1",1,2,0,"D"
2015-04-04,2014,"EA Guingamp","Olympique Lyon","1-3",1,3,"1",1,4,-2,"D"
2015-04-04,2014,"Montpellier HSC","SC Bastia","3-1",3,1,"1",1,4,2,"H"
2015-04-04,2014,"OGC Nice","Evian Thonon Gaillard","2-2",2,2,"1",1,4,0,"D"
2015-04-04,2014,"Lille OSC","Stade Reims","3-1",3,1,"1",1,4,2,"H"
2015-04-04,2014,"FC Lorient","Stade Rennes","0-3",0,3,"1",1,3,-3,"D"
2015-04-04,2014,"FC Metz","Toulouse FC","3-2",3,2,"1",1,5,1,"H"
2015-04-05,2014,"Girondins Bordeaux","RC Lens","2-1",2,1,"1",1,3,1,"H"
2015-04-05,2014,"FC Nantes","SM Caen","1-2",1,2,"1",1,3,-1,"D"
2015-04-05,2014,"Olympique Marseille","Paris Saint-Germain","2-3",2,3,"1",1,5,-1,"D"
2015-04-07,2014,"AS Monaco","Montpellier HSC","0-0",0,0,"1",1,0,0,"D"
2015-04-10,2014,"SM Caen","AS Monaco","0-3",0,3,"1",1,3,-3,"D"
2015-04-12,2014,"AS Saint-Etienne","FC Nantes","1-0",1,0,"1",1,1,1,"H"
2015-04-12,2014,"Stade Rennes","EA Guingamp","1-0",1,0,"1",1,1,1,"H"
2015-04-12,2014,"Evian Thonon Gaillard","Lille OSC","0-1",0,1,"1",1,1,-1,"D"
2015-04-12,2014,"RC Lens","FC Lorient","0-0",0,0,"1",1,0,0,"D"
2015-04-12,2014,"Toulouse FC","Montpellier HSC","1-0",1,0,"1",1,1,1,"H"
2015-04-12,2014,"Stade Reims","OGC Nice","0-1",0,1,"1",1,1,-1,"D"
2015-04-12,2014,"Girondins Bordeaux","Olympique Marseille","1-0",1,0,"1",1,1,1,"H"
2015-04-15,2014,"Olympique Lyon","SC Bastia","2-0",2,0,"1",1,2,2,"H"
2015-04-17,2014,"FC Nantes","Olympique Marseille","1-0",1,0,"1",1,1,1,"H"
2015-04-18,2014,"OGC Nice","Paris Saint-Germain","1-3",1,3,"1",1,4,-2,"D"
2015-04-18,2014,"EA Guingamp","Evian Thonon Gaillard","1-1",1,1,"1",1,2,0,"D"
2015-04-18,2014,"FC Metz","RC Lens","3-1",3,1,"1",1,4,2,"H"
2015-04-18,2014,"SC Bastia","Stade Reims","1-2",1,2,"1",1,3,-1,"D"
2015-04-18,2014,"AS Monaco","Stade Rennes","1-1",1,1,"1",1,2,0,"D"
2015-04-18,2014,"FC Lorient","Toulouse FC","0-1",0,1,"1",1,1,-1,"D"
2015-04-19,2014,"Lille OSC","Girondins Bordeaux","2-0",2,0,"1",1,2,2,"H"
2015-04-19,2014,"Montpellier HSC","SM Caen","1-0",1,0,"1",1,1,1,"H"
2015-04-19,2014,"Olympique Lyon","AS Saint-Etienne","2-2",2,2,"1",1,4,0,"D"
2015-04-24,2014,"Olympique Marseille","FC Lorient","3-5",3,5,"1",1,8,-2,"D"
2015-04-25,2014,"Paris Saint-Germain","Lille OSC","6-1",6,1,"1",1,7,5,"H"
2015-04-25,2014,"Evian Thonon Gaillard","SC Bastia","1-2",1,2,"1",1,3,-1,"D"
2015-04-25,2014,"SM Caen","EA Guingamp","0-2",0,2,"1",1,2,-2,"D"
2015-04-25,2014,"Girondins Bordeaux","FC Metz","1-1",1,1,"1",1,2,0,"D"
2015-04-25,2014,"Toulouse FC","FC Nantes","1-1",1,1,"1",1,2,0,"D"
2015-04-25,2014,"Stade Rennes","OGC Nice","2-1",2,1,"1",1,3,1,"H"
2015-04-26,2014,"AS Saint-Etienne","Montpellier HSC","1-0",1,0,"1",1,1,1,"H"
2015-04-26,2014,"RC Lens","AS Monaco","0-3",0,3,"1",1,3,-3,"D"
2015-04-26,2014,"Stade Reims","Olympique Lyon","2-4",2,4,"1",1,6,-2,"D"
2015-04-28,2014,"Paris Saint-Germain","FC Metz","3-1",3,1,"1",1,4,2,"H"
2015-05-01,2014,"FC Metz","Olympique Marseille","0-2",0,2,"1",1,2,-2,"D"
2015-05-02,2014,"Olympique Lyon","Evian Thonon Gaillard","2-0",2,0,"1",1,2,2,"H"
2015-05-02,2014,"FC Lorient","Girondins Bordeaux","0-0",0,0,"1",1,0,0,"D"
2015-05-02,2014,"OGC Nice","SM Caen","1-1",1,1,"1",1,2,0,"D"
2015-05-02,2014,"EA Guingamp","Stade Reims","2-0",2,0,"1",1,2,2,"H"
2015-05-02,2014,"Montpellier HSC","Stade Rennes","0-0",0,0,"1",1,0,0,"D"
2015-05-02,2014,"SC Bastia","AS Saint-Etienne","1-0",1,0,"1",1,1,1,"H"
2015-05-03,2014,"Lille OSC","RC Lens","3-1",3,1,"1",1,4,2,"H"
2015-05-03,2014,"AS Monaco","Toulouse FC","4-1",4,1,"1",1,5,3,"H"
2015-05-03,2014,"FC Nantes","Paris Saint-Germain","0-2",0,2,"1",1,2,-2,"D"
2015-05-08,2014,"Paris Saint-Germain","EA Guingamp","6-0",6,0,"1",1,6,6,"H"
2015-05-09,2014,"SM Caen","Olympique Lyon","3-0",3,0,"1",1,3,3,"H"
2015-05-09,2014,"Stade Rennes","SC Bastia","0-1",0,1,"1",1,1,-1,"D"
2015-05-09,2014,"Toulouse FC","Lille OSC","3-2",3,2,"1",1,5,1,"H"
2015-05-09,2014,"FC Metz","FC Lorient","0-4",0,4,"1",1,4,-4,"D"
2015-05-09,2014,"Girondins Bordeaux","FC Nantes","2-1",2,1,"1",1,3,1,"H"
2015-05-09,2014,"Evian Thonon Gaillard","Stade Reims","2-3",2,3,"1",1,5,-1,"D"
2015-05-10,2014,"RC Lens","Montpellier HSC","0-1",0,1,"1",1,1,-1,"D"
2015-05-10,2014,"AS Saint-Etienne","OGC Nice","5-0",5,0,"1",1,5,5,"H"
2015-05-10,2014,"Olympique Marseille","AS Monaco","2-1",2,1,"1",1,3,1,"H"
2015-05-16,2014,"Olympique Lyon","Girondins Bordeaux","1-1",1,1,"1",1,2,0,"D"
2015-05-16,2014,"SC Bastia","SM Caen","1-1",1,1,"1",1,2,0,"D"
2015-05-16,2014,"OGC Nice","RC Lens","2-1",2,1,"1",1,3,1,"H"
2015-05-16,2014,"FC Nantes","FC Lorient","1-1",1,1,"1",1,2,0,"D"
2015-05-16,2014,"Lille OSC","Olympique Marseille","0-4",0,4,"1",1,4,-4,"D"
2015-05-16,2014,"AS Monaco","FC Metz","2-0",2,0,"1",1,2,2,"H"
2015-05-16,2014,"Montpellier HSC","Paris Saint-Germain","1-2",1,2,"1",1,3,-1,"D"
2015-05-16,2014,"Stade Reims","Stade Rennes","1-0",1,0,"1",1,1,1,"H"
2015-05-16,2014,"Evian Thonon Gaillard","AS Saint-Etienne","1-2",1,2,"1",1,3,-1,"D"
2015-05-16,2014,"EA Guingamp","Toulouse FC","2-1",2,1,"1",1,3,1,"H"
2015-05-23,2014,"Olympique Marseille","SC Bastia","3-0",3,0,"1",1,3,3,"H"
2015-05-23,2014,"SM Caen","Evian Thonon Gaillard","3-2",3,2,"1",1,5,1,"H"
2015-05-23,2014,"AS Saint-Etienne","EA Guingamp","2-1",2,1,"1",1,3,1,"H"
2015-05-23,2014,"FC Metz","Lille OSC","1-4",1,4,"1",1,5,-3,"D"
2015-05-23,2014,"Stade Rennes","Olympique Lyon","0-1",0,1,"1",1,1,-1,"D"
2015-05-23,2014,"FC Lorient","AS Monaco","0-1",0,1,"1",1,1,-1,"D"
2015-05-23,2014,"Girondins Bordeaux","Montpellier HSC","2-1",2,1,"1",1,3,1,"H"
2015-05-23,2014,"RC Lens","FC Nantes","1-0",1,0,"1",1,1,1,"H"
2015-05-23,2014,"Toulouse FC","OGC Nice","2-3",2,3,"1",1,5,-1,"D"
2015-05-23,2014,"Paris Saint-Germain","Stade Reims","3-2",3,2,"1",1,5,1,"H"
2015-08-07,2015,"Lille OSC","Paris Saint-Germain","0-1",0,1,"1",1,1,-1,"A"
2015-08-08,2015,"SC Bastia","Stade Rennes","2-1",2,1,"1",1,3,1,"H"
2015-08-08,2015,"Olympique Marseille","SM Caen","0-1",0,1,"1",1,1,-1,"A"
2015-08-08,2015,"Montpellier HSC","Angers SCO","0-2",0,2,"1",1,2,-2,"A"
2015-08-08,2015,"FC Nantes","EA Guingamp","1-0",1,0,"1",1,1,1,"H"
2015-08-08,2015,"OGC Nice","AS Monaco","1-2",1,2,"1",1,3,-1,"A"
2015-08-08,2015,"ESTAC Troyes","AC Ajaccio","0-0",0,0,"1",1,0,0,"D"
2015-08-09,2015,"Girondins Bordeaux","Stade Reims","1-2",1,2,"1",1,3,-1,"A"
2015-08-09,2015,"Olympique Lyon","FC Lorient","0-0",0,0,"1",1,0,0,"D"
2015-08-09,2015,"Toulouse FC","AS Saint-Etienne","2-1",2,1,"1",1,3,1,"H"
2015-08-14,2015,"AS Monaco","Lille OSC","0-0",0,0,"1",1,0,0,"D"
2015-08-15,2015,"Angers SCO","FC Nantes","0-0",0,0,"1",1,0,0,"D"
2015-08-15,2015,"SM Caen","Toulouse FC","1-0",1,0,"1",1,1,1,"H"
2015-08-15,2015,"EA Guingamp","Olympique Lyon","0-1",0,1,"1",1,1,-1,"A"
2015-08-15,2015,"Stade Rennes","Montpellier HSC","1-0",1,0,"1",1,1,1,"H"
2015-08-15,2015,"AS Saint-Etienne","Girondins Bordeaux","1-1",1,1,"1",1,2,0,"D"
2015-08-15,2015,"ESTAC Troyes","OGC Nice","3-3",3,3,"1",1,6,0,"D"
2015-08-16,2015,"FC Lorient","SC Bastia","1-1",1,1,"1",1,2,0,"D"
2015-08-16,2015,"Paris Saint-Germain","AC Ajaccio","2-0",2,0,"1",1,2,2,"H"
2015-08-16,2015,"Stade Reims","Olympique Marseille","1-0",1,0,"1",1,1,1,"H"
2015-08-21,2015,"Montpellier HSC","Paris Saint-Germain","0-1",0,1,"1",1,1,-1,"A"
2015-08-22,2015,"AC Ajaccio","Angers SCO","0-2",0,2,"1",1,2,-2,"A"
2015-08-22,2015,"SC Bastia","EA Guingamp","3-0",3,0,"1",1,3,3,"H"
2015-08-22,2015,"Olympique Lyon","Stade Rennes","1-2",1,2,"1",1,3,-1,"A"
2015-08-22,2015,"FC Nantes","Stade Reims","1-0",1,0,"1",1,1,1,"H"
2015-08-22,2015,"OGC Nice","SM Caen","2-1",2,1,"1",1,3,1,"H"
2015-08-22,2015,"Toulouse FC","AS Monaco","1-1",1,1,"1",1,2,0,"D"
2015-08-23,2015,"Lille OSC","Girondins Bordeaux","0-0",0,0,"1",1,0,0,"D"
2015-08-23,2015,"FC Lorient","AS Saint-Etienne","0-1",0,1,"1",1,1,-1,"A"
2015-08-23,2015,"Olympique Marseille","ESTAC Troyes","6-0",6,0,"1",1,6,6,"H"
2015-08-28,2015,"EA Guingamp","Olympique Marseille","2-0",2,0,"1",1,2,2,"H"
2015-08-29,2015,"Angers SCO","OGC Nice","1-1",1,1,"1",1,2,0,"D"
2015-08-29,2015,"SM Caen","Olympique Lyon","0-4",0,4,"1",1,4,-4,"A"
2015-08-29,2015,"Lille OSC","AC Ajaccio","1-0",1,0,"1",1,1,1,"H"
2015-08-29,2015,"Stade Reims","FC Lorient","4-1",4,1,"1",1,5,3,"H"
2015-08-29,2015,"Stade Rennes","Toulouse FC","3-1",3,1,"1",1,4,2,"H"
2015-08-29,2015,"ESTAC Troyes","Montpellier HSC","0-0",0,0,"1",1,0,0,"D"
2015-08-30,2015,"Girondins Bordeaux","FC Nantes","2-0",2,0,"1",1,2,2,"H"
2015-08-30,2015,"AS Monaco","Paris Saint-Germain","0-3",0,3,"1",1,3,-3,"A"
2015-08-30,2015,"AS Saint-Etienne","SC Bastia","2-1",2,1,"1",1,3,1,"H"
2015-09-11,2015,"Paris Saint-Germain","Girondins Bordeaux","2-2",2,2,"1",1,4,0,"D"
2015-09-12,2015,"FC Lorient","Angers SCO","3-1",3,1,"1",1,4,2,"H"
2015-09-12,2015,"Olympique Lyon","Lille OSC","0-0",0,0,"1",1,0,0,"D"
2015-09-12,2015,"Montpellier HSC","AS Saint-Etienne","1-2",1,2,"1",1,3,-1,"A"
2015-09-12,2015,"OGC Nice","EA Guingamp","0-1",0,1,"1",1,1,-1,"A"
2015-09-12,2015,"Toulouse FC","Stade Reims","2-2",2,2,"1",1,4,0,"D"
2015-09-12,2015,"ESTAC Troyes","SM Caen","1-3",1,3,"1",1,4,-2,"A"
2015-09-13,2015,"AC Ajaccio","AS Monaco","0-1",0,1,"1",1,1,-1,"A"
2015-09-13,2015,"Olympique Marseille","SC Bastia","4-1",4,1,"1",1,5,3,"H"
2015-09-13,2015,"FC Nantes","Stade Rennes","0-2",0,2,"1",1,2,-2,"A"
2015-09-18,2015,"Stade Rennes","Lille OSC","1-1",1,1,"1",1,2,0,"D"
2015-09-19,2015,"Angers SCO","ESTAC Troyes","1-0",1,0,"1",1,1,1,"H"
2015-09-19,2015,"SC Bastia","OGC Nice","1-3",1,3,"1",1,4,-2,"A"
2015-09-19,2015,"SM Caen","Montpellier HSC","2-1",2,1,"1",1,3,1,"H"
2015-09-19,2015,"EA Guingamp","AC Ajaccio","2-1",2,1,"1",1,3,1,"H"
2015-09-19,2015,"Stade Reims","Paris Saint-Germain","1-1",1,1,"1",1,2,0,"D"
2015-09-20,2015,"Girondins Bordeaux","Toulouse FC","1-1",1,1,"1",1,2,0,"D"
2015-09-20,2015,"Olympique Marseille","Olympique Lyon","1-1",1,1,"1",1,2,0,"D"
2015-09-20,2015,"AS Monaco","FC Lorient","2-3",2,3,"1",1,5,-1,"A"
2015-09-20,2015,"AS Saint-Etienne","FC Nantes","2-0",2,0,"1",1,2,2,"H"
2015-09-22,2015,"Angers SCO","Stade Reims","0-0",0,0,"1",1,0,0,"D"
2015-09-22,2015,"Paris Saint-Germain","EA Guingamp","3-0",3,0,"1",1,3,3,"H"
2015-09-23,2015,"AC Ajaccio","Stade Rennes","1-1",1,1,"1",1,2,0,"D"
2015-09-23,2015,"FC Lorient","SM Caen","2-0",2,0,"1",1,2,2,"H"
2015-09-23,2015,"Olympique Lyon","SC Bastia","2-0",2,0,"1",1,2,2,"H"
2015-09-23,2015,"OGC Nice","Girondins Bordeaux","6-1",6,1,"1",1,7,5,"H"
2015-09-23,2015,"Toulouse FC","Olympique Marseille","1-1",1,1,"1",1,2,0,"D"
2015-09-23,2015,"ESTAC Troyes","AS Saint-Etienne","0-1",0,1,"1",1,1,-1,"A"
2015-09-24,2015,"Montpellier HSC","AS Monaco","2-3",2,3,"1",1,5,-1,"A"
2015-09-25,2015,"Stade Reims","Lille OSC","1-0",1,0,"1",1,1,1,"H"
2015-09-26,2015,"SC Bastia","Toulouse FC","3-0",3,0,"1",1,3,3,"H"
2015-09-26,2015,"Girondins Bordeaux","Olympique Lyon","3-1",3,1,"1",1,4,2,"H"
2015-09-26,2015,"SM Caen","AC Ajaccio","2-0",2,0,"1",1,2,2,"H"
2015-09-26,2015,"FC Nantes","Paris Saint-Germain","1-4",1,4,"1",1,5,-3,"A"
2015-09-26,2015,"Stade Rennes","ESTAC Troyes","1-1",1,1,"1",1,2,0,"D"
2015-09-27,2015,"EA Guingamp","AS Monaco","3-3",3,3,"1",1,6,0,"D"
2015-09-27,2015,"Olympique Marseille","Angers SCO","1-2",1,2,"1",1,3,-1,"A"
2015-09-27,2015,"Montpellier HSC","FC Lorient","2-1",2,1,"1",1,3,1,"H"
2015-09-27,2015,"AS Saint-Etienne","OGC Nice","1-4",1,4,"1",1,5,-3,"A"
2015-09-29,2015,"Lille OSC","FC Nantes","0-1",0,1,"1",1,1,-1,"A"
2015-10-02,2015,"Lille OSC","Montpellier HSC","2-0",2,0,"1",1,2,2,"H"
2015-10-03,2015,"AC Ajaccio","Toulouse FC","2-2",2,2,"1",1,4,0,"D"
2015-10-03,2015,"Angers SCO","SC Bastia","1-0",1,0,"1",1,1,1,"H"
2015-10-03,2015,"Olympique Lyon","Stade Reims","1-0",1,0,"1",1,1,1,"H"
2015-10-03,2015,"ESTAC Troyes","EA Guingamp","0-1",0,1,"1",1,1,-1,"A"
2015-10-04,2015,"SM Caen","AS Saint-Etienne","1-0",1,0,"1",1,1,1,"H"
2015-10-04,2015,"FC Lorient","Girondins Bordeaux","3-2",3,2,"1",1,5,1,"H"
2015-10-04,2015,"AS Monaco","Stade Rennes","1-1",1,1,"1",1,2,0,"D"
2015-10-04,2015,"Paris Saint-Germain","Olympique Marseille","2-1",2,1,"1",1,3,1,"H"
2015-10-16,2015,"AS Monaco","Olympique Lyon","1-1",1,1,"1",1,2,0,"D"
2015-10-17,2015,"SC Bastia","Paris Saint-Germain","0-2",0,2,"1",1,2,-2,"A"
2015-10-17,2015,"EA Guingamp","Lille OSC","1-1",1,1,"1",1,2,0,"D"
2015-10-17,2015,"FC Nantes","ESTAC Troyes","3-0",3,0,"1",1,3,3,"H"
2015-10-17,2015,"Stade Reims","SM Caen","0-1",0,1,"1",1,1,-1,"A"
2015-10-17,2015,"AS Saint-Etienne","AC Ajaccio","2-0",2,0,"1",1,2,2,"H"
2015-10-17,2015,"Toulouse FC","Angers SCO","1-2",1,2,"1",1,3,-1,"A"
2015-10-18,2015,"Girondins Bordeaux","Montpellier HSC","0-0",0,0,"1",1,0,0,"D"
2015-10-18,2015,"Olympique Marseille","FC Lorient","1-1",1,1,"1",1,2,0,"D"
2015-10-18,2015,"Stade Rennes","OGC Nice","1-4",1,4,"1",1,5,-3,"A"
2015-10-23,2015,"SM Caen","FC Nantes","0-2",0,2,"1",1,2,-2,"A"
2015-10-23,2015,"Olympique Lyon","Toulouse FC","3-0",3,0,"1",1,3,3,"H"
2015-10-24,2015,"AC Ajaccio","OGC Nice","3-1",3,1,"1",1,4,2,"H"
2015-10-24,2015,"Angers SCO","EA Guingamp","0-0",0,0,"1",1,0,0,"D"
2015-10-24,2015,"FC Lorient","Stade Rennes","1-1",1,1,"1",1,2,0,"D"
2015-10-24,2015,"Montpellier HSC","SC Bastia","2-0",2,0,"1",1,2,2,"H"
2015-10-25,2015,"Girondins Bordeaux","ESTAC Troyes","1-0",1,0,"1",1,1,1,"H"
2015-10-25,2015,"Lille OSC","Olympique Marseille","1-2",1,2,"1",1,3,-1,"A"
2015-10-25,2015,"Paris Saint-Germain","AS Saint-Etienne","4-1",4,1,"1",1,5,3,"H"
2015-10-25,2015,"Stade Reims","AS Monaco","0-1",0,1,"1",1,1,-1,"A"
2015-10-30,2015,"Stade Rennes","Paris Saint-Germain","0-1",0,1,"1",1,1,-1,"A"
2015-10-31,2015,"AC Ajaccio","Girondins Bordeaux","2-0",2,0,"1",1,2,2,"H"
2015-10-31,2015,"SC Bastia","SM Caen","1-0",1,0,"1",1,1,1,"H"
2015-10-31,2015,"EA Guingamp","FC Lorient","2-2",2,2,"1",1,4,0,"D"
2015-10-31,2015,"AS Saint-Etienne","Stade Reims","3-0",3,0,"1",1,3,3,"H"
2015-10-31,2015,"Toulouse FC","Montpellier HSC","1-1",1,1,"1",1,2,0,"D"
2015-10-31,2015,"ESTAC Troyes","Olympique Lyon","0-1",0,1,"1",1,1,-1,"A"
2015-11-01,2015,"AS Monaco","Angers SCO","1-0",1,0,"1",1,1,1,"H"
2015-11-01,2015,"FC Nantes","Olympique Marseille","0-1",0,1,"1",1,1,-1,"A"
2015-11-01,2015,"OGC Nice","Lille OSC","0-0",0,0,"1",1,0,0,"D"
2015-11-04,2015,"OGC Nice","FC Nantes","1-2",1,2,"1",1,3,-1,"A"
2015-11-06,2015,"Angers SCO","Stade Rennes","0-2",0,2,"1",1,2,-2,"A"
2015-11-07,2015,"SM Caen","EA Guingamp","2-1",2,1,"1",1,3,1,"H"
2015-11-07,2015,"Lille OSC","SC Bastia","1-1",1,1,"1",1,2,0,"D"
2015-11-07,2015,"FC Lorient","ESTAC Troyes","4-1",4,1,"1",1,5,3,"H"
2015-11-07,2015,"Montpellier HSC","FC Nantes","2-1",2,1,"1",1,3,1,"H"
2015-11-07,2015,"Paris Saint-Germain","Toulouse FC","5-0",5,0,"1",1,5,5,"H"
2015-11-07,2015,"Stade Reims","AC Ajaccio","1-2",1,2,"1",1,3,-1,"A"
2015-11-08,2015,"Girondins Bordeaux","AS Monaco","3-1",3,1,"1",1,4,2,"H"
2015-11-08,2015,"Olympique Lyon","AS Saint-Etienne","3-0",3,0,"1",1,3,3,"H"
2015-11-08,2015,"Olympique Marseille","OGC Nice","0-1",0,1,"1",1,1,-1,"A"
2015-11-20,2015,"OGC Nice","Olympique Lyon","3-0",3,0,"1",1,3,3,"H"
2015-11-21,2015,"EA Guingamp","Toulouse FC","2-0",2,0,"1",1,2,2,"H"
2015-11-21,2015,"FC Lorient","Paris Saint-Germain","1-2",1,2,"1",1,3,-1,"A"
2015-11-21,2015,"AS Monaco","FC Nantes","1-0",1,0,"1",1,1,1,"H"
2015-11-21,2015,"Montpellier HSC","Stade Reims","3-1",3,1,"1",1,4,2,"H"
2015-11-21,2015,"ESTAC Troyes","Lille OSC","1-1",1,1,"1",1,2,0,"D"
2015-11-22,2015,"SC Bastia","AC Ajaccio","1-2",1,2,"1",1,3,-1,"A"
2015-11-22,2015,"SM Caen","Angers SCO","0-0",0,0,"1",1,0,0,"D"
2015-11-22,2015,"Stade Rennes","Girondins Bordeaux","2-2",2,2,"1",1,4,0,"D"
2015-11-22,2015,"AS Saint-Etienne","Olympique Marseille","0-2",0,2,"1",1,2,-2,"A"
2015-11-27,2015,"Olympique Lyon","Montpellier HSC","2-4",2,4,"1",1,6,-2,"A"
2015-11-28,2015,"AC Ajaccio","FC Lorient","1-1",1,1,"1",1,2,0,"D"
2015-11-28,2015,"Angers SCO","Lille OSC","2-0",2,0,"1",1,2,2,"H"
2015-11-28,2015,"FC Nantes","SC Bastia","0-0",0,0,"1",1,0,0,"D"
2015-11-28,2015,"Paris Saint-Germain","ESTAC Troyes","4-1",4,1,"1",1,5,3,"H"
2015-11-28,2015,"Stade Reims","Stade Rennes","2-2",2,2,"1",1,4,0,"D"
2015-11-28,2015,"Toulouse FC","OGC Nice","2-0",2,0,"1",1,2,2,"H"
2015-11-29,2015,"Girondins Bordeaux","SM Caen","1-4",1,4,"1",1,5,-3,"A"
2015-11-29,2015,"Olympique Marseille","AS Monaco","3-3",3,3,"1",1,6,0,"D"
2015-11-29,2015,"AS Saint-Etienne","EA Guingamp","3-0",3,0,"1",1,3,3,"H"
2015-12-01,2015,"Angers SCO","Paris Saint-Germain","0-0",0,0,"1",1,0,0,"D"
2015-12-01,2015,"FC Lorient","OGC Nice","0-0",0,0,"1",1,0,0,"D"
2015-12-01,2015,"FC Nantes","Olympique Lyon","0-0",0,0,"1",1,0,0,"D"
2015-12-02,2015,"SC Bastia","Girondins Bordeaux","1-0",1,0,"1",1,1,1,"H"
2015-12-02,2015,"EA Guingamp","Stade Reims","1-2",1,2,"1",1,3,-1,"A"
2015-12-02,2015,"Lille OSC","AS Saint-Etienne","1-0",1,0,"1",1,1,1,"H"
2015-12-02,2015,"AS Monaco","SM Caen","1-1",1,1,"1",1,2,0,"D"
2015-12-02,2015,"Montpellier HSC","AC Ajaccio","0-2",0,2,"1",1,2,-2,"A"
2015-12-02,2015,"ESTAC Troyes","Toulouse FC","0-3",0,3,"1",1,3,-3,"A"
2015-12-03,2015,"Stade Rennes","Olympique Marseille","0-1",0,1,"1",1,1,-1,"A"
2015-12-04,2015,"OGC Nice","Paris Saint-Germain","0-3",0,3,"1",1,3,-3,"A"
2015-12-05,2015,"AC Ajaccio","FC Nantes","1-1",1,1,"1",1,2,0,"D"
2015-12-05,2015,"SC Bastia","AS Monaco","1-2",1,2,"1",1,3,-1,"A"
2015-12-05,2015,"SM Caen","Lille OSC","1-2",1,2,"1",1,3,-1,"A"
2015-12-05,2015,"Olympique Lyon","Angers SCO","0-2",0,2,"1",1,2,-2,"A"
2015-12-05,2015,"Stade Reims","ESTAC Troyes","1-1",1,1,"1",1,2,0,"D"
2015-12-05,2015,"Toulouse FC","FC Lorient","2-3",2,3,"1",1,5,-1,"A"
2015-12-06,2015,"Girondins Bordeaux","EA Guingamp","1-0",1,0,"1",1,1,1,"H"
2015-12-06,2015,"Olympique Marseille","Montpellier HSC","2-2",2,2,"1",1,4,0,"D"
2015-12-06,2015,"AS Saint-Etienne","Stade Rennes","1-1",1,1,"1",1,2,0,"D"
2015-12-11,2015,"Stade Rennes","SM Caen","1-1",1,1,"1",1,2,0,"D"
2015-12-12,2015,"Lille OSC","FC Lorient","3-0",3,0,"1",1,3,3,"H"
2015-12-12,2015,"Montpellier HSC","EA Guingamp","2-1",2,1,"1",1,3,1,"H"
2015-12-12,2015,"FC Nantes","Toulouse FC","1-1",1,1,"1",1,2,0,"D"
2015-12-12,2015,"Stade Reims","OGC Nice","1-1",1,1,"1",1,2,0,"D"
2015-12-12,2015,"ESTAC Troyes","SC Bastia","1-1",1,1,"1",1,2,0,"D"
2015-12-13,2015,"Angers SCO","Girondins Bordeaux","1-1",1,1,"1",1,2,0,"D"
2015-12-13,2015,"Olympique Marseille","AC Ajaccio","1-1",1,1,"1",1,2,0,"D"
2015-12-13,2015,"AS Monaco","AS Saint-Etienne","1-0",1,0,"1",1,1,1,"H"
2015-12-13,2015,"Paris Saint-Germain","Olympique Lyon","5-1",5,1,"1",1,6,4,"H"
2015-12-18,2015,"OGC Nice","Montpellier HSC","1-0",1,0,"1",1,1,1,"H"
2015-12-19,2015,"SC Bastia","Stade Reims","2-0",2,0,"1",1,2,2,"H"
2015-12-19,2015,"SM Caen","Paris Saint-Germain","0-3",0,3,"1",1,3,-3,"A"
2015-12-19,2015,"EA Guingamp","Stade Rennes","0-2",0,2,"1",1,2,-2,"A"
2015-12-19,2015,"FC Lorient","FC Nantes","0-0",0,0,"1",1,0,0,"D"
2015-12-19,2015,"Toulouse FC","Lille OSC","1-1",1,1,"1",1,2,0,"D"
2015-12-19,2015,"ESTAC Troyes","AS Monaco","0-0",0,0,"1",1,0,0,"D"
2015-12-20,2015,"AC Ajaccio","Olympique Lyon","2-1",2,1,"1",1,3,1,"H"
2015-12-20,2015,"Girondins Bordeaux","Olympique Marseille","1-1",1,1,"1",1,2,0,"D"
2015-12-20,2015,"AS Saint-Etienne","Angers SCO","1-0",1,0,"1",1,1,1,"H"
2016-01-08,2015,"Paris Saint-Germain","SC Bastia","2-0",2,0,"1",1,2,2,"H"
2016-01-09,2015,"Angers SCO","SM Caen","2-0",2,0,"1",1,2,2,"H"
2016-01-09,2015,"Olympique Lyon","ESTAC Troyes","4-1",4,1,"1",1,5,3,"H"
2016-01-09,2015,"AS Monaco","AC Ajaccio","2-2",2,2,"1",1,4,0,"D"
2016-01-09,2015,"Montpellier HSC","Girondins Bordeaux","0-1",0,1,"1",1,1,-1,"A"
2016-01-09,2015,"Stade Reims","Toulouse FC","1-3",1,3,"1",1,4,-2,"A"
2016-01-09,2015,"Stade Rennes","FC Lorient","2-2",2,2,"1",1,4,0,"D"
2016-01-10,2015,"Lille OSC","OGC Nice","1-1",1,1,"1",1,2,0,"D"
2016-01-10,2015,"Olympique Marseille","EA Guingamp","0-0",0,0,"1",1,0,0,"D"
2016-01-10,2015,"FC Nantes","AS Saint-Etienne","2-1",2,1,"1",1,3,1,"H"
2016-01-15,2015,"OGC Nice","Angers SCO","2-1",2,1,"1",1,3,1,"H"
2016-01-16,2015,"AC Ajaccio","Stade Reims","2-2",2,2,"1",1,4,0,"D"
2016-01-16,2015,"SC Bastia","Montpellier HSC","1-0",1,0,"1",1,1,1,"H"
2016-01-16,2015,"Girondins Bordeaux","Lille OSC","1-0",1,0,"1",1,1,1,"H"
2016-01-16,2015,"EA Guingamp","FC Nantes","2-2",2,2,"1",1,4,0,"D"
2016-01-16,2015,"Toulouse FC","Paris Saint-Germain","0-1",0,1,"1",1,1,-1,"A"
2016-01-16,2015,"ESTAC Troyes","Stade Rennes","2-4",2,4,"1",1,6,-2,"A"
2016-01-17,2015,"SM Caen","Olympique Marseille","1-3",1,3,"1",1,4,-2,"A"
2016-01-17,2015,"FC Lorient","AS Monaco","0-2",0,2,"1",1,2,-2,"A"
2016-01-17,2015,"AS Saint-Etienne","Olympique Lyon","1-0",1,0,"1",1,1,1,"H"
2016-01-22,2015,"Stade Rennes","AC Ajaccio","1-0",1,0,"1",1,1,1,"H"
2016-01-23,2015,"EA Guingamp","SC Bastia","1-0",1,0,"1",1,1,1,"H"
2016-01-23,2015,"Lille OSC","ESTAC Troyes","1-3",1,3,"1",1,4,-2,"A"
2016-01-23,2015,"Montpellier HSC","SM Caen","1-2",1,2,"1",1,3,-1,"A"
2016-01-23,2015,"FC Nantes","Girondins Bordeaux","2-2",2,2,"1",1,4,0,"D"
2016-01-23,2015,"OGC Nice","FC Lorient","2-1",2,1,"1",1,3,1,"H"
2016-01-23,2015,"Paris Saint-Germain","Angers SCO","5-1",5,1,"1",1,6,4,"H"
2016-01-24,2015,"Olympique Lyon","Olympique Marseille","1-1",1,1,"1",1,2,0,"D"
2016-01-24,2015,"AS Monaco","Toulouse FC","4-0",4,0,"1",1,4,4,"H"
2016-01-24,2015,"Stade Reims","AS Saint-Etienne","1-1",1,1,"1",1,2,0,"D"
2016-01-29,2015,"Olympique Marseille","Lille OSC","1-1",1,1,"1",1,2,0,"D"
2016-01-30,2015,"AC Ajaccio","Montpellier HSC","0-4",0,4,"1",1,4,-4,"A"
2016-01-30,2015,"Angers SCO","AS Monaco","3-0",3,0,"1",1,3,3,"H"
2016-01-30,2015,"SC Bastia","Olympique Lyon","1-0",1,0,"1",1,1,1,"H"
2016-01-30,2015,"FC Lorient","Stade Reims","2-0",2,0,"1",1,2,2,"H"
2016-01-30,2015,"Toulouse FC","EA Guingamp","1-2",1,2,"1",1,3,-1,"A"
2016-01-30,2015,"ESTAC Troyes","FC Nantes","0-1",0,1,"1",1,1,-1,"A"
2016-01-31,2015,"Girondins Bordeaux","Stade Rennes","4-0",4,0,"1",1,4,4,"H"
2016-01-31,2015,"SM Caen","OGC Nice","2-0",2,0,"1",1,2,2,"H"
2016-01-31,2015,"AS Saint-Etienne","Paris Saint-Germain","0-2",0,2,"1",1,2,-2,"A"
2016-02-02,2015,"AS Monaco","SC Bastia","2-0",2,0,"1",1,2,2,"H"
2016-02-02,2015,"Montpellier HSC","Olympique Marseille","0-1",0,1,"1",1,1,-1,"A"
2016-02-03,2015,"EA Guingamp","ESTAC Troyes","4-0",4,0,"1",1,4,4,"H"
2016-02-03,2015,"Lille OSC","SM Caen","1-0",1,0,"1",1,1,1,"H"
2016-02-03,2015,"Olympique Lyon","Girondins Bordeaux","3-0",3,0,"1",1,3,3,"H"
2016-02-03,2015,"FC Nantes","AC Ajaccio","3-1",3,1,"1",1,4,2,"H"
2016-02-03,2015,"OGC Nice","Toulouse FC","1-0",1,0,"1",1,1,1,"H"
2016-02-03,2015,"Paris Saint-Germain","FC Lorient","3-1",3,1,"1",1,4,2,"H"
2016-02-03,2015,"Stade Reims","Angers SCO","2-1",2,1,"1",1,3,1,"H"
2016-02-04,2015,"Stade Rennes","AS Saint-Etienne","0-1",0,1,"1",1,1,-1,"A"
2016-02-06,2015,"AC Ajaccio","EA Guingamp","0-0",0,0,"1",1,0,0,"D"
2016-02-06,2015,"Angers SCO","Olympique Lyon","0-3",0,3,"1",1,3,-3,"A"
2016-02-06,2015,"SC Bastia","ESTAC Troyes","2-0",2,0,"1",1,2,2,"H"
2016-02-06,2015,"SM Caen","Stade Reims","0-2",0,2,"1",1,2,-2,"A"
2016-02-06,2015,"FC Lorient","Montpellier HSC","1-1",1,1,"1",1,2,0,"D"
2016-02-06,2015,"AS Monaco","OGC Nice","1-0",1,0,"1",1,1,1,"H"
2016-02-06,2015,"Toulouse FC","FC Nantes","0-0",0,0,"1",1,0,0,"D"
2016-02-07,2015,"Girondins Bordeaux","AS Saint-Etienne","1-4",1,4,"1",1,5,-3,"A"
2016-02-07,2015,"Lille OSC","Stade Rennes","1-1",1,1,"1",1,2,0,"D"
2016-02-07,2015,"Olympique Marseille","Paris Saint-Germain","1-2",1,2,"1",1,3,-1,"A"
2016-02-12,2015,"Stade Rennes","Angers SCO","1-0",1,0,"1",1,1,1,"H"
2016-02-13,2015,"AC Ajaccio","ESTAC Troyes","2-3",2,3,"1",1,5,-1,"A"
2016-02-13,2015,"EA Guingamp","Girondins Bordeaux","2-4",2,4,"1",1,6,-2,"A"
2016-02-13,2015,"Montpellier HSC","Toulouse FC","2-0",2,0,"1",1,2,2,"H"
2016-02-13,2015,"FC Nantes","FC Lorient","2-1",2,1,"1",1,3,1,"H"
2016-02-13,2015,"Paris Saint-Germain","Lille OSC","0-0",0,0,"1",1,0,0,"D"
2016-02-13,2015,"Stade Reims","SC Bastia","0-1",0,1,"1",1,1,-1,"A"
2016-02-14,2015,"Olympique Lyon","SM Caen","4-1",4,1,"1",1,5,3,"H"
2016-02-14,2015,"OGC Nice","Olympique Marseille","1-1",1,1,"1",1,2,0,"D"
2016-02-14,2015,"AS Saint-Etienne","AS Monaco","1-1",1,1,"1",1,2,0,"D"
2016-02-19,2015,"Girondins Bordeaux","OGC Nice","0-0",0,0,"1",1,0,0,"D"
2016-02-20,2015,"Angers SCO","Montpellier HSC","2-3",2,3,"1",1,5,-1,"A"
2016-02-20,2015,"FC Lorient","EA Guingamp","4-3",4,3,"1",1,7,1,"H"
2016-02-20,2015,"AS Monaco","ESTAC Troyes","3-1",3,1,"1",1,4,2,"H"
2016-02-20,2015,"Paris Saint-Germain","Stade Reims","4-1",4,1,"1",1,5,3,"H"
2016-02-20,2015,"Toulouse FC","AC Ajaccio","1-1",1,1,"1",1,2,0,"D"
2016-02-21,2015,"SM Caen","Stade Rennes","1-0",1,0,"1",1,1,1,"H"
2016-02-21,2015,"Lille OSC","Olympique Lyon","1-0",1,0,"1",1,1,1,"H"
2016-02-21,2015,"Olympique Marseille","AS Saint-Etienne","1-1",1,1,"1",1,2,0,"D"
2016-02-26,2015,"OGC Nice","SC Bastia","0-2",0,2,"1",1,2,-2,"A"
2016-02-27,2015,"EA Guingamp","Angers SCO","2-2",2,2,"1",1,4,0,"D"
2016-02-27,2015,"Montpellier HSC","Lille OSC","3-0",3,0,"1",1,3,3,"H"
2016-02-27,2015,"Stade Reims","Girondins Bordeaux","4-1",4,1,"1",1,5,3,"H"
2016-02-27,2015,"Toulouse FC","Stade Rennes","1-2",1,2,"1",1,3,-1,"A"
2016-02-27,2015,"ESTAC Troyes","FC Lorient","0-1",0,1,"1",1,1,-1,"A"
2016-02-28,2015,"Olympique Lyon","Paris Saint-Germain","2-1",2,1,"1",1,3,1,"H"
2016-02-28,2015,"FC Nantes","AS Monaco","0-0",0,0,"1",1,0,0,"D"
2016-02-28,2015,"AS Saint-Etienne","SM Caen","1-2",1,2,"1",1,3,-1,"A"
2016-03-04,2015,"SM Caen","AS Monaco","2-2",2,2,"1",1,4,0,"D"
2016-03-05,2015,"Angers SCO","AS Saint-Etienne","0-0",0,0,"1",1,0,0,"D"
2016-03-05,2015,"SC Bastia","FC Lorient","0-0",0,0,"1",1,0,0,"D"
2016-03-05,2015,"Girondins Bordeaux","AC Ajaccio","1-1",1,1,"1",1,2,0,"D"
2016-03-05,2015,"Lille OSC","Stade Reims","2-0",2,0,"1",1,2,2,"H"
2016-03-05,2015,"OGC Nice","ESTAC Troyes","2-1",2,1,"1",1,3,1,"H"
2016-03-05,2015,"Paris Saint-Germain","Montpellier HSC","0-0",0,0,"1",1,0,0,"D"
2016-03-06,2015,"Olympique Lyon","EA Guingamp","5-1",5,1,"1",1,6,4,"H"
2016-03-06,2015,"Olympique Marseille","Toulouse FC","1-1",1,1,"1",1,2,0,"D"
2016-03-06,2015,"Stade Rennes","FC Nantes","4-1",4,1,"1",1,5,3,"H"
2016-03-09,2015,"AC Ajaccio","Olympique Marseille","1-1",1,1,"1",1,2,0,"D"
2016-03-09,2015,"SC Bastia","FC Nantes","0-0",0,0,"1",1,0,0,"D"
2016-03-11,2015,"AS Monaco","Stade Reims","2-2",2,2,"1",1,4,0,"D"
2016-03-12,2015,"AC Ajaccio","SM Caen","1-0",1,0,"1",1,1,1,"H"
2016-03-12,2015,"SC Bastia","Lille OSC","1-2",1,2,"1",1,3,-1,"A"
2016-03-12,2015,"EA Guingamp","AS Saint-Etienne","2-0",2,0,"1",1,2,2,"H"
2016-03-12,2015,"FC Lorient","Olympique Marseille","1-1",1,1,"1",1,2,0,"D"
2016-03-12,2015,"Montpellier HSC","OGC Nice","0-2",0,2,"1",1,2,-2,"A"
2016-03-12,2015,"Toulouse FC","Girondins Bordeaux","4-0",4,0,"1",1,4,4,"H"
2016-03-13,2015,"FC Nantes","Angers SCO","2-0",2,0,"1",1,2,2,"H"
2016-03-13,2015,"Stade Rennes","Olympique Lyon","2-2",2,2,"1",1,4,0,"D"
2016-03-13,2015,"ESTAC Troyes","Paris Saint-Germain","0-9",0,9,"1",1,9,-9,"A"
2016-03-18,2015,"Olympique Marseille","Stade Rennes","2-5",2,5,"1",1,7,-3,"A"
2016-03-19,2015,"Angers SCO","FC Lorient","5-1",5,1,"1",1,6,4,"H"
2016-03-19,2015,"SM Caen","ESTAC Troyes","2-1",2,1,"1",1,3,1,"H"
2016-03-19,2015,"Lille OSC","Toulouse FC","1-0",1,0,"1",1,1,1,"H"
2016-03-19,2015,"Olympique Lyon","FC Nantes","2-0",2,0,"1",1,2,2,"H"
2016-03-19,2015,"Stade Reims","EA Guingamp","0-1",0,1,"1",1,1,-1,"A"
2016-03-19,2015,"AS Saint-Etienne","Montpellier HSC","3-0",3,0,"1",1,3,3,"H"
2016-03-20,2015,"Girondins Bordeaux","SC Bastia","1-1",1,1,"1",1,2,0,"D"
2016-03-20,2015,"OGC Nice","AC Ajaccio","3-0",3,0,"1",1,3,3,"H"
2016-03-20,2015,"Paris Saint-Germain","AS Monaco","0-2",0,2,"1",1,2,-2,"A"
2016-04-01,2015,"AS Monaco","Girondins Bordeaux","1-2",1,2,"1",1,3,-1,"A"
2016-04-02,2015,"AC Ajaccio","AS Saint-Etienne","0-2",0,2,"1",1,2,-2,"A"
2016-04-02,2015,"EA Guingamp","Montpellier HSC","2-2",2,2,"1",1,4,0,"D"
2016-04-02,2015,"Paris Saint-Germain","OGC Nice","4-1",4,1,"1",1,5,3,"H"
2016-04-02,2015,"Stade Rennes","Stade Reims","3-1",3,1,"1",1,4,2,"H"
2016-04-02,2015,"Toulouse FC","SM Caen","2-0",2,0,"1",1,2,2,"H"
2016-04-02,2015,"ESTAC Troyes","Angers SCO","0-1",0,1,"1",1,1,-1,"A"
2016-04-03,2015,"SC Bastia","Olympique Marseille","2-1",2,1,"1",1,3,1,"H"
2016-04-03,2015,"FC Lorient","Olympique Lyon","1-3",1,3,"1",1,4,-2,"A"
2016-04-03,2015,"FC Nantes","Lille OSC","0-3",0,3,"1",1,3,-3,"A"
2016-04-08,2015,"Montpellier HSC","Olympique Lyon","0-2",0,2,"1",1,2,-2,"A"
2016-04-09,2015,"Angers SCO","AC Ajaccio","0-0",0,0,"1",1,0,0,"D"
2016-04-09,2015,"SM Caen","FC Lorient","1-2",1,2,"1",1,3,-1,"A"
2016-04-09,2015,"EA Guingamp","Paris Saint-Germain","0-2",0,2,"1",1,2,-2,"A"
2016-04-09,2015,"Stade Reims","FC Nantes","2-1",2,1,"1",1,3,1,"H"
2016-04-09,2015,"AS Saint-Etienne","ESTAC Troyes","1-0",1,0,"1",1,1,1,"H"
2016-04-09,2015,"Toulouse FC","SC Bastia","4-0",4,0,"1",1,4,4,"H"
2016-04-10,2015,"Lille OSC","AS Monaco","4-1",4,1,"1",1,5,3,"H"
2016-04-10,2015,"Olympique Marseille","Girondins Bordeaux","0-0",0,0,"1",1,0,0,"D"
2016-04-10,2015,"OGC Nice","Stade Rennes","3-0",3,0,"1",1,3,3,"H"
2016-04-15,2015,"Olympique Lyon","OGC Nice","1-1",1,1,"1",1,2,0,"D"
2016-04-16,2015,"AC Ajaccio","Lille OSC","2-4",2,4,"1",1,6,-2,"A"
2016-04-16,2015,"SC Bastia","AS Saint-Etienne","0-1",0,1,"1",1,1,-1,"A"
2016-04-16,2015,"Girondins Bordeaux","Angers SCO","1-3",1,3,"1",1,4,-2,"A"
2016-04-16,2015,"FC Lorient","Toulouse FC","1-1",1,1,"1",1,2,0,"D"
2016-04-16,2015,"Paris Saint-Germain","SM Caen","6-0",6,0,"1",1,6,6,"H"
2016-04-16,2015,"ESTAC Troyes","Stade Reims","2-1",2,1,"1",1,3,1,"H"
2016-04-17,2015,"AS Monaco","Olympique Marseille","2-1",2,1,"1",1,3,1,"H"
2016-04-17,2015,"FC Nantes","Montpellier HSC","0-2",0,2,"1",1,2,-2,"A"
2016-04-17,2015,"Stade Rennes","EA Guingamp","0-3",0,3,"1",1,3,-3,"A"
2016-04-22,2015,"OGC Nice","Stade Reims","2-0",2,0,"1",1,2,2,"H"
2016-04-23,2015,"Toulouse FC","Olympique Lyon","2-3",2,3,"1",1,5,-1,"A"
2016-04-24,2015,"AC Ajaccio","SC Bastia","3-2",3,2,"1",1,5,1,"H"
2016-04-24,2015,"EA Guingamp","SM Caen","1-1",1,1,"1",1,2,0,"D"
2016-04-24,2015,"Olympique Marseille","FC Nantes","1-1",1,1,"1",1,2,0,"D"
2016-04-24,2015,"Montpellier HSC","ESTAC Troyes","4-1",4,1,"1",1,5,3,"H"
2016-04-24,2015,"Stade Rennes","AS Monaco","1-1",1,1,"1",1,2,0,"D"
2016-04-24,2015,"AS Saint-Etienne","FC Lorient","2-0",2,0,"1",1,2,2,"H"
2016-04-27,2015,"Lille OSC","Angers SCO","0-0",0,0,"1",1,0,0,"D"
2016-04-29,2015,"Paris Saint-Germain","Stade Rennes","4-0",4,0,"1",1,4,4,"H"
2016-04-30,2015,"SM Caen","SC Bastia","0-0",0,0,"1",1,0,0,"D"
2016-04-30,2015,"FC Lorient","Lille OSC","0-1",0,1,"1",1,1,-1,"A"
2016-04-30,2015,"Olympique Lyon","AC Ajaccio","2-1",2,1,"1",1,3,1,"H"
2016-04-30,2015,"AS Monaco","EA Guingamp","3-2",3,2,"1",1,5,1,"H"
2016-04-30,2015,"FC Nantes","OGC Nice","1-0",1,0,"1",1,1,1,"H"
2016-04-30,2015,"Stade Reims","Montpellier HSC","2-3",2,3,"1",1,5,-1,"A"
2016-04-30,2015,"AS Saint-Etienne","Toulouse FC","0-0",0,0,"1",1,0,0,"D"
2016-04-30,2015,"ESTAC Troyes","Girondins Bordeaux","2-4",2,4,"1",1,6,-2,"A"
2016-05-01,2015,"Angers SCO","Olympique Marseille","0-1",0,1,"1",1,1,-1,"A"
2016-05-07,2015,"AC Ajaccio","Paris Saint-Germain","0-4",0,4,"1",1,4,-4,"A"
2016-05-07,2015,"SC Bastia","Angers SCO","1-0",1,0,"1",1,1,1,"H"
2016-05-07,2015,"Girondins Bordeaux","FC Lorient","3-0",3,0,"1",1,3,3,"H"
2016-05-07,2015,"Lille OSC","EA Guingamp","0-0",0,0,"1",1,0,0,"D"
2016-05-07,2015,"Olympique Lyon","AS Monaco","6-1",6,1,"1",1,7,5,"H"
2016-05-07,2015,"Olympique Marseille","Stade Reims","1-0",1,0,"1",1,1,1,"H"
2016-05-07,2015,"Montpellier HSC","Stade Rennes","2-0",2,0,"1",1,2,2,"H"
2016-05-07,2015,"FC Nantes","SM Caen","1-2",1,2,"1",1,3,-1,"A"
2016-05-07,2015,"OGC Nice","AS Saint-Etienne","2-0",2,0,"1",1,2,2,"H"
2016-05-07,2015,"Toulouse FC","ESTAC Troyes","1-0",1,0,"1",1,1,1,"H"
2016-05-11,2015,"Girondins Bordeaux","Paris Saint-Germain","1-1",1,1,"1",1,2,0,"D"
2016-05-14,2015,"Angers SCO","Toulouse FC","2-3",2,3,"1",1,5,-1,"A"
2016-05-14,2015,"SM Caen","Girondins Bordeaux","1-0",1,0,"1",1,1,1,"H"
2016-05-14,2015,"EA Guingamp","OGC Nice","2-3",2,3,"1",1,5,-1,"A"
2016-05-14,2015,"FC Lorient","AC Ajaccio","1-0",1,0,"1",1,1,1,"H"
2016-05-14,2015,"AS Monaco","Montpellier HSC","2-0",2,0,"1",1,2,2,"H"
2016-05-14,2015,"Paris Saint-Germain","FC Nantes","4-0",4,0,"1",1,4,4,"H"
2016-05-14,2015,"Stade Reims","Olympique Lyon","4-1",4,1,"1",1,5,3,"H"
2016-05-14,2015,"Stade Rennes","SC Bastia","1-2",1,2,"1",1,3,-1,"A"
2016-05-14,2015,"AS Saint-Etienne","Lille OSC","0-1",0,1,"1",1,1,-1,"A"
2016-05-14,2015,"ESTAC Troyes","Olympique Marseille","1-1",1,1,"1",1,2,0,"D"
2016-08-12,2016,"SC Bastia","Paris Saint-Germain","0-1",0,1,"F1",1,1,-1,"A"
2016-08-12,2016,"AS Monaco","EA Guingamp","2-2",2,2,"F1",1,4,0,"D"
2016-08-13,2016,"Girondins Bordeaux","AS Saint-Etienne","3-2",3,2,"F1",1,5,1,"H"
2016-08-13,2016,"SM Caen","FC Lorient","3-2",3,2,"F1",1,5,1,"H"
2016-08-13,2016,"Dijon FCO","FC Nantes","0-1",0,1,"F1",1,1,-1,"A"
2016-08-13,2016,"FC Metz","Lille OSC","3-2",3,2,"F1",1,5,1,"H"
2016-08-13,2016,"Montpellier HSC","Angers SCO","1-0",1,0,"F1",1,1,1,"H"
2016-08-14,2016,"Olympique Marseille","Toulouse FC","0-0",0,0,"F1",1,0,0,"D"
2016-08-14,2016,"AS Nancy","Olympique Lyon","0-3",0,3,"F1",1,3,-3,"A"
2016-08-14,2016,"OGC Nice","Stade Rennes","1-0",1,0,"F1",1,1,1,"H"
2016-08-19,2016,"Olympique Lyon","SM Caen","2-0",2,0,"F1",1,2,2,"H"
2016-08-20,2016,"Angers SCO","OGC Nice","0-1",0,1,"F1",1,1,-1,"A"
2016-08-20,2016,"Lille OSC","Dijon FCO","1-0",1,0,"F1",1,1,1,"H"
2016-08-20,2016,"FC Lorient","SC Bastia","0-3",0,3,"F1",1,3,-3,"A"
2016-08-20,2016,"FC Nantes","AS Monaco","0-1",0,1,"F1",1,1,-1,"A"
2016-08-20,2016,"Stade Rennes","AS Nancy","2-0",2,0,"F1",1,2,2,"H"
2016-08-20,2016,"Toulouse FC","Girondins Bordeaux","4-1",4,1,"F1",1,5,3,"H"
2016-08-21,2016,"EA Guingamp","Olympique Marseille","2-1",2,1,"F1",1,3,1,"H"
2016-08-21,2016,"Paris Saint-Germain","FC Metz","3-0",3,0,"F1",1,3,3,"H"
2016-08-21,2016,"AS Saint-Etienne","Montpellier HSC","3-1",3,1,"F1",1,4,2,"H"
2016-08-26,2016,"Olympique Marseille","FC Lorient","2-0",2,0,"F1",1,2,2,"H"
2016-08-27,2016,"SM Caen","SC Bastia","2-0",2,0,"F1",1,2,2,"H"
2016-08-27,2016,"Dijon FCO","Olympique Lyon","4-2",4,2,"F1",1,6,2,"H"
2016-08-27,2016,"FC Metz","Angers SCO","2-0",2,0,"F1",1,2,2,"H"
2016-08-27,2016,"Montpellier HSC","Stade Rennes","1-1",1,1,"F1",1,2,0,"D"
2016-08-27,2016,"AS Nancy","EA Guingamp","0-2",0,2,"F1",1,2,-2,"A"
2016-08-27,2016,"OGC Nice","Lille OSC","1-1",1,1,"F1",1,2,0,"D"
2016-08-28,2016,"Girondins Bordeaux","FC Nantes","1-0",1,0,"F1",1,1,1,"H"
2016-08-28,2016,"AS Monaco","Paris Saint-Germain","3-1",3,1,"F1",1,4,2,"H"
2016-08-28,2016,"AS Saint-Etienne","Toulouse FC","0-0",0,0,"F1",1,0,0,"D"
2016-09-09,2016,"Paris Saint-Germain","AS Saint-Etienne","1-1",1,1,"F1",1,2,0,"D"
2016-09-10,2016,"Angers SCO","Dijon FCO","3-1",3,1,"F1",1,4,2,"H"
2016-09-10,2016,"SC Bastia","Toulouse FC","2-1",2,1,"F1",1,3,1,"H"
2016-09-10,2016,"EA Guingamp","Montpellier HSC","1-1",1,1,"F1",1,2,0,"D"
2016-09-10,2016,"Lille OSC","AS Monaco","1-4",1,4,"F1",1,5,-3,"A"
2016-09-10,2016,"FC Lorient","AS Nancy","0-2",0,2,"F1",1,2,-2,"A"
2016-09-10,2016,"Olympique Lyon","Girondins Bordeaux","1-3",1,3,"F1",1,4,-2,"A"
2016-09-11,2016,"FC Nantes","FC Metz","0-3",0,3,"F1",1,3,-3,"A"
2016-09-11,2016,"OGC Nice","Olympique Marseille","3-2",3,2,"F1",1,5,1,"H"
2016-09-11,2016,"Stade Rennes","SM Caen","2-0",2,0,"F1",1,2,2,"H"
2016-09-16,2016,"SM Caen","Paris Saint-Germain","0-6",0,6,"F1",1,6,-6,"A"
2016-09-17,2016,"Girondins Bordeaux","Angers SCO","0-1",0,1,"F1",1,1,-1,"A"
2016-09-17,2016,"Dijon FCO","FC Metz","0-0",0,0,"F1",1,0,0,"D"
2016-09-17,2016,"FC Lorient","Lille OSC","1-0",1,0,"F1",1,1,1,"H"
2016-09-17,2016,"AS Monaco","Stade Rennes","3-0",3,0,"F1",1,3,3,"H"
2016-09-17,2016,"AS Nancy","FC Nantes","1-1",1,1,"F1",1,2,0,"D"
2016-09-17,2016,"Toulouse FC","EA Guingamp","2-1",2,1,"F1",1,3,1,"H"
2016-09-18,2016,"Olympique Marseille","Olympique Lyon","0-0",0,0,"F1",1,0,0,"D"
2016-09-18,2016,"Montpellier HSC","OGC Nice","1-1",1,1,"F1",1,2,0,"D"
2016-09-18,2016,"AS Saint-Etienne","SC Bastia","1-0",1,0,"F1",1,1,1,"H"
2016-09-20,2016,"Lille OSC","Toulouse FC","1-2",1,2,"F1",1,3,-1,"A"
2016-09-20,2016,"Paris Saint-Germain","Dijon FCO","3-0",3,0,"F1",1,3,3,"H"
2016-09-21,2016,"Angers SCO","SM Caen","2-1",2,1,"F1",1,3,1,"H"
2016-09-21,2016,"SC Bastia","AS Nancy","0-0",0,0,"F1",1,0,0,"D"
2016-09-21,2016,"EA Guingamp","FC Lorient","1-0",1,0,"F1",1,1,1,"H"
2016-09-21,2016,"Olympique Lyon","Montpellier HSC","5-1",5,1,"F1",1,6,4,"H"
2016-09-21,2016,"FC Metz","Girondins Bordeaux","0-3",0,3,"F1",1,3,-3,"A"
2016-09-21,2016,"FC Nantes","AS Saint-Etienne","0-0",0,0,"F1",1,0,0,"D"
2016-09-21,2016,"OGC Nice","AS Monaco","4-0",4,0,"F1",1,4,4,"H"
2016-09-21,2016,"Stade Rennes","Olympique Marseille","3-2",3,2,"F1",1,5,1,"H"
2016-09-23,2016,"Toulouse FC","Paris Saint-Germain","2-0",2,0,"F1",1,2,2,"H"
2016-09-24,2016,"SC Bastia","EA Guingamp","1-0",1,0,"F1",1,1,1,"H"
2016-09-24,2016,"Girondins Bordeaux","SM Caen","0-0",0,0,"F1",1,0,0,"D"
2016-09-24,2016,"Dijon FCO","Stade Rennes","3-0",3,0,"F1",1,3,3,"H"
2016-09-24,2016,"FC Lorient","Olympique Lyon","1-0",1,0,"F1",1,1,1,"H"
2016-09-24,2016,"AS Monaco","Angers SCO","2-1",2,1,"F1",1,3,1,"H"
2016-09-24,2016,"Montpellier HSC","FC Metz","0-1",0,1,"F1",1,1,-1,"A"
2016-09-25,2016,"Olympique Marseille","FC Nantes","2-1",2,1,"F1",1,3,1,"H"
2016-09-25,2016,"AS Nancy","OGC Nice","0-1",0,1,"F1",1,1,-1,"A"
2016-09-25,2016,"AS Saint-Etienne","Lille OSC","3-1",3,1,"F1",1,4,2,"H"
2016-09-30,2016,"Stade Rennes","EA Guingamp","1-0",1,0,"F1",1,1,1,"H"
2016-10-01,2016,"SM Caen","Toulouse FC","1-0",1,0,"F1",1,1,1,"H"
2016-10-01,2016,"Dijon FCO","Montpellier HSC","3-3",3,3,"F1",1,6,0,"D"
2016-10-01,2016,"Lille OSC","AS Nancy","1-0",1,0,"F1",1,1,1,"H"
2016-10-01,2016,"FC Metz","AS Monaco","0-7",0,7,"F1",1,7,-7,"A"
2016-10-01,2016,"FC Nantes","SC Bastia","1-0",1,0,"F1",1,1,1,"H"
2016-10-01,2016,"Paris Saint-Germain","Girondins Bordeaux","2-0",2,0,"F1",1,2,2,"H"
2016-10-02,2016,"Angers SCO","Olympique Marseille","1-1",1,1,"F1",1,2,0,"D"
2016-10-02,2016,"Olympique Lyon","AS Saint-Etienne","2-0",2,0,"F1",1,2,2,"H"
2016-10-02,2016,"OGC Nice","FC Lorient","2-1",2,1,"F1",1,3,1,"H"
2016-10-14,2016,"OGC Nice","Olympique Lyon","2-0",2,0,"F1",1,2,2,"H"
2016-10-14,2016,"Toulouse FC","AS Monaco","3-1",3,1,"F1",1,4,2,"H"
2016-10-15,2016,"SC Bastia","Angers SCO","1-2",1,2,"F1",1,3,-1,"A"
2016-10-15,2016,"EA Guingamp","Lille OSC","1-0",1,0,"F1",1,1,1,"H"
2016-10-15,2016,"FC Lorient","FC Nantes","1-2",1,2,"F1",1,3,-1,"A"
2016-10-15,2016,"Montpellier HSC","SM Caen","3-2",3,2,"F1",1,5,1,"H"
2016-10-15,2016,"AS Nancy","Paris Saint-Germain","1-2",1,2,"F1",1,3,-1,"A"
2016-10-16,2016,"Olympique Marseille","FC Metz","1-0",1,0,"F1",1,1,1,"H"
2016-10-16,2016,"Stade Rennes","Girondins Bordeaux","1-1",1,1,"F1",1,2,0,"D"
2016-10-16,2016,"AS Saint-Etienne","Dijon FCO","1-1",1,1,"F1",1,2,0,"D"
2016-10-21,2016,"AS Monaco","Montpellier HSC","6-2",6,2,"F1",1,8,4,"H"
2016-10-22,2016,"Angers SCO","Toulouse FC","0-0",0,0,"F1",1,0,0,"D"
2016-10-22,2016,"Girondins Bordeaux","AS Nancy","1-1",1,1,"F1",1,2,0,"D"
2016-10-22,2016,"Dijon FCO","FC Lorient","1-0",1,0,"F1",1,1,1,"H"
2016-10-22,2016,"Lille OSC","SC Bastia","2-1",2,1,"F1",1,3,1,"H"
2016-10-22,2016,"Olympique Lyon","EA Guingamp","1-3",1,3,"F1",1,4,-2,"A"
2016-10-22,2016,"FC Nantes","Stade Rennes","1-2",1,2,"F1",1,3,-1,"A"
2016-10-23,2016,"SM Caen","AS Saint-Etienne","0-2",0,2,"F1",1,2,-2,"A"
2016-10-23,2016,"FC Metz","OGC Nice","2-4",2,4,"F1",1,6,-2,"A"
2016-10-23,2016,"Paris Saint-Germain","Olympique Marseille","0-0",0,0,"F1",1,0,0,"D"
2016-10-28,2016,"Lille OSC","Paris Saint-Germain","0-1",0,1,"F1",1,1,-1,"A"
2016-10-29,2016,"SC Bastia","Dijon FCO","0-0",0,0,"F1",1,0,0,"D"
2016-10-29,2016,"EA Guingamp","Angers SCO","1-0",1,0,"F1",1,1,1,"H"
2016-10-29,2016,"FC Lorient","Montpellier HSC","2-2",2,2,"F1",1,4,0,"D"
2016-10-29,2016,"AS Nancy","SM Caen","2-0",2,0,"F1",1,2,2,"H"
2016-10-29,2016,"AS Saint-Etienne","AS Monaco","1-1",1,1,"F1",1,2,0,"D"
2016-10-29,2016,"Toulouse FC","Olympique Lyon","1-2",1,2,"F1",1,3,-1,"A"
2016-10-30,2016,"Olympique Marseille","Girondins Bordeaux","0-0",0,0,"F1",1,0,0,"D"
2016-10-30,2016,"OGC Nice","FC Nantes","4-1",4,1,"F1",1,5,3,"H"
2016-10-30,2016,"Stade Rennes","FC Metz","1-0",1,0,"F1",1,1,1,"H"
2016-11-04,2016,"Montpellier HSC","Olympique Marseille","3-1",3,1,"F1",1,4,2,"H"
2016-11-05,2016,"Angers SCO","Lille OSC","1-0",1,0,"F1",1,1,1,"H"
2016-11-05,2016,"Girondins Bordeaux","FC Lorient","2-1",2,1,"F1",1,3,1,"H"
2016-11-05,2016,"Dijon FCO","EA Guingamp","3-3",3,3,"F1",1,6,0,"D"
2016-11-05,2016,"Olympique Lyon","SC Bastia","2-1",2,1,"F1",1,3,1,"H"
2016-11-05,2016,"AS Monaco","AS Nancy","6-0",6,0,"F1",1,6,6,"H"
2016-11-05,2016,"FC Nantes","Toulouse FC","1-1",1,1,"F1",1,2,0,"D"
2016-11-06,2016,"SM Caen","OGC Nice","1-0",1,0,"F1",1,1,1,"H"
2016-11-06,2016,"FC Metz","AS Saint-Etienne","0-0",0,0,"F1",1,0,0,"D"
2016-11-06,2016,"Paris Saint-Germain","Stade Rennes","4-0",4,0,"F1",1,4,4,"H"
2016-11-18,2016,"Lille OSC","Olympique Lyon","0-1",0,1,"F1",1,1,-1,"A"
2016-11-18,2016,"FC Lorient","AS Monaco","0-3",0,3,"F1",1,3,-3,"A"
2016-11-19,2016,"SC Bastia","Montpellier HSC","1-1",1,1,"F1",1,2,0,"D"
2016-11-19,2016,"AS Nancy","Dijon FCO","1-0",1,0,"F1",1,1,1,"H"
2016-11-19,2016,"Paris Saint-Germain","FC Nantes","2-0",2,0,"F1",1,2,2,"H"
2016-11-19,2016,"Stade Rennes","Angers SCO","1-1",1,1,"F1",1,2,0,"D"
2016-11-19,2016,"Toulouse FC","FC Metz","1-2",1,2,"F1",1,3,-1,"A"
2016-11-20,2016,"EA Guingamp","Girondins Bordeaux","1-1",1,1,"F1",1,2,0,"D"
2016-11-20,2016,"Olympique Marseille","SM Caen","1-0",1,0,"F1",1,1,1,"H"
2016-11-20,2016,"AS Saint-Etienne","OGC Nice","0-1",0,1,"F1",1,1,-1,"A"
2016-11-25,2016,"Stade Rennes","Toulouse FC","1-0",1,0,"F1",1,1,1,"H"
2016-11-26,2016,"Girondins Bordeaux","Dijon FCO","3-2",3,2,"F1",1,5,1,"H"
2016-11-26,2016,"SM Caen","EA Guingamp","1-1",1,1,"F1",1,2,0,"D"
2016-11-26,2016,"FC Metz","FC Lorient","3-3",3,3,"F1",1,6,0,"D"
2016-11-26,2016,"AS Monaco","Olympique Marseille","4-0",4,0,"F1",1,4,4,"H"
2016-11-26,2016,"Montpellier HSC","AS Nancy","0-0",0,0,"F1",1,0,0,"D"
2016-11-26,2016,"FC Nantes","Lille OSC","0-0",0,0,"F1",1,0,0,"D"
2016-11-27,2016,"Angers SCO","AS Saint-Etienne","1-2",1,2,"F1",1,3,-1,"A"
2016-11-27,2016,"Olympique Lyon","Paris Saint-Germain","1-2",1,2,"F1",1,3,-1,"A"
2016-11-27,2016,"OGC Nice","SC Bastia","1-1",1,1,"F1",1,2,0,"D"
2016-11-29,2016,"Dijon FCO","AS Monaco","1-1",1,1,"F1",1,2,0,"D"
2016-11-29,2016,"Lille OSC","SM Caen","4-2",4,2,"F1",1,6,2,"H"
2016-11-29,2016,"FC Lorient","Stade Rennes","2-1",2,1,"F1",1,3,1,"H"
2016-11-30,2016,"SC Bastia","Girondins Bordeaux","1-1",1,1,"F1",1,2,0,"D"
2016-11-30,2016,"EA Guingamp","OGC Nice","0-1",0,1,"F1",1,1,-1,"A"
2016-11-30,2016,"AS Nancy","FC Metz","4-0",4,0,"F1",1,4,4,"H"
2016-11-30,2016,"FC Nantes","Olympique Lyon","0-6",0,6,"F1",1,6,-6,"A"
2016-11-30,2016,"Paris Saint-Germain","Angers SCO","2-0",2,0,"F1",1,2,2,"H"
2016-11-30,2016,"AS Saint-Etienne","Olympique Marseille","0-0",0,0,"F1",1,0,0,"D"
2016-11-30,2016,"Toulouse FC","Montpellier HSC","1-0",1,0,"F1",1,1,1,"H"
2016-12-02,2016,"SM Caen","Dijon FCO","3-3",3,3,"F1",1,6,0,"D"
2016-12-03,2016,"Angers SCO","FC Lorient","2-2",2,2,"F1",1,4,0,"D"
2016-12-03,2016,"Girondins Bordeaux","Lille OSC","0-1",0,1,"F1",1,1,-1,"A"
2016-12-03,2016,"EA Guingamp","FC Nantes","2-0",2,0,"F1",1,2,2,"H"
2016-12-03,2016,"AS Monaco","SC Bastia","5-0",5,0,"F1",1,5,5,"H"
2016-12-03,2016,"Montpellier HSC","Paris Saint-Germain","3-0",3,0,"F1",1,3,3,"H"
2016-12-04,2016,"Olympique Marseille","AS Nancy","3-0",3,0,"F1",1,3,3,"H"
2016-12-04,2016,"OGC Nice","Toulouse FC","3-0",3,0,"F1",1,3,3,"H"
2016-12-04,2016,"Stade Rennes","AS Saint-Etienne","2-0",2,0,"F1",1,2,2,"H"
2016-12-10,2016,"SC Bastia","FC Metz","2-0",2,0,"F1",1,2,2,"H"
2016-12-10,2016,"Girondins Bordeaux","AS Monaco","0-4",0,4,"F1",1,4,-4,"A"
2016-12-10,2016,"Dijon FCO","Olympique Marseille","1-2",1,2,"F1",1,3,-1,"A"
2016-12-10,2016,"Lille OSC","Montpellier HSC","2-1",2,1,"F1",1,3,1,"H"
2016-12-10,2016,"AS Nancy","Angers SCO","2-0",2,0,"F1",1,2,2,"H"
2016-12-10,2016,"Toulouse FC","FC Lorient","3-2",3,2,"F1",1,5,1,"H"
2016-12-11,2016,"Olympique Lyon","Stade Rennes","1-0",1,0,"F1",1,1,1,"H"
2016-12-11,2016,"Paris Saint-Germain","OGC Nice","2-2",2,2,"F1",1,4,0,"D"
2016-12-11,2016,"AS Saint-Etienne","EA Guingamp","1-0",1,0,"F1",1,1,1,"H"
2016-12-16,2016,"Angers SCO","FC Nantes","0-2",0,2,"F1",1,2,-2,"A"
2016-12-17,2016,"EA Guingamp","Paris Saint-Germain","2-1",2,1,"F1",1,3,1,"H"
2016-12-17,2016,"FC Lorient","AS Saint-Etienne","2-1",2,1,"F1",1,3,1,"H"
2016-12-17,2016,"Montpellier HSC","Girondins Bordeaux","4-0",4,0,"F1",1,4,4,"H"
2016-12-17,2016,"Stade Rennes","SC Bastia","1-2",1,2,"F1",1,3,-1,"A"
2016-12-17,2016,"Toulouse FC","AS Nancy","1-1",1,1,"F1",1,2,0,"D"
2016-12-18,2016,"SM Caen","FC Metz","3-0",3,0,"F1",1,3,3,"H"
2016-12-18,2016,"Olympique Marseille","Lille OSC","2-0",2,0,"F1",1,2,2,"H"
2016-12-18,2016,"AS Monaco","Olympique Lyon","1-3",1,3,"F1",1,4,-2,"A"
2016-12-18,2016,"OGC Nice","Dijon FCO","2-1",2,1,"F1",1,3,1,"H"
2016-12-21,2016,"SC Bastia","Olympique Marseille","1-2",1,2,"F1",1,3,-1,"A"
2016-12-21,2016,"Girondins Bordeaux","OGC Nice","0-0",0,0,"F1",1,0,0,"D"
2016-12-21,2016,"Dijon FCO","Toulouse FC","2-0",2,0,"F1",1,2,2,"H"
2016-12-21,2016,"Lille OSC","Stade Rennes","1-1",1,1,"F1",1,2,0,"D"
2016-12-21,2016,"Olympique Lyon","Angers SCO","2-0",2,0,"F1",1,2,2,"H"
2016-12-21,2016,"FC Metz","EA Guingamp","2-2",2,2,"F1",1,4,0,"D"
2016-12-21,2016,"AS Monaco","SM Caen","2-1",2,1,"F1",1,3,1,"H"
2016-12-21,2016,"FC Nantes","Montpellier HSC","1-0",1,0,"F1",1,1,1,"H"
2016-12-21,2016,"Paris Saint-Germain","FC Lorient","5-0",5,0,"F1",1,5,5,"H"
2016-12-21,2016,"AS Saint-Etienne","AS Nancy","0-0",0,0,"F1",1,0,0,"D"
2017-01-13,2016,"Lille OSC","AS Saint-Etienne","1-1",1,1,"F1",1,2,0,"D"
2017-01-14,2016,"Angers SCO","Girondins Bordeaux","1-1",1,1,"F1",1,2,0,"D"
2017-01-14,2016,"FC Lorient","EA Guingamp","3-1",3,1,"F1",1,4,2,"H"
2017-01-14,2016,"Montpellier HSC","Dijon FCO","1-1",1,1,"F1",1,2,0,"D"
2017-01-14,2016,"AS Nancy","SC Bastia","1-0",1,0,"F1",1,1,1,"H"
2017-01-14,2016,"Stade Rennes","Paris Saint-Germain","0-1",0,1,"F1",1,1,-1,"A"
2017-01-14,2016,"Toulouse FC","FC Nantes","0-1",0,1,"F1",1,1,-1,"A"
2017-01-15,2016,"SM Caen","Olympique Lyon","3-2",3,2,"F1",1,5,1,"H"
2017-01-15,2016,"Olympique Marseille","AS Monaco","1-4",1,4,"F1",1,5,-3,"A"
2017-01-15,2016,"OGC Nice","FC Metz","0-0",0,0,"F1",1,0,0,"D"
2017-01-18,2016,"FC Nantes","SM Caen","1-0",1,0,"F1",1,1,1,"H"
2017-01-20,2016,"SC Bastia","OGC Nice","1-1",1,1,"F1",1,2,0,"D"
2017-01-21,2016,"Girondins Bordeaux","Toulouse FC","1-0",1,0,"F1",1,1,1,"H"
2017-01-21,2016,"Dijon FCO","Lille OSC","0-0",0,0,"F1",1,0,0,"D"
2017-01-21,2016,"EA Guingamp","Stade Rennes","1-1",1,1,"F1",1,2,0,"D"
2017-01-21,2016,"FC Metz","Montpellier HSC","2-0",2,0,"F1",1,2,2,"H"
2017-01-21,2016,"FC Nantes","Paris Saint-Germain","0-2",0,2,"F1",1,2,-2,"A"
2017-01-22,2016,"Olympique Lyon","Olympique Marseille","3-1",3,1,"F1",1,4,2,"H"
2017-01-22,2016,"AS Monaco","FC Lorient","4-0",4,0,"F1",1,4,4,"H"
2017-01-22,2016,"AS Saint-Etienne","Angers SCO","2-1",2,1,"F1",1,3,1,"H"
2017-01-27,2016,"Olympique Marseille","Montpellier HSC","5-1",5,1,"F1",1,6,4,"H"
2017-01-28,2016,"Angers SCO","FC Metz","2-1",2,1,"F1",1,3,1,"H"
2017-01-28,2016,"SC Bastia","SM Caen","1-1",1,1,"F1",1,2,0,"D"
2017-01-28,2016,"FC Lorient","Dijon FCO","2-3",2,3,"F1",1,5,-1,"A"
2017-01-28,2016,"Olympique Lyon","Lille OSC","1-2",1,2,"F1",1,3,-1,"A"
2017-01-28,2016,"AS Nancy","Girondins Bordeaux","0-2",0,2,"F1",1,2,-2,"A"
2017-01-28,2016,"Stade Rennes","FC Nantes","1-1",1,1,"F1",1,2,0,"D"
2017-01-29,2016,"OGC Nice","EA Guingamp","3-1",3,1,"F1",1,4,2,"H"
2017-01-29,2016,"Paris Saint-Germain","AS Monaco","1-1",1,1,"F1",1,2,0,"D"
2017-01-29,2016,"Toulouse FC","AS Saint-Etienne","0-3",0,3,"F1",1,3,-3,"A"
2017-02-03,2016,"FC Metz","Olympique Marseille","1-0",1,0,"F1",1,1,1,"H"
2017-02-04,2016,"Girondins Bordeaux","Stade Rennes","1-1",1,1,"F1",1,2,0,"D"
2017-02-04,2016,"Dijon FCO","Paris Saint-Germain","1-3",1,3,"F1",1,4,-2,"A"
2017-02-04,2016,"EA Guingamp","SM Caen","0-1",0,1,"F1",1,1,-1,"A"
2017-02-04,2016,"Lille OSC","FC Lorient","0-1",0,1,"F1",1,1,-1,"A"
2017-02-04,2016,"AS Monaco","OGC Nice","3-0",3,0,"F1",1,3,3,"H"
2017-02-04,2016,"Montpellier HSC","SC Bastia","2-1",2,1,"F1",1,3,1,"H"
2017-02-05,2016,"FC Nantes","AS Nancy","0-2",0,2,"F1",1,2,-2,"A"
2017-02-05,2016,"AS Saint-Etienne","Olympique Lyon","2-0",2,0,"F1",1,2,2,"H"
2017-02-05,2016,"Toulouse FC","Angers SCO","4-0",4,0,"F1",1,4,4,"H"
2017-02-07,2016,"SM Caen","Girondins Bordeaux","0-4",0,4,"F1",1,4,-4,"A"
2017-02-07,2016,"Montpellier HSC","AS Monaco","1-2",1,2,"F1",1,3,-1,"A"
2017-02-07,2016,"Paris Saint-Germain","Lille OSC","2-1",2,1,"F1",1,3,1,"H"
2017-02-08,2016,"Angers SCO","Stade Rennes","0-0",0,0,"F1",1,0,0,"D"
2017-02-08,2016,"FC Lorient","Toulouse FC","1-1",1,1,"F1",1,2,0,"D"
2017-02-08,2016,"Olympique Lyon","AS Nancy","4-0",4,0,"F1",1,4,4,"H"
2017-02-08,2016,"Olympique Marseille","EA Guingamp","2-0",2,0,"F1",1,2,2,"H"
2017-02-08,2016,"FC Metz","Dijon FCO","2-1",2,1,"F1",1,3,1,"H"
2017-02-08,2016,"OGC Nice","AS Saint-Etienne","1-0",1,0,"F1",1,1,1,"H"
2017-02-10,2016,"Girondins Bordeaux","Paris Saint-Germain","0-3",0,3,"F1",1,3,-3,"A"
2017-02-11,2016,"Dijon FCO","SM Caen","2-0",2,0,"F1",1,2,2,"H"
2017-02-11,2016,"EA Guingamp","Olympique Lyon","2-1",2,1,"F1",1,3,1,"H"
2017-02-11,2016,"Lille OSC","Angers SCO","1-2",1,2,"F1",1,3,-1,"A"
2017-02-11,2016,"AS Monaco","FC Metz","5-0",5,0,"F1",1,5,5,"H"
2017-02-11,2016,"AS Nancy","Montpellier HSC","0-3",0,3,"F1",1,3,-3,"A"
2017-02-11,2016,"Toulouse FC","SC Bastia","4-1",4,1,"F1",1,5,3,"H"
2017-02-12,2016,"FC Nantes","Olympique Marseille","3-2",3,2,"F1",1,5,1,"H"
2017-02-12,2016,"Stade Rennes","OGC Nice","2-2",2,2,"F1",1,4,0,"D"
2017-02-12,2016,"AS Saint-Etienne","FC Lorient","4-0",4,0,"F1",1,4,4,"H"
2017-02-17,2016,"SC Bastia","AS Monaco","1-1",1,1,"F1",1,2,0,"D"
2017-02-18,2016,"Angers SCO","AS Nancy","1-0",1,0,"F1",1,1,1,"H"
2017-02-18,2016,"SM Caen","Lille OSC","0-1",0,1,"F1",1,1,-1,"A"
2017-02-18,2016,"FC Lorient","OGC Nice","0-1",0,1,"F1",1,1,-1,"A"
2017-02-18,2016,"Olympique Marseille","Stade Rennes","2-0",2,0,"F1",1,2,2,"H"
2017-02-18,2016,"FC Metz","FC Nantes","1-1",1,1,"F1",1,2,0,"D"
2017-02-19,2016,"Girondins Bordeaux","EA Guingamp","3-0",3,0,"F1",1,3,3,"H"
2017-02-19,2016,"Olympique Lyon","Dijon FCO","4-2",4,2,"F1",1,6,2,"H"
2017-02-19,2016,"Montpellier HSC","AS Saint-Etienne","2-1",2,1,"F1",1,3,1,"H"
2017-02-19,2016,"Paris Saint-Germain","Toulouse FC","0-0",0,0,"F1",1,0,0,"D"
2017-02-21,2016,"SM Caen","AS Nancy","1-0",1,0,"F1",1,1,1,"H"
2017-02-24,2016,"FC Nantes","Dijon FCO","3-1",3,1,"F1",1,4,2,"H"
2017-02-24,2016,"OGC Nice","Montpellier HSC","2-1",2,1,"F1",1,3,1,"H"
2017-02-25,2016,"Angers SCO","SC Bastia","3-0",3,0,"F1",1,3,3,"H"
2017-02-25,2016,"EA Guingamp","AS Monaco","1-2",1,2,"F1",1,3,-1,"A"
2017-02-25,2016,"Lille OSC","Girondins Bordeaux","2-3",2,3,"F1",1,5,-1,"A"
2017-02-25,2016,"AS Nancy","Toulouse FC","0-0",0,0,"F1",1,0,0,"D"
2017-02-25,2016,"Stade Rennes","FC Lorient","1-0",1,0,"F1",1,1,1,"H"
2017-02-26,2016,"Olympique Lyon","FC Metz","5-0",5,0,"F1",1,5,5,"H"
2017-02-26,2016,"Olympique Marseille","Paris Saint-Germain","1-5",1,5,"F1",1,6,-4,"A"
2017-02-26,2016,"AS Saint-Etienne","SM Caen","0-1",0,1,"F1",1,1,-1,"A"
2017-03-01,2016,"SC Bastia","FC Nantes","2-2",2,2,"F1",1,4,0,"D"
2017-03-03,2016,"Girondins Bordeaux","Olympique Lyon","1-1",1,1,"F1",1,2,0,"D"
2017-03-04,2016,"SC Bastia","AS Saint-Etienne","0-0",0,0,"F1",1,0,0,"D"
2017-03-04,2016,"SM Caen","Angers SCO","2-3",2,3,"F1",1,5,-1,"A"
2017-03-04,2016,"Dijon FCO","OGC Nice","0-1",0,1,"F1",1,1,-1,"A"
2017-03-04,2016,"FC Metz","Stade Rennes","1-1",1,1,"F1",1,2,0,"D"
2017-03-04,2016,"Montpellier HSC","EA Guingamp","1-1",1,1,"F1",1,2,0,"D"
2017-03-04,2016,"Paris Saint-Germain","AS Nancy","1-0",1,0,"F1",1,1,1,"H"
2017-03-05,2016,"FC Lorient","Olympique Marseille","1-4",1,4,"F1",1,5,-3,"A"
2017-03-05,2016,"AS Monaco","FC Nantes","4-0",4,0,"F1",1,4,4,"H"
2017-03-05,2016,"Toulouse FC","Lille OSC","1-1",1,1,"F1",1,2,0,"D"
2017-03-10,2016,"Olympique Marseille","Angers SCO","3-0",3,0,"F1",1,3,3,"H"
2017-03-10,2016,"OGC Nice","SM Caen","2-2",2,2,"F1",1,4,0,"D"
2017-03-11,2016,"EA Guingamp","SC Bastia","5-0",5,0,"F1",1,5,5,"H"
2017-03-11,2016,"AS Monaco","Girondins Bordeaux","2-1",2,1,"F1",1,3,1,"H"
2017-03-11,2016,"Montpellier HSC","FC Nantes","2-3",2,3,"F1",1,5,-1,"A"
2017-03-11,2016,"AS Nancy","Lille OSC","1-2",1,2,"F1",1,3,-1,"A"
2017-03-11,2016,"Stade Rennes","Dijon FCO","1-1",1,1,"F1",1,2,0,"D"
2017-03-12,2016,"FC Lorient","Paris Saint-Germain","1-2",1,2,"F1",1,3,-1,"A"
2017-03-12,2016,"Olympique Lyon","Toulouse FC","4-0",4,0,"F1",1,4,4,"H"
2017-03-12,2016,"AS Saint-Etienne","FC Metz","2-2",2,2,"F1",1,4,0,"D"
2017-03-17,2016,"Lille OSC","Olympique Marseille","0-0",0,0,"F1",1,0,0,"D"
2017-03-17,2016,"FC Metz","SC Bastia","1-0",1,0,"F1",1,1,1,"H"
2017-03-18,2016,"Angers SCO","EA Guingamp","3-0",3,0,"F1",1,3,3,"H"
2017-03-18,2016,"Girondins Bordeaux","Montpellier HSC","5-1",5,1,"F1",1,6,4,"H"
2017-03-18,2016,"AS Nancy","FC Lorient","2-3",2,3,"F1",1,5,-1,"A"
2017-03-18,2016,"FC Nantes","OGC Nice","1-1",1,1,"F1",1,2,0,"D"
2017-03-18,2016,"Toulouse FC","Stade Rennes","0-0",0,0,"F1",1,0,0,"D"
2017-03-19,2016,"SM Caen","AS Monaco","0-3",0,3,"F1",1,3,-3,"A"
2017-03-19,2016,"Dijon FCO","AS Saint-Etienne","0-1",0,1,"F1",1,1,-1,"A"
2017-03-19,2016,"Paris Saint-Germain","Olympique Lyon","2-1",2,1,"F1",1,3,1,"H"
2017-03-31,2016,"EA Guingamp","AS Nancy","1-0",1,0,"F1",1,1,1,"H"
2017-04-01,2016,"SC Bastia","Lille OSC","0-1",0,1,"F1",1,1,-1,"A"
2017-04-01,2016,"Olympique Marseille","Dijon FCO","1-1",1,1,"F1",1,2,0,"D"
2017-04-02,2016,"FC Lorient","SM Caen","1-0",1,0,"F1",1,1,1,"H"
2017-04-02,2016,"Montpellier HSC","Toulouse FC","0-1",0,1,"F1",1,1,-1,"A"
2017-04-02,2016,"FC Nantes","Angers SCO","2-1",2,1,"F1",1,3,1,"H"
2017-04-02,2016,"OGC Nice","Girondins Bordeaux","2-1",2,1,"F1",1,3,1,"H"
2017-04-02,2016,"Stade Rennes","Olympique Lyon","1-1",1,1,"F1",1,2,0,"D"
2017-04-05,2016,"FC Metz","Olympique Lyon","0-3",0,3,"F1",1,3,-3,"A"
2017-04-07,2016,"Lille OSC","OGC Nice","1-2",1,2,"F1",1,3,-1,"A"
2017-04-08,2016,"Angers SCO","AS Monaco","0-1",0,1,"F1",1,1,-1,"A"
2017-04-08,2016,"Girondins Bordeaux","FC Metz","3-0",3,0,"F1",1,3,3,"H"
2017-04-08,2016,"SM Caen","Montpellier HSC","0-2",0,2,"F1",1,2,-2,"A"
2017-04-08,2016,"Dijon FCO","SC Bastia","1-2",1,2,"F1",1,3,-1,"A"
2017-04-08,2016,"Olympique Lyon","FC Lorient","1-4",1,4,"F1",1,5,-3,"A"
2017-04-08,2016,"AS Nancy","Stade Rennes","3-0",3,0,"F1",1,3,3,"H"
2017-04-09,2016,"Paris Saint-Germain","EA Guingamp","4-0",4,0,"F1",1,4,4,"H"
2017-04-09,2016,"AS Saint-Etienne","FC Nantes","1-1",1,1,"F1",1,2,0,"D"
2017-04-09,2016,"Toulouse FC","Olympique Marseille","0-0",0,0,"F1",1,0,0,"D"
2017-04-14,2016,"Angers SCO","Paris Saint-Germain","0-2",0,2,"F1",1,2,-2,"A"
2017-04-15,2016,"EA Guingamp","Toulouse FC","2-1",2,1,"F1",1,3,1,"H"
2017-04-15,2016,"FC Metz","SM Caen","2-2",2,2,"F1",1,4,0,"D"
2017-04-15,2016,"AS Monaco","Dijon FCO","2-1",2,1,"F1",1,3,1,"H"
2017-04-15,2016,"Montpellier HSC","FC Lorient","2-0",2,0,"F1",1,2,2,"H"
2017-04-15,2016,"OGC Nice","AS Nancy","3-1",3,1,"F1",1,4,2,"H"
2017-04-15,2016,"Stade Rennes","Lille OSC","2-0",2,0,"F1",1,2,2,"H"
2017-04-16,2016,"SC Bastia","Olympique Lyon","0-3",0,3,"F1",1,3,-3,"A"
2017-04-16,2016,"Olympique Marseille","AS Saint-Etienne","4-0",4,0,"F1",1,4,4,"H"
2017-04-16,2016,"FC Nantes","Girondins Bordeaux","0-1",0,1,"F1",1,1,-1,"A"
2017-04-18,2016,"FC Metz","Paris Saint-Germain","2-3",2,3,"F1",1,5,-1,"A"
2017-04-21,2016,"AS Nancy","Olympique Marseille","0-0",0,0,"F1",1,0,0,"D"
2017-04-22,2016,"Girondins Bordeaux","SC Bastia","2-0",2,0,"F1",1,2,2,"H"
2017-04-22,2016,"SM Caen","FC Nantes","0-2",0,2,"F1",1,2,-2,"A"
2017-04-22,2016,"Dijon FCO","Angers SCO","3-2",3,2,"F1",1,5,1,"H"
2017-04-22,2016,"Lille OSC","EA Guingamp","3-0",3,0,"F1",1,3,3,"H"
2017-04-22,2016,"FC Lorient","FC Metz","5-1",5,1,"F1",1,6,4,"H"
2017-04-22,2016,"Paris Saint-Germain","Montpellier HSC","2-0",2,0,"F1",1,2,2,"H"
2017-04-23,2016,"Olympique Lyon","AS Monaco","1-2",1,2,"F1",1,3,-1,"A"
2017-04-23,2016,"AS Saint-Etienne","Stade Rennes","1-1",1,1,"F1",1,2,0,"D"
2017-04-23,2016,"Toulouse FC","OGC Nice","1-1",1,1,"F1",1,2,0,"D"
2017-04-28,2016,"Angers SCO","Olympique Lyon","1-2",1,2,"F1",1,3,-1,"A"
2017-04-29,2016,"SC Bastia","Stade Rennes","1-0",1,0,"F1",1,1,1,"H"
2017-04-29,2016,"EA Guingamp","AS Saint-Etienne","0-2",0,2,"F1",1,2,-2,"A"
2017-04-29,2016,"FC Metz","AS Nancy","2-1",2,1,"F1",1,3,1,"H"
2017-04-29,2016,"AS Monaco","Toulouse FC","3-1",3,1,"F1",1,4,2,"H"
2017-04-29,2016,"Montpellier HSC","Lille OSC","0-3",0,3,"F1",1,3,-3,"A"
2017-04-29,2016,"FC Nantes","FC Lorient","1-0",1,0,"F1",1,1,1,"H"
2017-04-30,2016,"SM Caen","Olympique Marseille","1-5",1,5,"F1",1,6,-4,"A"
2017-04-30,2016,"Dijon FCO","Girondins Bordeaux","0-0",0,0,"F1",1,0,0,"D"
2017-04-30,2016,"OGC Nice","Paris Saint-Germain","3-1",3,1,"F1",1,4,2,"H"
2017-05-05,2016,"AS Saint-Etienne","Girondins Bordeaux","2-2",2,2,"F1",1,4,0,"D"
2017-05-06,2016,"EA Guingamp","Dijon FCO","4-0",4,0,"F1",1,4,4,"H"
2017-05-06,2016,"Lille OSC","FC Metz","0-2",0,2,"F1",1,2,-2,"A"
2017-05-06,2016,"FC Lorient","Angers SCO","1-1",1,1,"F1",1,2,0,"D"
2017-05-06,2016,"AS Nancy","AS Monaco","0-3",0,3,"F1",1,3,-3,"A"
2017-05-06,2016,"Paris Saint-Germain","SC Bastia","5-0",5,0,"F1",1,5,5,"H"
2017-05-06,2016,"Toulouse FC","SM Caen","0-1",0,1,"F1",1,1,-1,"A"
2017-05-07,2016,"Olympique Lyon","FC Nantes","3-2",3,2,"F1",1,5,1,"H"
2017-05-07,2016,"Olympique Marseille","OGC Nice","2-1",2,1,"F1",1,3,1,"H"
2017-05-07,2016,"Stade Rennes","Montpellier HSC","1-0",1,0,"F1",1,1,1,"H"
2017-05-14,2016,"SC Bastia","FC Lorient","2-0",2,0,"F1",1,2,2,"H"
2017-05-14,2016,"Girondins Bordeaux","Olympique Marseille","1-1",1,1,"F1",1,2,0,"D"
2017-05-14,2016,"SM Caen","Stade Rennes","0-1",0,1,"F1",1,1,-1,"A"
2017-05-14,2016,"Dijon FCO","AS Nancy","2-0",2,0,"F1",1,2,2,"H"
2017-05-14,2016,"FC Metz","Toulouse FC","1-1",1,1,"F1",1,2,0,"D"
2017-05-14,2016,"AS Monaco","Lille OSC","4-0",4,0,"F1",1,4,4,"H"
2017-05-14,2016,"Montpellier HSC","Olympique Lyon","1-3",1,3,"F1",1,4,-2,"A"
2017-05-14,2016,"FC Nantes","EA Guingamp","4-1",4,1,"F1",1,5,3,"H"
2017-05-14,2016,"OGC Nice","Angers SCO","0-2",0,2,"F1",1,2,-2,"A"
2017-05-14,2016,"AS Saint-Etienne","Paris Saint-Germain","0-5",0,5,"F1",1,5,-5,"A"
2017-05-17,2016,"AS Monaco","AS Saint-Etienne","2-0",2,0,"F1",1,2,2,"H"
2017-05-20,2016,"Angers SCO","Montpellier HSC","2-0",2,0,"F1",1,2,2,"H"
2017-05-20,2016,"EA Guingamp","FC Metz","1-0",1,0,"F1",1,1,1,"H"
2017-05-20,2016,"Lille OSC","FC Nantes","3-0",3,0,"F1",1,3,3,"H"
2017-05-20,2016,"FC Lorient","Girondins Bordeaux","1-1",1,1,"F1",1,2,0,"D"
2017-05-20,2016,"Olympique Lyon","OGC Nice","3-3",3,3,"F1",1,6,0,"D"
2017-05-20,2016,"Olympique Marseille","SC Bastia","1-0",1,0,"F1",1,1,1,"H"
2017-05-20,2016,"AS Nancy","AS Saint-Etienne","3-1",3,1,"F1",1,4,2,"H"
2017-05-20,2016,"Paris Saint-Germain","SM Caen","1-1",1,1,"F1",1,2,0,"D"
2017-05-20,2016,"Stade Rennes","AS Monaco","2-3",2,3,"F1",1,5,-1,"A"
2017-05-20,2016,"Toulouse FC","Dijon FCO","0-0",0,0,"F1",1,0,0,"D"
2017-08-04,2017,"AS Monaco","Toulouse FC","3-2",3,2,"F1",1,5,1,"H"
2017-08-05,2017,"Olympique Lyon","RC Strasbourg","4-0",4,0,"F1",1,4,4,"H"
2017-08-05,2017,"FC Metz","EA Guingamp","1-3",1,3,"F1",1,4,-2,"A"
2017-08-05,2017,"Montpellier HSC","SM Caen","1-0",1,0,"F1",1,1,1,"H"
2017-08-05,2017,"Paris Saint-Germain","Amiens SC","2-0",2,0,"F1",1,2,2,"H"
2017-08-05,2017,"AS Saint-Etienne","OGC Nice","1-0",1,0,"F1",1,1,1,"H"
2017-08-05,2017,"ESTAC Troyes","Stade Rennes","1-1",1,1,"F1",1,2,0,"D"
2017-08-06,2017,"Angers SCO","Girondins Bordeaux","2-2",2,2,"F1",1,4,0,"D"
2017-08-06,2017,"Lille OSC","FC Nantes","3-0",3,0,"F1",1,3,3,"H"
2017-08-06,2017,"Olympique Marseille","Dijon FCO","3-0",3,0,"F1",1,3,3,"H"
2017-08-11,2017,"OGC Nice","ESTAC Troyes","1-2",1,2,"F1",1,3,-1,"A"
2017-08-11,2017,"Stade Rennes","Olympique Lyon","1-2",1,2,"F1",1,3,-1,"A"
2017-08-12,2017,"Amiens SC","Angers SCO","0-2",0,2,"F1",1,2,-2,"A"
2017-08-12,2017,"Girondins Bordeaux","FC Metz","2-0",2,0,"F1",1,2,2,"H"
2017-08-12,2017,"SM Caen","AS Saint-Etienne","0-1",0,1,"F1",1,1,-1,"A"
2017-08-12,2017,"FC Nantes","Olympique Marseille","0-1",0,1,"F1",1,1,-1,"A"
2017-08-12,2017,"Toulouse FC","Montpellier HSC","1-0",1,0,"F1",1,1,1,"H"
2017-08-13,2017,"Dijon FCO","AS Monaco","1-4",1,4,"F1",1,5,-3,"A"
2017-08-13,2017,"EA Guingamp","Paris Saint-Germain","0-3",0,3,"F1",1,3,-3,"A"
2017-08-13,2017,"RC Strasbourg","Lille OSC","3-0",3,0,"F1",1,3,3,"H"
2017-08-18,2017,"FC Metz","AS Monaco","0-1",0,1,"F1",1,1,-1,"A"
2017-08-19,2017,"Olympique Lyon","Girondins Bordeaux","3-3",3,3,"F1",1,6,0,"D"
2017-08-19,2017,"Montpellier HSC","RC Strasbourg","1-1",1,1,"F1",1,2,0,"D"
2017-08-19,2017,"OGC Nice","EA Guingamp","2-0",2,0,"F1",1,2,2,"H"
2017-08-19,2017,"Stade Rennes","Dijon FCO","2-2",2,2,"F1",1,4,0,"D"
2017-08-19,2017,"AS Saint-Etienne","Amiens SC","3-0",3,0,"F1",1,3,3,"H"
2017-08-19,2017,"ESTAC Troyes","FC Nantes","0-1",0,1,"F1",1,1,-1,"A"
2017-08-20,2017,"Lille OSC","SM Caen","0-2",0,2,"F1",1,2,-2,"A"
2017-08-20,2017,"Olympique Marseille","Angers SCO","1-1",1,1,"F1",1,2,0,"D"
2017-08-20,2017,"Paris Saint-Germain","Toulouse FC","6-2",6,2,"F1",1,8,4,"H"
2017-08-25,2017,"Paris Saint-Germain","AS Saint-Etienne","3-0",3,0,"F1",1,3,3,"H"
2017-08-26,2017,"Amiens SC","OGC Nice","3-0",3,0,"F1",1,3,3,"H"
2017-08-26,2017,"Girondins Bordeaux","ESTAC Troyes","2-1",2,1,"F1",1,3,1,"H"
2017-08-26,2017,"SM Caen","FC Metz","1-0",1,0,"F1",1,1,1,"H"
2017-08-26,2017,"Dijon FCO","Montpellier HSC","2-1",2,1,"F1",1,3,1,"H"
2017-08-26,2017,"FC Nantes","Olympique Lyon","0-0",0,0,"F1",1,0,0,"D"
2017-08-26,2017,"Toulouse FC","Stade Rennes","3-2",3,2,"F1",1,5,1,"H"
2017-08-27,2017,"Angers SCO","Lille OSC","1-1",1,1,"F1",1,2,0,"D"
2017-08-27,2017,"EA Guingamp","RC Strasbourg","2-0",2,0,"F1",1,2,2,"H"
2017-08-27,2017,"AS Monaco","Olympique Marseille","6-1",6,1,"F1",1,7,5,"H"
2017-09-08,2017,"Lille OSC","Girondins Bordeaux","0-0",0,0,"F1",1,0,0,"D"
2017-09-08,2017,"FC Metz","Paris Saint-Germain","1-5",1,5,"F1",1,6,-4,"A"
2017-09-09,2017,"SM Caen","Dijon FCO","2-1",2,1,"F1",1,3,1,"H"
2017-09-09,2017,"Montpellier HSC","FC Nantes","0-1",0,1,"F1",1,1,-1,"A"
2017-09-09,2017,"OGC Nice","AS Monaco","4-0",4,0,"F1",1,4,4,"H"
2017-09-09,2017,"RC Strasbourg","Amiens SC","0-1",0,1,"F1",1,1,-1,"A"
2017-09-09,2017,"ESTAC Troyes","Toulouse FC","0-0",0,0,"F1",1,0,0,"D"
2017-09-10,2017,"Olympique Lyon","EA Guingamp","2-1",2,1,"F1",1,3,1,"H"
2017-09-10,2017,"Olympique Marseille","Stade Rennes","1-3",1,3,"F1",1,4,-2,"A"
2017-09-10,2017,"AS Saint-Etienne","Angers SCO","1-1",1,1,"F1",1,2,0,"D"
2017-09-15,2017,"Toulouse FC","Girondins Bordeaux","0-1",0,1,"F1",1,1,-1,"A"
2017-09-16,2017,"Dijon FCO","AS Saint-Etienne","0-1",0,1,"F1",1,1,-1,"A"
2017-09-16,2017,"EA Guingamp","Lille OSC","1-0",1,0,"F1",1,1,1,"H"
2017-09-16,2017,"AS Monaco","RC Strasbourg","3-0",3,0,"F1",1,3,3,"H"
2017-09-16,2017,"FC Nantes","SM Caen","1-0",1,0,"F1",1,1,1,"H"
2017-09-16,2017,"ESTAC Troyes","Montpellier HSC","0-1",0,1,"F1",1,1,-1,"A"
2017-09-17,2017,"Amiens SC","Olympique Marseille","0-2",0,2,"F1",1,2,-2,"A"
2017-09-17,2017,"Angers SCO","FC Metz","0-1",0,1,"F1",1,1,-1,"A"
2017-09-17,2017,"Paris Saint-Germain","Olympique Lyon","2-0",2,0,"F1",1,2,2,"H"
2017-09-17,2017,"Stade Rennes","OGC Nice","0-1",0,1,"F1",1,1,-1,"A"
2017-09-22,2017,"Lille OSC","AS Monaco","0-4",0,4,"F1",1,4,-4,"A"
2017-09-22,2017,"OGC Nice","Angers SCO","2-2",2,2,"F1",1,4,0,"D"
2017-09-23,2017,"Girondins Bordeaux","EA Guingamp","3-1",3,1,"F1",1,4,2,"H"
2017-09-23,2017,"SM Caen","Amiens SC","1-0",1,0,"F1",1,1,1,"H"
2017-09-23,2017,"Olympique Lyon","Dijon FCO","3-3",3,3,"F1",1,6,0,"D"
2017-09-23,2017,"FC Metz","ESTAC Troyes","0-1",0,1,"F1",1,1,-1,"A"
2017-09-23,2017,"Montpellier HSC","Paris Saint-Germain","0-0",0,0,"F1",1,0,0,"D"
2017-09-24,2017,"Olympique Marseille","Toulouse FC","2-0",2,0,"F1",1,2,2,"H"
2017-09-24,2017,"AS Saint-Etienne","Stade Rennes","2-2",2,2,"F1",1,4,0,"D"
2017-09-24,2017,"RC Strasbourg","FC Nantes","1-2",1,2,"F1",1,3,-1,"A"
2017-09-29,2017,"AS Monaco","Montpellier HSC","1-1",1,1,"F1",1,2,0,"D"
2017-09-30,2017,"Dijon FCO","RC Strasbourg","1-1",1,1,"F1",1,2,0,"D"
2017-09-30,2017,"EA Guingamp","Toulouse FC","1-1",1,1,"F1",1,2,0,"D"
2017-09-30,2017,"FC Nantes","FC Metz","1-0",1,0,"F1",1,1,1,"H"
2017-09-30,2017,"Paris Saint-Germain","Girondins Bordeaux","6-2",6,2,"F1",1,8,4,"H"
2017-09-30,2017,"Stade Rennes","SM Caen","0-1",0,1,"F1",1,1,-1,"A"
2017-10-01,2017,"Angers SCO","Olympique Lyon","3-3",3,3,"F1",1,6,0,"D"
2017-10-01,2017,"OGC Nice","Olympique Marseille","2-4",2,4,"F1",1,6,-2,"A"
2017-10-01,2017,"ESTAC Troyes","AS Saint-Etienne","2-1",2,1,"F1",1,3,1,"H"
2017-10-13,2017,"Olympique Lyon","AS Monaco","3-2",3,2,"F1",1,5,1,"H"
2017-10-14,2017,"SM Caen","Angers SCO","0-2",0,2,"F1",1,2,-2,"A"
2017-10-14,2017,"Dijon FCO","Paris Saint-Germain","1-2",1,2,"F1",1,3,-1,"A"
2017-10-14,2017,"EA Guingamp","Stade Rennes","2-0",2,0,"F1",1,2,2,"H"
2017-10-14,2017,"Lille OSC","ESTAC Troyes","2-2",2,2,"F1",1,4,0,"D"
2017-10-14,2017,"AS Saint-Etienne","FC Metz","3-1",3,1,"F1",1,4,2,"H"
2017-10-14,2017,"Toulouse FC","Amiens SC","1-0",1,0,"F1",1,1,1,"H"
2017-10-15,2017,"Girondins Bordeaux","FC Nantes","1-1",1,1,"F1",1,2,0,"D"
2017-10-15,2017,"Montpellier HSC","OGC Nice","2-0",2,0,"F1",1,2,2,"H"
2017-10-15,2017,"RC Strasbourg","Olympique Marseille","3-3",3,3,"F1",1,6,0,"D"
2017-10-20,2017,"AS Saint-Etienne","Montpellier HSC","0-1",0,1,"F1",1,1,-1,"A"
2017-10-21,2017,"Amiens SC","Girondins Bordeaux","1-0",1,0,"F1",1,1,1,"H"
2017-10-21,2017,"Angers SCO","Toulouse FC","0-1",0,1,"F1",1,1,-1,"A"
2017-10-21,2017,"FC Metz","Dijon FCO","1-2",1,2,"F1",1,3,-1,"A"
2017-10-21,2017,"AS Monaco","SM Caen","2-0",2,0,"F1",1,2,2,"H"
2017-10-21,2017,"FC Nantes","EA Guingamp","2-1",2,1,"F1",1,3,1,"H"
2017-10-21,2017,"Stade Rennes","Lille OSC","1-0",1,0,"F1",1,1,1,"H"
2017-10-22,2017,"Olympique Marseille","Paris Saint-Germain","2-2",2,2,"F1",1,4,0,"D"
2017-10-22,2017,"OGC Nice","RC Strasbourg","1-2",1,2,"F1",1,3,-1,"A"
2017-10-22,2017,"ESTAC Troyes","Olympique Lyon","0-5",0,5,"F1",1,5,-5,"A"
2017-10-27,2017,"Paris Saint-Germain","OGC Nice","3-0",3,0,"F1",1,3,3,"H"
2017-10-28,2017,"Girondins Bordeaux","AS Monaco","0-2",0,2,"F1",1,2,-2,"A"
2017-10-28,2017,"SM Caen","ESTAC Troyes","1-0",1,0,"F1",1,1,1,"H"
2017-10-28,2017,"Dijon FCO","FC Nantes","1-0",1,0,"F1",1,1,1,"H"
2017-10-28,2017,"EA Guingamp","Amiens SC","1-1",1,1,"F1",1,2,0,"D"
2017-10-28,2017,"Montpellier HSC","Stade Rennes","0-1",0,1,"F1",1,1,-1,"A"
2017-10-28,2017,"RC Strasbourg","Angers SCO","2-2",2,2,"F1",1,4,0,"D"
2017-10-29,2017,"Lille OSC","Olympique Marseille","0-1",0,1,"F1",1,1,-1,"A"
2017-10-29,2017,"Olympique Lyon","FC Metz","2-0",2,0,"F1",1,2,2,"H"
2017-10-29,2017,"Toulouse FC","AS Saint-Etienne","0-0",0,0,"F1",1,0,0,"D"
2017-11-03,2017,"Stade Rennes","Girondins Bordeaux","1-0",1,0,"F1",1,1,1,"H"
2017-11-04,2017,"Angers SCO","Paris Saint-Germain","0-5",0,5,"F1",1,5,-5,"A"
2017-11-04,2017,"AS Monaco","EA Guingamp","6-0",6,0,"F1",1,6,6,"H"
2017-11-04,2017,"Montpellier HSC","Amiens SC","1-1",1,1,"F1",1,2,0,"D"
2017-11-04,2017,"FC Nantes","Toulouse FC","2-1",2,1,"F1",1,3,1,"H"
2017-11-04,2017,"ESTAC Troyes","RC Strasbourg","3-0",3,0,"F1",1,3,3,"H"
2017-11-05,2017,"Olympique Marseille","SM Caen","5-0",5,0,"F1",1,5,5,"H"
2017-11-05,2017,"FC Metz","Lille OSC","0-3",0,3,"F1",1,3,-3,"A"
2017-11-05,2017,"OGC Nice","Dijon FCO","1-0",1,0,"F1",1,1,1,"H"
2017-11-05,2017,"AS Saint-Etienne","Olympique Lyon","0-5",0,5,"F1",1,5,-5,"A"
2017-11-17,2017,"Amiens SC","AS Monaco","1-1",1,1,"F1",1,2,0,"D"
2017-11-17,2017,"Lille OSC","AS Saint-Etienne","3-1",3,1,"F1",1,4,2,"H"
2017-11-18,2017,"Dijon FCO","ESTAC Troyes","3-1",3,1,"F1",1,4,2,"H"
2017-11-18,2017,"EA Guingamp","Angers SCO","1-1",1,1,"F1",1,2,0,"D"
2017-11-18,2017,"Paris Saint-Germain","FC Nantes","4-1",4,1,"F1",1,5,3,"H"
2017-11-18,2017,"RC Strasbourg","Stade Rennes","2-1",2,1,"F1",1,3,1,"H"
2017-11-18,2017,"Toulouse FC","FC Metz","0-0",0,0,"F1",1,0,0,"D"
2017-11-19,2017,"Girondins Bordeaux","Olympique Marseille","1-1",1,1,"F1",1,2,0,"D"
2017-11-19,2017,"SM Caen","OGC Nice","1-1",1,1,"F1",1,2,0,"D"
2017-11-19,2017,"Olympique Lyon","Montpellier HSC","0-0",0,0,"F1",1,0,0,"D"
2017-11-20,2017,"Amiens SC","Lille OSC","3-0",3,0,"F1",1,3,3,"H"
2017-11-24,2017,"AS Saint-Etienne","RC Strasbourg","2-2",2,2,"F1",1,4,0,"D"
2017-11-25,2017,"SM Caen","Girondins Bordeaux","1-0",1,0,"F1",1,1,1,"H"
2017-11-25,2017,"Dijon FCO","Toulouse FC","3-1",3,1,"F1",1,4,2,"H"
2017-11-25,2017,"FC Metz","Amiens SC","0-2",0,2,"F1",1,2,-2,"A"
2017-11-25,2017,"Montpellier HSC","Lille OSC","3-0",3,0,"F1",1,3,3,"H"
2017-11-25,2017,"Stade Rennes","FC Nantes","2-1",2,1,"F1",1,3,1,"H"
2017-11-25,2017,"ESTAC Troyes","Angers SCO","3-0",3,0,"F1",1,3,3,"H"
2017-11-26,2017,"Olympique Marseille","EA Guingamp","1-0",1,0,"F1",1,1,1,"H"
2017-11-26,2017,"AS Monaco","Paris Saint-Germain","1-2",1,2,"F1",1,3,-1,"A"
2017-11-26,2017,"OGC Nice","Olympique Lyon","0-5",0,5,"F1",1,5,-5,"A"
2017-11-28,2017,"Amiens SC","Dijon FCO","2-1",2,1,"F1",1,3,1,"H"
2017-11-28,2017,"Girondins Bordeaux","AS Saint-Etienne","3-0",3,0,"F1",1,3,3,"H"
2017-11-28,2017,"RC Strasbourg","SM Caen","0-0",0,0,"F1",1,0,0,"D"
2017-11-29,2017,"Angers SCO","Stade Rennes","1-2",1,2,"F1",1,3,-1,"A"
2017-11-29,2017,"EA Guingamp","Montpellier HSC","0-0",0,0,"F1",1,0,0,"D"
2017-11-29,2017,"Olympique Lyon","Lille OSC","1-2",1,2,"F1",1,3,-1,"A"
2017-11-29,2017,"FC Metz","Olympique Marseille","0-3",0,3,"F1",1,3,-3,"A"
2017-11-29,2017,"FC Nantes","AS Monaco","1-0",1,0,"F1",1,1,1,"H"
2017-11-29,2017,"Paris Saint-Germain","ESTAC Troyes","2-0",2,0,"F1",1,2,2,"H"
2017-11-29,2017,"Toulouse FC","OGC Nice","1-2",1,2,"F1",1,3,-1,"A"
2017-12-01,2017,"Dijon FCO","Girondins Bordeaux","3-2",3,2,"F1",1,5,1,"H"
2017-12-02,2017,"Lille OSC","Toulouse FC","1-0",1,0,"F1",1,1,1,"H"
2017-12-02,2017,"AS Monaco","Angers SCO","1-0",1,0,"F1",1,1,1,"H"
2017-12-02,2017,"OGC Nice","FC Metz","3-1",3,1,"F1",1,4,2,"H"
2017-12-02,2017,"Stade Rennes","Amiens SC","2-0",2,0,"F1",1,2,2,"H"
2017-12-02,2017,"RC Strasbourg","Paris Saint-Germain","2-1",2,1,"F1",1,3,1,"H"
2017-12-02,2017,"ESTAC Troyes","EA Guingamp","0-1",0,1,"F1",1,1,-1,"A"
2017-12-03,2017,"SM Caen","Olympique Lyon","1-2",1,2,"F1",1,3,-1,"A"
2017-12-03,2017,"Montpellier HSC","Olympique Marseille","1-1",1,1,"F1",1,2,0,"D"
2017-12-03,2017,"AS Saint-Etienne","FC Nantes","1-1",1,1,"F1",1,2,0,"D"
2017-12-08,2017,"Girondins Bordeaux","RC Strasbourg","0-3",0,3,"F1",1,3,-3,"A"
2017-12-09,2017,"Angers SCO","Montpellier HSC","1-1",1,1,"F1",1,2,0,"D"
2017-12-09,2017,"EA Guingamp","Dijon FCO","4-0",4,0,"F1",1,4,4,"H"
2017-12-09,2017,"FC Metz","Stade Rennes","1-1",1,1,"F1",1,2,0,"D"
2017-12-09,2017,"AS Monaco","ESTAC Troyes","3-2",3,2,"F1",1,5,1,"H"
2017-12-09,2017,"Paris Saint-Germain","Lille OSC","3-1",3,1,"F1",1,4,2,"H"
2017-12-09,2017,"Toulouse FC","SM Caen","2-0",2,0,"F1",1,2,2,"H"
2017-12-10,2017,"Amiens SC","Olympique Lyon","1-2",1,2,"F1",1,3,-1,"A"
2017-12-10,2017,"Olympique Marseille","AS Saint-Etienne","3-0",3,0,"F1",1,3,3,"H"
2017-12-10,2017,"FC Nantes","OGC Nice","1-2",1,2,"F1",1,3,-1,"A"
2017-12-15,2017,"AS Saint-Etienne","AS Monaco","0-4",0,4,"F1",1,4,-4,"A"
2017-12-16,2017,"SM Caen","EA Guingamp","0-0",0,0,"F1",1,0,0,"D"
2017-12-16,2017,"Dijon FCO","Lille OSC","3-0",3,0,"F1",1,3,3,"H"
2017-12-16,2017,"Montpellier HSC","FC Metz","1-3",1,3,"F1",1,4,-2,"A"
2017-12-16,2017,"Stade Rennes","Paris Saint-Germain","1-4",1,4,"F1",1,5,-3,"A"
2017-12-16,2017,"RC Strasbourg","Toulouse FC","2-1",2,1,"F1",1,3,1,"H"
2017-12-16,2017,"ESTAC Troyes","Amiens SC","1-0",1,0,"F1",1,1,1,"H"
2017-12-17,2017,"Olympique Lyon","Olympique Marseille","2-0",2,0,"F1",1,2,2,"H"
2017-12-17,2017,"FC Nantes","Angers SCO","1-0",1,0,"F1",1,1,1,"H"
2017-12-17,2017,"OGC Nice","Girondins Bordeaux","1-0",1,0,"F1",1,1,1,"H"
2017-12-20,2017,"Amiens SC","FC Nantes","0-1",0,1,"F1",1,1,-1,"A"
2017-12-20,2017,"Angers SCO","Dijon FCO","2-1",2,1,"F1",1,3,1,"H"
2017-12-20,2017,"Girondins Bordeaux","Montpellier HSC","0-2",0,2,"F1",1,2,-2,"A"
2017-12-20,2017,"EA Guingamp","AS Saint-Etienne","2-1",2,1,"F1",1,3,1,"H"
2017-12-20,2017,"Lille OSC","OGC Nice","1-1",1,1,"F1",1,2,0,"D"
2017-12-20,2017,"Olympique Marseille","ESTAC Troyes","3-1",3,1,"F1",1,4,2,"H"
2017-12-20,2017,"FC Metz","RC Strasbourg","3-0",3,0,"F1",1,3,3,"H"
2017-12-20,2017,"AS Monaco","Stade Rennes","2-1",2,1,"F1",1,3,1,"H"
2017-12-20,2017,"Paris Saint-Germain","SM Caen","3-1",3,1,"F1",1,4,2,"H"
2017-12-20,2017,"Toulouse FC","Olympique Lyon","1-2",1,2,"F1",1,3,-1,"A"
2018-01-12,2017,"RC Strasbourg","EA Guingamp","0-2",0,2,"F1",1,2,-2,"A"
2018-01-13,2017,"SM Caen","Lille OSC","0-1",0,1,"F1",1,1,-1,"A"
2018-01-13,2017,"Dijon FCO","FC Metz","1-1",1,1,"F1",1,2,0,"D"
2018-01-13,2017,"Montpellier HSC","AS Monaco","0-0",0,0,"F1",1,0,0,"D"
2018-01-13,2017,"OGC Nice","Amiens SC","1-0",1,0,"F1",1,1,1,"H"
2018-01-13,2017,"Stade Rennes","Olympique Marseille","0-3",0,3,"F1",1,3,-3,"A"
2018-01-13,2017,"ESTAC Troyes","Girondins Bordeaux","0-1",0,1,"F1",1,1,-1,"A"
2018-01-14,2017,"Olympique Lyon","Angers SCO","1-1",1,1,"F1",1,2,0,"D"
2018-01-14,2017,"FC Nantes","Paris Saint-Germain","0-1",0,1,"F1",1,1,-1,"A"
2018-01-14,2017,"AS Saint-Etienne","Toulouse FC","2-0",2,0,"F1",1,2,2,"H"
2018-01-16,2017,"Girondins Bordeaux","SM Caen","0-2",0,2,"F1",1,2,-2,"A"
2018-01-16,2017,"Olympique Marseille","RC Strasbourg","2-0",2,0,"F1",1,2,2,"H"
2018-01-16,2017,"AS Monaco","OGC Nice","2-2",2,2,"F1",1,4,0,"D"
2018-01-17,2017,"Amiens SC","Montpellier HSC","1-1",1,1,"F1",1,2,0,"D"
2018-01-17,2017,"Angers SCO","ESTAC Troyes","3-1",3,1,"F1",1,4,2,"H"
2018-01-17,2017,"EA Guingamp","Olympique Lyon","0-2",0,2,"F1",1,2,-2,"A"
2018-01-17,2017,"Lille OSC","Stade Rennes","1-2",1,2,"F1",1,3,-1,"A"
2018-01-17,2017,"FC Metz","AS Saint-Etienne","3-0",3,0,"F1",1,3,3,"H"
2018-01-17,2017,"Paris Saint-Germain","Dijon FCO","8-0",8,0,"F1",1,8,8,"H"
2018-01-17,2017,"Toulouse FC","FC Nantes","1-1",1,1,"F1",1,2,0,"D"
2018-01-19,2017,"SM Caen","Olympique Marseille","0-2",0,2,"F1",1,2,-2,"A"
2018-01-20,2017,"Amiens SC","EA Guingamp","3-1",3,1,"F1",1,4,2,"H"
2018-01-20,2017,"Montpellier HSC","Toulouse FC","2-1",2,1,"F1",1,3,1,"H"
2018-01-20,2017,"FC Nantes","Girondins Bordeaux","0-1",0,1,"F1",1,1,-1,"A"
2018-01-20,2017,"Stade Rennes","Angers SCO","1-0",1,0,"F1",1,1,1,"H"
2018-01-20,2017,"RC Strasbourg","Dijon FCO","3-2",3,2,"F1",1,5,1,"H"
2018-01-20,2017,"ESTAC Troyes","Lille OSC","1-0",1,0,"F1",1,1,1,"H"
2018-01-21,2017,"Olympique Lyon","Paris Saint-Germain","2-1",2,1,"F1",1,3,1,"H"
2018-01-21,2017,"AS Monaco","FC Metz","3-1",3,1,"F1",1,4,2,"H"
2018-01-21,2017,"OGC Nice","AS Saint-Etienne","1-0",1,0,"F1",1,1,1,"H"
2018-01-26,2017,"Dijon FCO","Stade Rennes","2-1",2,1,"F1",1,3,1,"H"
2018-01-27,2017,"Angers SCO","Amiens SC","1-0",1,0,"F1",1,1,1,"H"
2018-01-27,2017,"EA Guingamp","FC Nantes","0-3",0,3,"F1",1,3,-3,"A"
2018-01-27,2017,"FC Metz","OGC Nice","2-1",2,1,"F1",1,3,1,"H"
2018-01-27,2017,"Paris Saint-Germain","Montpellier HSC","4-0",4,0,"F1",1,4,4,"H"
2018-01-27,2017,"AS Saint-Etienne","SM Caen","2-1",2,1,"F1",1,3,1,"H"
2018-01-27,2017,"Toulouse FC","ESTAC Troyes","1-0",1,0,"F1",1,1,1,"H"
2018-01-28,2017,"Girondins Bordeaux","Olympique Lyon","3-1",3,1,"F1",1,4,2,"H"
2018-01-28,2017,"Lille OSC","RC Strasbourg","2-1",2,1,"F1",1,3,1,"H"
2018-01-28,2017,"Olympique Marseille","AS Monaco","2-2",2,2,"F1",1,4,0,"D"
2018-02-02,2017,"Olympique Marseille","FC Metz","6-3",6,3,"F1",1,9,3,"H"
2018-02-03,2017,"Amiens SC","AS Saint-Etienne","0-2",0,2,"F1",1,2,-2,"A"
2018-02-03,2017,"Lille OSC","Paris Saint-Germain","0-3",0,3,"F1",1,3,-3,"A"
2018-02-03,2017,"Montpellier HSC","Angers SCO","2-1",2,1,"F1",1,3,1,"H"
2018-02-03,2017,"OGC Nice","Toulouse FC","0-1",0,1,"F1",1,1,-1,"A"
2018-02-03,2017,"RC Strasbourg","Girondins Bordeaux","0-2",0,2,"F1",1,2,-2,"A"
2018-02-04,2017,"SM Caen","FC Nantes","3-2",3,2,"F1",1,5,1,"H"
2018-02-04,2017,"AS Monaco","Olympique Lyon","3-2",3,2,"F1",1,5,1,"H"
2018-02-04,2017,"Stade Rennes","EA Guingamp","0-1",0,1,"F1",1,1,-1,"A"
2018-02-09,2017,"AS Saint-Etienne","Olympique Marseille","2-2",2,2,"F1",1,4,0,"D"
2018-02-10,2017,"Angers SCO","AS Monaco","0-4",0,4,"F1",1,4,-4,"A"
2018-02-10,2017,"Girondins Bordeaux","Amiens SC","3-2",3,2,"F1",1,5,1,"H"
2018-02-10,2017,"Dijon FCO","OGC Nice","3-2",3,2,"F1",1,5,1,"H"
2018-02-10,2017,"EA Guingamp","SM Caen","0-0",0,0,"F1",1,0,0,"D"
2018-02-10,2017,"FC Metz","Montpellier HSC","0-1",0,1,"F1",1,1,-1,"A"
2018-02-10,2017,"Toulouse FC","Paris Saint-Germain","0-1",0,1,"F1",1,1,-1,"A"
2018-02-11,2017,"Olympique Lyon","Stade Rennes","0-2",0,2,"F1",1,2,-2,"A"
2018-02-11,2017,"FC Nantes","Lille OSC","2-2",2,2,"F1",1,4,0,"D"
2018-02-11,2017,"RC Strasbourg","ESTAC Troyes","2-1",2,1,"F1",1,3,1,"H"
2018-02-16,2017,"AS Monaco","Dijon FCO","4-0",4,0,"F1",1,4,4,"H"
2018-02-17,2017,"Amiens SC","Toulouse FC","0-0",0,0,"F1",1,0,0,"D"
2018-02-17,2017,"Angers SCO","AS Saint-Etienne","0-1",0,1,"F1",1,1,-1,"A"
2018-02-17,2017,"SM Caen","Stade Rennes","2-2",2,2,"F1",1,4,0,"D"
2018-02-17,2017,"Montpellier HSC","EA Guingamp","1-1",1,1,"F1",1,2,0,"D"
2018-02-17,2017,"Paris Saint-Germain","RC Strasbourg","5-2",5,2,"F1",1,7,3,"H"
2018-02-17,2017,"ESTAC Troyes","FC Metz","1-0",1,0,"F1",1,1,1,"H"
2018-02-18,2017,"Lille OSC","Olympique Lyon","2-2",2,2,"F1",1,4,0,"D"
2018-02-18,2017,"Olympique Marseille","Girondins Bordeaux","1-0",1,0,"F1",1,1,1,"H"
2018-02-18,2017,"OGC Nice","FC Nantes","1-1",1,1,"F1",1,2,0,"D"
2018-02-20,2017,"ESTAC Troyes","Dijon FCO","0-0",0,0,"F1",1,0,0,"D"
2018-02-23,2017,"RC Strasbourg","Montpellier HSC","0-0",0,0,"F1",1,0,0,"D"
2018-02-24,2017,"Dijon FCO","SM Caen","2-0",2,0,"F1",1,2,2,"H"
2018-02-24,2017,"EA Guingamp","FC Metz","2-2",2,2,"F1",1,4,0,"D"
2018-02-24,2017,"Lille OSC","Angers SCO","1-2",1,2,"F1",1,3,-1,"A"
2018-02-24,2017,"FC Nantes","Amiens SC","0-1",0,1,"F1",1,1,-1,"A"
2018-02-24,2017,"Stade Rennes","ESTAC Troyes","2-0",2,0,"F1",1,2,2,"H"
2018-02-24,2017,"Toulouse FC","AS Monaco","3-3",3,3,"F1",1,6,0,"D"
2018-02-25,2017,"Girondins Bordeaux","OGC Nice","0-0",0,0,"F1",1,0,0,"D"
2018-02-25,2017,"Olympique Lyon","AS Saint-Etienne","1-1",1,1,"F1",1,2,0,"D"
2018-02-25,2017,"Paris Saint-Germain","Olympique Marseille","3-0",3,0,"F1",1,3,3,"H"
2018-03-02,2017,"AS Monaco","Girondins Bordeaux","2-1",2,1,"F1",1,3,1,"H"
2018-03-02,2017,"OGC Nice","Lille OSC","2-1",2,1,"F1",1,3,1,"H"
2018-03-03,2017,"Amiens SC","Stade Rennes","0-2",0,2,"F1",1,2,-2,"A"
2018-03-03,2017,"Angers SCO","EA Guingamp","3-0",3,0,"F1",1,3,3,"H"
2018-03-03,2017,"FC Metz","Toulouse FC","1-1",1,1,"F1",1,2,0,"D"
2018-03-03,2017,"AS Saint-Etienne","Dijon FCO","2-2",2,2,"F1",1,4,0,"D"
2018-03-03,2017,"ESTAC Troyes","Paris Saint-Germain","0-2",0,2,"F1",1,2,-2,"A"
2018-03-04,2017,"SM Caen","RC Strasbourg","2-0",2,0,"F1",1,2,2,"H"
2018-03-04,2017,"Olympique Marseille","FC Nantes","1-1",1,1,"F1",1,2,0,"D"
2018-03-04,2017,"Montpellier HSC","Olympique Lyon","1-1",1,1,"F1",1,2,0,"D"
2018-03-09,2017,"RC Strasbourg","AS Monaco","1-3",1,3,"F1",1,4,-2,"A"
2018-03-10,2017,"Girondins Bordeaux","Angers SCO","0-0",0,0,"F1",1,0,0,"D"
2018-03-10,2017,"Dijon FCO","Amiens SC","1-1",1,1,"F1",1,2,0,"D"
2018-03-10,2017,"Lille OSC","Montpellier HSC","1-1",1,1,"F1",1,2,0,"D"
2018-03-10,2017,"FC Nantes","ESTAC Troyes","1-0",1,0,"F1",1,1,1,"H"
2018-03-10,2017,"Paris Saint-Germain","FC Metz","5-0",5,0,"F1",1,5,5,"H"
2018-03-10,2017,"Stade Rennes","AS Saint-Etienne","1-1",1,1,"F1",1,2,0,"D"
2018-03-11,2017,"EA Guingamp","OGC Nice","2-5",2,5,"F1",1,7,-3,"A"
2018-03-11,2017,"Olympique Lyon","SM Caen","1-0",1,0,"F1",1,1,1,"H"
2018-03-11,2017,"Toulouse FC","Olympique Marseille","1-2",1,2,"F1",1,3,-1,"A"
2018-03-14,2017,"Paris Saint-Germain","Angers SCO","2-1",2,1,"F1",1,3,1,"H"
2018-03-16,2017,"AS Monaco","Lille OSC","2-1",2,1,"F1",1,3,1,"H"
2018-03-17,2017,"Amiens SC","ESTAC Troyes","1-1",1,1,"F1",1,2,0,"D"
2018-03-17,2017,"Angers SCO","SM Caen","3-0",3,0,"F1",1,3,3,"H"
2018-03-17,2017,"Girondins Bordeaux","Stade Rennes","0-2",0,2,"F1",1,2,-2,"A"
2018-03-17,2017,"Montpellier HSC","Dijon FCO","2-2",2,2,"F1",1,4,0,"D"
2018-03-17,2017,"Toulouse FC","RC Strasbourg","2-2",2,2,"F1",1,4,0,"D"
2018-03-18,2017,"Olympique Marseille","Olympique Lyon","2-3",2,3,"F1",1,5,-1,"A"
2018-03-18,2017,"FC Metz","FC Nantes","1-1",1,1,"F1",1,2,0,"D"
2018-03-18,2017,"OGC Nice","Paris Saint-Germain","1-2",1,2,"F1",1,3,-1,"A"
2018-03-18,2017,"AS Saint-Etienne","EA Guingamp","2-0",2,0,"F1",1,2,2,"H"
2018-03-31,2017,"Dijon FCO","Olympique Marseille","1-3",1,3,"F1",1,4,-2,"A"
2018-04-01,2017,"SM Caen","Montpellier HSC","1-3",1,3,"F1",1,4,-2,"A"
2018-04-01,2017,"EA Guingamp","Girondins Bordeaux","2-1",2,1,"F1",1,3,1,"H"
2018-04-01,2017,"Lille OSC","Amiens SC","0-1",0,1,"F1",1,1,-1,"A"
2018-04-01,2017,"Olympique Lyon","Toulouse FC","2-0",2,0,"F1",1,2,2,"H"
2018-04-01,2017,"FC Nantes","AS Saint-Etienne","0-3",0,3,"F1",1,3,-3,"A"
2018-04-01,2017,"RC Strasbourg","FC Metz","2-2",2,2,"F1",1,4,0,"D"
2018-04-01,2017,"ESTAC Troyes","OGC Nice","0-2",0,2,"F1",1,2,-2,"A"
2018-04-04,2017,"Stade Rennes","AS Monaco","1-1",1,1,"F1",1,2,0,"D"
2018-04-06,2017,"AS Saint-Etienne","Paris Saint-Germain","1-1",1,1,"F1",1,2,0,"D"
2018-04-07,2017,"Amiens SC","SM Caen","3-0",3,0,"F1",1,3,3,"H"
2018-04-07,2017,"Angers SCO","RC Strasbourg","1-1",1,1,"F1",1,2,0,"D"
2018-04-07,2017,"Girondins Bordeaux","Lille OSC","2-1",2,1,"F1",1,3,1,"H"
2018-04-07,2017,"EA Guingamp","ESTAC Troyes","4-0",4,0,"F1",1,4,4,"H"
2018-04-07,2017,"AS Monaco","FC Nantes","2-1",2,1,"F1",1,3,1,"H"
2018-04-07,2017,"Toulouse FC","Dijon FCO","0-1",0,1,"F1",1,1,-1,"A"
2018-04-08,2017,"Olympique Marseille","Montpellier HSC","0-0",0,0,"F1",1,0,0,"D"
2018-04-08,2017,"FC Metz","Olympique Lyon","0-5",0,5,"F1",1,5,-5,"A"
2018-04-08,2017,"OGC Nice","Stade Rennes","1-1",1,1,"F1",1,2,0,"D"
2018-04-13,2017,"Angers SCO","OGC Nice","1-1",1,1,"F1",1,2,0,"D"
2018-04-14,2017,"Lille OSC","EA Guingamp","2-2",2,2,"F1",1,4,0,"D"
2018-04-14,2017,"Olympique Lyon","Amiens SC","3-0",3,0,"F1",1,3,3,"H"
2018-04-14,2017,"FC Nantes","Dijon FCO","1-1",1,1,"F1",1,2,0,"D"
2018-04-14,2017,"Stade Rennes","FC Metz","1-2",1,2,"F1",1,3,-1,"A"
2018-04-14,2017,"RC Strasbourg","AS Saint-Etienne","0-1",0,1,"F1",1,1,-1,"A"
2018-04-15,2017,"Montpellier HSC","Girondins Bordeaux","1-3",1,3,"F1",1,4,-2,"A"
2018-04-15,2017,"Paris Saint-Germain","AS Monaco","7-1",7,1,"F1",1,8,6,"H"
2018-04-15,2017,"ESTAC Troyes","Olympique Marseille","2-3",2,3,"F1",1,5,-1,"A"
2018-04-20,2017,"Dijon FCO","Olympique Lyon","2-5",2,5,"F1",1,7,-3,"A"
2018-04-20,2017,"FC Nantes","Stade Rennes","1-1",1,1,"F1",1,2,0,"D"
2018-04-21,2017,"Amiens SC","RC Strasbourg","3-1",3,1,"F1",1,4,2,"H"
2018-04-21,2017,"EA Guingamp","AS Monaco","3-1",3,1,"F1",1,4,2,"H"
2018-04-21,2017,"Olympique Marseille","Lille OSC","5-1",5,1,"F1",1,6,4,"H"
2018-04-21,2017,"FC Metz","SM Caen","1-1",1,1,"F1",1,2,0,"D"
2018-04-21,2017,"Toulouse FC","Angers SCO","2-0",2,0,"F1",1,2,2,"H"
2018-04-22,2017,"Girondins Bordeaux","Paris Saint-Germain","0-1",0,1,"F1",1,1,-1,"A"
2018-04-22,2017,"OGC Nice","Montpellier HSC","1-0",1,0,"F1",1,1,1,"H"
2018-04-22,2017,"AS Saint-Etienne","ESTAC Troyes","2-1",2,1,"F1",1,3,1,"H"
2018-04-25,2017,"SM Caen","Toulouse FC","0-0",0,0,"F1",1,0,0,"D"
2018-04-27,2017,"Montpellier HSC","AS Saint-Etienne","0-1",0,1,"F1",1,1,-1,"A"
2018-04-28,2017,"Girondins Bordeaux","Dijon FCO","3-1",3,1,"F1",1,4,2,"H"
2018-04-28,2017,"Lille OSC","FC Metz","3-1",3,1,"F1",1,4,2,"H"
2018-04-28,2017,"Olympique Lyon","FC Nantes","2-0",2,0,"F1",1,2,2,"H"
2018-04-28,2017,"AS Monaco","Amiens SC","0-0",0,0,"F1",1,0,0,"D"
2018-04-28,2017,"RC Strasbourg","OGC Nice","1-1",1,1,"F1",1,2,0,"D"
2018-04-28,2017,"ESTAC Troyes","SM Caen","3-1",3,1,"F1",1,4,2,"H"
2018-04-29,2017,"Angers SCO","Olympique Marseille","1-1",1,1,"F1",1,2,0,"D"
2018-04-29,2017,"Paris Saint-Germain","EA Guingamp","2-2",2,2,"F1",1,4,0,"D"
2018-04-29,2017,"Stade Rennes","Toulouse FC","2-1",2,1,"F1",1,3,1,"H"
2018-05-04,2017,"Amiens SC","Paris Saint-Germain","2-2",2,2,"F1",1,4,0,"D"
2018-05-06,2017,"SM Caen","AS Monaco","1-2",1,2,"F1",1,3,-1,"A"
2018-05-06,2017,"Dijon FCO","EA Guingamp","3-1",3,1,"F1",1,4,2,"H"
2018-05-06,2017,"Olympique Lyon","ESTAC Troyes","3-0",3,0,"F1",1,3,3,"H"
2018-05-06,2017,"Olympique Marseille","OGC Nice","2-1",2,1,"F1",1,3,1,"H"
2018-05-06,2017,"FC Metz","Angers SCO","1-2",1,2,"F1",1,3,-1,"A"
2018-05-06,2017,"FC Nantes","Montpellier HSC","0-2",0,2,"F1",1,2,-2,"A"
2018-05-06,2017,"Stade Rennes","RC Strasbourg","2-1",2,1,"F1",1,3,1,"H"
2018-05-06,2017,"AS Saint-Etienne","Girondins Bordeaux","1-3",1,3,"F1",1,4,-2,"A"
2018-05-06,2017,"Toulouse FC","Lille OSC","2-3",2,3,"F1",1,5,-1,"A"
2018-05-11,2017,"EA Guingamp","Olympique Marseille","3-3",3,3,"F1",1,6,0,"D"
2018-05-12,2017,"Amiens SC","FC Metz","2-0",2,0,"F1",1,2,2,"H"
2018-05-12,2017,"Angers SCO","FC Nantes","0-2",0,2,"F1",1,2,-2,"A"
2018-05-12,2017,"Girondins Bordeaux","Toulouse FC","4-2",4,2,"F1",1,6,2,"H"
2018-05-12,2017,"Lille OSC","Dijon FCO","2-1",2,1,"F1",1,3,1,"H"
2018-05-12,2017,"AS Monaco","AS Saint-Etienne","1-0",1,0,"F1",1,1,1,"H"
2018-05-12,2017,"Montpellier HSC","ESTAC Troyes","1-1",1,1,"F1",1,2,0,"D"
2018-05-12,2017,"OGC Nice","SM Caen","4-1",4,1,"F1",1,5,3,"H"
2018-05-12,2017,"Paris Saint-Germain","Stade Rennes","0-2",0,2,"F1",1,2,-2,"A"
2018-05-12,2017,"RC Strasbourg","Olympique Lyon","3-2",3,2,"F1",1,5,1,"H"
2018-05-19,2017,"SM Caen","Paris Saint-Germain","0-0",0,0,"F1",1,0,0,"D"
2018-05-19,2017,"Dijon FCO","Angers SCO","2-1",2,1,"F1",1,3,1,"H"
2018-05-19,2017,"Olympique Lyon","OGC Nice","3-2",3,2,"F1",1,5,1,"H"
2018-05-19,2017,"Olympique Marseille","Amiens SC","2-1",2,1,"F1",1,3,1,"H"
2018-05-19,2017,"FC Metz","Girondins Bordeaux","0-4",0,4,"F1",1,4,-4,"A"
2018-05-19,2017,"FC Nantes","RC Strasbourg","1-0",1,0,"F1",1,1,1,"H"
2018-05-19,2017,"Stade Rennes","Montpellier HSC","1-1",1,1,"F1",1,2,0,"D"
2018-05-19,2017,"AS Saint-Etienne","Lille OSC","5-0",5,0,"F1",1,5,5,"H"
2018-05-19,2017,"Toulouse FC","EA Guingamp","2-1",2,1,"F1",1,3,1,"H"
2018-05-19,2017,"ESTAC Troyes","AS Monaco","0-3",0,3,"F1",1,3,-3,"A"
2018-08-10,2018,"Olympique Marseille","Toulouse FC","4-0",4,0,"F1",1,4,4,"H"
2018-08-11,2018,"Angers SCO","Nimes Olympique","3-4",3,4,"F1",1,7,-1,"A"
2018-08-11,2018,"Lille OSC","Stade Rennes","3-1",3,1,"F1",1,4,2,"H"
2018-08-11,2018,"Montpellier HSC","Dijon FCO","1-2",1,2,"F1",1,3,-1,"A"
2018-08-11,2018,"FC Nantes","AS Monaco","1-3",1,3,"F1",1,4,-2,"A"
2018-08-11,2018,"OGC Nice","Stade Reims","0-1",0,1,"F1",1,1,-1,"A"
2018-08-11,2018,"AS Saint-Etienne","EA Guingamp","2-1",2,1,"F1",1,3,1,"H"
2018-08-12,2018,"Girondins Bordeaux","RC Strasbourg","0-2",0,2,"F1",1,2,-2,"A"
2018-08-12,2018,"Olympique Lyon","Amiens SC","2-0",2,0,"F1",1,2,2,"H"
2018-08-12,2018,"Paris Saint-Germain","SM Caen","3-0",3,0,"F1",1,3,3,"H"
2018-08-17,2018,"Stade Reims","Olympique Lyon","1-0",1,0,"F1",1,1,1,"H"
2018-08-18,2018,"Amiens SC","Montpellier HSC","1-2",1,2,"F1",1,3,-1,"A"
2018-08-18,2018,"SM Caen","OGC Nice","1-1",1,1,"F1",1,2,0,"D"
2018-08-18,2018,"Dijon FCO","FC Nantes","2-0",2,0,"F1",1,2,2,"H"
2018-08-18,2018,"EA Guingamp","Paris Saint-Germain","1-3",1,3,"F1",1,4,-2,"A"
2018-08-18,2018,"AS Monaco","Lille OSC","0-0",0,0,"F1",1,0,0,"D"
2018-08-18,2018,"Stade Rennes","Angers SCO","1-0",1,0,"F1",1,1,1,"H"
2018-08-19,2018,"Nimes Olympique","Olympique Marseille","3-1",3,1,"F1",1,4,2,"H"
2018-08-19,2018,"RC Strasbourg","AS Saint-Etienne","1-1",1,1,"F1",1,2,0,"D"
2018-08-19,2018,"Toulouse FC","Girondins Bordeaux","2-1",2,1,"F1",1,3,1,"H"
2018-08-24,2018,"Olympique Lyon","RC Strasbourg","2-0",2,0,"F1",1,2,2,"H"
2018-08-25,2018,"Amiens SC","Stade Reims","4-1",4,1,"F1",1,5,3,"H"
2018-08-25,2018,"Montpellier HSC","AS Saint-Etienne","0-0",0,0,"F1",1,0,0,"D"
2018-08-25,2018,"FC Nantes","SM Caen","1-1",1,1,"F1",1,2,0,"D"
2018-08-25,2018,"OGC Nice","Dijon FCO","0-4",0,4,"F1",1,4,-4,"A"
2018-08-25,2018,"Paris Saint-Germain","Angers SCO","3-1",3,1,"F1",1,4,2,"H"
2018-08-25,2018,"Toulouse FC","Nimes Olympique","1-0",1,0,"F1",1,1,1,"H"
2018-08-26,2018,"Girondins Bordeaux","AS Monaco","2-1",2,1,"F1",1,3,1,"H"
2018-08-26,2018,"Lille OSC","EA Guingamp","3-0",3,0,"F1",1,3,3,"H"
2018-08-26,2018,"Olympique Marseille","Stade Rennes","2-2",2,2,"F1",1,4,0,"D"
2018-08-31,2018,"Olympique Lyon","OGC Nice","0-1",0,1,"F1",1,1,-1,"A"
2018-09-01,2018,"Angers SCO","Lille OSC","1-0",1,0,"F1",1,1,1,"H"
2018-09-01,2018,"Dijon FCO","SM Caen","0-2",0,2,"F1",1,2,-2,"A"
2018-09-01,2018,"EA Guingamp","Toulouse FC","1-2",1,2,"F1",1,3,-1,"A"
2018-09-01,2018,"Nimes Olympique","Paris Saint-Germain","2-4",2,4,"F1",1,6,-2,"A"
2018-09-01,2018,"Stade Reims","Montpellier HSC","0-1",0,1,"F1",1,1,-1,"A"
2018-09-01,2018,"RC Strasbourg","FC Nantes","2-3",2,3,"F1",1,5,-1,"A"
2018-09-02,2018,"AS Monaco","Olympique Marseille","2-3",2,3,"F1",1,5,-1,"A"
2018-09-02,2018,"Stade Rennes","Girondins Bordeaux","2-0",2,0,"F1",1,2,2,"H"
2018-09-02,2018,"AS Saint-Etienne","Amiens SC","0-0",0,0,"F1",1,0,0,"D"
2018-09-14,2018,"OGC Nice","Stade Rennes","2-1",2,1,"F1",1,3,1,"H"
2018-09-14,2018,"Paris Saint-Germain","AS Saint-Etienne","4-0",4,0,"F1",1,4,4,"H"
2018-09-15,2018,"Amiens SC","Lille OSC","2-3",2,3,"F1",1,5,-1,"A"
2018-09-15,2018,"SM Caen","Olympique Lyon","2-2",2,2,"F1",1,4,0,"D"
2018-09-15,2018,"Dijon FCO","Angers SCO","1-3",1,3,"F1",1,4,-2,"A"
2018-09-15,2018,"Montpellier HSC","RC Strasbourg","1-1",1,1,"F1",1,2,0,"D"
2018-09-15,2018,"Toulouse FC","AS Monaco","1-1",1,1,"F1",1,2,0,"D"
2018-09-16,2018,"Girondins Bordeaux","Nimes Olympique","3-3",3,3,"F1",1,6,0,"D"
2018-09-16,2018,"Olympique Marseille","EA Guingamp","4-0",4,0,"F1",1,4,4,"H"
2018-09-16,2018,"FC Nantes","Stade Reims","0-0",0,0,"F1",1,0,0,"D"
2018-09-21,2018,"AS Monaco","Nimes Olympique","1-1",1,1,"F1",1,2,0,"D"
2018-09-22,2018,"Angers SCO","Toulouse FC","0-0",0,0,"F1",1,0,0,"D"
2018-09-22,2018,"Lille OSC","FC Nantes","2-1",2,1,"F1",1,3,1,"H"
2018-09-22,2018,"Montpellier HSC","OGC Nice","1-0",1,0,"F1",1,1,1,"H"
2018-09-22,2018,"Stade Reims","Dijon FCO","0-0",0,0,"F1",1,0,0,"D"
2018-09-22,2018,"AS Saint-Etienne","SM Caen","2-1",2,1,"F1",1,3,1,"H"
2018-09-22,2018,"RC Strasbourg","Amiens SC","3-1",3,1,"F1",1,4,2,"H"
2018-09-23,2018,"EA Guingamp","Girondins Bordeaux","1-3",1,3,"F1",1,4,-2,"A"
2018-09-23,2018,"Olympique Lyon","Olympique Marseille","4-2",4,2,"F1",1,6,2,"H"
2018-09-23,2018,"Stade Rennes","Paris Saint-Germain","1-3",1,3,"F1",1,4,-2,"A"
2018-09-25,2018,"AS Monaco","Angers SCO","0-1",0,1,"F1",1,1,-1,"A"
2018-09-25,2018,"FC Nantes","OGC Nice","1-2",1,2,"F1",1,3,-1,"A"
2018-09-25,2018,"Toulouse FC","AS Saint-Etienne","2-3",2,3,"F1",1,5,-1,"A"
2018-09-26,2018,"Amiens SC","Stade Rennes","2-1",2,1,"F1",1,3,1,"H"
2018-09-26,2018,"Girondins Bordeaux","Lille OSC","1-0",1,0,"F1",1,1,1,"H"
2018-09-26,2018,"SM Caen","Montpellier HSC","2-2",2,2,"F1",1,4,0,"D"
2018-09-26,2018,"Dijon FCO","Olympique Lyon","0-3",0,3,"F1",1,3,-3,"A"
2018-09-26,2018,"Olympique Marseille","RC Strasbourg","3-2",3,2,"F1",1,5,1,"H"
2018-09-26,2018,"Nimes Olympique","EA Guingamp","0-0",0,0,"F1",1,0,0,"D"
2018-09-26,2018,"Paris Saint-Germain","Stade Reims","4-1",4,1,"F1",1,5,3,"H"
2018-09-28,2018,"AS Saint-Etienne","AS Monaco","2-0",2,0,"F1",1,2,2,"H"
2018-09-29,2018,"Angers SCO","EA Guingamp","0-1",0,1,"F1",1,1,-1,"A"
2018-09-29,2018,"SM Caen","Amiens SC","1-0",1,0,"F1",1,1,1,"H"
2018-09-29,2018,"Olympique Lyon","FC Nantes","1-1",1,1,"F1",1,2,0,"D"
2018-09-29,2018,"OGC Nice","Paris Saint-Germain","0-3",0,3,"F1",1,3,-3,"A"
2018-09-29,2018,"Stade Reims","Girondins Bordeaux","0-0",0,0,"F1",1,0,0,"D"
2018-09-29,2018,"RC Strasbourg","Dijon FCO","3-0",3,0,"F1",1,3,3,"H"
2018-09-30,2018,"Lille OSC","Olympique Marseille","3-0",3,0,"F1",1,3,3,"H"
2018-09-30,2018,"Montpellier HSC","Nimes Olympique","3-0",3,0,"F1",1,3,3,"H"
2018-09-30,2018,"Stade Rennes","Toulouse FC","1-1",1,1,"F1",1,2,0,"D"
2018-10-05,2018,"Toulouse FC","OGC Nice","1-1",1,1,"F1",1,2,0,"D"
2018-10-06,2018,"Amiens SC","Dijon FCO","1-0",1,0,"F1",1,1,1,"H"
2018-10-06,2018,"Angers SCO","RC Strasbourg","2-2",2,2,"F1",1,4,0,"D"
2018-10-06,2018,"EA Guingamp","Montpellier HSC","1-1",1,1,"F1",1,2,0,"D"
2018-10-06,2018,"Lille OSC","AS Saint-Etienne","3-1",3,1,"F1",1,4,2,"H"
2018-10-06,2018,"Nimes Olympique","Stade Reims","0-0",0,0,"F1",1,0,0,"D"
2018-10-07,2018,"Girondins Bordeaux","FC Nantes","3-0",3,0,"F1",1,3,3,"H"
2018-10-07,2018,"Olympique Marseille","SM Caen","2-0",2,0,"F1",1,2,2,"H"
2018-10-07,2018,"AS Monaco","Stade Rennes","1-2",1,2,"F1",1,3,-1,"A"
2018-10-07,2018,"Paris Saint-Germain","Olympique Lyon","5-0",5,0,"F1",1,5,5,"H"
2018-10-19,2018,"Olympique Lyon","Nimes Olympique","2-0",2,0,"F1",1,2,2,"H"
2018-10-20,2018,"SM Caen","EA Guingamp","0-0",0,0,"F1",1,0,0,"D"
2018-10-20,2018,"Dijon FCO","Lille OSC","1-2",1,2,"F1",1,3,-1,"A"
2018-10-20,2018,"FC Nantes","Toulouse FC","4-0",4,0,"F1",1,4,4,"H"
2018-10-20,2018,"Paris Saint-Germain","Amiens SC","5-0",5,0,"F1",1,5,5,"H"
2018-10-20,2018,"Stade Reims","Angers SCO","1-1",1,1,"F1",1,2,0,"D"
2018-10-20,2018,"RC Strasbourg","AS Monaco","2-1",2,1,"F1",1,3,1,"H"
2018-10-21,2018,"Montpellier HSC","Girondins Bordeaux","2-0",2,0,"F1",1,2,2,"H"
2018-10-21,2018,"OGC Nice","Olympique Marseille","0-1",0,1,"F1",1,1,-1,"A"
2018-10-21,2018,"AS Saint-Etienne","Stade Rennes","1-1",1,1,"F1",1,2,0,"D"
2018-10-26,2018,"Nimes Olympique","AS Saint-Etienne","1-1",1,1,"F1",1,2,0,"D"
2018-10-27,2018,"Amiens SC","FC Nantes","1-2",1,2,"F1",1,3,-1,"A"
2018-10-27,2018,"Angers SCO","Olympique Lyon","1-2",1,2,"F1",1,3,-1,"A"
2018-10-27,2018,"EA Guingamp","RC Strasbourg","1-1",1,1,"F1",1,2,0,"D"
2018-10-27,2018,"Lille OSC","SM Caen","1-0",1,0,"F1",1,1,1,"H"
2018-10-27,2018,"AS Monaco","Dijon FCO","2-2",2,2,"F1",1,4,0,"D"
2018-10-27,2018,"Toulouse FC","Montpellier HSC","0-3",0,3,"F1",1,3,-3,"A"
2018-10-28,2018,"Girondins Bordeaux","OGC Nice","0-1",0,1,"F1",1,1,-1,"A"
2018-10-28,2018,"Olympique Marseille","Paris Saint-Germain","0-2",0,2,"F1",1,2,-2,"A"
2018-10-28,2018,"Stade Rennes","Stade Reims","0-2",0,2,"F1",1,2,-2,"A"
2018-11-02,2018,"Paris Saint-Germain","Lille OSC","2-1",2,1,"F1",1,3,1,"H"
2018-11-03,2018,"SM Caen","Stade Rennes","1-2",1,2,"F1",1,3,-1,"A"
2018-11-03,2018,"Dijon FCO","Nimes Olympique","0-4",0,4,"F1",1,4,-4,"A"
2018-11-03,2018,"Olympique Lyon","Girondins Bordeaux","1-1",1,1,"F1",1,2,0,"D"
2018-11-03,2018,"OGC Nice","Amiens SC","1-0",1,0,"F1",1,1,1,"H"
2018-11-03,2018,"Stade Reims","AS Monaco","1-0",1,0,"F1",1,1,1,"H"
2018-11-03,2018,"RC Strasbourg","Toulouse FC","1-1",1,1,"F1",1,2,0,"D"
2018-11-04,2018,"Montpellier HSC","Olympique Marseille","3-0",3,0,"F1",1,3,3,"H"
2018-11-04,2018,"FC Nantes","EA Guingamp","5-0",5,0,"F1",1,5,5,"H"
2018-11-04,2018,"AS Saint-Etienne","Angers SCO","4-3",4,3,"F1",1,7,1,"H"
2018-11-09,2018,"Lille OSC","RC Strasbourg","0-0",0,0,"F1",1,0,0,"D"
2018-11-10,2018,"Angers SCO","Montpellier HSC","1-0",1,0,"F1",1,1,1,"H"
2018-11-10,2018,"EA Guingamp","Olympique Lyon","2-4",2,4,"F1",1,6,-2,"A"
2018-11-10,2018,"Nimes Olympique","OGC Nice","0-1",0,1,"F1",1,1,-1,"A"
2018-11-10,2018,"AS Saint-Etienne","Stade Reims","2-0",2,0,"F1",1,2,2,"H"
2018-11-10,2018,"Toulouse FC","Amiens SC","0-1",0,1,"F1",1,1,-1,"A"
2018-11-11,2018,"Girondins Bordeaux","SM Caen","0-0",0,0,"F1",1,0,0,"D"
2018-11-11,2018,"Olympique Marseille","Dijon FCO","2-0",2,0,"F1",1,2,2,"H"
2018-11-11,2018,"AS Monaco","Paris Saint-Germain","0-4",0,4,"F1",1,4,-4,"A"
2018-11-11,2018,"Stade Rennes","FC Nantes","1-1",1,1,"F1",1,2,0,"D"
2018-11-23,2018,"Olympique Lyon","AS Saint-Etienne","1-0",1,0,"F1",1,1,1,"H"
2018-11-24,2018,"SM Caen","AS Monaco","0-1",0,1,"F1",1,1,-1,"A"
2018-11-24,2018,"Dijon FCO","Girondins Bordeaux","0-0",0,0,"F1",1,0,0,"D"
2018-11-24,2018,"FC Nantes","Angers SCO","1-1",1,1,"F1",1,2,0,"D"
2018-11-24,2018,"Paris Saint-Germain","Toulouse FC","1-0",1,0,"F1",1,1,1,"H"
2018-11-24,2018,"Stade Reims","EA Guingamp","2-1",2,1,"F1",1,3,1,"H"
2018-11-24,2018,"RC Strasbourg","Nimes Olympique","0-1",0,1,"F1",1,1,-1,"A"
2018-11-25,2018,"Amiens SC","Olympique Marseille","1-3",1,3,"F1",1,4,-2,"A"
2018-11-25,2018,"Montpellier HSC","Stade Rennes","2-2",2,2,"F1",1,4,0,"D"
2018-11-25,2018,"OGC Nice","Lille OSC","2-0",2,0,"F1",1,2,2,"H"
2018-11-30,2018,"AS Saint-Etienne","FC Nantes","3-0",3,0,"F1",1,3,3,"H"
2018-12-01,2018,"Angers SCO","SM Caen","1-1",1,1,"F1",1,2,0,"D"
2018-12-01,2018,"EA Guingamp","OGC Nice","0-0",0,0,"F1",1,0,0,"D"
2018-12-01,2018,"Lille OSC","Olympique Lyon","2-2",2,2,"F1",1,4,0,"D"
2018-12-01,2018,"AS Monaco","Montpellier HSC","1-2",1,2,"F1",1,3,-1,"A"
2018-12-01,2018,"Nimes Olympique","Amiens SC","3-0",3,0,"F1",1,3,3,"H"
2018-12-02,2018,"Girondins Bordeaux","Paris Saint-Germain","2-2",2,2,"F1",1,4,0,"D"
2018-12-02,2018,"Olympique Marseille","Stade Reims","0-0",0,0,"F1",1,0,0,"D"
2018-12-02,2018,"Stade Rennes","RC Strasbourg","1-4",1,4,"F1",1,5,-3,"A"
2018-12-02,2018,"Toulouse FC","Dijon FCO","2-2",2,2,"F1",1,4,0,"D"
2018-12-04,2018,"Amiens SC","AS Monaco","0-2",0,2,"F1",1,2,-2,"A"
2018-12-04,2018,"Montpellier HSC","Lille OSC","0-1",0,1,"F1",1,1,-1,"A"
2018-12-04,2018,"OGC Nice","Angers SCO","0-0",0,0,"F1",1,0,0,"D"
2018-12-05,2018,"Girondins Bordeaux","AS Saint-Etienne","3-2",3,2,"F1",1,5,1,"H"
2018-12-05,2018,"SM Caen","Nimes Olympique","1-2",1,2,"F1",1,3,-1,"A"
2018-12-05,2018,"Dijon FCO","EA Guingamp","2-1",2,1,"F1",1,3,1,"H"
2018-12-05,2018,"Olympique Lyon","Stade Rennes","0-2",0,2,"F1",1,2,-2,"A"
2018-12-05,2018,"FC Nantes","Olympique Marseille","3-2",3,2,"F1",1,5,1,"H"
2018-12-05,2018,"Stade Reims","Toulouse FC","0-1",0,1,"F1",1,1,-1,"A"
2018-12-05,2018,"RC Strasbourg","Paris Saint-Germain","1-1",1,1,"F1",1,2,0,"D"
2018-12-08,2018,"EA Guingamp","Amiens SC","1-2",1,2,"F1",1,3,-1,"A"
2018-12-08,2018,"Stade Rennes","Dijon FCO","2-0",2,0,"F1",1,2,2,"H"
2018-12-09,2018,"Lille OSC","Stade Reims","1-1",1,1,"F1",1,2,0,"D"
2018-12-09,2018,"RC Strasbourg","SM Caen","2-2",2,2,"F1",1,4,0,"D"
2018-12-15,2018,"Stade Reims","RC Strasbourg","2-1",2,1,"F1",1,3,1,"H"
2018-12-16,2018,"Olympique Lyon","AS Monaco","3-0",3,0,"F1",1,3,3,"H"
2018-12-16,2018,"OGC Nice","AS Saint-Etienne","1-1",1,1,"F1",1,2,0,"D"
2018-12-16,2018,"Nimes Olympique","Lille OSC","2-3",2,3,"F1",1,5,-1,"A"
2018-12-18,2018,"SM Caen","Toulouse FC","2-1",2,1,"F1",1,3,1,"H"
2018-12-22,2018,"Angers SCO","Olympique Marseille","1-1",1,1,"F1",1,2,0,"D"
2018-12-22,2018,"Lille OSC","Toulouse FC","1-2",1,2,"F1",1,3,-1,"A"
2018-12-22,2018,"AS Monaco","EA Guingamp","0-2",0,2,"F1",1,2,-2,"A"
2018-12-22,2018,"Montpellier HSC","Olympique Lyon","1-1",1,1,"F1",1,2,0,"D"
2018-12-22,2018,"Paris Saint-Germain","FC Nantes","1-0",1,0,"F1",1,1,1,"H"
2018-12-22,2018,"Stade Reims","SM Caen","2-2",2,2,"F1",1,4,0,"D"
2018-12-22,2018,"Stade Rennes","Nimes Olympique","4-0",4,0,"F1",1,4,4,"H"
2018-12-22,2018,"AS Saint-Etienne","Dijon FCO","3-0",3,0,"F1",1,3,3,"H"
2018-12-22,2018,"RC Strasbourg","OGC Nice","2-0",2,0,"F1",1,2,2,"H"
2018-12-23,2018,"Girondins Bordeaux","Amiens SC","1-1",1,1,"F1",1,2,0,"D"
2019-01-08,2018,"Amiens SC","Angers SCO","0-0",0,0,"F1",1,0,0,"D"
2019-01-08,2018,"FC Nantes","Montpellier HSC","2-0",2,0,"F1",1,2,2,"H"
2019-01-11,2018,"SM Caen","Lille OSC","1-3",1,3,"F1",1,4,-2,"A"
2019-01-11,2018,"Olympique Lyon","Stade Reims","1-1",1,1,"F1",1,2,0,"D"
2019-01-12,2018,"Amiens SC","Paris Saint-Germain","0-3",0,3,"F1",1,3,-3,"A"
2019-01-12,2018,"EA Guingamp","AS Saint-Etienne","0-1",0,1,"F1",1,1,-1,"A"
2019-01-12,2018,"OGC Nice","Girondins Bordeaux","1-0",1,0,"F1",1,1,1,"H"
2019-01-13,2018,"Dijon FCO","Montpellier HSC","1-1",1,1,"F1",1,2,0,"D"
2019-01-13,2018,"Olympique Marseille","AS Monaco","1-1",1,1,"F1",1,2,0,"D"
2019-01-13,2018,"FC Nantes","Stade Rennes","0-1",0,1,"F1",1,1,-1,"A"
2019-01-13,2018,"Toulouse FC","RC Strasbourg","1-2",1,2,"F1",1,3,-1,"A"
2019-01-15,2018,"Angers SCO","Girondins Bordeaux","1-2",1,2,"F1",1,3,-1,"A"
2019-01-16,2018,"EA Guingamp","Stade Rennes","2-1",2,1,"F1",1,3,1,"H"
2019-01-16,2018,"AS Monaco","OGC Nice","1-1",1,1,"F1",1,2,0,"D"
2019-01-16,2018,"Nimes Olympique","FC Nantes","1-0",1,0,"F1",1,1,1,"H"
2019-01-16,2018,"AS Saint-Etienne","Olympique Marseille","2-1",2,1,"F1",1,3,1,"H"
2019-01-16,2018,"Toulouse FC","Olympique Lyon","2-2",2,2,"F1",1,4,0,"D"
2019-01-18,2018,"Lille OSC","Amiens SC","2-1",2,1,"F1",1,3,1,"H"
2019-01-19,2018,"AS Monaco","RC Strasbourg","1-5",1,5,"F1",1,6,-4,"A"
2019-01-19,2018,"Nimes Olympique","Toulouse FC","0-1",0,1,"F1",1,1,-1,"A"
2019-01-19,2018,"Paris Saint-Germain","EA Guingamp","9-0",9,0,"F1",1,9,9,"H"
2019-01-19,2018,"Stade Reims","OGC Nice","1-1",1,1,"F1",1,2,0,"D"
2019-01-20,2018,"Angers SCO","FC Nantes","1-0",1,0,"F1",1,1,1,"H"
2019-01-20,2018,"Girondins Bordeaux","Dijon FCO","1-0",1,0,"F1",1,1,1,"H"
2019-01-20,2018,"SM Caen","Olympique Marseille","0-1",0,1,"F1",1,1,-1,"A"
2019-01-20,2018,"Stade Rennes","Montpellier HSC","0-0",0,0,"F1",1,0,0,"D"
2019-01-20,2018,"AS Saint-Etienne","Olympique Lyon","1-2",1,2,"F1",1,3,-1,"A"
2019-01-23,2018,"Nimes Olympique","Angers SCO","3-1",3,1,"F1",1,4,2,"H"
2019-01-25,2018,"Olympique Marseille","Lille OSC","1-2",1,2,"F1",1,3,-1,"A"
2019-01-26,2018,"Dijon FCO","AS Monaco","2-0",2,0,"F1",1,2,2,"H"
2019-01-26,2018,"EA Guingamp","Stade Reims","0-1",0,1,"F1",1,1,-1,"A"
2019-01-26,2018,"OGC Nice","Nimes Olympique","2-0",2,0,"F1",1,2,2,"H"
2019-01-26,2018,"RC Strasbourg","Girondins Bordeaux","1-0",1,0,"F1",1,1,1,"H"
2019-01-27,2018,"Amiens SC","Olympique Lyon","0-1",0,1,"F1",1,1,-1,"A"
2019-01-27,2018,"Montpellier HSC","SM Caen","2-0",2,0,"F1",1,2,2,"H"
2019-01-27,2018,"Paris Saint-Germain","Stade Rennes","4-1",4,1,"F1",1,5,3,"H"
2019-01-27,2018,"Toulouse FC","Angers SCO","0-0",0,0,"F1",1,0,0,"D"
2019-01-30,2018,"FC Nantes","AS Saint-Etienne","1-1",1,1,"F1",1,2,0,"D"
2019-02-01,2018,"Lille OSC","OGC Nice","4-0",4,0,"F1",1,4,4,"H"
2019-02-02,2018,"Angers SCO","Dijon FCO","1-0",1,0,"F1",1,1,1,"H"
2019-02-02,2018,"AS Monaco","Toulouse FC","2-1",2,1,"F1",1,3,1,"H"
2019-02-02,2018,"Stade Reims","Olympique Marseille","2-1",2,1,"F1",1,3,1,"H"
2019-02-02,2018,"Stade Rennes","Amiens SC","1-0",1,0,"F1",1,1,1,"H"
2019-02-03,2018,"Olympique Lyon","Paris Saint-Germain","2-1",2,1,"F1",1,3,1,"H"
2019-02-03,2018,"Nimes Olympique","Montpellier HSC","1-1",1,1,"F1",1,2,0,"D"
2019-02-05,2018,"Olympique Marseille","Girondins Bordeaux","1-0",1,0,"F1",1,1,1,"H"
2019-02-08,2018,"Dijon FCO","Olympique Marseille","1-2",1,2,"F1",1,3,-1,"A"
2019-02-09,2018,"Amiens SC","SM Caen","1-0",1,0,"F1",1,1,1,"H"
2019-02-09,2018,"Paris Saint-Germain","Girondins Bordeaux","1-0",1,0,"F1",1,1,1,"H"
2019-02-09,2018,"RC Strasbourg","Angers SCO","1-2",1,2,"F1",1,3,-1,"A"
2019-02-10,2018,"EA Guingamp","Lille OSC","0-2",0,2,"F1",1,2,-2,"A"
2019-02-10,2018,"Montpellier HSC","AS Monaco","2-2",2,2,"F1",1,4,0,"D"
2019-02-10,2018,"FC Nantes","Nimes Olympique","2-4",2,4,"F1",1,6,-2,"A"
2019-02-10,2018,"OGC Nice","Olympique Lyon","1-0",1,0,"F1",1,1,1,"H"
2019-02-10,2018,"Stade Rennes","AS Saint-Etienne","3-0",3,0,"F1",1,3,3,"H"
2019-02-10,2018,"Toulouse FC","Stade Reims","1-1",1,1,"F1",1,2,0,"D"
2019-02-13,2018,"SM Caen","FC Nantes","0-1",0,1,"F1",1,1,-1,"A"
2019-02-13,2018,"AS Saint-Etienne","RC Strasbourg","2-1",2,1,"F1",1,3,1,"H"
2019-02-15,2018,"Olympique Lyon","EA Guingamp","2-1",2,1,"F1",1,3,1,"H"
2019-02-15,2018,"Nimes Olympique","Dijon FCO","2-0",2,0,"F1",1,2,2,"H"
2019-02-16,2018,"Angers SCO","OGC Nice","3-0",3,0,"F1",1,3,3,"H"
2019-02-16,2018,"Olympique Marseille","Amiens SC","2-0",2,0,"F1",1,2,2,"H"
2019-02-16,2018,"AS Monaco","FC Nantes","1-0",1,0,"F1",1,1,1,"H"
2019-02-17,2018,"Girondins Bordeaux","Toulouse FC","2-1",2,1,"F1",1,3,1,"H"
2019-02-17,2018,"SM Caen","RC Strasbourg","0-0",0,0,"F1",1,0,0,"D"
2019-02-17,2018,"Lille OSC","Montpellier HSC","0-0",0,0,"F1",1,0,0,"D"
2019-02-17,2018,"Stade Reims","Stade Rennes","2-0",2,0,"F1",1,2,2,"H"
2019-02-17,2018,"AS Saint-Etienne","Paris Saint-Germain","0-1",0,1,"F1",1,1,-1,"A"
2019-02-20,2018,"Girondins Bordeaux","EA Guingamp","0-0",0,0,"F1",1,0,0,"D"
2019-02-20,2018,"Paris Saint-Germain","Montpellier HSC","5-1",5,1,"F1",1,6,4,"H"
2019-02-22,2018,"Dijon FCO","AS Saint-Etienne","0-1",0,1,"F1",1,1,-1,"A"
2019-02-22,2018,"RC Strasbourg","Lille OSC","1-1",1,1,"F1",1,2,0,"D"
2019-02-23,2018,"Amiens SC","OGC Nice","1-0",1,0,"F1",1,1,1,"H"
2019-02-23,2018,"EA Guingamp","Angers SCO","1-0",1,0,"F1",1,1,1,"H"
2019-02-23,2018,"Paris Saint-Germain","Nimes Olympique","3-0",3,0,"F1",1,3,3,"H"
2019-02-24,2018,"AS Monaco","Olympique Lyon","2-0",2,0,"F1",1,2,2,"H"
2019-02-24,2018,"Montpellier HSC","Stade Reims","2-4",2,4,"F1",1,6,-2,"A"
2019-02-24,2018,"FC Nantes","Girondins Bordeaux","1-0",1,0,"F1",1,1,1,"H"
2019-02-24,2018,"Stade Rennes","Olympique Marseille","1-1",1,1,"F1",1,2,0,"D"
2019-02-24,2018,"Toulouse FC","SM Caen","1-1",1,1,"F1",1,2,0,"D"
2019-03-02,2018,"Angers SCO","AS Monaco","2-2",2,2,"F1",1,4,0,"D"
2019-03-02,2018,"SM Caen","Paris Saint-Germain","1-2",1,2,"F1",1,3,-1,"A"
2019-03-02,2018,"Stade Reims","Amiens SC","2-2",2,2,"F1",1,4,0,"D"
2019-03-03,2018,"EA Guingamp","FC Nantes","0-0",0,0,"F1",1,0,0,"D"
2019-03-03,2018,"Lille OSC","Dijon FCO","1-0",1,0,"F1",1,1,1,"H"
2019-03-03,2018,"Olympique Lyon","Toulouse FC","5-1",5,1,"F1",1,6,4,"H"
2019-03-03,2018,"Olympique Marseille","AS Saint-Etienne","2-0",2,0,"F1",1,2,2,"H"
2019-03-03,2018,"OGC Nice","RC Strasbourg","1-0",1,0,"F1",1,1,1,"H"
2019-03-05,2018,"Girondins Bordeaux","Montpellier HSC","1-2",1,2,"F1",1,3,-1,"A"
2019-03-09,2018,"Amiens SC","Nimes Olympique","2-1",2,1,"F1",1,3,1,"H"
2019-03-09,2018,"Dijon FCO","Stade Reims","1-1",1,1,"F1",1,2,0,"D"
2019-03-09,2018,"AS Monaco","Girondins Bordeaux","1-1",1,1,"F1",1,2,0,"D"
2019-03-09,2018,"RC Strasbourg","Olympique Lyon","2-2",2,2,"F1",1,4,0,"D"
2019-03-10,2018,"Olympique Marseille","OGC Nice","1-0",1,0,"F1",1,1,1,"H"
2019-03-10,2018,"Montpellier HSC","Angers SCO","2-2",2,2,"F1",1,4,0,"D"
2019-03-10,2018,"Stade Rennes","SM Caen","3-1",3,1,"F1",1,4,2,"H"
2019-03-10,2018,"AS Saint-Etienne","Lille OSC","0-1",0,1,"F1",1,1,-1,"A"
2019-03-10,2018,"Toulouse FC","EA Guingamp","1-0",1,0,"F1",1,1,1,"H"
2019-03-12,2018,"Dijon FCO","Paris Saint-Germain","0-4",0,4,"F1",1,4,-4,"A"
2019-03-15,2018,"Lille OSC","AS Monaco","0-1",0,1,"F1",1,1,-1,"A"
2019-03-15,2018,"OGC Nice","Toulouse FC","1-1",1,1,"F1",1,2,0,"D"
2019-03-16,2018,"Angers SCO","Amiens SC","0-0",0,0,"F1",1,0,0,"D"
2019-03-16,2018,"SM Caen","AS Saint-Etienne","0-5",0,5,"F1",1,5,-5,"A"
2019-03-16,2018,"EA Guingamp","Dijon FCO","1-0",1,0,"F1",1,1,1,"H"
2019-03-16,2018,"Nimes Olympique","RC Strasbourg","2-2",2,2,"F1",1,4,0,"D"
2019-03-17,2018,"Girondins Bordeaux","Stade Rennes","1-1",1,1,"F1",1,2,0,"D"
2019-03-17,2018,"Olympique Lyon","Montpellier HSC","3-2",3,2,"F1",1,5,1,"H"
2019-03-17,2018,"Paris Saint-Germain","Olympique Marseille","3-1",3,1,"F1",1,4,2,"H"
2019-03-17,2018,"Stade Reims","FC Nantes","1-0",1,0,"F1",1,1,1,"H"
2019-03-29,2018,"Stade Rennes","Olympique Lyon","0-1",0,1,"F1",1,1,-1,"A"
2019-03-30,2018,"Olympique Marseille","Angers SCO","2-2",2,2,"F1",1,4,0,"D"
2019-03-31,2018,"Amiens SC","Girondins Bordeaux","0-0",0,0,"F1",1,0,0,"D"
2019-03-31,2018,"Dijon FCO","OGC Nice","0-1",0,1,"F1",1,1,-1,"A"
2019-03-31,2018,"AS Monaco","SM Caen","0-1",0,1,"F1",1,1,-1,"A"
2019-03-31,2018,"FC Nantes","Lille OSC","2-3",2,3,"F1",1,5,-1,"A"
2019-03-31,2018,"Toulouse FC","Paris Saint-Germain","0-1",0,1,"F1",1,1,-1,"A"
2019-04-01,2018,"AS Saint-Etienne","Nimes Olympique","2-1",2,1,"F1",1,3,1,"H"
2019-04-03,2018,"Montpellier HSC","EA Guingamp","2-0",2,0,"F1",1,2,2,"H"
2019-04-03,2018,"RC Strasbourg","Stade Reims","4-0",4,0,"F1",1,4,4,"H"
2019-04-05,2018,"Girondins Bordeaux","Olympique Marseille","2-0",2,0,"F1",1,2,2,"H"
2019-04-06,2018,"Amiens SC","AS Saint-Etienne","2-2",2,2,"F1",1,4,0,"D"
2019-04-06,2018,"Angers SCO","Stade Rennes","3-3",3,3,"F1",1,6,0,"D"
2019-04-06,2018,"EA Guingamp","AS Monaco","1-1",1,1,"F1",1,2,0,"D"
2019-04-06,2018,"Olympique Lyon","Dijon FCO","1-3",1,3,"F1",1,4,-2,"A"
2019-04-06,2018,"Nimes Olympique","SM Caen","2-0",2,0,"F1",1,2,2,"H"
2019-04-07,2018,"OGC Nice","Montpellier HSC","1-0",1,0,"F1",1,1,1,"H"
2019-04-07,2018,"Paris Saint-Germain","RC Strasbourg","2-2",2,2,"F1",1,4,0,"D"
2019-04-07,2018,"Stade Reims","Lille OSC","1-1",1,1,"F1",1,2,0,"D"
2019-04-07,2018,"Toulouse FC","FC Nantes","1-0",1,0,"F1",1,1,1,"H"
2019-04-09,2018,"Nimes Olympique","Stade Rennes","3-1",3,1,"F1",1,4,2,"H"
2019-04-12,2018,"Dijon FCO","Amiens SC","0-0",0,0,"F1",1,0,0,"D"
2019-04-12,2018,"FC Nantes","Olympique Lyon","2-1",2,1,"F1",1,3,1,"H"
2019-04-13,2018,"SM Caen","Angers SCO","0-1",0,1,"F1",1,1,-1,"A"
2019-04-13,2018,"Olympique Marseille","Nimes Olympique","2-1",2,1,"F1",1,3,1,"H"
2019-04-13,2018,"AS Monaco","Stade Reims","0-0",0,0,"F1",1,0,0,"D"
2019-04-13,2018,"RC Strasbourg","EA Guingamp","3-3",3,3,"F1",1,6,0,"D"
2019-04-14,2018,"Lille OSC","Paris Saint-Germain","5-1",5,1,"F1",1,6,4,"H"
2019-04-14,2018,"Montpellier HSC","Toulouse FC","2-1",2,1,"F1",1,3,1,"H"
2019-04-14,2018,"Stade Rennes","OGC Nice","0-0",0,0,"F1",1,0,0,"D"
2019-04-14,2018,"AS Saint-Etienne","Girondins Bordeaux","3-0",3,0,"F1",1,3,3,"H"
2019-04-17,2018,"FC Nantes","Paris Saint-Germain","3-2",3,2,"F1",1,5,1,"H"
2019-04-19,2018,"Dijon FCO","Stade Rennes","3-2",3,2,"F1",1,5,1,"H"
2019-04-19,2018,"Olympique Lyon","Angers SCO","2-1",2,1,"F1",1,3,1,"H"
2019-04-20,2018,"EA Guingamp","Olympique Marseille","1-3",1,3,"F1",1,4,-2,"A"
2019-04-20,2018,"OGC Nice","SM Caen","0-1",0,1,"F1",1,1,-1,"A"
2019-04-20,2018,"Nimes Olympique","Girondins Bordeaux","2-1",2,1,"F1",1,3,1,"H"
2019-04-20,2018,"RC Strasbourg","Montpellier HSC","1-3",1,3,"F1",1,4,-2,"A"
2019-04-21,2018,"FC Nantes","Amiens SC","3-2",3,2,"F1",1,5,1,"H"
2019-04-21,2018,"Paris Saint-Germain","AS Monaco","3-1",3,1,"F1",1,4,2,"H"
2019-04-21,2018,"Stade Reims","AS Saint-Etienne","0-2",0,2,"F1",1,2,-2,"A"
2019-04-21,2018,"Toulouse FC","Lille OSC","0-0",0,0,"F1",1,0,0,"D"
2019-04-26,2018,"Girondins Bordeaux","Olympique Lyon","2-3",2,3,"F1",1,5,-1,"A"
2019-04-28,2018,"Amiens SC","RC Strasbourg","0-0",0,0,"F1",1,0,0,"D"
2019-04-28,2018,"Angers SCO","Stade Reims","1-1",1,1,"F1",1,2,0,"D"
2019-04-28,2018,"SM Caen","Dijon FCO","1-0",1,0,"F1",1,1,1,"H"
2019-04-28,2018,"Lille OSC","Nimes Olympique","5-0",5,0,"F1",1,5,5,"H"
2019-04-28,2018,"Olympique Marseille","FC Nantes","1-2",1,2,"F1",1,3,-1,"A"
2019-04-28,2018,"OGC Nice","EA Guingamp","3-0",3,0,"F1",1,3,3,"H"
2019-04-28,2018,"AS Saint-Etienne","Toulouse FC","2-0",2,0,"F1",1,2,2,"H"
2019-04-30,2018,"Montpellier HSC","Paris Saint-Germain","3-2",3,2,"F1",1,5,1,"H"
2019-05-01,2018,"Stade Rennes","AS Monaco","2-2",2,2,"F1",1,4,0,"D"
2019-05-03,2018,"RC Strasbourg","Olympique Marseille","1-1",1,1,"F1",1,2,0,"D"
2019-05-04,2018,"Girondins Bordeaux","Angers SCO","0-1",0,1,"F1",1,1,-1,"A"
2019-05-04,2018,"EA Guingamp","SM Caen","0-0",0,0,"F1",1,0,0,"D"
2019-05-04,2018,"Paris Saint-Germain","OGC Nice","1-1",1,1,"F1",1,2,0,"D"
2019-05-04,2018,"Stade Reims","Nimes Olympique","0-3",0,3,"F1",1,3,-3,"A"
2019-05-05,2018,"Olympique Lyon","Lille OSC","2-2",2,2,"F1",1,4,0,"D"
2019-05-05,2018,"AS Monaco","AS Saint-Etienne","2-3",2,3,"F1",1,5,-1,"A"
2019-05-05,2018,"Montpellier HSC","Amiens SC","1-1",1,1,"F1",1,2,0,"D"
2019-05-05,2018,"FC Nantes","Dijon FCO","3-0",3,0,"F1",1,3,3,"H"
2019-05-05,2018,"Toulouse FC","Stade Rennes","2-2",2,2,"F1",1,4,0,"D"
2019-05-10,2018,"AS Saint-Etienne","Montpellier HSC","0-1",0,1,"F1",1,1,-1,"A"
2019-05-11,2018,"Amiens SC","Toulouse FC","0-0",0,0,"F1",1,0,0,"D"
2019-05-11,2018,"Angers SCO","Paris Saint-Germain","1-2",1,2,"F1",1,3,-1,"A"
2019-05-11,2018,"SM Caen","Stade Reims","3-2",3,2,"F1",1,5,1,"H"
2019-05-11,2018,"Dijon FCO","RC Strasbourg","2-1",2,1,"F1",1,3,1,"H"
2019-05-11,2018,"OGC Nice","FC Nantes","1-1",1,1,"F1",1,2,0,"D"
2019-05-11,2018,"Nimes Olympique","AS Monaco","1-0",1,0,"F1",1,1,1,"H"
2019-05-12,2018,"Lille OSC","Girondins Bordeaux","1-0",1,0,"F1",1,1,1,"H"
2019-05-12,2018,"Olympique Marseille","Olympique Lyon","0-3",0,3,"F1",1,3,-3,"A"
2019-05-12,2018,"Stade Rennes","EA Guingamp","1-1",1,1,"F1",1,2,0,"D"
2019-05-18,2018,"Girondins Bordeaux","Stade Reims","0-1",0,1,"F1",1,1,-1,"A"
2019-05-18,2018,"EA Guingamp","Nimes Olympique","2-2",2,2,"F1",1,4,0,"D"
2019-05-18,2018,"Lille OSC","Angers SCO","5-0",5,0,"F1",1,5,5,"H"
2019-05-18,2018,"Olympique Lyon","SM Caen","4-0",4,0,"F1",1,4,4,"H"
2019-05-18,2018,"AS Monaco","Amiens SC","2-0",2,0,"F1",1,2,2,"H"
2019-05-18,2018,"Montpellier HSC","FC Nantes","1-1",1,1,"F1",1,2,0,"D"
2019-05-18,2018,"Paris Saint-Germain","Dijon FCO","4-0",4,0,"F1",1,4,4,"H"
2019-05-18,2018,"AS Saint-Etienne","OGC Nice","3-0",3,0,"F1",1,3,3,"H"
2019-05-18,2018,"RC Strasbourg","Stade Rennes","0-2",0,2,"F1",1,2,-2,"A"
2019-05-18,2018,"Toulouse FC","Olympique Marseille","2-5",2,5,"F1",1,7,-3,"A"
2019-05-24,2018,"Amiens SC","EA Guingamp","2-1",2,1,"F1",1,3,1,"H"
2019-05-24,2018,"Angers SCO","AS Saint-Etienne","1-1",1,1,"F1",1,2,0,"D"
2019-05-24,2018,"SM Caen","Girondins Bordeaux","0-1",0,1,"F1",1,1,-1,"A"
2019-05-24,2018,"Dijon FCO","Toulouse FC","2-1",2,1,"F1",1,3,1,"H"
2019-05-24,2018,"Olympique Marseille","Montpellier HSC","1-0",1,0,"F1",1,1,1,"H"
2019-05-24,2018,"FC Nantes","RC Strasbourg","0-1",0,1,"F1",1,1,-1,"A"
2019-05-24,2018,"OGC Nice","AS Monaco","2-0",2,0,"F1",1,2,2,"H"
2019-05-24,2018,"Nimes Olympique","Olympique Lyon","2-3",2,3,"F1",1,5,-1,"A"
2019-05-24,2018,"Stade Reims","Paris Saint-Germain","3-1",3,1,"F1",1,4,2,"H"
2019-05-24,2018,"Stade Rennes","Lille OSC","3-1",3,1,"F1",1,4,2,"H"
2019-08-09,2019,"AS Monaco","Olympique Lyon","0-3",0,3,"F1",1,3,-3,"A"
2019-08-10,2019,"Olympique Marseille","Stade Reims","0-2",0,2,"F1",1,2,-2,"A"
2019-08-10,2019,"Angers SCO","Girondins Bordeaux","3-1",3,1,"F1",1,4,2,"H"
2019-08-10,2019,"Stade Brest","Toulouse FC","1-1",1,1,"F1",1,2,0,"D"
2019-08-10,2019,"Dijon FCO","AS Saint-Etienne","1-2",1,2,"F1",1,3,-1,"A"
2019-08-10,2019,"Montpellier HSC","Stade Rennes","0-1",0,1,"F1",1,1,-1,"A"
2019-08-10,2019,"OGC Nice","Amiens SC","2-1",2,1,"F1",1,3,1,"H"
2019-08-11,2019,"Lille OSC","FC Nantes","2-1",2,1,"F1",1,3,1,"H"
2019-08-11,2019,"RC Strasbourg","FC Metz","1-1",1,1,"F1",1,2,0,"D"
2019-08-11,2019,"Paris Saint-Germain","Nimes Olympique","3-0",3,0,"F1",1,3,3,"H"
2019-08-16,2019,"Olympique Lyon","Angers SCO","6-0",6,0,"F1",1,6,6,"H"
2019-08-17,2019,"FC Nantes","Olympique Marseille","0-0",0,0,"F1",1,0,0,"D"
2019-08-17,2019,"Amiens SC","Lille OSC","1-0",1,0,"F1",1,1,1,"H"
2019-08-17,2019,"Girondins Bordeaux","Montpellier HSC","1-1",1,1,"F1",1,2,0,"D"
2019-08-17,2019,"FC Metz","AS Monaco","3-0",3,0,"F1",1,3,3,"H"
2019-08-17,2019,"Nimes Olympique","OGC Nice","1-2",1,2,"F1",1,3,-1,"A"
2019-08-17,2019,"Toulouse FC","Dijon FCO","1-0",1,0,"F1",1,1,1,"H"
2019-08-18,2019,"AS Saint-Etienne","Stade Brest","1-1",1,1,"F1",1,2,0,"D"
2019-08-18,2019,"Stade Reims","RC Strasbourg","0-0",0,0,"F1",1,0,0,"D"
2019-08-18,2019,"Stade Rennes","Paris Saint-Germain","2-1",2,1,"F1",1,3,1,"H"
2019-08-24,2019,"Amiens SC","FC Nantes","1-2",1,2,"F1",1,3,-1,"A"
2019-08-24,2019,"Angers SCO","FC Metz","3-0",3,0,"F1",1,3,3,"H"
2019-08-24,2019,"Stade Brest","Stade Reims","1-0",1,0,"F1",1,1,1,"H"
2019-08-24,2019,"Dijon FCO","Girondins Bordeaux","0-2",0,2,"F1",1,2,-2,"A"
2019-08-25,2019,"AS Monaco","Nimes Olympique","2-2",2,2,"F1",1,4,0,"D"
2019-08-25,2019,"RC Strasbourg","Stade Rennes","0-2",0,2,"F1",1,2,-2,"A"
2019-08-25,2019,"Paris Saint-Germain","Toulouse FC","4-0",4,0,"F1",1,4,4,"H"
2019-08-27,2019,"Montpellier HSC","Olympique Lyon","1-0",1,0,"F1",1,1,1,"H"
2019-08-28,2019,"Lille OSC","AS Saint-Etienne","3-0",3,0,"F1",1,3,3,"H"
2019-08-28,2019,"OGC Nice","Olympique Marseille","1-2",1,2,"F1",1,3,-1,"A"
2019-08-30,2019,"FC Metz","Paris Saint-Germain","0-2",0,2,"F1",1,2,-2,"A"
2019-08-31,2019,"Olympique Lyon","Girondins Bordeaux","1-1",1,1,"F1",1,2,0,"D"
2019-08-31,2019,"Angers SCO","Dijon FCO","2-0",2,0,"F1",1,2,2,"H"
2019-08-31,2019,"FC Nantes","Montpellier HSC","1-0",1,0,"F1",1,1,1,"H"
2019-08-31,2019,"Nimes Olympique","Stade Brest","3-0",3,0,"F1",1,3,3,"H"
2019-08-31,2019,"Toulouse FC","Amiens SC","2-0",2,0,"F1",1,2,2,"H"
2019-09-01,2019,"Stade Reims","Lille OSC","2-0",2,0,"F1",1,2,2,"H"
2019-09-01,2019,"Stade Rennes","OGC Nice","1-2",1,2,"F1",1,3,-1,"A"
2019-09-01,2019,"RC Strasbourg","AS Monaco","2-2",2,2,"F1",1,4,0,"D"
2019-09-01,2019,"Olympique Marseille","AS Saint-Etienne","1-0",1,0,"F1",1,1,1,"H"
2019-09-13,2019,"Lille OSC","Angers SCO","2-1",2,1,"F1",1,3,1,"H"
2019-09-13,2019,"Amiens SC","Olympique Lyon","2-2",2,2,"F1",1,4,0,"D"
2019-09-14,2019,"Paris Saint-Germain","RC Strasbourg","1-0",1,0,"F1",1,1,1,"H"
2019-09-14,2019,"Girondins Bordeaux","FC Metz","2-0",2,0,"F1",1,2,2,"H"
2019-09-14,2019,"Stade Brest","Stade Rennes","0-0",0,0,"F1",1,0,0,"D"
2019-09-14,2019,"Dijon FCO","Nimes Olympique","0-0",0,0,"F1",1,0,0,"D"
2019-09-14,2019,"Montpellier HSC","OGC Nice","2-1",2,1,"F1",1,3,1,"H"
2019-09-15,2019,"FC Nantes","Stade Reims","1-0",1,0,"F1",1,1,1,"H"
2019-09-15,2019,"AS Saint-Etienne","Toulouse FC","2-2",2,2,"F1",1,4,0,"D"
2019-09-15,2019,"AS Monaco","Olympique Marseille","3-4",3,4,"F1",1,7,-1,"A"
2019-09-20,2019,"RC Strasbourg","FC Nantes","2-1",2,1,"F1",1,3,1,"H"
2019-09-21,2019,"Olympique Marseille","Montpellier HSC","1-1",1,1,"F1",1,2,0,"D"
2019-09-21,2019,"Girondins Bordeaux","Stade Brest","2-2",2,2,"F1",1,4,0,"D"
2019-09-21,2019,"FC Metz","Amiens SC","1-2",1,2,"F1",1,3,-1,"A"
2019-09-21,2019,"OGC Nice","Dijon FCO","2-1",2,1,"F1",1,3,1,"H"
2019-09-21,2019,"Nimes Olympique","Toulouse FC","1-0",1,0,"F1",1,1,1,"H"
2019-09-21,2019,"Stade Reims","AS Monaco","0-0",0,0,"F1",1,0,0,"D"
2019-09-22,2019,"Stade Rennes","Lille OSC","1-1",1,1,"F1",1,2,0,"D"
2019-09-22,2019,"Angers SCO","AS Saint-Etienne","4-1",4,1,"F1",1,5,3,"H"
2019-09-22,2019,"Olympique Lyon","Paris Saint-Germain","0-1",0,1,"F1",1,1,-1,"A"
2019-09-24,2019,"Dijon FCO","Olympique Marseille","0-0",0,0,"F1",1,0,0,"D"
2019-09-24,2019,"AS Monaco","OGC Nice","3-1",3,1,"F1",1,4,2,"H"
2019-09-25,2019,"Amiens SC","Girondins Bordeaux","1-3",1,3,"F1",1,4,-2,"A"
2019-09-25,2019,"Stade Brest","Olympique Lyon","2-2",2,2,"F1",1,4,0,"D"
2019-09-25,2019,"Lille OSC","RC Strasbourg","2-0",2,0,"F1",1,2,2,"H"
2019-09-25,2019,"Montpellier HSC","Nimes Olympique","1-0",1,0,"F1",1,1,1,"H"
2019-09-25,2019,"FC Nantes","Stade Rennes","1-0",1,0,"F1",1,1,1,"H"
2019-09-25,2019,"AS Saint-Etienne","FC Metz","0-1",0,1,"F1",1,1,-1,"A"
2019-09-25,2019,"Toulouse FC","Angers SCO","0-2",0,2,"F1",1,2,-2,"A"
2019-09-25,2019,"Paris Saint-Germain","Stade Reims","0-2",0,2,"F1",1,2,-2,"A"
2019-09-28,2019,"Olympique Lyon","FC Nantes","0-1",0,1,"F1",1,1,-1,"A"
2019-09-28,2019,"Girondins Bordeaux","Paris Saint-Germain","0-1",0,1,"F1",1,1,-1,"A"
2019-09-28,2019,"Angers SCO","Amiens SC","1-1",1,1,"F1",1,2,0,"D"
2019-09-28,2019,"FC Metz","Toulouse FC","2-2",2,2,"F1",1,4,0,"D"
2019-09-28,2019,"AS Monaco","Stade Brest","4-1",4,1,"F1",1,5,3,"H"
2019-09-28,2019,"OGC Nice","Lille OSC","1-1",1,1,"F1",1,2,0,"D"
2019-09-28,2019,"Stade Reims","Dijon FCO","1-2",1,2,"F1",1,3,-1,"A"
2019-09-29,2019,"RC Strasbourg","Montpellier HSC","1-0",1,0,"F1",1,1,1,"H"
2019-09-29,2019,"Nimes Olympique","AS Saint-Etienne","0-1",0,1,"F1",1,1,-1,"A"
2019-09-29,2019,"Olympique Marseille","Stade Rennes","1-1",1,1,"F1",1,2,0,"D"
2019-10-04,2019,"Amiens SC","Olympique Marseille","3-1",3,1,"F1",1,4,2,"H"
2019-10-05,2019,"Paris Saint-Germain","Angers SCO","4-0",4,0,"F1",1,4,4,"H"
2019-10-05,2019,"Stade Brest","FC Metz","2-0",2,0,"F1",1,2,2,"H"
2019-10-05,2019,"Dijon FCO","RC Strasbourg","1-0",1,0,"F1",1,1,1,"H"
2019-10-05,2019,"Montpellier HSC","AS Monaco","3-1",3,1,"F1",1,4,2,"H"
2019-10-05,2019,"FC Nantes","OGC Nice","1-0",1,0,"F1",1,1,1,"H"
2019-10-05,2019,"Toulouse FC","Girondins Bordeaux","1-3",1,3,"F1",1,4,-2,"A"
2019-10-06,2019,"Lille OSC","Nimes Olympique","2-2",2,2,"F1",1,4,0,"D"
2019-10-06,2019,"Stade Rennes","Stade Reims","0-1",0,1,"F1",1,1,-1,"A"
2019-10-06,2019,"AS Saint-Etienne","Olympique Lyon","1-0",1,0,"F1",1,1,1,"H"
2019-10-18,2019,"OGC Nice","Paris Saint-Germain","1-4",1,4,"F1",1,5,-3,"A"
2019-10-19,2019,"Olympique Lyon","Dijon FCO","0-0",0,0,"F1",1,0,0,"D"
2019-10-19,2019,"Angers SCO","Stade Brest","0-1",0,1,"F1",1,1,-1,"A"
2019-10-19,2019,"FC Metz","FC Nantes","1-0",1,0,"F1",1,1,1,"H"
2019-10-19,2019,"Nimes Olympique","Amiens SC","1-1",1,1,"F1",1,2,0,"D"
2019-10-19,2019,"Stade Reims","Montpellier HSC","1-0",1,0,"F1",1,1,1,"H"
2019-10-19,2019,"Toulouse FC","Lille OSC","2-1",2,1,"F1",1,3,1,"H"
2019-10-20,2019,"Girondins Bordeaux","AS Saint-Etienne","0-1",0,1,"F1",1,1,-1,"A"
2019-10-20,2019,"AS Monaco","Stade Rennes","3-2",3,2,"F1",1,5,1,"H"
2019-10-20,2019,"Olympique Marseille","RC Strasbourg","2-0",2,0,"F1",1,2,2,"H"
2019-10-25,2019,"FC Nantes","AS Monaco","0-1",0,1,"F1",1,1,-1,"A"
2019-10-26,2019,"Lille OSC","Girondins Bordeaux","3-0",3,0,"F1",1,3,3,"H"
2019-10-26,2019,"Stade Brest","Dijon FCO","2-0",2,0,"F1",1,2,2,"H"
2019-10-26,2019,"Olympique Lyon","FC Metz","2-0",2,0,"F1",1,2,2,"H"
2019-10-26,2019,"Montpellier HSC","Angers SCO","0-0",0,0,"F1",1,0,0,"D"
2019-10-26,2019,"Stade Reims","Nimes Olympique","0-0",0,0,"F1",1,0,0,"D"
2019-10-26,2019,"RC Strasbourg","OGC Nice","1-0",1,0,"F1",1,1,1,"H"
2019-10-27,2019,"Stade Rennes","Toulouse FC","3-2",3,2,"F1",1,5,1,"H"
2019-10-27,2019,"AS Saint-Etienne","Amiens SC","2-2",2,2,"F1",1,4,0,"D"
2019-10-27,2019,"Paris Saint-Germain","Olympique Marseille","4-0",4,0,"F1",1,4,4,"H"
2019-11-01,2019,"Dijon FCO","Paris Saint-Germain","2-1",2,1,"F1",1,3,1,"H"
2019-11-02,2019,"Olympique Marseille","Lille OSC","2-1",2,1,"F1",1,3,1,"H"
2019-11-02,2019,"Amiens SC","Stade Brest","1-0",1,0,"F1",1,1,1,"H"
2019-11-02,2019,"Angers SCO","RC Strasbourg","1-0",1,0,"F1",1,1,1,"H"
2019-11-02,2019,"FC Metz","Montpellier HSC","2-2",2,2,"F1",1,4,0,"D"
2019-11-02,2019,"Toulouse FC","Olympique Lyon","2-3",2,3,"F1",1,5,-1,"A"
2019-11-03,2019,"Girondins Bordeaux","FC Nantes","2-0",2,0,"F1",1,2,2,"H"
2019-11-03,2019,"OGC Nice","Stade Reims","2-0",2,0,"F1",1,2,2,"H"
2019-11-03,2019,"AS Saint-Etienne","AS Monaco","1-0",1,0,"F1",1,1,1,"H"
2019-11-08,2019,"OGC Nice","Girondins Bordeaux","1-1",1,1,"F1",1,2,0,"D"
2019-11-09,2019,"Stade Brest","Paris Saint-Germain","1-2",1,2,"F1",1,3,-1,"A"
2019-11-09,2019,"Lille OSC","FC Metz","0-0",0,0,"F1",1,0,0,"D"
2019-11-09,2019,"AS Monaco","Dijon FCO","1-0",1,0,"F1",1,1,1,"H"
2019-11-09,2019,"Stade Reims","Angers SCO","0-0",0,0,"F1",1,0,0,"D"
2019-11-09,2019,"RC Strasbourg","Nimes Olympique","4-1",4,1,"F1",1,5,3,"H"
2019-11-10,2019,"Stade Rennes","Amiens SC","3-1",3,1,"F1",1,4,2,"H"
2019-11-10,2019,"Montpellier HSC","Toulouse FC","3-0",3,0,"F1",1,3,3,"H"
2019-11-10,2019,"FC Nantes","AS Saint-Etienne","2-3",2,3,"F1",1,5,-1,"A"
2019-11-10,2019,"Olympique Marseille","Olympique Lyon","2-1",2,1,"F1",1,3,1,"H"
2019-11-22,2019,"Paris Saint-Germain","Lille OSC","2-0",2,0,"F1",1,2,2,"H"
2019-11-23,2019,"Olympique Lyon","OGC Nice","2-1",2,1,"F1",1,3,1,"H"
2019-11-23,2019,"Amiens SC","RC Strasbourg","0-4",0,4,"F1",1,4,-4,"A"
2019-11-23,2019,"Angers SCO","Nimes Olympique","1-0",1,0,"F1",1,1,1,"H"
2019-11-23,2019,"Stade Brest","FC Nantes","1-1",1,1,"F1",1,2,0,"D"
2019-11-23,2019,"Dijon FCO","Stade Rennes","2-1",2,1,"F1",1,3,1,"H"
2019-11-23,2019,"FC Metz","Stade Reims","1-1",1,1,"F1",1,2,0,"D"
2019-11-24,2019,"Girondins Bordeaux","AS Monaco","2-1",2,1,"F1",1,3,1,"H"
2019-11-24,2019,"AS Saint-Etienne","Montpellier HSC","0-0",0,0,"F1",1,0,0,"D"
2019-11-24,2019,"Toulouse FC","Olympique Marseille","0-2",0,2,"F1",1,2,-2,"A"
2019-11-29,2019,"Olympique Marseille","Stade Brest","2-1",2,1,"F1",1,3,1,"H"
2019-11-30,2019,"RC Strasbourg","Olympique Lyon","1-2",1,2,"F1",1,3,-1,"A"
2019-11-30,2019,"Lille OSC","Dijon FCO","1-0",1,0,"F1",1,1,1,"H"
2019-11-30,2019,"Montpellier HSC","Amiens SC","4-2",4,2,"F1",1,6,2,"H"
2019-11-30,2019,"OGC Nice","Angers SCO","3-1",3,1,"F1",1,4,2,"H"
2019-11-30,2019,"Nimes Olympique","FC Metz","1-1",1,1,"F1",1,2,0,"D"
2019-11-30,2019,"Stade Reims","Girondins Bordeaux","1-1",1,1,"F1",1,2,0,"D"
2019-12-01,2019,"FC Nantes","Toulouse FC","2-1",2,1,"F1",1,3,1,"H"
2019-12-01,2019,"Stade Rennes","AS Saint-Etienne","2-1",2,1,"F1",1,3,1,"H"
2019-12-03,2019,"Angers SCO","Olympique Marseille","0-2",0,2,"F1",1,2,-2,"A"
2019-12-03,2019,"Girondins Bordeaux","Nimes Olympique","6-0",6,0,"F1",1,6,6,"H"
2019-12-03,2019,"Stade Brest","RC Strasbourg","5-0",5,0,"F1",1,5,5,"H"
2019-12-03,2019,"Olympique Lyon","Lille OSC","0-1",0,1,"F1",1,1,-1,"A"
2019-12-04,2019,"Dijon FCO","Montpellier HSC","2-2",2,2,"F1",1,4,0,"D"
2019-12-04,2019,"FC Metz","Stade Rennes","0-1",0,1,"F1",1,1,-1,"A"
2019-12-04,2019,"AS Saint-Etienne","OGC Nice","4-1",4,1,"F1",1,5,3,"H"
2019-12-04,2019,"Toulouse FC","AS Monaco","1-2",1,2,"F1",1,3,-1,"A"
2019-12-04,2019,"Paris Saint-Germain","FC Nantes","2-0",2,0,"F1",1,2,2,"H"
2019-12-06,2019,"Lille OSC","Stade Brest","1-0",1,0,"F1",1,1,1,"H"
2019-12-06,2019,"Nimes Olympique","Olympique Lyon","0-4",0,4,"F1",1,4,-4,"A"
2019-12-07,2019,"Montpellier HSC","Paris Saint-Germain","1-3",1,3,"F1",1,4,-2,"A"
2019-12-07,2019,"AS Monaco","Amiens SC","3-0",3,0,"F1",1,3,3,"H"
2019-12-07,2019,"OGC Nice","FC Metz","4-1",4,1,"F1",1,5,3,"H"
2019-12-07,2019,"Stade Rennes","Angers SCO","2-1",2,1,"F1",1,3,1,"H"
2019-12-07,2019,"RC Strasbourg","Toulouse FC","4-2",4,2,"F1",1,6,2,"H"
2019-12-08,2019,"Stade Reims","AS Saint-Etienne","3-1",3,1,"F1",1,4,2,"H"
2019-12-08,2019,"FC Nantes","Dijon FCO","1-0",1,0,"F1",1,1,1,"H"
2019-12-08,2019,"Olympique Marseille","Girondins Bordeaux","3-1",3,1,"F1",1,4,2,"H"
2019-12-13,2019,"Lille OSC","Montpellier HSC","2-1",2,1,"F1",1,3,1,"H"
2019-12-14,2019,"FC Metz","Olympique Marseille","1-1",1,1,"F1",1,2,0,"D"
2019-12-14,2019,"Amiens SC","Dijon FCO","1-1",1,1,"F1",1,2,0,"D"
2019-12-14,2019,"Angers SCO","AS Monaco","0-0",0,0,"F1",1,0,0,"D"
2019-12-14,2019,"Stade Brest","OGC Nice","0-0",0,0,"F1",1,0,0,"D"
2019-12-14,2019,"Nimes Olympique","FC Nantes","0-1",0,1,"F1",1,1,-1,"A"
2019-12-14,2019,"Toulouse FC","Stade Reims","0-1",0,1,"F1",1,1,-1,"A"
2019-12-15,2019,"Girondins Bordeaux","RC Strasbourg","0-1",0,1,"F1",1,1,-1,"A"
2019-12-15,2019,"Olympique Lyon","Stade Rennes","0-1",0,1,"F1",1,1,-1,"A"
2019-12-15,2019,"AS Saint-Etienne","Paris Saint-Germain","0-4",0,4,"F1",1,4,-4,"A"
2019-12-21,2019,"Dijon FCO","FC Metz","2-2",2,2,"F1",1,4,0,"D"
2019-12-21,2019,"Olympique Marseille","Nimes Olympique","3-1",3,1,"F1",1,4,2,"H"
2019-12-21,2019,"AS Monaco","Lille OSC","5-1",5,1,"F1",1,6,4,"H"
2019-12-21,2019,"Montpellier HSC","Stade Brest","4-0",4,0,"F1",1,4,4,"H"
2019-12-21,2019,"FC Nantes","Angers SCO","1-2",1,2,"F1",1,3,-1,"A"
2019-12-21,2019,"OGC Nice","Toulouse FC","3-0",3,0,"F1",1,3,3,"H"
2019-12-21,2019,"Paris Saint-Germain","Amiens SC","4-1",4,1,"F1",1,5,3,"H"
2019-12-21,2019,"Stade Reims","Olympique Lyon","1-1",1,1,"F1",1,2,0,"D"
2019-12-21,2019,"Stade Rennes","Girondins Bordeaux","1-0",1,0,"F1",1,1,1,"H"
2019-12-21,2019,"RC Strasbourg","AS Saint-Etienne","2-1",2,1,"F1",1,3,1,"H"
2020-01-10,2019,"Stade Rennes","Olympique Marseille","0-1",0,1,"F1",1,1,-1,"A"
2020-01-11,2019,"Girondins Bordeaux","Olympique Lyon","1-2",1,2,"F1",1,3,-1,"A"
2020-01-11,2019,"Amiens SC","Montpellier HSC","1-2",1,2,"F1",1,3,-1,"A"
2020-01-11,2019,"Angers SCO","OGC Nice","1-1",1,1,"F1",1,2,0,"D"
2020-01-11,2019,"FC Metz","RC Strasbourg","1-0",1,0,"F1",1,1,1,"H"
2020-01-11,2019,"Nimes Olympique","Stade Reims","2-0",2,0,"F1",1,2,2,"H"
2020-01-11,2019,"Toulouse FC","Stade Brest","2-5",2,5,"F1",1,7,-3,"A"
2020-01-12,2019,"AS Saint-Etienne","FC Nantes","0-2",0,2,"F1",1,2,-2,"A"
2020-01-12,2019,"Dijon FCO","Lille OSC","1-0",1,0,"F1",1,1,1,"H"
2020-01-12,2019,"Paris Saint-Germain","AS Monaco","3-3",3,3,"F1",1,6,0,"D"
2020-01-15,2019,"Amiens SC","Stade Reims","1-1",1,1,"F1",1,2,0,"D"
2020-01-15,2019,"Nimes Olympique","Stade Rennes","0-1",0,1,"F1",1,1,-1,"A"
2020-01-15,2019,"AS Monaco","Paris Saint-Germain","1-4",1,4,"F1",1,5,-3,"A"
2020-01-24,2019,"OGC Nice","Stade Rennes","1-1",1,1,"F1",1,2,0,"D"
2020-01-25,2019,"Olympique Marseille","Angers SCO","0-0",0,0,"F1",1,0,0,"D"
2020-01-25,2019,"Stade Brest","Amiens SC","2-1",2,1,"F1",1,3,1,"H"
2020-01-25,2019,"AS Monaco","RC Strasbourg","1-3",1,3,"F1",1,4,-2,"A"
2020-01-25,2019,"Montpellier HSC","Dijon FCO","2-1",2,1,"F1",1,3,1,"H"
2020-01-25,2019,"Stade Reims","FC Metz","0-1",0,1,"F1",1,1,-1,"A"
2020-01-25,2019,"AS Saint-Etienne","Nimes Olympique","2-1",2,1,"F1",1,3,1,"H"
2020-01-26,2019,"Olympique Lyon","Toulouse FC","3-0",3,0,"F1",1,3,3,"H"
2020-01-26,2019,"FC Nantes","Girondins Bordeaux","0-1",0,1,"F1",1,1,-1,"A"
2020-01-26,2019,"Lille OSC","Paris Saint-Germain","0-2",0,2,"F1",1,2,-2,"A"
2020-01-31,2019,"Stade Rennes","FC Nantes","3-2",3,2,"F1",1,5,1,"H"
2020-02-01,2019,"Paris Saint-Germain","Montpellier HSC","5-0",5,0,"F1",1,5,5,"H"
2020-02-01,2019,"Amiens SC","Toulouse FC","0-0",0,0,"F1",1,0,0,"D"
2020-02-01,2019,"Angers SCO","Stade Reims","1-4",1,4,"F1",1,5,-3,"A"
2020-02-01,2019,"Dijon FCO","Stade Brest","3-0",3,0,"F1",1,3,3,"H"
2020-02-01,2019,"Nimes Olympique","AS Monaco","3-1",3,1,"F1",1,4,2,"H"
2020-02-01,2019,"RC Strasbourg","Lille OSC","1-2",1,2,"F1",1,3,-1,"A"
2020-02-02,2019,"OGC Nice","Olympique Lyon","2-1",2,1,"F1",1,3,1,"H"
2020-02-02,2019,"FC Metz","AS Saint-Etienne","3-1",3,1,"F1",1,4,2,"H"
2020-02-02,2019,"Girondins Bordeaux","Olympique Marseille","0-0",0,0,"F1",1,0,0,"D"
2020-02-04,2019,"Lille OSC","Stade Rennes","1-0",1,0,"F1",1,1,1,"H"
2020-02-04,2019,"AS Monaco","Angers SCO","1-0",1,0,"F1",1,1,1,"H"
2020-02-04,2019,"FC Nantes","Paris Saint-Germain","1-2",1,2,"F1",1,3,-1,"A"
2020-02-05,2019,"Stade Brest","Girondins Bordeaux","1-1",1,1,"F1",1,2,0,"D"
2020-02-05,2019,"Olympique Lyon","Amiens SC","0-0",0,0,"F1",1,0,0,"D"
2020-02-05,2019,"Montpellier HSC","FC Metz","1-1",1,1,"F1",1,2,0,"D"
2020-02-05,2019,"Nimes Olympique","Dijon FCO","2-0",2,0,"F1",1,2,2,"H"
2020-02-05,2019,"Stade Reims","OGC Nice","1-1",1,1,"F1",1,2,0,"D"
2020-02-05,2019,"Toulouse FC","RC Strasbourg","0-1",0,1,"F1",1,1,-1,"A"
2020-02-05,2019,"AS Saint-Etienne","Olympique Marseille","0-2",0,2,"F1",1,2,-2,"A"
2020-02-07,2019,"Angers SCO","Lille OSC","0-2",0,2,"F1",1,2,-2,"A"
2020-02-08,2019,"Olympique Marseille","Toulouse FC","1-0",1,0,"F1",1,1,1,"H"
2020-02-08,2019,"Amiens SC","AS Monaco","1-2",1,2,"F1",1,3,-1,"A"
2020-02-08,2019,"Dijon FCO","FC Nantes","3-3",3,3,"F1",1,6,0,"D"
2020-02-08,2019,"FC Metz","Girondins Bordeaux","1-2",1,2,"F1",1,3,-1,"A"
2020-02-08,2019,"OGC Nice","Nimes Olympique","1-3",1,3,"F1",1,4,-2,"A"
2020-02-08,2019,"Stade Rennes","Stade Brest","0-0",0,0,"F1",1,0,0,"D"
2020-02-09,2019,"Montpellier HSC","AS Saint-Etienne","1-0",1,0,"F1",1,1,1,"H"
2020-02-09,2019,"RC Strasbourg","Stade Reims","3-0",3,0,"F1",1,3,3,"H"
2020-02-09,2019,"Paris Saint-Germain","Olympique Lyon","4-2",4,2,"F1",1,6,2,"H"
2020-02-14,2019,"AS Monaco","Montpellier HSC","1-0",1,0,"F1",1,1,1,"H"
2020-02-15,2019,"Amiens SC","Paris Saint-Germain","4-4",4,4,"F1",1,8,0,"D"
2020-02-15,2019,"Girondins Bordeaux","Dijon FCO","2-2",2,2,"F1",1,4,0,"D"
2020-02-15,2019,"FC Nantes","FC Metz","0-0",0,0,"F1",1,0,0,"D"
2020-02-15,2019,"Nimes Olympique","Angers SCO","1-0",1,0,"F1",1,1,1,"H"
2020-02-15,2019,"Toulouse FC","OGC Nice","0-2",0,2,"F1",1,2,-2,"A"
2020-02-16,2019,"Olympique Lyon","RC Strasbourg","1-1",1,1,"F1",1,2,0,"D"
2020-02-16,2019,"Stade Brest","AS Saint-Etienne","3-2",3,2,"F1",1,5,1,"H"
2020-02-16,2019,"Stade Reims","Stade Rennes","1-0",1,0,"F1",1,1,1,"H"
2020-02-16,2019,"Lille OSC","Olympique Marseille","1-2",1,2,"F1",1,3,-1,"A"
2020-02-21,2019,"OGC Nice","Stade Brest","2-2",2,2,"F1",1,4,0,"D"
2020-02-21,2019,"FC Metz","Olympique Lyon","0-2",0,2,"F1",1,2,-2,"A"
2020-02-22,2019,"Olympique Marseille","FC Nantes","1-3",1,3,"F1",1,4,-2,"A"
2020-02-22,2019,"Angers SCO","Montpellier HSC","1-0",1,0,"F1",1,1,1,"H"
2020-02-22,2019,"Dijon FCO","AS Monaco","1-1",1,1,"F1",1,2,0,"D"
2020-02-22,2019,"Lille OSC","Toulouse FC","3-0",3,0,"F1",1,3,3,"H"
2020-02-22,2019,"RC Strasbourg","Amiens SC","0-0",0,0,"F1",1,0,0,"D"
2020-02-23,2019,"AS Saint-Etienne","Stade Reims","1-1",1,1,"F1",1,2,0,"D"
2020-02-23,2019,"Stade Rennes","Nimes Olympique","2-1",2,1,"F1",1,3,1,"H"
2020-02-23,2019,"Paris Saint-Germain","Girondins Bordeaux","4-3",4,3,"F1",1,7,1,"H"
2020-02-28,2019,"Nimes Olympique","Olympique Marseille","2-3",2,3,"F1",1,5,-1,"A"
2020-02-29,2019,"Paris Saint-Germain","Dijon FCO","4-0",4,0,"F1",1,4,4,"H"
2020-02-29,2019,"Amiens SC","FC Metz","0-1",0,1,"F1",1,1,-1,"A"
2020-02-29,2019,"Stade Brest","Angers SCO","0-1",0,1,"F1",1,1,-1,"A"
2020-02-29,2019,"AS Monaco","Stade Reims","1-1",1,1,"F1",1,2,0,"D"
2020-02-29,2019,"Montpellier HSC","RC Strasbourg","3-0",3,0,"F1",1,3,3,"H"
2020-02-29,2019,"Toulouse FC","Stade Rennes","0-2",0,2,"F1",1,2,-2,"A"
2020-03-01,2019,"FC Nantes","Lille OSC","0-1",0,1,"F1",1,1,-1,"A"
2020-03-01,2019,"Girondins Bordeaux","OGC Nice","1-1",1,1,"F1",1,2,0,"D"
2020-03-01,2019,"Olympique Lyon","AS Saint-Etienne","2-0",2,0,"F1",1,2,2,"H"
2020-03-06,2019,"Olympique Marseille","Amiens SC","2-2",2,2,"F1",1,4,0,"D"
2020-03-07,2019,"Angers SCO","FC Nantes","2-0",2,0,"F1",1,2,2,"H"
2020-03-07,2019,"Dijon FCO","Toulouse FC","2-1",2,1,"F1",1,3,1,"H"
2020-03-07,2019,"FC Metz","Nimes Olympique","2-1",2,1,"F1",1,3,1,"H"
2020-03-07,2019,"OGC Nice","AS Monaco","2-1",2,1,"F1",1,3,1,"H"
2020-03-07,2019,"Stade Reims","Stade Brest","1-0",1,0,"F1",1,1,1,"H"
2020-03-08,2019,"AS Saint-Etienne","Girondins Bordeaux","1-1",1,1,"F1",1,2,0,"D"
2020-03-08,2019,"Stade Rennes","Montpellier HSC","5-0",5,0,"F1",1,5,5,"H"
2020-03-08,2019,"Lille OSC","Olympique Lyon","1-0",1,0,"F1",1,1,1,"H"
2020-08-21,2020,"Girondins Bordeaux","FC Nantes","0-0",0,0,"F1",1,0,0,"D"
2020-08-22,2020,"Dijon FCO","Angers SCO","0-1",0,1,"F1",1,1,-1,"A"
2020-08-22,2020,"Lille OSC","Stade Rennes","1-1",1,1,"F1",1,2,0,"D"
2020-08-23,2020,"AS Monaco","Stade Reims","2-2",2,2,"F1",1,4,0,"D"
2020-08-23,2020,"FC Lorient","RC Strasbourg","3-1",3,1,"F1",1,4,2,"H"
2020-08-23,2020,"Nimes Olympique","Stade Brest","4-0",4,0,"F1",1,4,4,"H"
2020-08-23,2020,"OGC Nice","RC Lens","2-1",2,1,"F1",1,3,1,"H"
2020-08-28,2020,"Olympique Lyon","Dijon FCO","4-1",4,1,"F1",1,5,3,"H"
2020-08-29,2020,"Stade Rennes","Montpellier HSC","2-1",2,1,"F1",1,3,1,"H"
2020-08-29,2020,"RC Strasbourg","OGC Nice","0-2",0,2,"F1",1,2,-2,"A"
2020-08-30,2020,"Stade Reims","Lille OSC","0-1",0,1,"F1",1,1,-1,"A"
2020-08-30,2020,"Angers SCO","Girondins Bordeaux","0-2",0,2,"F1",1,2,-2,"A"
2020-08-30,2020,"FC Metz","AS Monaco","0-1",0,1,"F1",1,1,-1,"A"
2020-08-30,2020,"FC Nantes","Nimes Olympique","2-1",2,1,"F1",1,3,1,"H"
2020-08-30,2020,"AS Saint-Etienne","FC Lorient","2-0",2,0,"F1",1,2,2,"H"
2020-08-30,2020,"Stade Brest","Olympique Marseille","2-3",2,3,"F1",1,5,-1,"A"
2020-09-10,2020,"RC Lens","Paris Saint-Germain","1-0",1,0,"F1",1,1,1,"H"
2020-09-11,2020,"Girondins Bordeaux","Olympique Lyon","0-0",0,0,"F1",1,0,0,"D"
2020-09-12,2020,"Montpellier HSC","OGC Nice","3-1",3,1,"F1",1,4,2,"H"
2020-09-12,2020,"AS Saint-Etienne","RC Strasbourg","2-0",2,0,"F1",1,2,2,"H"
2020-09-13,2020,"Lille OSC","FC Metz","1-0",1,0,"F1",1,1,1,"H"
2020-09-13,2020,"Angers SCO","Stade Reims","1-0",1,0,"F1",1,1,1,"H"
2020-09-13,2020,"Dijon FCO","Stade Brest","0-2",0,2,"F1",1,2,-2,"A"
2020-09-13,2020,"FC Lorient","RC Lens","2-3",2,3,"F1",1,5,-1,"A"
2020-09-13,2020,"Nimes Olympique","Stade Rennes","2-4",2,4,"F1",1,6,-2,"A"
2020-09-13,2020,"AS Monaco","FC Nantes","2-1",2,1,"F1",1,3,1,"H"
2020-09-13,2020,"Paris Saint-Germain","Olympique Marseille","0-1",0,1,"F1",1,1,-1,"A"
2020-09-15,2020,"Montpellier HSC","Olympique Lyon","2-1",2,1,"F1",1,3,1,"H"
2020-09-16,2020,"Paris Saint-Germain","FC Metz","1-0",1,0,"F1",1,1,1,"H"
2020-09-17,2020,"Olympique Marseille","AS Saint-Etienne","0-2",0,2,"F1",1,2,-2,"A"
2020-09-18,2020,"Olympique Lyon","Nimes Olympique","0-0",0,0,"F1",1,0,0,"D"
2020-09-19,2020,"RC Lens","Girondins Bordeaux","2-1",2,1,"F1",1,3,1,"H"
2020-09-19,2020,"Stade Rennes","AS Monaco","2-1",2,1,"F1",1,3,1,"H"
2020-09-20,2020,"OGC Nice","Paris Saint-Germain","0-3",0,3,"F1",1,3,-3,"A"
2020-09-20,2020,"Stade Brest","FC Lorient","3-2",3,2,"F1",1,5,1,"H"
2020-09-20,2020,"FC Metz","Stade Reims","2-1",2,1,"F1",1,3,1,"H"
2020-09-20,2020,"Montpellier HSC","Angers SCO","4-1",4,1,"F1",1,5,3,"H"
2020-09-20,2020,"RC Strasbourg","Dijon FCO","1-0",1,0,"F1",1,1,1,"H"
2020-09-20,2020,"FC Nantes","AS Saint-Etienne","2-2",2,2,"F1",1,4,0,"D"
2020-09-20,2020,"Olympique Marseille","Lille OSC","1-1",1,1,"F1",1,2,0,"D"
2020-09-25,2020,"Lille OSC","FC Nantes","2-0",2,0,"F1",1,2,2,"H"
2020-09-26,2020,"AS Saint-Etienne","Stade Rennes","0-3",0,3,"F1",1,3,-3,"A"
2020-09-26,2020,"Olympique Marseille","FC Metz","1-1",1,1,"F1",1,2,0,"D"
2020-09-27,2020,"Girondins Bordeaux","OGC Nice","0-0",0,0,"F1",1,0,0,"D"
2020-09-27,2020,"Angers SCO","Stade Brest","3-2",3,2,"F1",1,5,1,"H"
2020-09-27,2020,"Dijon FCO","Montpellier HSC","2-2",2,2,"F1",1,4,0,"D"
2020-09-27,2020,"AS Monaco","RC Strasbourg","3-2",3,2,"F1",1,5,1,"H"
2020-09-27,2020,"Nimes Olympique","RC Lens","1-1",1,1,"F1",1,2,0,"D"
2020-09-27,2020,"FC Lorient","Olympique Lyon","1-1",1,1,"F1",1,2,0,"D"
2020-09-27,2020,"Stade Reims","Paris Saint-Germain","0-2",0,2,"F1",1,2,-2,"A"
2020-10-02,2020,"Paris Saint-Germain","Angers SCO","6-1",6,1,"F1",1,7,5,"H"
2020-10-03,2020,"RC Lens","AS Saint-Etienne","2-0",2,0,"F1",1,2,2,"H"
2020-10-03,2020,"OGC Nice","FC Nantes","2-1",2,1,"F1",1,3,1,"H"
2020-10-04,2020,"Montpellier HSC","Nimes Olympique","0-1",0,1,"F1",1,1,-1,"A"
2020-10-04,2020,"Girondins Bordeaux","Dijon FCO","3-0",3,0,"F1",1,3,3,"H"
2020-10-04,2020,"Stade Brest","AS Monaco","1-0",1,0,"F1",1,1,1,"H"
2020-10-04,2020,"FC Metz","FC Lorient","3-1",3,1,"F1",1,4,2,"H"
2020-10-04,2020,"RC Strasbourg","Lille OSC","0-3",0,3,"F1",1,3,-3,"A"
2020-10-04,2020,"Stade Rennes","Stade Reims","2-2",2,2,"F1",1,4,0,"D"
2020-10-04,2020,"Olympique Lyon","Olympique Marseille","1-1",1,1,"F1",1,2,0,"D"
2020-10-16,2020,"Dijon FCO","Stade Rennes","1-1",1,1,"F1",1,2,0,"D"
2020-10-16,2020,"Nimes Olympique","Paris Saint-Germain","0-4",0,4,"F1",1,4,-4,"A"
2020-10-17,2020,"Stade Reims","FC Lorient","1-3",1,3,"F1",1,4,-2,"A"
2020-10-17,2020,"Olympique Marseille","Girondins Bordeaux","3-1",3,1,"F1",1,4,2,"H"
2020-10-18,2020,"RC Strasbourg","Olympique Lyon","2-3",2,3,"F1",1,5,-1,"A"
2020-10-18,2020,"Angers SCO","FC Metz","1-1",1,1,"F1",1,2,0,"D"
2020-10-18,2020,"AS Monaco","Montpellier HSC","1-1",1,1,"F1",1,2,0,"D"
2020-10-18,2020,"FC Nantes","Stade Brest","3-1",3,1,"F1",1,4,2,"H"
2020-10-18,2020,"AS Saint-Etienne","OGC Nice","1-3",1,3,"F1",1,4,-2,"A"
2020-10-18,2020,"Lille OSC","RC Lens","4-0",4,0,"F1",1,4,4,"H"
2020-10-23,2020,"Stade Rennes","Angers SCO","1-2",1,2,"F1",1,3,-1,"A"
2020-10-24,2020,"FC Lorient","Olympique Marseille","0-1",0,1,"F1",1,1,-1,"A"
2020-10-24,2020,"Paris Saint-Germain","Dijon FCO","4-0",4,0,"F1",1,4,4,"H"
2020-10-25,2020,"Girondins Bordeaux","Nimes Olympique","2-0",2,0,"F1",1,2,2,"H"
2020-10-25,2020,"Stade Brest","RC Strasbourg","0-3",0,3,"F1",1,3,-3,"A"
2020-10-25,2020,"FC Metz","AS Saint-Etienne","2-0",2,0,"F1",1,2,2,"H"
2020-10-25,2020,"Montpellier HSC","Stade Reims","0-4",0,4,"F1",1,4,-4,"A"
2020-10-25,2020,"OGC Nice","Lille OSC","1-1",1,1,"F1",1,2,0,"D"
2020-10-25,2020,"Olympique Lyon","AS Monaco","4-1",4,1,"F1",1,5,3,"H"
2020-10-31,2020,"Stade Rennes","Stade Brest","2-1",2,1,"F1",1,3,1,"H"
2020-10-31,2020,"FC Nantes","Paris Saint-Germain","0-3",0,3,"F1",1,3,-3,"A"
2020-11-01,2020,"AS Saint-Etienne","Montpellier HSC","0-1",0,1,"F1",1,1,-1,"A"
2020-11-01,2020,"Angers SCO","OGC Nice","0-3",0,3,"F1",1,3,-3,"A"
2020-11-01,2020,"Dijon FCO","FC Lorient","0-0",0,0,"F1",1,0,0,"D"
2020-11-01,2020,"Nimes Olympique","FC Metz","0-1",0,1,"F1",1,1,-1,"A"
2020-11-01,2020,"Stade Reims","RC Strasbourg","2-1",2,1,"F1",1,3,1,"H"
2020-11-01,2020,"AS Monaco","Girondins Bordeaux","4-0",4,0,"F1",1,4,4,"H"
2020-11-01,2020,"Lille OSC","Olympique Lyon","1-1",1,1,"F1",1,2,0,"D"
2020-11-06,2020,"RC Strasbourg","Olympique Marseille","0-1",0,1,"F1",1,1,-1,"A"
2020-11-07,2020,"Girondins Bordeaux","Montpellier HSC","0-2",0,2,"F1",1,2,-2,"A"
2020-11-07,2020,"Paris Saint-Germain","Stade Rennes","3-0",3,0,"F1",1,3,3,"H"
2020-11-08,2020,"Stade Brest","Lille OSC","3-2",3,2,"F1",1,5,1,"H"
2020-11-08,2020,"RC Lens","Stade Reims","4-4",4,4,"F1",1,8,0,"D"
2020-11-08,2020,"FC Lorient","FC Nantes","0-2",0,2,"F1",1,2,-2,"A"
2020-11-08,2020,"FC Metz","Dijon FCO","1-1",1,1,"F1",1,2,0,"D"
2020-11-08,2020,"Nimes Olympique","Angers SCO","1-5",1,5,"F1",1,6,-4,"A"
2020-11-08,2020,"OGC Nice","AS Monaco","1-2",1,2,"F1",1,3,-1,"A"
2020-11-08,2020,"Olympique Lyon","AS Saint-Etienne","2-1",2,1,"F1",1,3,1,"H"
2020-11-20,2020,"Stade Rennes","Girondins Bordeaux","0-1",0,1,"F1",1,1,-1,"A"
2020-11-20,2020,"AS Monaco","Paris Saint-Germain","3-2",3,2,"F1",1,5,1,"H"
2020-11-21,2020,"Stade Brest","AS Saint-Etienne","4-1",4,1,"F1",1,5,3,"H"
2020-11-22,2020,"FC Nantes","FC Metz","1-1",1,1,"F1",1,2,0,"D"
2020-11-22,2020,"Dijon FCO","RC Lens","0-1",0,1,"F1",1,1,-1,"A"
2020-11-22,2020,"Montpellier HSC","RC Strasbourg","4-3",4,3,"F1",1,7,1,"H"
2020-11-22,2020,"Stade Reims","Nimes Olympique","0-1",0,1,"F1",1,1,-1,"A"
2020-11-22,2020,"Angers SCO","Olympique Lyon","0-1",0,1,"F1",1,1,-1,"A"
2020-11-22,2020,"Lille OSC","FC Lorient","4-0",4,0,"F1",1,4,4,"H"
2020-11-25,2020,"RC Lens","FC Nantes","1-1",1,1,"F1",1,2,0,"D"
2020-11-27,2020,"RC Strasbourg","Stade Rennes","1-1",1,1,"F1",1,2,0,"D"
2020-11-28,2020,"Olympique Marseille","FC Nantes","3-1",3,1,"F1",1,4,2,"H"
2020-11-28,2020,"Paris Saint-Germain","Girondins Bordeaux","2-2",2,2,"F1",1,4,0,"D"
2020-11-29,2020,"Olympique Lyon","Stade Reims","3-0",3,0,"F1",1,3,3,"H"
2020-11-29,2020,"RC Lens","Angers SCO","1-3",1,3,"F1",1,4,-2,"A"
2020-11-29,2020,"FC Lorient","Montpellier HSC","0-1",0,1,"F1",1,1,-1,"A"
2020-11-29,2020,"FC Metz","Stade Brest","0-2",0,2,"F1",1,2,-2,"A"
2020-11-29,2020,"AS Monaco","Nimes Olympique","3-0",3,0,"F1",1,3,3,"H"
2020-11-29,2020,"OGC Nice","Dijon FCO","1-3",1,3,"F1",1,4,-2,"A"
2020-11-29,2020,"AS Saint-Etienne","Lille OSC","1-1",1,1,"F1",1,2,0,"D"
2020-12-04,2020,"Nimes Olympique","Olympique Marseille","0-2",0,2,"F1",1,2,-2,"A"
2020-12-05,2020,"Stade Rennes","RC Lens","0-2",0,2,"F1",1,2,-2,"A"
2020-12-05,2020,"Montpellier HSC","Paris Saint-Germain","1-3",1,3,"F1",1,4,-2,"A"
2020-12-06,2020,"Lille OSC","AS Monaco","2-1",2,1,"F1",1,3,1,"H"
2020-12-06,2020,"Angers SCO","FC Lorient","2-0",2,0,"F1",1,2,2,"H"
2020-12-06,2020,"Girondins Bordeaux","Stade Brest","1-0",1,0,"F1",1,1,1,"H"
2020-12-06,2020,"Dijon FCO","AS Saint-Etienne","0-0",0,0,"F1",1,0,0,"D"
2020-12-06,2020,"FC Nantes","RC Strasbourg","0-4",0,4,"F1",1,4,-4,"A"
2020-12-06,2020,"Stade Reims","OGC Nice","0-0",0,0,"F1",1,0,0,"D"
2020-12-06,2020,"FC Metz","Olympique Lyon","1-3",1,3,"F1",1,4,-2,"A"
2020-12-11,2020,"AS Saint-Etienne","Angers SCO","0-0",0,0,"F1",1,0,0,"D"
2020-12-12,2020,"Olympique Marseille","AS Monaco","2-1",2,1,"F1",1,3,1,"H"
2020-12-12,2020,"RC Lens","Montpellier HSC","2-3",2,3,"F1",1,5,-1,"A"
2020-12-13,2020,"OGC Nice","Stade Rennes","0-1",0,1,"F1",1,1,-1,"A"
2020-12-13,2020,"Stade Brest","Stade Reims","2-1",2,1,"F1",1,3,1,"H"
2020-12-13,2020,"FC Lorient","Nimes Olympique","3-0",3,0,"F1",1,3,3,"H"
2020-12-13,2020,"FC Nantes","Dijon FCO","1-1",1,1,"F1",1,2,0,"D"
2020-12-13,2020,"RC Strasbourg","FC Metz","2-2",2,2,"F1",1,4,0,"D"
2020-12-13,2020,"Lille OSC","Girondins Bordeaux","2-1",2,1,"F1",1,3,1,"H"
2020-12-13,2020,"Paris Saint-Germain","Olympique Lyon","0-1",0,1,"F1",1,1,-1,"A"
2020-12-16,2020,"Angers SCO","RC Strasbourg","0-2",0,2,"F1",1,2,-2,"A"
2020-12-16,2020,"Dijon FCO","Lille OSC","0-2",0,2,"F1",1,2,-2,"A"
2020-12-16,2020,"Montpellier HSC","FC Metz","0-2",0,2,"F1",1,2,-2,"A"
2020-12-16,2020,"Nimes Olympique","OGC Nice","0-2",0,2,"F1",1,2,-2,"A"
2020-12-16,2020,"Stade Reims","FC Nantes","3-2",3,2,"F1",1,5,1,"H"
2020-12-16,2020,"Girondins Bordeaux","AS Saint-Etienne","1-2",1,2,"F1",1,3,-1,"A"
2020-12-16,2020,"Olympique Lyon","Stade Brest","2-2",2,2,"F1",1,4,0,"D"
2020-12-16,2020,"AS Monaco","RC Lens","0-3",0,3,"F1",1,3,-3,"A"
2020-12-16,2020,"Paris Saint-Germain","FC Lorient","2-0",2,0,"F1",1,2,2,"H"
2020-12-16,2020,"Stade Rennes","Olympique Marseille","2-1",2,1,"F1",1,3,1,"H"
2020-12-19,2020,"FC Metz","RC Lens","2-0",2,0,"F1",1,2,2,"H"
2020-12-19,2020,"Olympique Marseille","Stade Reims","1-1",1,1,"F1",1,2,0,"D"
2020-12-19,2020,"OGC Nice","Olympique Lyon","1-4",1,4,"F1",1,5,-3,"A"
2020-12-20,2020,"Stade Brest","Montpellier HSC","2-2",2,2,"F1",1,4,0,"D"
2020-12-20,2020,"Dijon FCO","AS Monaco","0-1",0,1,"F1",1,1,-1,"A"
2020-12-20,2020,"FC Nantes","Angers SCO","1-1",1,1,"F1",1,2,0,"D"
2020-12-20,2020,"AS Saint-Etienne","Nimes Olympique","2-2",2,2,"F1",1,4,0,"D"
2020-12-20,2020,"RC Strasbourg","Girondins Bordeaux","0-2",0,2,"F1",1,2,-2,"A"
2020-12-20,2020,"FC Lorient","Stade Rennes","0-3",0,3,"F1",1,3,-3,"A"
2020-12-20,2020,"Lille OSC","Paris Saint-Germain","0-0",0,0,"F1",1,0,0,"D"
2020-12-23,2020,"Girondins Bordeaux","Stade Reims","1-3",1,3,"F1",1,4,-2,"A"
2020-12-23,2020,"RC Lens","Stade Brest","2-1",2,1,"F1",1,3,1,"H"
2020-12-23,2020,"OGC Nice","FC Lorient","2-2",2,2,"F1",1,4,0,"D"
2020-12-23,2020,"Nimes Olympique","Dijon FCO","1-3",1,3,"F1",1,4,-2,"A"
2020-12-23,2020,"Stade Rennes","FC Metz","1-0",1,0,"F1",1,1,1,"H"
2020-12-23,2020,"Angers SCO","Olympique Marseille","2-1",2,1,"F1",1,3,1,"H"
2020-12-23,2020,"Olympique Lyon","FC Nantes","3-0",3,0,"F1",1,3,3,"H"
2020-12-23,2020,"AS Monaco","AS Saint-Etienne","2-2",2,2,"F1",1,4,0,"D"
2020-12-23,2020,"Montpellier HSC","Lille OSC","2-3",2,3,"F1",1,5,-1,"A"
2020-12-23,2020,"Paris Saint-Germain","RC Strasbourg","4-0",4,0,"F1",1,4,4,"H"
2021-01-06,2020,"Stade Brest","OGC Nice","2-0",2,0,"F1",1,2,2,"H"
2021-01-06,2020,"FC Lorient","AS Monaco","2-5",2,5,"F1",1,7,-3,"A"
2021-01-06,2020,"FC Metz","Girondins Bordeaux","0-0",0,0,"F1",1,0,0,"D"
2021-01-06,2020,"FC Nantes","Stade Rennes","0-0",0,0,"F1",1,0,0,"D"
2021-01-06,2020,"RC Strasbourg","Nimes Olympique","5-0",5,0,"F1",1,5,5,"H"
2021-01-06,2020,"Lille OSC","Angers SCO","1-2",1,2,"F1",1,3,-1,"A"
2021-01-06,2020,"Olympique Lyon","RC Lens","3-2",3,2,"F1",1,5,1,"H"
2021-01-06,2020,"Olympique Marseille","Montpellier HSC","3-1",3,1,"F1",1,4,2,"H"
2021-01-06,2020,"Stade Reims","Dijon FCO","0-0",0,0,"F1",1,0,0,"D"
2021-01-06,2020,"AS Saint-Etienne","Paris Saint-Germain","1-1",1,1,"F1",1,2,0,"D"
2021-01-09,2020,"Girondins Bordeaux","FC Lorient","2-1",2,1,"F1",1,3,1,"H"
2021-01-09,2020,"Dijon FCO","Olympique Marseille","0-0",0,0,"F1",1,0,0,"D"
2021-01-09,2020,"RC Lens","RC Strasbourg","0-1",0,1,"F1",1,1,-1,"A"
2021-01-09,2020,"FC Metz","OGC Nice","1-1",1,1,"F1",1,2,0,"D"
2021-01-09,2020,"AS Monaco","Angers SCO","3-0",3,0,"F1",1,3,3,"H"
2021-01-09,2020,"Montpellier HSC","FC Nantes","1-1",1,1,"F1",1,2,0,"D"
2021-01-09,2020,"Nimes Olympique","Lille OSC","0-1",0,1,"F1",1,1,-1,"A"
2021-01-09,2020,"Paris Saint-Germain","Stade Brest","3-0",3,0,"F1",1,3,3,"H"
2021-01-09,2020,"Stade Reims","AS Saint-Etienne","3-1",3,1,"F1",1,4,2,"H"
2021-01-09,2020,"Stade Rennes","Olympique Lyon","2-2",2,2,"F1",1,4,0,"D"
2021-01-15,2020,"Montpellier HSC","AS Monaco","2-3",2,3,"F1",1,5,-1,"A"
2021-01-16,2020,"Olympique Marseille","Nimes Olympique","1-2",1,2,"F1",1,3,-1,"A"
2021-01-16,2020,"Angers SCO","Paris Saint-Germain","0-1",0,1,"F1",1,1,-1,"A"
2021-01-17,2020,"Stade Brest","Stade Rennes","1-2",1,2,"F1",1,3,-1,"A"
2021-01-17,2020,"FC Nantes","RC Lens","1-1",1,1,"F1",1,2,0,"D"
2021-01-17,2020,"OGC Nice","Girondins Bordeaux","0-3",0,3,"F1",1,3,-3,"A"
2021-01-17,2020,"RC Strasbourg","AS Saint-Etienne","1-0",1,0,"F1",1,1,1,"H"
2021-01-17,2020,"Lille OSC","Stade Reims","2-1",2,1,"F1",1,3,1,"H"
2021-01-17,2020,"Olympique Lyon","FC Metz","0-1",0,1,"F1",1,1,-1,"A"
2021-01-20,2020,"Olympique Marseille","RC Lens","0-1",0,1,"F1",1,1,-1,"A"
2021-01-22,2020,"Paris Saint-Germain","Montpellier HSC","4-0",4,0,"F1",1,4,4,"H"
2021-01-23,2020,"RC Lens","OGC Nice","0-1",0,1,"F1",1,1,-1,"A"
2021-01-23,2020,"AS Monaco","Olympique Marseille","3-1",3,1,"F1",1,4,2,"H"
2021-01-24,2020,"Girondins Bordeaux","Angers SCO","2-1",2,1,"F1",1,3,1,"H"
2021-01-24,2020,"Dijon FCO","RC Strasbourg","1-1",1,1,"F1",1,2,0,"D"
2021-01-24,2020,"FC Metz","FC Nantes","2-0",2,0,"F1",1,2,2,"H"
2021-01-24,2020,"Stade Reims","Stade Brest","1-0",1,0,"F1",1,1,1,"H"
2021-01-24,2020,"Stade Rennes","Lille OSC","0-1",0,1,"F1",1,1,-1,"A"
2021-01-24,2020,"AS Saint-Etienne","Olympique Lyon","0-5",0,5,"F1",1,5,-5,"A"
2021-01-27,2020,"FC Lorient","Dijon FCO","3-2",3,2,"F1",1,5,1,"H"
2021-01-29,2020,"Olympique Lyon","Girondins Bordeaux","2-1",2,1,"F1",1,3,1,"H"
2021-01-30,2020,"Montpellier HSC","RC Lens","1-2",1,2,"F1",1,3,-1,"A"
2021-01-31,2020,"OGC Nice","AS Saint-Etienne","0-1",0,1,"F1",1,1,-1,"A"
2021-01-31,2020,"Angers SCO","Nimes Olympique","3-1",3,1,"F1",1,4,2,"H"
2021-01-31,2020,"Stade Brest","FC Metz","2-4",2,4,"F1",1,6,-2,"A"
2021-01-31,2020,"FC Lorient","Paris Saint-Germain","3-2",3,2,"F1",1,5,1,"H"
2021-01-31,2020,"RC Strasbourg","Stade Reims","0-1",0,1,"F1",1,1,-1,"A"
2021-01-31,2020,"Lille OSC","Dijon FCO","1-0",1,0,"F1",1,1,1,"H"
2021-01-31,2020,"FC Nantes","AS Monaco","1-2",1,2,"F1",1,3,-1,"A"
2021-02-03,2020,"Girondins Bordeaux","Lille OSC","0-3",0,3,"F1",1,3,-3,"A"
2021-02-03,2020,"FC Metz","Montpellier HSC","1-1",1,1,"F1",1,2,0,"D"
2021-02-03,2020,"Stade Reims","Angers SCO","0-0",0,0,"F1",1,0,0,"D"
2021-02-03,2020,"Stade Rennes","FC Lorient","1-1",1,1,"F1",1,2,0,"D"
2021-02-03,2020,"RC Strasbourg","Stade Brest","2-2",2,2,"F1",1,4,0,"D"
2021-02-03,2020,"Dijon FCO","Olympique Lyon","0-1",0,1,"F1",1,1,-1,"A"
2021-02-03,2020,"RC Lens","Olympique Marseille","2-2",2,2,"F1",1,4,0,"D"
2021-02-03,2020,"AS Monaco","OGC Nice","2-1",2,1,"F1",1,3,1,"H"
2021-02-03,2020,"Paris Saint-Germain","Nimes Olympique","3-0",3,0,"F1",1,3,3,"H"
2021-02-03,2020,"AS Saint-Etienne","FC Nantes","1-1",1,1,"F1",1,2,0,"D"
2021-02-06,2020,"FC Lorient","Stade Reims","1-0",1,0,"F1",1,1,1,"H"
2021-02-06,2020,"Olympique Lyon","RC Strasbourg","3-0",3,0,"F1",1,3,3,"H"
2021-02-06,2020,"RC Lens","Stade Rennes","0-0",0,0,"F1",1,0,0,"D"
2021-02-07,2020,"Stade Brest","Girondins Bordeaux","2-1",2,1,"F1",1,3,1,"H"
2021-02-07,2020,"Montpellier HSC","Dijon FCO","4-2",4,2,"F1",1,6,2,"H"
2021-02-07,2020,"OGC Nice","Angers SCO","3-0",3,0,"F1",1,3,3,"H"
2021-02-07,2020,"Nimes Olympique","AS Monaco","3-4",3,4,"F1",1,7,-1,"A"
2021-02-07,2020,"AS Saint-Etienne","FC Metz","1-0",1,0,"F1",1,1,1,"H"
2021-02-07,2020,"FC Nantes","Lille OSC","0-2",0,2,"F1",1,2,-2,"A"
2021-02-07,2020,"Olympique Marseille","Paris Saint-Germain","0-2",0,2,"F1",1,2,-2,"A"
2021-02-13,2020,"Paris Saint-Germain","OGC Nice","2-1",2,1,"F1",1,3,1,"H"
2021-02-13,2020,"Stade Reims","RC Lens","1-1",1,1,"F1",1,2,0,"D"
2021-02-13,2020,"Olympique Lyon","Montpellier HSC","1-2",1,2,"F1",1,3,-1,"A"
2021-02-14,2020,"AS Monaco","FC Lorient","2-2",2,2,"F1",1,4,0,"D"
2021-02-14,2020,"Angers SCO","FC Nantes","1-3",1,3,"F1",1,4,-2,"A"
2021-02-14,2020,"Dijon FCO","Nimes Olympique","0-2",0,2,"F1",1,2,-2,"A"
2021-02-14,2020,"FC Metz","RC Strasbourg","1-2",1,2,"F1",1,3,-1,"A"
2021-02-14,2020,"Stade Rennes","AS Saint-Etienne","0-2",0,2,"F1",1,2,-2,"A"
2021-02-14,2020,"Lille OSC","Stade Brest","0-0",0,0,"F1",1,0,0,"D"
2021-02-14,2020,"Girondins Bordeaux","Olympique Marseille","0-0",0,0,"F1",1,0,0,"D"
2021-02-17,2020,"Olympique Marseille","OGC Nice","3-2",3,2,"F1",1,5,1,"H"
2021-02-19,2020,"Stade Brest","Olympique Lyon","2-3",2,3,"F1",1,5,-1,"A"
2021-02-20,2020,"AS Saint-Etienne","Stade Reims","1-1",1,1,"F1",1,2,0,"D"
2021-02-20,2020,"FC Nantes","Olympique Marseille","1-1",1,1,"F1",1,2,0,"D"
2021-02-21,2020,"Montpellier HSC","Stade Rennes","2-1",2,1,"F1",1,3,1,"H"
2021-02-21,2020,"RC Lens","Dijon FCO","2-1",2,1,"F1",1,3,1,"H"
2021-02-21,2020,"OGC Nice","FC Metz","1-2",1,2,"F1",1,3,-1,"A"
2021-02-21,2020,"Nimes Olympique","Girondins Bordeaux","2-0",2,0,"F1",1,2,2,"H"
2021-02-21,2020,"RC Strasbourg","Angers SCO","0-0",0,0,"F1",1,0,0,"D"
2021-02-21,2020,"FC Lorient","Lille OSC","1-4",1,4,"F1",1,5,-3,"A"
2021-02-21,2020,"Paris Saint-Germain","AS Monaco","0-2",0,2,"F1",1,2,-2,"A"
2021-02-24,2020,"Nimes Olympique","FC Lorient","1-0",1,0,"F1",1,1,1,"H"
2021-02-26,2020,"Stade Rennes","OGC Nice","1-2",1,2,"F1",1,3,-1,"A"
2021-02-27,2020,"Girondins Bordeaux","FC Metz","1-2",1,2,"F1",1,3,-1,"A"
2021-02-27,2020,"Dijon FCO","Paris Saint-Germain","0-4",0,4,"F1",1,4,-4,"A"
2021-02-28,2020,"AS Monaco","Stade Brest","2-0",2,0,"F1",1,2,2,"H"
2021-02-28,2020,"Angers SCO","RC Lens","2-2",2,2,"F1",1,4,0,"D"
2021-02-28,2020,"FC Lorient","AS Saint-Etienne","2-1",2,1,"F1",1,3,1,"H"
2021-02-28,2020,"Nimes Olympique","FC Nantes","1-1",1,1,"F1",1,2,0,"D"
2021-02-28,2020,"Stade Reims","Montpellier HSC","0-0",0,0,"F1",1,0,0,"D"
2021-02-28,2020,"Lille OSC","RC Strasbourg","1-1",1,1,"F1",1,2,0,"D"
2021-02-28,2020,"Olympique Marseille","Olympique Lyon","1-1",1,1,"F1",1,2,0,"D"
2021-03-03,2020,"Stade Brest","Dijon FCO","3-1",3,1,"F1",1,4,2,"H"
2021-03-03,2020,"Olympique Lyon","Stade Rennes","1-0",1,0,"F1",1,1,1,"H"
2021-03-03,2020,"FC Metz","Angers SCO","0-1",0,1,"F1",1,1,-1,"A"
2021-03-03,2020,"OGC Nice","Nimes Olympique","2-1",2,1,"F1",1,3,1,"H"
2021-03-03,2020,"AS Saint-Etienne","RC Lens","2-3",2,3,"F1",1,5,-1,"A"
2021-03-03,2020,"Girondins Bordeaux","Paris Saint-Germain","0-1",0,1,"F1",1,1,-1,"A"
2021-03-03,2020,"Lille OSC","Olympique Marseille","2-0",2,0,"F1",1,2,2,"H"
2021-03-03,2020,"Montpellier HSC","FC Lorient","1-1",1,1,"F1",1,2,0,"D"
2021-03-03,2020,"FC Nantes","Stade Reims","1-2",1,2,"F1",1,3,-1,"A"
2021-03-03,2020,"RC Strasbourg","AS Monaco","1-0",1,0,"F1",1,1,1,"H"
2021-03-10,2020,"Olympique Marseille","Stade Rennes","1-0",1,0,"F1",1,1,1,"H"
2021-03-12,2020,"Stade Reims","Olympique Lyon","1-1",1,1,"F1",1,2,0,"D"
2021-03-13,2020,"Angers SCO","AS Saint-Etienne","0-1",0,1,"F1",1,1,-1,"A"
2021-03-13,2020,"Olympique Marseille","Stade Brest","3-1",3,1,"F1",1,4,2,"H"
2021-03-14,2020,"Nimes Olympique","Montpellier HSC","1-1",1,1,"F1",1,2,0,"D"
2021-03-14,2020,"Dijon FCO","Girondins Bordeaux","1-3",1,3,"F1",1,4,-2,"A"
2021-03-14,2020,"RC Lens","FC Metz","2-2",2,2,"F1",1,4,0,"D"
2021-03-14,2020,"FC Lorient","OGC Nice","1-1",1,1,"F1",1,2,0,"D"
2021-03-14,2020,"Stade Rennes","RC Strasbourg","1-0",1,0,"F1",1,1,1,"H"
2021-03-14,2020,"AS Monaco","Lille OSC","0-0",0,0,"F1",1,0,0,"D"
2021-03-14,2020,"Paris Saint-Germain","FC Nantes","1-2",1,2,"F1",1,3,-1,"A"
2021-03-19,2020,"AS Saint-Etienne","AS Monaco","0-4",0,4,"F1",1,4,-4,"A"
2021-03-20,2020,"FC Metz","Stade Rennes","1-3",1,3,"F1",1,4,-2,"A"
2021-03-20,2020,"OGC Nice","Olympique Marseille","3-0",3,0,"F1",1,3,3,"H"
2021-03-21,2020,"RC Strasbourg","RC Lens","1-2",1,2,"F1",1,3,-1,"A"
2021-03-21,2020,"Stade Brest","Angers SCO","0-0",0,0,"F1",1,0,0,"D"
2021-03-21,2020,"Dijon FCO","Stade Reims","0-1",0,1,"F1",1,1,-1,"A"
2021-03-21,2020,"Montpellier HSC","Girondins Bordeaux","3-1",3,1,"F1",1,4,2,"H"
2021-03-21,2020,"FC Nantes","FC Lorient","1-1",1,1,"F1",1,2,0,"D"
2021-03-21,2020,"Lille OSC","Nimes Olympique","1-2",1,2,"F1",1,3,-1,"A"
2021-03-21,2020,"Olympique Lyon","Paris Saint-Germain","2-4",2,4,"F1",1,6,-2,"A"
2021-04-03,2020,"AS Monaco","FC Metz","4-0",4,0,"F1",1,4,4,"H"
2021-04-03,2020,"Paris Saint-Germain","Lille OSC","0-1",0,1,"F1",1,1,-1,"A"
2021-04-03,2020,"RC Lens","Olympique Lyon","1-1",1,1,"F1",1,2,0,"D"
2021-04-04,2020,"Angers SCO","Montpellier HSC","1-1",1,1,"F1",1,2,0,"D"
2021-04-04,2020,"Girondins Bordeaux","RC Strasbourg","2-3",2,3,"F1",1,5,-1,"A"
2021-04-04,2020,"FC Lorient","Stade Brest","1-0",1,0,"F1",1,1,1,"H"
2021-04-04,2020,"FC Nantes","OGC Nice","1-2",1,2,"F1",1,3,-1,"A"
2021-04-04,2020,"Stade Reims","Stade Rennes","2-2",2,2,"F1",1,4,0,"D"
2021-04-04,2020,"Nimes Olympique","AS Saint-Etienne","0-2",0,2,"F1",1,2,-2,"A"
2021-04-04,2020,"Olympique Marseille","Dijon FCO","2-0",2,0,"F1",1,2,2,"H"
2021-04-09,2020,"FC Metz","Lille OSC","0-2",0,2,"F1",1,2,-2,"A"
2021-04-10,2020,"RC Strasbourg","Paris Saint-Germain","1-4",1,4,"F1",1,5,-3,"A"
2021-04-10,2020,"Montpellier HSC","Olympique Marseille","3-3",3,3,"F1",1,6,0,"D"
2021-04-11,2020,"Stade Rennes","FC Nantes","1-0",1,0,"F1",1,1,1,"H"
2021-04-11,2020,"Stade Brest","Nimes Olympique","1-1",1,1,"F1",1,2,0,"D"
2021-04-11,2020,"RC Lens","FC Lorient","4-1",4,1,"F1",1,5,3,"H"
2021-04-11,2020,"OGC Nice","Stade Reims","0-0",0,0,"F1",1,0,0,"D"
2021-04-11,2020,"AS Saint-Etienne","Girondins Bordeaux","4-1",4,1,"F1",1,5,3,"H"
2021-04-11,2020,"AS Monaco","Dijon FCO","3-0",3,0,"F1",1,3,3,"H"
2021-04-11,2020,"Olympique Lyon","Angers SCO","3-0",3,0,"F1",1,3,3,"H"
2021-04-16,2020,"Lille OSC","Montpellier HSC","1-1",1,1,"F1",1,2,0,"D"
2021-04-17,2020,"Angers SCO","Stade Rennes","0-3",0,3,"F1",1,3,-3,"A"
2021-04-17,2020,"Olympique Marseille","FC Lorient","3-2",3,2,"F1",1,5,1,"H"
2021-04-18,2020,"Paris Saint-Germain","AS Saint-Etienne","3-2",3,2,"F1",1,5,1,"H"
2021-04-18,2020,"Stade Brest","RC Lens","1-1",1,1,"F1",1,2,0,"D"
2021-04-18,2020,"Dijon FCO","OGC Nice","2-0",2,0,"F1",1,2,2,"H"
2021-04-18,2020,"Nimes Olympique","RC Strasbourg","1-1",1,1,"F1",1,2,0,"D"
2021-04-18,2020,"Stade Reims","FC Metz","0-0",0,0,"F1",1,0,0,"D"
2021-04-18,2020,"Girondins Bordeaux","AS Monaco","0-3",0,3,"F1",1,3,-3,"A"
2021-04-18,2020,"FC Nantes","Olympique Lyon","1-2",1,2,"F1",1,3,-1,"A"
2021-04-23,2020,"Stade Reims","Olympique Marseille","1-3",1,3,"F1",1,4,-2,"A"
2021-04-24,2020,"AS Saint-Etienne","Stade Brest","1-2",1,2,"F1",1,3,-1,"A"
2021-04-24,2020,"FC Metz","Paris Saint-Germain","1-3",1,3,"F1",1,4,-2,"A"
2021-04-25,2020,"OGC Nice","Montpellier HSC","3-1",3,1,"F1",1,4,2,"H"
2021-04-25,2020,"RC Lens","Nimes Olympique","2-1",2,1,"F1",1,3,1,"H"
2021-04-25,2020,"FC Lorient","Girondins Bordeaux","4-1",4,1,"F1",1,5,3,"H"
2021-04-25,2020,"Stade Rennes","Dijon FCO","5-1",5,1,"F1",1,6,4,"H"
2021-04-25,2020,"RC Strasbourg","FC Nantes","1-2",1,2,"F1",1,3,-1,"A"
2021-04-25,2020,"Angers SCO","AS Monaco","0-1",0,1,"F1",1,1,-1,"A"
2021-04-25,2020,"Olympique Lyon","Lille OSC","2-3",2,3,"F1",1,5,-1,"A"
2021-04-30,2020,"Olympique Marseille","RC Strasbourg","1-1",1,1,"F1",1,2,0,"D"
2021-05-01,2020,"Paris Saint-Germain","RC Lens","2-1",2,1,"F1",1,3,1,"H"
2021-05-01,2020,"Lille OSC","OGC Nice","2-0",2,0,"F1",1,2,2,"H"
2021-05-02,2020,"Girondins Bordeaux","Stade Rennes","1-0",1,0,"F1",1,1,1,"H"
2021-05-02,2020,"Stade Brest","FC Nantes","1-4",1,4,"F1",1,5,-3,"A"
2021-05-02,2020,"Dijon FCO","FC Metz","1-5",1,5,"F1",1,6,-4,"A"
2021-05-02,2020,"FC Lorient","Angers SCO","2-0",2,0,"F1",1,2,2,"H"
2021-05-02,2020,"Nimes Olympique","Stade Reims","2-2",2,2,"F1",1,4,0,"D"
2021-05-02,2020,"Montpellier HSC","AS Saint-Etienne","1-2",1,2,"F1",1,3,-1,"A"
2021-05-02,2020,"AS Monaco","Olympique Lyon","2-3",2,3,"F1",1,5,-1,"A"
2021-05-07,2020,"RC Lens","Lille OSC","0-3",0,3,"F1",1,3,-3,"A"
2021-05-08,2020,"FC Nantes","Girondins Bordeaux","3-0",3,0,"F1",1,3,3,"H"
2021-05-08,2020,"Olympique Lyon","FC Lorient","4-1",4,1,"F1",1,5,3,"H"
2021-05-09,2020,"AS Saint-Etienne","Olympique Marseille","1-0",1,0,"F1",1,1,1,"H"
2021-05-09,2020,"Angers SCO","Dijon FCO","3-0",3,0,"F1",1,3,3,"H"
2021-05-09,2020,"FC Metz","Nimes Olympique","0-3",0,3,"F1",1,3,-3,"A"
2021-05-09,2020,"OGC Nice","Stade Brest","3-2",3,2,"F1",1,5,1,"H"
2021-05-09,2020,"RC Strasbourg","Montpellier HSC","2-3",2,3,"F1",1,5,-1,"A"
2021-05-09,2020,"Stade Reims","AS Monaco","0-1",0,1,"F1",1,1,-1,"A"
2021-05-09,2020,"Stade Rennes","Paris Saint-Germain","1-1",1,1,"F1",1,2,0,"D"
2021-05-16,2020,"Girondins Bordeaux","RC Lens","3-0",3,0,"F1",1,3,3,"H"
2021-05-16,2020,"Dijon FCO","FC Nantes","0-4",0,4,"F1",1,4,-4,"A"
2021-05-16,2020,"Lille OSC","AS Saint-Etienne","0-0",0,0,"F1",1,0,0,"D"
2021-05-16,2020,"FC Lorient","FC Metz","2-1",2,1,"F1",1,3,1,"H"
2021-05-16,2020,"Olympique Marseille","Angers SCO","3-2",3,2,"F1",1,5,1,"H"
2021-05-16,2020,"AS Monaco","Stade Rennes","2-1",2,1,"F1",1,3,1,"H"
2021-05-16,2020,"Montpellier HSC","Stade Brest","0-0",0,0,"F1",1,0,0,"D"
2021-05-16,2020,"OGC Nice","RC Strasbourg","0-2",0,2,"F1",1,2,-2,"A"
2021-05-16,2020,"Nimes Olympique","Olympique Lyon","2-5",2,5,"F1",1,7,-3,"A"
2021-05-16,2020,"Paris Saint-Germain","Stade Reims","4-0",4,0,"F1",1,4,4,"H"
2021-05-23,2020,"Angers SCO","Lille OSC","1-2",1,2,"F1",1,3,-1,"A"
2021-05-23,2020,"Stade Brest","Paris Saint-Germain","0-2",0,2,"F1",1,2,-2,"A"
2021-05-23,2020,"RC Lens","AS Monaco","0-0",0,0,"F1",1,0,0,"D"
2021-05-23,2020,"Olympique Lyon","OGC Nice","2-3",2,3,"F1",1,5,-1,"A"
2021-05-23,2020,"FC Metz","Olympique Marseille","1-1",1,1,"F1",1,2,0,"D"
2021-05-23,2020,"FC Nantes","Montpellier HSC","1-2",1,2,"F1",1,3,-1,"A"
2021-05-23,2020,"Stade Reims","Girondins Bordeaux","1-2",1,2,"F1",1,3,-1,"A"
2021-05-23,2020,"Stade Rennes","Nimes Olympique","2-0",2,0,"F1",1,2,2,"H"
2021-05-23,2020,"AS Saint-Etienne","Dijon FCO","0-1",0,1,"F1",1,1,-1,"A"
2021-05-23,2020,"RC Strasbourg","FC Lorient","1-1",1,1,"F1",1,2,0,"D"
2021-08-06,2021,"AS Monaco","FC Nantes","1-1",1,1,"F1",1,2,0,"D"
2021-08-07,2021,"Olympique Lyon","Stade Brest","1-1",1,1,"F1",1,2,0,"D"
2021-08-07,2021,"ESTAC Troyes","Paris Saint-Germain","1-2",1,2,"F1",1,3,-1,"A"
2021-08-08,2021,"Stade Rennes","RC Lens","1-1",1,1,"F1",1,2,0,"D"
2021-08-08,2021,"Girondins Bordeaux","Clermont Foot 63","0-2",0,2,"F1",1,2,-2,"A"
2021-08-08,2021,"OGC Nice","Stade Reims","0-0",0,0,"F1",1,0,0,"D"
2021-08-08,2021,"AS Saint-Etienne","FC Lorient","1-1",1,1,"F1",1,2,0,"D"
2021-08-08,2021,"RC Strasbourg","Angers SCO","0-2",0,2,"F1",1,2,-2,"A"
2021-08-08,2021,"FC Metz","Lille OSC","3-3",3,3,"F1",1,6,0,"D"
2021-08-08,2021,"Montpellier HSC","Olympique Marseille","2-3",2,3,"F1",1,5,-1,"A"
2021-08-13,2021,"FC Lorient","AS Monaco","1-0",1,0,"F1",1,1,1,"H"
2021-08-14,2021,"Lille OSC","OGC Nice","0-4",0,4,"F1",1,4,-4,"A"
2021-08-14,2021,"Paris Saint-Germain","RC Strasbourg","4-2",4,2,"F1",1,6,2,"H"
2021-08-15,2021,"Angers SCO","Olympique Lyon","3-0",3,0,"F1",1,3,3,"H"
2021-08-15,2021,"Stade Brest","Stade Rennes","1-1",1,1,"F1",1,2,0,"D"
2021-08-15,2021,"Clermont Foot 63","ESTAC Troyes","2-0",2,0,"F1",1,2,2,"H"
2021-08-15,2021,"FC Nantes","FC Metz","2-0",2,0,"F1",1,2,2,"H"
2021-08-15,2021,"Stade Reims","Montpellier HSC","3-3",3,3,"F1",1,6,0,"D"
2021-08-15,2021,"RC Lens","AS Saint-Etienne","2-2",2,2,"F1",1,4,0,"D"
2021-08-15,2021,"Olympique Marseille","Girondins Bordeaux","2-2",2,2,"F1",1,4,0,"D"
2021-08-20,2021,"Stade Brest","Paris Saint-Germain","2-4",2,4,"F1",1,6,-2,"A"
2021-08-21,2021,"AS Monaco","RC Lens","0-2",0,2,"F1",1,2,-2,"A"
2021-08-21,2021,"AS Saint-Etienne","Lille OSC","1-1",1,1,"F1",1,2,0,"D"
2021-08-22,2021,"Olympique Lyon","Clermont Foot 63","3-3",3,3,"F1",1,6,0,"D"
2021-08-22,2021,"Girondins Bordeaux","Angers SCO","1-1",1,1,"F1",1,2,0,"D"
2021-08-22,2021,"FC Metz","Stade Reims","1-1",1,1,"F1",1,2,0,"D"
2021-08-22,2021,"Montpellier HSC","FC Lorient","3-1",3,1,"F1",1,4,2,"H"
2021-08-22,2021,"RC Strasbourg","ESTAC Troyes","1-1",1,1,"F1",1,2,0,"D"
2021-08-22,2021,"Stade Rennes","FC Nantes","1-0",1,0,"F1",1,1,1,"H"
2021-08-27,2021,"FC Nantes","Olympique Lyon","0-1",0,1,"F1",1,1,-1,"A"
2021-08-28,2021,"OGC Nice","Girondins Bordeaux","4-0",4,0,"F1",1,4,4,"H"
2021-08-28,2021,"Olympique Marseille","AS Saint-Etienne","3-1",3,1,"F1",1,4,2,"H"
2021-08-29,2021,"ESTAC Troyes","AS Monaco","1-2",1,2,"F1",1,3,-1,"A"
2021-08-29,2021,"Angers SCO","Stade Rennes","2-0",2,0,"F1",1,2,2,"H"
2021-08-29,2021,"Clermont Foot 63","FC Metz","2-2",2,2,"F1",1,4,0,"D"
2021-08-29,2021,"RC Lens","FC Lorient","2-2",2,2,"F1",1,4,0,"D"
2021-08-29,2021,"RC Strasbourg","Stade Brest","3-1",3,1,"F1",1,4,2,"H"
2021-08-29,2021,"Lille OSC","Montpellier HSC","2-1",2,1,"F1",1,3,1,"H"
2021-08-29,2021,"Stade Reims","Paris Saint-Germain","0-2",0,2,"F1",1,2,-2,"A"
2021-09-10,2021,"FC Lorient","Lille OSC","2-1",2,1,"F1",1,3,1,"H"
2021-09-11,2021,"Paris Saint-Germain","Clermont Foot 63","4-0",4,0,"F1",1,4,4,"H"
2021-09-11,2021,"AS Monaco","Olympique Marseille","0-2",0,2,"F1",1,2,-2,"A"
2021-09-12,2021,"Montpellier HSC","AS Saint-Etienne","2-0",2,0,"F1",1,2,2,"H"
2021-09-12,2021,"Girondins Bordeaux","RC Lens","2-3",2,3,"F1",1,5,-1,"A"
2021-09-12,2021,"Stade Brest","Angers SCO","1-1",1,1,"F1",1,2,0,"D"
2021-09-12,2021,"FC Metz","ESTAC Troyes","0-2",0,2,"F1",1,2,-2,"A"
2021-09-12,2021,"Stade Rennes","Stade Reims","0-2",0,2,"F1",1,2,-2,"A"
2021-09-12,2021,"FC Nantes","OGC Nice","0-2",0,2,"F1",1,2,-2,"A"
2021-09-12,2021,"Olympique Lyon","RC Strasbourg","3-1",3,1,"F1",1,4,2,"H"
2021-09-17,2021,"RC Strasbourg","FC Metz","3-0",3,0,"F1",1,3,3,"H"
2021-09-18,2021,"RC Lens","Lille OSC","1-0",1,0,"F1",1,1,1,"H"
2021-09-18,2021,"AS Saint-Etienne","Girondins Bordeaux","1-2",1,2,"F1",1,3,-1,"A"
2021-09-19,2021,"OGC Nice","AS Monaco","2-2",2,2,"F1",1,4,0,"D"
2021-09-19,2021,"Angers SCO","FC Nantes","1-4",1,4,"F1",1,5,-3,"A"
2021-09-19,2021,"Clermont Foot 63","Stade Brest","1-1",1,1,"F1",1,2,0,"D"
2021-09-19,2021,"Stade Reims","FC Lorient","0-0",0,0,"F1",1,0,0,"D"
2021-09-19,2021,"ESTAC Troyes","Montpellier HSC","1-1",1,1,"F1",1,2,0,"D"
2021-09-19,2021,"Olympique Marseille","Stade Rennes","2-0",2,0,"F1",1,2,2,"H"
2021-09-19,2021,"Paris Saint-Germain","Olympique Lyon","2-1",2,1,"F1",1,3,1,"H"
2021-09-22,2021,"Lille OSC","Stade Reims","2-1",2,1,"F1",1,3,1,"H"
2021-09-22,2021,"AS Monaco","AS Saint-Etienne","3-1",3,1,"F1",1,4,2,"H"
2021-09-22,2021,"Montpellier HSC","Girondins Bordeaux","3-3",3,3,"F1",1,6,0,"D"
2021-09-22,2021,"FC Nantes","Stade Brest","3-1",3,1,"F1",1,4,2,"H"
2021-09-22,2021,"Stade Rennes","Clermont Foot 63","6-0",6,0,"F1",1,6,6,"H"
2021-09-22,2021,"Angers SCO","Olympique Marseille","0-0",0,0,"F1",1,0,0,"D"
2021-09-22,2021,"RC Lens","RC Strasbourg","0-1",0,1,"F1",1,1,-1,"A"
2021-09-22,2021,"FC Lorient","OGC Nice","1-0",1,0,"F1",1,1,1,"H"
2021-09-22,2021,"Olympique Lyon","ESTAC Troyes","3-1",3,1,"F1",1,4,2,"H"
2021-09-22,2021,"FC Metz","Paris Saint-Germain","1-2",1,2,"F1",1,3,-1,"A"
2021-09-25,2021,"AS Saint-Etienne","OGC Nice","0-3",0,3,"F1",1,3,-3,"A"
2021-09-25,2021,"RC Strasbourg","Lille OSC","1-2",1,2,"F1",1,3,-1,"A"
2021-09-25,2021,"Olympique Lyon","FC Lorient","1-1",1,1,"F1",1,2,0,"D"
2021-09-25,2021,"Paris Saint-Germain","Montpellier HSC","2-0",2,0,"F1",1,2,2,"H"
2021-09-26,2021,"Girondins Bordeaux","Stade Rennes","1-1",1,1,"F1",1,2,0,"D"
2021-09-26,2021,"Stade Brest","FC Metz","1-2",1,2,"F1",1,3,-1,"A"
2021-09-26,2021,"Stade Reims","FC Nantes","3-1",3,1,"F1",1,4,2,"H"
2021-09-26,2021,"ESTAC Troyes","Angers SCO","1-1",1,1,"F1",1,2,0,"D"
2021-09-26,2021,"Clermont Foot 63","AS Monaco","1-3",1,3,"F1",1,4,-2,"A"
2021-09-26,2021,"Olympique Marseille","RC Lens","2-3",2,3,"F1",1,5,-1,"A"
2021-10-01,2021,"RC Lens","Stade Reims","2-0",2,0,"F1",1,2,2,"H"
2021-10-02,2021,"Montpellier HSC","RC Strasbourg","1-1",1,1,"F1",1,2,0,"D"
2021-10-02,2021,"OGC Nice","Stade Brest","2-1",2,1,"F1",1,3,1,"H"
2021-10-03,2021,"Stade Rennes","Paris Saint-Germain","2-0",2,0,"F1",1,2,2,"H"
2021-10-03,2021,"Angers SCO","FC Metz","3-2",3,2,"F1",1,5,1,"H"
2021-10-03,2021,"FC Lorient","Clermont Foot 63","1-1",1,1,"F1",1,2,0,"D"
2021-10-03,2021,"AS Monaco","Girondins Bordeaux","3-0",3,0,"F1",1,3,3,"H"
2021-10-03,2021,"FC Nantes","ESTAC Troyes","2-0",2,0,"F1",1,2,2,"H"
2021-10-03,2021,"Lille OSC","Olympique Marseille","2-0",2,0,"F1",1,2,2,"H"
2021-10-03,2021,"AS Saint-Etienne","Olympique Lyon","1-1",1,1,"F1",1,2,0,"D"
2021-10-15,2021,"Paris Saint-Germain","Angers SCO","2-1",2,1,"F1",1,3,1,"H"
2021-10-16,2021,"Clermont Foot 63","Lille OSC","1-0",1,0,"F1",1,1,1,"H"
2021-10-16,2021,"Olympique Lyon","AS Monaco","2-0",2,0,"F1",1,2,2,"H"
2021-10-17,2021,"ESTAC Troyes","OGC Nice","1-0",1,0,"F1",1,1,1,"H"
2021-10-17,2021,"Girondins Bordeaux","FC Nantes","1-1",1,1,"F1",1,2,0,"D"
2021-10-17,2021,"Stade Brest","Stade Reims","1-1",1,1,"F1",1,2,0,"D"
2021-10-17,2021,"FC Metz","Stade Rennes","0-3",0,3,"F1",1,3,-3,"A"
2021-10-17,2021,"RC Strasbourg","AS Saint-Etienne","5-1",5,1,"F1",1,6,4,"H"
2021-10-17,2021,"Montpellier HSC","RC Lens","1-0",1,0,"F1",1,1,1,"H"
2021-10-17,2021,"Olympique Marseille","FC Lorient","4-1",4,1,"F1",1,5,3,"H"
2021-10-22,2021,"AS Saint-Etienne","Angers SCO","2-2",2,2,"F1",1,4,0,"D"
2021-10-23,2021,"FC Nantes","Clermont Foot 63","2-1",2,1,"F1",1,3,1,"H"
2021-10-23,2021,"Lille OSC","Stade Brest","1-1",1,1,"F1",1,2,0,"D"
2021-10-24,2021,"OGC Nice","Olympique Lyon","3-2",3,2,"F1",1,5,1,"H"
2021-10-24,2021,"RC Lens","FC Metz","4-1",4,1,"F1",1,5,3,"H"
2021-10-24,2021,"FC Lorient","Girondins Bordeaux","1-1",1,1,"F1",1,2,0,"D"
2021-10-24,2021,"Stade Reims","ESTAC Troyes","1-2",1,2,"F1",1,3,-1,"A"
2021-10-24,2021,"Stade Rennes","RC Strasbourg","1-0",1,0,"F1",1,1,1,"H"
2021-10-24,2021,"AS Monaco","Montpellier HSC","3-1",3,1,"F1",1,4,2,"H"
2021-10-24,2021,"Olympique Marseille","Paris Saint-Germain","0-0",0,0,"F1",1,0,0,"D"
2021-10-27,2021,"OGC Nice","Olympique Marseille","1-1",1,1,"F1",1,2,0,"D"
2021-10-29,2021,"Paris Saint-Germain","Lille OSC","2-1",2,1,"F1",1,3,1,"H"
2021-10-30,2021,"FC Metz","AS Saint-Etienne","1-1",1,1,"F1",1,2,0,"D"
2021-10-30,2021,"Olympique Lyon","RC Lens","2-1",2,1,"F1",1,3,1,"H"
2021-10-31,2021,"Angers SCO","OGC Nice","1-2",1,2,"F1",1,3,-1,"A"
2021-10-31,2021,"Girondins Bordeaux","Stade Reims","3-2",3,2,"F1",1,5,1,"H"
2021-10-31,2021,"Montpellier HSC","FC Nantes","2-0",2,0,"F1",1,2,2,"H"
2021-10-31,2021,"RC Strasbourg","FC Lorient","4-0",4,0,"F1",1,4,4,"H"
2021-10-31,2021,"ESTAC Troyes","Stade Rennes","2-2",2,2,"F1",1,4,0,"D"
2021-10-31,2021,"Stade Brest","AS Monaco","2-0",2,0,"F1",1,2,2,"H"
2021-10-31,2021,"Clermont Foot 63","Olympique Marseille","0-1",0,1,"F1",1,1,-1,"A"
2021-11-05,2021,"RC Lens","ESTAC Troyes","4-0",4,0,"F1",1,4,4,"H"
2021-11-06,2021,"Lille OSC","Angers SCO","1-1",1,1,"F1",1,2,0,"D"
2021-11-06,2021,"Girondins Bordeaux","Paris Saint-Germain","2-3",2,3,"F1",1,5,-1,"A"
2021-11-07,2021,"Olympique Marseille","FC Metz","0-0",0,0,"F1",1,0,0,"D"
2021-11-07,2021,"FC Lorient","Stade Brest","1-2",1,2,"F1",1,3,-1,"A"
2021-11-07,2021,"FC Nantes","RC Strasbourg","2-2",2,2,"F1",1,4,0,"D"
2021-11-07,2021,"Stade Reims","AS Monaco","0-0",0,0,"F1",1,0,0,"D"
2021-11-07,2021,"AS Saint-Etienne","Clermont Foot 63","3-2",3,2,"F1",1,5,1,"H"
2021-11-07,2021,"OGC Nice","Montpellier HSC","0-1",0,1,"F1",1,1,-1,"A"
2021-11-07,2021,"Stade Rennes","Olympique Lyon","4-1",4,1,"F1",1,5,3,"H"
2021-11-19,2021,"AS Monaco","Lille OSC","2-2",2,2,"F1",1,4,0,"D"
2021-11-20,2021,"Paris Saint-Germain","FC Nantes","3-1",3,1,"F1",1,4,2,"H"
2021-11-20,2021,"Stade Rennes","Montpellier HSC","2-0",2,0,"F1",1,2,2,"H"
2021-11-21,2021,"Stade Brest","RC Lens","4-0",4,0,"F1",1,4,4,"H"
2021-11-21,2021,"Angers SCO","FC Lorient","1-0",1,0,"F1",1,1,1,"H"
2021-11-21,2021,"FC Metz","Girondins Bordeaux","3-3",3,3,"F1",1,6,0,"D"
2021-11-21,2021,"RC Strasbourg","Stade Reims","1-1",1,1,"F1",1,2,0,"D"
2021-11-21,2021,"ESTAC Troyes","AS Saint-Etienne","0-1",0,1,"F1",1,1,-1,"A"
2021-11-21,2021,"Clermont Foot 63","OGC Nice","1-2",1,2,"F1",1,3,-1,"A"
2021-11-26,2021,"RC Lens","Angers SCO","2-2",2,2,"F1",1,4,0,"D"
2021-11-27,2021,"Lille OSC","FC Nantes","1-1",1,1,"F1",1,2,0,"D"
2021-11-27,2021,"OGC Nice","FC Metz","0-1",0,1,"F1",1,1,-1,"A"
2021-11-28,2021,"AS Saint-Etienne","Paris Saint-Germain","1-3",1,3,"F1",1,4,-2,"A"
2021-11-28,2021,"Girondins Bordeaux","Stade Brest","1-2",1,2,"F1",1,3,-1,"A"
2021-11-28,2021,"FC Lorient","Stade Rennes","0-2",0,2,"F1",1,2,-2,"A"
2021-11-28,2021,"AS Monaco","RC Strasbourg","1-1",1,1,"F1",1,2,0,"D"
2021-11-28,2021,"Stade Reims","Clermont Foot 63","1-0",1,0,"F1",1,1,1,"H"
2021-11-28,2021,"Montpellier HSC","Olympique Lyon","0-1",0,1,"F1",1,1,-1,"A"
2021-11-28,2021,"Olympique Marseille","ESTAC Troyes","1-0",1,0,"F1",1,1,1,"H"
2021-12-01,2021,"Angers SCO","AS Monaco","1-3",1,3,"F1",1,4,-2,"A"
2021-12-01,2021,"Stade Brest","AS Saint-Etienne","1-0",1,0,"F1",1,1,1,"H"
2021-12-01,2021,"FC Metz","Montpellier HSC","1-3",1,3,"F1",1,4,-2,"A"
2021-12-01,2021,"RC Strasbourg","Girondins Bordeaux","5-2",5,2,"F1",1,7,3,"H"
2021-12-01,2021,"ESTAC Troyes","FC Lorient","2-0",2,0,"F1",1,2,2,"H"
2021-12-01,2021,"Clermont Foot 63","RC Lens","2-2",2,2,"F1",1,4,0,"D"
2021-12-01,2021,"Olympique Lyon","Stade Reims","1-2",1,2,"F1",1,3,-1,"A"
2021-12-01,2021,"FC Nantes","Olympique Marseille","0-1",0,1,"F1",1,1,-1,"A"
2021-12-01,2021,"Paris Saint-Germain","OGC Nice","0-0",0,0,"F1",1,0,0,"D"
2021-12-01,2021,"Stade Rennes","Lille OSC","1-2",1,2,"F1",1,3,-1,"A"
2021-12-04,2021,"Olympique Marseille","Stade Brest","1-2",1,2,"F1",1,3,-1,"A"
2021-12-04,2021,"Lille OSC","ESTAC Troyes","2-1",2,1,"F1",1,3,1,"H"
2021-12-04,2021,"RC Lens","Paris Saint-Germain","1-1",1,1,"F1",1,2,0,"D"
2021-12-05,2021,"AS Saint-Etienne","Stade Rennes","0-5",0,5,"F1",1,5,-5,"A"
2021-12-05,2021,"FC Lorient","FC Nantes","0-1",0,1,"F1",1,1,-1,"A"
2021-12-05,2021,"AS Monaco","FC Metz","4-0",4,0,"F1",1,4,4,"H"
2021-12-05,2021,"Montpellier HSC","Clermont Foot 63","1-0",1,0,"F1",1,1,1,"H"
2021-12-05,2021,"Stade Reims","Angers SCO","1-2",1,2,"F1",1,3,-1,"A"
2021-12-05,2021,"OGC Nice","RC Strasbourg","0-3",0,3,"F1",1,3,-3,"A"
2021-12-05,2021,"Girondins Bordeaux","Olympique Lyon","2-2",2,2,"F1",1,4,0,"D"
2021-12-10,2021,"FC Nantes","RC Lens","3-2",3,2,"F1",1,5,1,"H"
2021-12-11,2021,"Stade Brest","Montpellier HSC","0-4",0,4,"F1",1,4,-4,"A"
2021-12-11,2021,"Stade Reims","AS Saint-Etienne","2-0",2,0,"F1",1,2,2,"H"
2021-12-12,2021,"Lille OSC","Olympique Lyon","0-0",0,0,"F1",1,0,0,"D"
2021-12-12,2021,"Angers SCO","Clermont Foot 63","0-1",0,1,"F1",1,1,-1,"A"
2021-12-12,2021,"FC Metz","FC Lorient","4-1",4,1,"F1",1,5,3,"H"
2021-12-12,2021,"Stade Rennes","OGC Nice","1-2",1,2,"F1",1,3,-1,"A"
2021-12-12,2021,"ESTAC Troyes","Girondins Bordeaux","1-2",1,2,"F1",1,3,-1,"A"
2021-12-12,2021,"RC Strasbourg","Olympique Marseille","0-2",0,2,"F1",1,2,-2,"A"
2021-12-12,2021,"Paris Saint-Germain","AS Monaco","2-0",2,0,"F1",1,2,2,"H"
2021-12-22,2021,"Girondins Bordeaux","Lille OSC","2-3",2,3,"F1",1,5,-1,"A"
2021-12-22,2021,"FC Lorient","Paris Saint-Germain","1-1",1,1,"F1",1,2,0,"D"
2021-12-22,2021,"Olympique Lyon","FC Metz","1-1",1,1,"F1",1,2,0,"D"
2021-12-22,2021,"Olympique Marseille","Stade Reims","1-1",1,1,"F1",1,2,0,"D"
2021-12-22,2021,"AS Monaco","Stade Rennes","2-1",2,1,"F1",1,3,1,"H"
2021-12-22,2021,"Montpellier HSC","Angers SCO","4-1",4,1,"F1",1,5,3,"H"
2021-12-22,2021,"OGC Nice","RC Lens","2-1",2,1,"F1",1,3,1,"H"
2021-12-22,2021,"AS Saint-Etienne","FC Nantes","0-1",0,1,"F1",1,1,-1,"A"
2021-12-22,2021,"ESTAC Troyes","Stade Brest","1-1",1,1,"F1",1,2,0,"D"
2022-01-07,2021,"Girondins Bordeaux","Olympique Marseille","0-1",0,1,"F1",1,1,-1,"A"
2022-01-08,2021,"RC Lens","Stade Rennes","1-0",1,0,"F1",1,1,1,"H"
2022-01-09,2021,"Stade Brest","OGC Nice","0-3",0,3,"F1",1,3,-3,"A"
2022-01-09,2021,"Clermont Foot 63","Stade Reims","0-0",0,0,"F1",1,0,0,"D"
2022-01-09,2021,"FC Metz","RC Strasbourg","0-2",0,2,"F1",1,2,-2,"A"
2022-01-09,2021,"FC Nantes","AS Monaco","0-0",0,0,"F1",1,0,0,"D"
2022-01-09,2021,"Olympique Lyon","Paris Saint-Germain","1-1",1,1,"F1",1,2,0,"D"
2022-01-14,2021,"OGC Nice","FC Nantes","2-1",2,1,"F1",1,3,1,"H"
2022-01-15,2021,"AS Saint-Etienne","RC Lens","1-2",1,2,"F1",1,3,-1,"A"
2022-01-15,2021,"Paris Saint-Germain","Stade Brest","2-0",2,0,"F1",1,2,2,"H"
2022-01-16,2021,"Stade Rennes","Girondins Bordeaux","6-0",6,0,"F1",1,6,6,"H"
2022-01-16,2021,"FC Lorient","Angers SCO","0-0",0,0,"F1",1,0,0,"D"
2022-01-16,2021,"AS Monaco","Clermont Foot 63","4-0",4,0,"F1",1,4,4,"H"
2022-01-16,2021,"Stade Reims","FC Metz","0-1",0,1,"F1",1,1,-1,"A"
2022-01-16,2021,"RC Strasbourg","Montpellier HSC","3-1",3,1,"F1",1,4,2,"H"
2022-01-16,2021,"ESTAC Troyes","Olympique Lyon","0-1",0,1,"F1",1,1,-1,"A"
2022-01-16,2021,"Olympique Marseille","Lille OSC","1-1",1,1,"F1",1,2,0,"D"
2022-01-19,2021,"Clermont Foot 63","RC Strasbourg","0-2",0,2,"F1",1,2,-2,"A"
2022-01-19,2021,"Lille OSC","FC Lorient","3-1",3,1,"F1",1,4,2,"H"
2022-01-19,2021,"Montpellier HSC","ESTAC Troyes","0-1",0,1,"F1",1,1,-1,"A"
2022-01-21,2021,"Olympique Lyon","AS Saint-Etienne","1-0",1,0,"F1",1,1,1,"H"
2022-01-22,2021,"Stade Brest","Lille OSC","2-0",2,0,"F1",1,2,2,"H"
2022-01-22,2021,"RC Lens","Olympique Marseille","0-2",0,2,"F1",1,2,-2,"A"
2022-01-23,2021,"FC Metz","OGC Nice","0-2",0,2,"F1",1,2,-2,"A"
2022-01-23,2021,"Angers SCO","ESTAC Troyes","2-1",2,1,"F1",1,3,1,"H"
2022-01-23,2021,"Girondins Bordeaux","RC Strasbourg","4-3",4,3,"F1",1,7,1,"H"
2022-01-23,2021,"Clermont Foot 63","Stade Rennes","2-1",2,1,"F1",1,3,1,"H"
2022-01-23,2021,"FC Nantes","FC Lorient","4-2",4,2,"F1",1,6,2,"H"
2022-01-23,2021,"Montpellier HSC","AS Monaco","3-2",3,2,"F1",1,5,1,"H"
2022-01-23,2021,"Paris Saint-Germain","Stade Reims","4-0",4,0,"F1",1,4,4,"H"
2022-01-26,2021,"Angers SCO","AS Saint-Etienne","0-1",0,1,"F1",1,1,-1,"A"
2022-02-01,2021,"Olympique Lyon","Olympique Marseille","2-1",2,1,"F1",1,3,1,"H"
2022-02-04,2021,"Olympique Marseille","Angers SCO","5-2",5,2,"F1",1,7,3,"H"
2022-02-05,2021,"AS Saint-Etienne","Montpellier HSC","3-1",3,1,"F1",1,4,2,"H"
2022-02-05,2021,"AS Monaco","Olympique Lyon","2-0",2,0,"F1",1,2,2,"H"
2022-02-06,2021,"FC Lorient","RC Lens","2-0",2,0,"F1",1,2,2,"H"
2022-02-06,2021,"OGC Nice","Clermont Foot 63","0-1",0,1,"F1",1,1,-1,"A"
2022-02-06,2021,"Stade Reims","Girondins Bordeaux","5-0",5,0,"F1",1,5,5,"H"
2022-02-06,2021,"RC Strasbourg","FC Nantes","1-0",1,0,"F1",1,1,1,"H"
2022-02-06,2021,"ESTAC Troyes","FC Metz","0-0",0,0,"F1",1,0,0,"D"
2022-02-06,2021,"Stade Rennes","Stade Brest","2-0",2,0,"F1",1,2,2,"H"
2022-02-06,2021,"Lille OSC","Paris Saint-Germain","1-5",1,5,"F1",1,6,-4,"A"
2022-02-11,2021,"Paris Saint-Germain","Stade Rennes","1-0",1,0,"F1",1,1,1,"H"
2022-02-12,2021,"Montpellier HSC","Lille OSC","0-1",0,1,"F1",1,1,-1,"A"
2022-02-12,2021,"Olympique Lyon","OGC Nice","2-0",2,0,"F1",1,2,2,"H"
2022-02-13,2021,"AS Monaco","FC Lorient","0-0",0,0,"F1",1,0,0,"D"
2022-02-13,2021,"Angers SCO","RC Strasbourg","0-1",0,1,"F1",1,1,-1,"A"
2022-02-13,2021,"Stade Brest","ESTAC Troyes","5-1",5,1,"F1",1,6,4,"H"
2022-02-13,2021,"Clermont Foot 63","AS Saint-Etienne","1-2",1,2,"F1",1,3,-1,"A"
2022-02-13,2021,"FC Nantes","Stade Reims","1-0",1,0,"F1",1,1,1,"H"
2022-02-13,2021,"RC Lens","Girondins Bordeaux","3-2",3,2,"F1",1,5,1,"H"
2022-02-13,2021,"FC Metz","Olympique Marseille","1-2",1,2,"F1",1,3,-1,"A"
2022-02-18,2021,"Lille OSC","FC Metz","0-0",0,0,"F1",1,0,0,"D"
2022-02-19,2021,"RC Lens","Olympique Lyon","1-1",1,1,"F1",1,2,0,"D"
2022-02-19,2021,"FC Nantes","Paris Saint-Germain","3-1",3,1,"F1",1,4,2,"H"
2022-02-20,2021,"OGC Nice","Angers SCO","1-0",1,0,"F1",1,1,1,"H"
2022-02-20,2021,"FC Lorient","Montpellier HSC","0-1",0,1,"F1",1,1,-1,"A"
2022-02-20,2021,"Stade Reims","Stade Brest","1-1",1,1,"F1",1,2,0,"D"
2022-02-20,2021,"Stade Rennes","ESTAC Troyes","4-1",4,1,"F1",1,5,3,"H"
2022-02-20,2021,"AS Saint-Etienne","RC Strasbourg","2-2",2,2,"F1",1,4,0,"D"
2022-02-20,2021,"Girondins Bordeaux","AS Monaco","1-1",1,1,"F1",1,2,0,"D"
2022-02-20,2021,"Olympique Marseille","Clermont Foot 63","0-2",0,2,"F1",1,2,-2,"A"
2022-02-25,2021,"Montpellier HSC","Stade Rennes","2-4",2,4,"F1",1,6,-2,"A"
2022-02-26,2021,"RC Strasbourg","OGC Nice","0-0",0,0,"F1",1,0,0,"D"
2022-02-26,2021,"Paris Saint-Germain","AS Saint-Etienne","3-1",3,1,"F1",1,4,2,"H"
2022-02-27,2021,"AS Monaco","Stade Reims","1-2",1,2,"F1",1,3,-1,"A"
2022-02-27,2021,"Angers SCO","RC Lens","1-2",1,2,"F1",1,3,-1,"A"
2022-02-27,2021,"Stade Brest","FC Lorient","0-1",0,1,"F1",1,1,-1,"A"
2022-02-27,2021,"Clermont Foot 63","Girondins Bordeaux","1-1",1,1,"F1",1,2,0,"D"
2022-02-27,2021,"FC Metz","FC Nantes","0-0",0,0,"F1",1,0,0,"D"
2022-02-27,2021,"ESTAC Troyes","Olympique Marseille","1-1",1,1,"F1",1,2,0,"D"
2022-02-27,2021,"Olympique Lyon","Lille OSC","0-1",0,1,"F1",1,1,-1,"A"
2022-03-04,2021,"FC Lorient","Olympique Lyon","1-4",1,4,"F1",1,5,-3,"A"
2022-03-05,2021,"RC Lens","Stade Brest","0-1",0,1,"F1",1,1,-1,"A"
2022-03-05,2021,"OGC Nice","Paris Saint-Germain","1-0",1,0,"F1",1,1,1,"H"
2022-03-06,2021,"AS Saint-Etienne","FC Metz","1-0",1,0,"F1",1,1,1,"H"
2022-03-06,2021,"Girondins Bordeaux","ESTAC Troyes","0-2",0,2,"F1",1,2,-2,"A"
2022-03-06,2021,"FC Nantes","Montpellier HSC","2-0",2,0,"F1",1,2,2,"H"
2022-03-06,2021,"Stade Reims","RC Strasbourg","1-1",1,1,"F1",1,2,0,"D"
2022-03-06,2021,"Stade Rennes","Angers SCO","2-0",2,0,"F1",1,2,2,"H"
2022-03-06,2021,"Lille OSC","Clermont Foot 63","4-0",4,0,"F1",1,4,4,"H"
2022-03-06,2021,"Olympique Marseille","AS Monaco","0-1",0,1,"F1",1,1,-1,"A"
2022-03-11,2021,"Lille OSC","AS Saint-Etienne","0-0",0,0,"F1",1,0,0,"D"
2022-03-12,2021,"Montpellier HSC","OGC Nice","0-0",0,0,"F1",1,0,0,"D"
2022-03-12,2021,"ESTAC Troyes","FC Nantes","1-0",1,0,"F1",1,1,1,"H"
2022-03-13,2021,"Paris Saint-Germain","Girondins Bordeaux","3-0",3,0,"F1",1,3,3,"H"
2022-03-13,2021,"Angers SCO","Stade Reims","0-1",0,1,"F1",1,1,-1,"A"
2022-03-13,2021,"Clermont Foot 63","FC Lorient","0-2",0,2,"F1",1,2,-2,"A"
2022-03-13,2021,"FC Metz","RC Lens","0-0",0,0,"F1",1,0,0,"D"
2022-03-13,2021,"RC Strasbourg","AS Monaco","1-0",1,0,"F1",1,1,1,"H"
2022-03-13,2021,"Olympique Lyon","Stade Rennes","2-4",2,4,"F1",1,6,-2,"A"
2022-03-13,2021,"Stade Brest","Olympique Marseille","1-4",1,4,"F1",1,5,-3,"A"
2022-03-18,2021,"AS Saint-Etienne","ESTAC Troyes","1-1",1,1,"F1",1,2,0,"D"
2022-03-19,2021,"RC Lens","Clermont Foot 63","3-1",3,1,"F1",1,4,2,"H"
2022-03-19,2021,"FC Nantes","Lille OSC","0-1",0,1,"F1",1,1,-1,"A"
2022-03-20,2021,"AS Monaco","Paris Saint-Germain","3-0",3,0,"F1",1,3,3,"H"
2022-03-20,2021,"Angers SCO","Stade Brest","1-0",1,0,"F1",1,1,1,"H"
2022-03-20,2021,"Girondins Bordeaux","Montpellier HSC","0-2",0,2,"F1",1,2,-2,"A"
2022-03-20,2021,"FC Lorient","RC Strasbourg","0-0",0,0,"F1",1,0,0,"D"
2022-03-20,2021,"Stade Rennes","FC Metz","6-1",6,1,"F1",1,7,5,"H"
2022-03-20,2021,"Stade Reims","Olympique Lyon","0-0",0,0,"F1",1,0,0,"D"
2022-03-20,2021,"Olympique Marseille","OGC Nice","2-1",2,1,"F1",1,3,1,"H"
2022-04-02,2021,"OGC Nice","Stade Rennes","1-1",1,1,"F1",1,2,0,"D"
2022-04-02,2021,"Lille OSC","Girondins Bordeaux","0-0",0,0,"F1",1,0,0,"D"
2022-04-03,2021,"RC Strasbourg","RC Lens","1-0",1,0,"F1",1,1,1,"H"
2022-04-03,2021,"Clermont Foot 63","FC Nantes","2-3",2,3,"F1",1,5,-1,"A"
2022-04-03,2021,"FC Metz","AS Monaco","1-2",1,2,"F1",1,3,-1,"A"
2022-04-03,2021,"Montpellier HSC","Stade Brest","1-2",1,2,"F1",1,3,-1,"A"
2022-04-03,2021,"AS Saint-Etienne","Olympique Marseille","2-4",2,4,"F1",1,6,-2,"A"
2022-04-03,2021,"ESTAC Troyes","Stade Reims","1-0",1,0,"F1",1,1,1,"H"
2022-04-03,2021,"Olympique Lyon","Angers SCO","3-2",3,2,"F1",1,5,1,"H"
2022-04-03,2021,"Paris Saint-Germain","FC Lorient","5-1",5,1,"F1",1,6,4,"H"
2022-04-08,2021,"FC Lorient","AS Saint-Etienne","6-2",6,2,"F1",1,8,4,"H"
2022-04-09,2021,"Stade Reims","Stade Rennes","2-3",2,3,"F1",1,5,-1,"A"
2022-04-09,2021,"Clermont Foot 63","Paris Saint-Germain","1-6",1,6,"F1",1,7,-5,"A"
2022-04-10,2021,"Girondins Bordeaux","FC Metz","3-1",3,1,"F1",1,4,2,"H"
2022-04-10,2021,"Angers SCO","Lille OSC","1-1",1,1,"F1",1,2,0,"D"
2022-04-10,2021,"Stade Brest","FC Nantes","1-1",1,1,"F1",1,2,0,"D"
2022-04-10,2021,"AS Monaco","ESTAC Troyes","2-1",2,1,"F1",1,3,1,"H"
2022-04-10,2021,"RC Lens","OGC Nice","3-0",3,0,"F1",1,3,3,"H"
2022-04-10,2021,"RC Strasbourg","Olympique Lyon","1-1",1,1,"F1",1,2,0,"D"
2022-04-10,2021,"Olympique Marseille","Montpellier HSC","2-0",2,0,"F1",1,2,2,"H"
2022-04-15,2021,"Stade Rennes","AS Monaco","2-3",2,3,"F1",1,5,-1,"A"
2022-04-16,2021,"AS Saint-Etienne","Stade Brest","2-1",2,1,"F1",1,3,1,"H"
2022-04-16,2021,"Lille OSC","RC Lens","1-2",1,2,"F1",1,3,-1,"A"
2022-04-17,2021,"OGC Nice","FC Lorient","2-1",2,1,"F1",1,3,1,"H"
2022-04-17,2021,"FC Metz","Clermont Foot 63","1-1",1,1,"F1",1,2,0,"D"
2022-04-17,2021,"Montpellier HSC","Stade Reims","0-0",0,0,"F1",1,0,0,"D"
2022-04-17,2021,"FC Nantes","Angers SCO","1-1",1,1,"F1",1,2,0,"D"
2022-04-17,2021,"ESTAC Troyes","RC Strasbourg","1-1",1,1,"F1",1,2,0,"D"
2022-04-17,2021,"Olympique Lyon","Girondins Bordeaux","6-1",6,1,"F1",1,7,5,"H"
2022-04-17,2021,"Paris Saint-Germain","Olympique Marseille","2-1",2,1,"F1",1,3,1,"H"
2022-04-20,2021,"Girondins Bordeaux","AS Saint-Etienne","2-2",2,2,"F1",1,4,0,"D"
2022-04-20,2021,"FC Lorient","FC Metz","1-0",1,0,"F1",1,1,1,"H"
2022-04-20,2021,"AS Monaco","OGC Nice","1-0",1,0,"F1",1,1,1,"H"
2022-04-20,2021,"Stade Reims","Lille OSC","2-1",2,1,"F1",1,3,1,"H"
2022-04-20,2021,"ESTAC Troyes","Clermont Foot 63","0-1",0,1,"F1",1,1,-1,"A"
2022-04-20,2021,"Angers SCO","Paris Saint-Germain","0-3",0,3,"F1",1,3,-3,"A"
2022-04-20,2021,"Stade Brest","Olympique Lyon","2-1",2,1,"F1",1,3,1,"H"
2022-04-20,2021,"RC Lens","Montpellier HSC","2-0",2,0,"F1",1,2,2,"H"
2022-04-20,2021,"Olympique Marseille","FC Nantes","3-2",3,2,"F1",1,5,1,"H"
2022-04-20,2021,"RC Strasbourg","Stade Rennes","2-1",2,1,"F1",1,3,1,"H"
2022-04-23,2021,"Olympique Lyon","Montpellier HSC","5-2",5,2,"F1",1,7,3,"H"
2022-04-23,2021,"AS Saint-Etienne","AS Monaco","1-4",1,4,"F1",1,5,-3,"A"
2022-04-23,2021,"Paris Saint-Germain","RC Lens","1-1",1,1,"F1",1,2,0,"D"
2022-04-24,2021,"Stade Rennes","FC Lorient","5-0",5,0,"F1",1,5,5,"H"
2022-04-24,2021,"Clermont Foot 63","Angers SCO","2-2",2,2,"F1",1,4,0,"D"
2022-04-24,2021,"FC Metz","Stade Brest","0-1",0,1,"F1",1,1,-1,"A"
2022-04-24,2021,"FC Nantes","Girondins Bordeaux","5-3",5,3,"F1",1,8,2,"H"
2022-04-24,2021,"OGC Nice","ESTAC Troyes","1-0",1,0,"F1",1,1,1,"H"
2022-04-24,2021,"Lille OSC","RC Strasbourg","1-0",1,0,"F1",1,1,1,"H"
2022-04-24,2021,"Stade Reims","Olympique Marseille","0-1",0,1,"F1",1,1,-1,"A"
2022-04-29,2021,"RC Strasbourg","Paris Saint-Germain","3-3",3,3,"F1",1,6,0,"D"
2022-04-30,2021,"RC Lens","FC Nantes","2-2",2,2,"F1",1,4,0,"D"
2022-04-30,2021,"Stade Rennes","AS Saint-Etienne","2-0",2,0,"F1",1,2,2,"H"
2022-05-01,2021,"ESTAC Troyes","Lille OSC","3-0",3,0,"F1",1,3,3,"H"
2022-05-01,2021,"Stade Brest","Clermont Foot 63","2-0",2,0,"F1",1,2,2,"H"
2022-05-01,2021,"FC Lorient","Stade Reims","1-2",1,2,"F1",1,3,-1,"A"
2022-05-01,2021,"AS Monaco","Angers SCO","2-0",2,0,"F1",1,2,2,"H"
2022-05-01,2021,"Montpellier HSC","FC Metz","2-2",2,2,"F1",1,4,0,"D"
2022-05-01,2021,"Girondins Bordeaux","OGC Nice","0-1",0,1,"F1",1,1,-1,"A"
2022-05-01,2021,"Olympique Marseille","Olympique Lyon","0-3",0,3,"F1",1,3,-3,"A"
2022-05-06,2021,"Lille OSC","AS Monaco","1-2",1,2,"F1",1,3,-1,"A"
2022-05-07,2021,"Stade Brest","RC Strasbourg","0-1",0,1,"F1",1,1,-1,"A"
2022-05-08,2021,"FC Metz","Olympique Lyon","3-2",3,2,"F1",1,5,1,"H"
2022-05-08,2021,"Angers SCO","Girondins Bordeaux","4-1",4,1,"F1",1,5,3,"H"
2022-05-08,2021,"Clermont Foot 63","Montpellier HSC","2-1",2,1,"F1",1,3,1,"H"
2022-05-08,2021,"Stade Reims","RC Lens","1-2",1,2,"F1",1,3,-1,"A"
2022-05-08,2021,"FC Lorient","Olympique Marseille","0-3",0,3,"F1",1,3,-3,"A"
2022-05-08,2021,"Paris Saint-Germain","ESTAC Troyes","2-2",2,2,"F1",1,4,0,"D"
2022-05-11,2021,"OGC Nice","AS Saint-Etienne","4-2",4,2,"F1",1,6,2,"H"
2022-05-11,2021,"FC Nantes","Stade Rennes","2-1",2,1,"F1",1,3,1,"H"
2022-05-14,2021,"Girondins Bordeaux","FC Lorient","0-0",0,0,"F1",1,0,0,"D"
2022-05-14,2021,"Olympique Lyon","FC Nantes","3-2",3,2,"F1",1,5,1,"H"
2022-05-14,2021,"FC Metz","Angers SCO","1-0",1,0,"F1",1,1,1,"H"
2022-05-14,2021,"AS Monaco","Stade Brest","4-2",4,2,"F1",1,6,2,"H"
2022-05-14,2021,"Montpellier HSC","Paris Saint-Germain","0-4",0,4,"F1",1,4,-4,"A"
2022-05-14,2021,"OGC Nice","Lille OSC","1-3",1,3,"F1",1,4,-2,"A"
2022-05-14,2021,"Stade Rennes","Olympique Marseille","2-0",2,0,"F1",1,2,2,"H"
2022-05-14,2021,"AS Saint-Etienne","Stade Reims","1-2",1,2,"F1",1,3,-1,"A"
2022-05-14,2021,"RC Strasbourg","Clermont Foot 63","1-0",1,0,"F1",1,1,1,"H"
2022-05-14,2021,"ESTAC Troyes","RC Lens","1-3",1,3,"F1",1,4,-2,"A"
2022-05-21,2021,"Angers SCO","Montpellier HSC","2-0",2,0,"F1",1,2,2,"H"
2022-05-21,2021,"Stade Brest","Girondins Bordeaux","2-4",2,4,"F1",1,6,-2,"A"
2022-05-21,2021,"Clermont Foot 63","Olympique Lyon","1-2",1,2,"F1",1,3,-1,"A"
2022-05-21,2021,"RC Lens","AS Monaco","2-2",2,2,"F1",1,4,0,"D"
2022-05-21,2021,"Lille OSC","Stade Rennes","2-2",2,2,"F1",1,4,0,"D"
2022-05-21,2021,"FC Lorient","ESTAC Troyes","1-1",1,1,"F1",1,2,0,"D"
2022-05-21,2021,"Olympique Marseille","RC Strasbourg","4-0",4,0,"F1",1,4,4,"H"
2022-05-21,2021,"FC Nantes","AS Saint-Etienne","1-1",1,1,"F1",1,2,0,"D"
2022-05-21,2021,"Paris Saint-Germain","FC Metz","5-0",5,0,"F1",1,5,5,"H"
2022-05-21,2021,"Stade Reims","OGC Nice","2-3",2,3,"F1",1,5,-1,"A"
