"Date","Season","home","visitor","FT","hgoal","vgoal","division","tier","totgoal","goaldif","result"
1994-08-13,1994,"Zeytinburnu","Fenerbahce","1-4",1,4,"T1",1,5,-3,"A"
1994-08-14,1994,"Ad. Demirspor","Antalya","1-0",1,0,"T1",1,1,1,"H"
1994-08-14,1994,"Ankaragucu","Gaziantepspor","1-0",1,0,"T1",1,1,1,"H"
1994-08-14,1994,"Bursaspor","P. Ofisi","5-2",5,2,"T1",1,7,3,"H"
1994-08-14,1994,"Denizlispor","Besiktas","1-3",1,3,"T1",1,4,-2,"A"
1994-08-14,1994,"Galatasaray","Genclerbirligi","3-1",3,1,"T1",1,4,2,"H"
1994-08-14,1994,"Kocaelispor","Samsunspor","0-0",0,0,"T1",1,0,0,"D"
1994-08-14,1994,"Trabzonspor","Altay","3-1",3,1,"T1",1,4,2,"H"
1994-08-14,1994,"Vanspor","Kayseri","3-0",3,0,"T1",1,3,3,"H"
1994-08-20,1994,"Fenerbahce","Ankaragucu","2-1",2,1,"T1",1,3,1,"H"
1994-08-20,1994,"P. Ofisi","Galatasaray","0-3",0,3,"T1",1,3,-3,"A"
1994-08-21,1994,"Altay","Bursaspor","1-1",1,1,"T1",1,2,0,"D"
1994-08-21,1994,"Antalya","Trabzonspor","1-3",1,3,"T1",1,4,-2,"A"
1994-08-21,1994,"Besiktas","Kocaelispor","7-1",7,1,"T1",1,8,6,"H"
1994-08-21,1994,"Gaziantepspor","Denizlispor","3-1",3,1,"T1",1,4,2,"H"
1994-08-21,1994,"Genclerbirligi","Zeytinburnu","1-1",1,1,"T1",1,2,0,"D"
1994-08-21,1994,"Kayseri","Ad. Demirspor","4-2",4,2,"T1",1,6,2,"H"
1994-08-21,1994,"Samsunspor","Vanspor","2-1",2,1,"T1",1,3,1,"H"
1994-08-27,1994,"Denizlispor","Fenerbahce","2-3",2,3,"T1",1,5,-1,"A"
1994-08-28,1994,"Ad. Demirspor","Samsunspor","2-0",2,0,"T1",1,2,2,"H"
1994-08-28,1994,"Bursaspor","Antalya","2-1",2,1,"T1",1,3,1,"H"
1994-08-28,1994,"Galatasaray","Altay","3-1",3,1,"T1",1,4,2,"H"
1994-08-28,1994,"Genclerbirligi","P. Ofisi","1-0",1,0,"T1",1,1,1,"H"
1994-08-28,1994,"Kocaelispor","Gaziantepspor","2-1",2,1,"T1",1,3,1,"H"
1994-08-28,1994,"Trabzonspor","Kayseri","5-2",5,2,"T1",1,7,3,"H"
1994-08-28,1994,"Vanspor","Besiktas","0-2",0,2,"T1",1,2,-2,"A"
1994-08-28,1994,"Zeytinburnu","Ankaragucu","2-0",2,0,"T1",1,2,2,"H"
1994-09-10,1994,"Ankaragucu","Denizlispor","2-1",2,1,"T1",1,3,1,"H"
1994-09-10,1994,"Fenerbahce","Kocaelispor","5-1",5,1,"T1",1,6,4,"H"
1994-09-10,1994,"Samsunspor","Trabzonspor","3-1",3,1,"T1",1,4,2,"H"
1994-09-11,1994,"Altay","Genclerbirligi","1-1",1,1,"T1",1,2,0,"D"
1994-09-11,1994,"Antalya","Galatasaray","0-5",0,5,"T1",1,5,-5,"A"
1994-09-11,1994,"Besiktas","Ad. Demirspor","3-0",3,0,"T1",1,3,3,"H"
1994-09-11,1994,"Gaziantepspor","Vanspor","1-0",1,0,"T1",1,1,1,"H"
1994-09-11,1994,"Kayseri","Bursaspor","2-1",2,1,"T1",1,3,1,"H"
1994-09-11,1994,"P. Ofisi","Zeytinburnu","2-0",2,0,"T1",1,2,2,"H"
1994-09-17,1994,"P. Ofisi","Altay","2-2",2,2,"T1",1,4,0,"D"
1994-09-17,1994,"Vanspor","Fenerbahce","1-0",1,0,"T1",1,1,1,"H"
1994-09-18,1994,"Ad. Demirspor","Gaziantepspor","3-2",3,2,"T1",1,5,1,"H"
1994-09-18,1994,"Bursaspor","Samsunspor","1-1",1,1,"T1",1,2,0,"D"
1994-09-18,1994,"Galatasaray","Kayseri","2-1",2,1,"T1",1,3,1,"H"
1994-09-18,1994,"Genclerbirligi","Antalya","3-1",3,1,"T1",1,4,2,"H"
1994-09-18,1994,"Kocaelispor","Ankaragucu","2-0",2,0,"T1",1,2,2,"H"
1994-09-18,1994,"Trabzonspor","Besiktas","0-2",0,2,"T1",1,2,-2,"A"
1994-09-18,1994,"Zeytinburnu","Denizlispor","1-0",1,0,"T1",1,1,1,"H"
1994-09-24,1994,"Fenerbahce","Ad. Demirspor","3-0",3,0,"T1",1,3,3,"H"
1994-09-24,1994,"Gaziantepspor","Trabzonspor","0-2",0,2,"T1",1,2,-2,"A"
1994-09-24,1994,"Samsunspor","Galatasaray","2-2",2,2,"T1",1,4,0,"D"
1994-09-25,1994,"Altay","Zeytinburnu","2-0",2,0,"T1",1,2,2,"H"
1994-09-25,1994,"Ankaragucu","Vanspor","1-0",1,0,"T1",1,1,1,"H"
1994-09-25,1994,"Antalya","P. Ofisi","0-1",0,1,"T1",1,1,-1,"A"
1994-09-25,1994,"Besiktas","Bursaspor","1-2",1,2,"T1",1,3,-1,"A"
1994-09-25,1994,"Denizlispor","Kocaelispor","4-3",4,3,"T1",1,7,1,"H"
1994-09-25,1994,"Kayseri","Genclerbirligi","3-4",3,4,"T1",1,7,-1,"A"
1994-10-01,1994,"Genclerbirligi","Samsunspor","5-1",5,1,"T1",1,6,4,"H"
1994-10-02,1994,"Ad. Demirspor","Ankaragucu","2-3",2,3,"T1",1,5,-1,"A"
1994-10-02,1994,"Altay","Antalya","1-1",1,1,"T1",1,2,0,"D"
1994-10-02,1994,"Bursaspor","Gaziantepspor","3-0",3,0,"T1",1,3,3,"H"
1994-10-02,1994,"Galatasaray","Besiktas","3-1",3,1,"T1",1,4,2,"H"
1994-10-02,1994,"P. Ofisi","Kayseri","0-1",0,1,"T1",1,1,-1,"A"
1994-10-02,1994,"Trabzonspor","Fenerbahce","1-0",1,0,"T1",1,1,1,"H"
1994-10-02,1994,"Vanspor","Denizlispor","2-1",2,1,"T1",1,3,1,"H"
1994-10-02,1994,"Zeytinburnu","Kocaelispor","3-2",3,2,"T1",1,5,1,"H"
1994-10-08,1994,"Ankaragucu","Trabzonspor","1-1",1,1,"T1",1,2,0,"D"
1994-10-08,1994,"Besiktas","Genclerbirligi","2-0",2,0,"T1",1,2,2,"H"
1994-10-08,1994,"Fenerbahce","Bursaspor","1-1",1,1,"T1",1,2,0,"D"
1994-10-08,1994,"Gaziantepspor","Galatasaray","2-2",2,2,"T1",1,4,0,"D"
1994-10-09,1994,"Antalya","Zeytinburnu","4-0",4,0,"T1",1,4,4,"H"
1994-10-09,1994,"Denizlispor","Ad. Demirspor","2-0",2,0,"T1",1,2,2,"H"
1994-10-09,1994,"Kayseri","Altay","1-1",1,1,"T1",1,2,0,"D"
1994-10-09,1994,"Kocaelispor","Vanspor","2-0",2,0,"T1",1,2,2,"H"
1994-10-09,1994,"Samsunspor","P. Ofisi","8-2",8,2,"T1",1,10,6,"H"
1994-10-15,1994,"Galatasaray","Fenerbahce","1-1",1,1,"T1",1,2,0,"D"
1994-10-15,1994,"Genclerbirligi","Gaziantepspor","3-2",3,2,"T1",1,5,1,"H"
1994-10-15,1994,"Trabzonspor","Denizlispor","3-1",3,1,"T1",1,4,2,"H"
1994-10-16,1994,"Ad. Demirspor","Kocaelispor","1-1",1,1,"T1",1,2,0,"D"
1994-10-16,1994,"Altay","Samsunspor","3-2",3,2,"T1",1,5,1,"H"
1994-10-16,1994,"Antalya","Kayseri","2-0",2,0,"T1",1,2,2,"H"
1994-10-16,1994,"Bursaspor","Ankaragucu","1-0",1,0,"T1",1,1,1,"H"
1994-10-16,1994,"P. Ofisi","Besiktas","0-2",0,2,"T1",1,2,-2,"A"
1994-10-16,1994,"Zeytinburnu","Vanspor","0-2",0,2,"T1",1,2,-2,"A"
1994-10-22,1994,"Fenerbahce","Genclerbirligi","2-3",2,3,"T1",1,5,-1,"A"
1994-10-22,1994,"Kocaelispor","Trabzonspor","2-2",2,2,"T1",1,4,0,"D"
1994-10-23,1994,"Ankaragucu","Galatasaray","2-1",2,1,"T1",1,3,1,"H"
1994-10-23,1994,"Besiktas","Altay","1-0",1,0,"T1",1,1,1,"H"
1994-10-23,1994,"Denizlispor","Bursaspor","3-1",3,1,"T1",1,4,2,"H"
1994-10-23,1994,"Gaziantepspor","P. Ofisi","1-0",1,0,"T1",1,1,1,"H"
1994-10-23,1994,"Kayseri","Zeytinburnu","2-1",2,1,"T1",1,3,1,"H"
1994-10-23,1994,"Samsunspor","Antalya","1-0",1,0,"T1",1,1,1,"H"
1994-10-23,1994,"Vanspor","Ad. Demirspor","2-0",2,0,"T1",1,2,2,"H"
1994-10-29,1994,"Galatasaray","Denizlispor","4-0",4,0,"T1",1,4,4,"H"
1994-10-29,1994,"P. Ofisi","Fenerbahce","0-4",0,4,"T1",1,4,-4,"A"
1994-10-29,1994,"Trabzonspor","Vanspor","0-0",0,0,"T1",1,0,0,"D"
1994-10-30,1994,"Altay","Gaziantepspor","5-2",5,2,"T1",1,7,3,"H"
1994-10-30,1994,"Antalya","Besiktas","1-1",1,1,"T1",1,2,0,"D"
1994-10-30,1994,"Bursaspor","Kocaelispor","1-0",1,0,"T1",1,1,1,"H"
1994-10-30,1994,"Genclerbirligi","Ankaragucu","1-0",1,0,"T1",1,1,1,"H"
1994-10-30,1994,"Kayseri","Samsunspor","2-2",2,2,"T1",1,4,0,"D"
1994-10-30,1994,"Zeytinburnu","Ad. Demirspor","4-2",4,2,"T1",1,6,2,"H"
1994-11-05,1994,"Ad. Demirspor","Trabzonspor","0-3",0,3,"T1",1,3,-3,"A"
1994-11-05,1994,"Fenerbahce","Altay","2-1",2,1,"T1",1,3,1,"H"
1994-11-06,1994,"Ankaragucu","P. Ofisi","1-2",1,2,"T1",1,3,-1,"A"
1994-11-06,1994,"Besiktas","Kayseri","4-1",4,1,"T1",1,5,3,"H"
1994-11-06,1994,"Denizlispor","Genclerbirligi","0-0",0,0,"T1",1,0,0,"D"
1994-11-06,1994,"Gaziantepspor","Antalya","2-0",2,0,"T1",1,2,2,"H"
1994-11-06,1994,"Kocaelispor","Galatasaray","0-2",0,2,"T1",1,2,-2,"A"
1994-11-06,1994,"Samsunspor","Zeytinburnu","1-1",1,1,"T1",1,2,0,"D"
1994-11-06,1994,"Vanspor","Bursaspor","2-0",2,0,"T1",1,2,2,"H"
1994-11-12,1994,"Genclerbirligi","Kocaelispor","1-1",1,1,"T1",1,2,0,"D"
1994-11-13,1994,"Altay","Ankaragucu","1-1",1,1,"T1",1,2,0,"D"
1994-11-13,1994,"Antalya","Fenerbahce","2-1",2,1,"T1",1,3,1,"H"
1994-11-13,1994,"Bursaspor","Ad. Demirspor","2-0",2,0,"T1",1,2,2,"H"
1994-11-13,1994,"Galatasaray","Vanspor","4-1",4,1,"T1",1,5,3,"H"
1994-11-13,1994,"Kayseri","Gaziantepspor","1-1",1,1,"T1",1,2,0,"D"
1994-11-13,1994,"P. Ofisi","Denizlispor","1-3",1,3,"T1",1,4,-2,"A"
1994-11-13,1994,"Samsunspor","Besiktas","2-3",2,3,"T1",1,5,-1,"A"
1994-11-13,1994,"Zeytinburnu","Trabzonspor","1-6",1,6,"T1",1,7,-5,"A"
1994-11-19,1994,"Ad. Demirspor","Galatasaray","1-2",1,2,"T1",1,3,-1,"A"
1994-11-19,1994,"Trabzonspor","Bursaspor","1-0",1,0,"T1",1,1,1,"H"
1994-11-20,1994,"Ankaragucu","Antalya","2-2",2,2,"T1",1,4,0,"D"
1994-11-20,1994,"Besiktas","Zeytinburnu","3-1",3,1,"T1",1,4,2,"H"
1994-11-20,1994,"Denizlispor","Altay","1-1",1,1,"T1",1,2,0,"D"
1994-11-20,1994,"Fenerbahce","Kayseri","8-1",8,1,"T1",1,9,7,"H"
1994-11-20,1994,"Gaziantepspor","Samsunspor","1-2",1,2,"T1",1,3,-1,"A"
1994-11-20,1994,"Kocaelispor","P. Ofisi","4-0",4,0,"T1",1,4,4,"H"
1994-11-20,1994,"Vanspor","Genclerbirligi","2-1",2,1,"T1",1,3,1,"H"
1994-11-26,1994,"P. Ofisi","Vanspor","1-0",1,0,"T1",1,1,1,"H"
1994-11-27,1994,"Altay","Kocaelispor","0-2",0,2,"T1",1,2,-2,"A"
1994-11-27,1994,"Antalya","Denizlispor","1-1",1,1,"T1",1,2,0,"D"
1994-11-27,1994,"Bursaspor","Zeytinburnu","3-0",3,0,"T1",1,3,3,"H"
1994-11-27,1994,"Galatasaray","Trabzonspor","2-1",2,1,"T1",1,3,1,"H"
1994-11-27,1994,"Gaziantepspor","Besiktas","0-0",0,0,"T1",1,0,0,"D"
1994-11-27,1994,"Genclerbirligi","Ad. Demirspor","0-0",0,0,"T1",1,0,0,"D"
1994-11-27,1994,"Kayseri","Ankaragucu","4-2",4,2,"T1",1,6,2,"H"
1994-11-27,1994,"Samsunspor","Fenerbahce","1-2",1,2,"T1",1,3,-1,"A"
1994-12-03,1994,"Bursaspor","Galatasaray","2-1",2,1,"T1",1,3,1,"H"
1994-12-04,1994,"Ad. Demirspor","P. Ofisi","1-1",1,1,"T1",1,2,0,"D"
1994-12-04,1994,"Ankaragucu","Samsunspor","1-0",1,0,"T1",1,1,1,"H"
1994-12-04,1994,"Denizlispor","Kayseri","3-0",3,0,"T1",1,3,3,"H"
1994-12-04,1994,"Fenerbahce","Besiktas","1-1",1,1,"T1",1,2,0,"D"
1994-12-04,1994,"Kocaelispor","Antalya","2-1",2,1,"T1",1,3,1,"H"
1994-12-04,1994,"Trabzonspor","Genclerbirligi","4-0",4,0,"T1",1,4,4,"H"
1994-12-04,1994,"Zeytinburnu","Gaziantepspor","1-1",1,1,"T1",1,2,0,"D"
1994-12-17,1994,"Genclerbirligi","Bursaspor","1-0",1,0,"T1",1,1,1,"H"
1994-12-18,1994,"Altay","Ad. Demirspor","3-2",3,2,"T1",1,5,1,"H"
1994-12-18,1994,"Antalya","Vanspor","1-0",1,0,"T1",1,1,1,"H"
1994-12-18,1994,"Besiktas","Ankaragucu","5-1",5,1,"T1",1,6,4,"H"
1994-12-18,1994,"Galatasaray","Zeytinburnu","4-0",4,0,"T1",1,4,4,"H"
1994-12-18,1994,"Gaziantepspor","Fenerbahce","1-1",1,1,"T1",1,2,0,"D"
1994-12-18,1994,"Kayseri","Kocaelispor","4-2",4,2,"T1",1,6,2,"H"
1994-12-18,1994,"P. Ofisi","Trabzonspor","2-5",2,5,"T1",1,7,-3,"A"
1994-12-18,1994,"Samsunspor","Denizlispor","1-1",1,1,"T1",1,2,0,"D"
1995-01-23,1994,"Altay","Trabzonspor","0-1",0,1,"T1",1,1,-1,"A"
1995-01-23,1994,"Antalya","Ad. Demirspor","2-1",2,1,"T1",1,3,1,"H"
1995-01-23,1994,"Besiktas","Denizlispor","2-0",2,0,"T1",1,2,2,"H"
1995-01-23,1994,"Fenerbahce","Zeytinburnu","3-0",3,0,"T1",1,3,3,"H"
1995-01-23,1994,"Gaziantepspor","Ankaragucu","3-2",3,2,"T1",1,5,1,"H"
1995-01-23,1994,"Genclerbirligi","Galatasaray","3-1",3,1,"T1",1,4,2,"H"
1995-01-23,1994,"Kayseri","Vanspor","4-1",4,1,"T1",1,5,3,"H"
1995-01-23,1994,"P. Ofisi","Bursaspor","1-0",1,0,"T1",1,1,1,"H"
1995-01-23,1994,"Samsunspor","Kocaelispor","1-0",1,0,"T1",1,1,1,"H"
1995-01-26,1994,"Vanspor","Altay","1-1",1,1,"T1",1,2,0,"D"
1995-01-29,1994,"Ad. Demirspor","Kayseri","0-2",0,2,"T1",1,2,-2,"A"
1995-01-29,1994,"Ankaragucu","Fenerbahce","2-3",2,3,"T1",1,5,-1,"A"
1995-01-29,1994,"Bursaspor","Altay","1-1",1,1,"T1",1,2,0,"D"
1995-01-29,1994,"Denizlispor","Gaziantepspor","2-1",2,1,"T1",1,3,1,"H"
1995-01-29,1994,"Galatasaray","P. Ofisi","2-0",2,0,"T1",1,2,2,"H"
1995-01-29,1994,"Kocaelispor","Besiktas","1-1",1,1,"T1",1,2,0,"D"
1995-01-29,1994,"Trabzonspor","Antalya","0-0",0,0,"T1",1,0,0,"D"
1995-01-29,1994,"Vanspor","Samsunspor","5-1",5,1,"T1",1,6,4,"H"
1995-01-29,1994,"Zeytinburnu","Genclerbirligi","0-0",0,0,"T1",1,0,0,"D"
1995-02-05,1994,"Altay","Galatasaray","0-3",0,3,"T1",1,3,-3,"A"
1995-02-05,1994,"Ankaragucu","Zeytinburnu","2-2",2,2,"T1",1,4,0,"D"
1995-02-05,1994,"Antalya","Bursaspor","0-1",0,1,"T1",1,1,-1,"A"
1995-02-05,1994,"Besiktas","Vanspor","3-0",3,0,"T1",1,3,3,"H"
1995-02-05,1994,"Fenerbahce","Denizlispor","3-0",3,0,"T1",1,3,3,"H"
1995-02-05,1994,"Gaziantepspor","Kocaelispor","2-0",2,0,"T1",1,2,2,"H"
1995-02-05,1994,"Kayseri","Trabzonspor","0-0",0,0,"T1",1,0,0,"D"
1995-02-05,1994,"P. Ofisi","Genclerbirligi","1-2",1,2,"T1",1,3,-1,"A"
1995-02-05,1994,"Samsunspor","Ad. Demirspor","5-1",5,1,"T1",1,6,4,"H"
1995-02-12,1994,"Ad. Demirspor","Besiktas","0-1",0,1,"T1",1,1,-1,"A"
1995-02-12,1994,"Bursaspor","Kayseri","1-1",1,1,"T1",1,2,0,"D"
1995-02-12,1994,"Denizlispor","Ankaragucu","0-0",0,0,"T1",1,0,0,"D"
1995-02-12,1994,"Genclerbirligi","Altay","2-0",2,0,"T1",1,2,2,"H"
1995-02-12,1994,"Trabzonspor","Samsunspor","5-0",5,0,"T1",1,5,5,"H"
1995-02-12,1994,"Vanspor","Gaziantepspor","2-0",2,0,"T1",1,2,2,"H"
1995-02-12,1994,"Zeytinburnu","P. Ofisi","2-1",2,1,"T1",1,3,1,"H"
1995-02-19,1994,"Altay","P. Ofisi","1-0",1,0,"T1",1,1,1,"H"
1995-02-19,1994,"Ankaragucu","Kocaelispor","2-1",2,1,"T1",1,3,1,"H"
1995-02-19,1994,"Antalya","Genclerbirligi","0-0",0,0,"T1",1,0,0,"D"
1995-02-19,1994,"Besiktas","Trabzonspor","4-0",4,0,"T1",1,4,4,"H"
1995-02-19,1994,"Denizlispor","Zeytinburnu","1-0",1,0,"T1",1,1,1,"H"
1995-02-19,1994,"Fenerbahce","Vanspor","2-1",2,1,"T1",1,3,1,"H"
1995-02-19,1994,"Gaziantepspor","Ad. Demirspor","2-0",2,0,"T1",1,2,2,"H"
1995-02-19,1994,"Kayseri","Galatasaray","0-2",0,2,"T1",1,2,-2,"A"
1995-02-19,1994,"Samsunspor","Bursaspor","1-1",1,1,"T1",1,2,0,"D"
1995-02-26,1994,"Ad. Demirspor","Fenerbahce","0-1",0,1,"T1",1,1,-1,"A"
1995-02-26,1994,"Bursaspor","Besiktas","2-2",2,2,"T1",1,4,0,"D"
1995-02-26,1994,"Galatasaray","Samsunspor","0-1",0,1,"T1",1,1,-1,"A"
1995-02-26,1994,"Genclerbirligi","Kayseri","3-1",3,1,"T1",1,4,2,"H"
1995-02-26,1994,"Kocaelispor","Denizlispor","4-1",4,1,"T1",1,5,3,"H"
1995-02-26,1994,"P. Ofisi","Antalya","2-0",2,0,"T1",1,2,2,"H"
1995-02-26,1994,"Trabzonspor","Gaziantepspor","3-0",3,0,"T1",1,3,3,"H"
1995-02-26,1994,"Vanspor","Ankaragucu","1-1",1,1,"T1",1,2,0,"D"
1995-02-26,1994,"Zeytinburnu","Altay","0-0",0,0,"T1",1,0,0,"D"
1995-03-04,1994,"Fenerbahce","Trabzonspor","1-1",1,1,"T1",1,2,0,"D"
1995-03-05,1994,"Ankaragucu","Ad. Demirspor","3-0",3,0,"T1",1,3,3,"H"
1995-03-05,1994,"Antalya","Altay","0-1",0,1,"T1",1,1,-1,"A"
1995-03-05,1994,"Besiktas","Galatasaray","2-3",2,3,"T1",1,5,-1,"A"
1995-03-05,1994,"Denizlispor","Vanspor","4-0",4,0,"T1",1,4,4,"H"
1995-03-05,1994,"Gaziantepspor","Bursaspor","4-2",4,2,"T1",1,6,2,"H"
1995-03-05,1994,"Kayseri","P. Ofisi","3-1",3,1,"T1",1,4,2,"H"
1995-03-05,1994,"Kocaelispor","Zeytinburnu","4-1",4,1,"T1",1,5,3,"H"
1995-03-05,1994,"Samsunspor","Genclerbirligi","1-3",1,3,"T1",1,4,-2,"A"
1995-03-11,1994,"Genclerbirligi","Besiktas","1-3",1,3,"T1",1,4,-2,"A"
1995-03-12,1994,"Ad. Demirspor","Denizlispor","1-1",1,1,"T1",1,2,0,"D"
1995-03-12,1994,"Altay","Kayseri","2-1",2,1,"T1",1,3,1,"H"
1995-03-12,1994,"Bursaspor","Fenerbahce","1-1",1,1,"T1",1,2,0,"D"
1995-03-12,1994,"Galatasaray","Gaziantepspor","1-2",1,2,"T1",1,3,-1,"A"
1995-03-12,1994,"P. Ofisi","Samsunspor","2-2",2,2,"T1",1,4,0,"D"
1995-03-12,1994,"Trabzonspor","Ankaragucu","4-0",4,0,"T1",1,4,4,"H"
1995-03-12,1994,"Vanspor","Kocaelispor","0-0",0,0,"T1",1,0,0,"D"
1995-03-12,1994,"Zeytinburnu","Antalya","2-2",2,2,"T1",1,4,0,"D"
1995-03-15,1994,"Galatasaray","Antalya","0-3",0,3,"T1",1,3,-3,"A"
1995-03-15,1994,"Kocaelispor","Fenerbahce","3-2",3,2,"T1",1,5,1,"H"
1995-03-19,1994,"Ankaragucu","Bursaspor","0-0",0,0,"T1",1,0,0,"D"
1995-03-19,1994,"Besiktas","P. Ofisi","3-1",3,1,"T1",1,4,2,"H"
1995-03-19,1994,"Denizlispor","Trabzonspor","0-1",0,1,"T1",1,1,-1,"A"
1995-03-19,1994,"Fenerbahce","Galatasaray","3-0",3,0,"T1",1,3,3,"H"
1995-03-19,1994,"Gaziantepspor","Genclerbirligi","3-0",3,0,"T1",1,3,3,"H"
1995-03-19,1994,"Kayseri","Antalya","4-2",4,2,"T1",1,6,2,"H"
1995-03-19,1994,"Kocaelispor","Ad. Demirspor","1-1",1,1,"T1",1,2,0,"D"
1995-03-19,1994,"Samsunspor","Altay","0-1",0,1,"T1",1,1,-1,"A"
1995-03-19,1994,"Vanspor","Zeytinburnu","1-1",1,1,"T1",1,2,0,"D"
1995-03-24,1994,"Altay","Besiktas","2-8",2,8,"T1",1,10,-6,"A"
1995-03-25,1994,"Galatasaray","Ankaragucu","2-1",2,1,"T1",1,3,1,"H"
1995-03-25,1994,"Genclerbirligi","Fenerbahce","2-1",2,1,"T1",1,3,1,"H"
1995-03-25,1994,"Trabzonspor","Kocaelispor","4-0",4,0,"T1",1,4,4,"H"
1995-03-26,1994,"Ad. Demirspor","Vanspor","0-0",0,0,"T1",1,0,0,"D"
1995-03-26,1994,"Antalya","Samsunspor","2-0",2,0,"T1",1,2,2,"H"
1995-03-26,1994,"Bursaspor","Denizlispor","3-2",3,2,"T1",1,5,1,"H"
1995-03-26,1994,"P. Ofisi","Gaziantepspor","2-2",2,2,"T1",1,4,0,"D"
1995-03-26,1994,"Zeytinburnu","Kayseri","1-0",1,0,"T1",1,1,1,"H"
1995-04-02,1994,"Ad. Demirspor","Zeytinburnu","1-2",1,2,"T1",1,3,-1,"A"
1995-04-02,1994,"Ankaragucu","Genclerbirligi","1-2",1,2,"T1",1,3,-1,"A"
1995-04-02,1994,"Besiktas","Antalya","2-1",2,1,"T1",1,3,1,"H"
1995-04-02,1994,"Denizlispor","Galatasaray","0-0",0,0,"T1",1,0,0,"D"
1995-04-02,1994,"Fenerbahce","P. Ofisi","6-2",6,2,"T1",1,8,4,"H"
1995-04-02,1994,"Gaziantepspor","Altay","2-0",2,0,"T1",1,2,2,"H"
1995-04-02,1994,"Kocaelispor","Bursaspor","1-1",1,1,"T1",1,2,0,"D"
1995-04-02,1994,"Samsunspor","Kayseri","2-2",2,2,"T1",1,4,0,"D"
1995-04-02,1994,"Vanspor","Trabzonspor","0-2",0,2,"T1",1,2,-2,"A"
1995-04-07,1994,"Altay","Fenerbahce","2-1",2,1,"T1",1,3,1,"H"
1995-04-07,1994,"P. Ofisi","Ankaragucu","1-2",1,2,"T1",1,3,-1,"A"
1995-04-08,1994,"Antalya","Gaziantepspor","2-3",2,3,"T1",1,5,-1,"A"
1995-04-08,1994,"Bursaspor","Vanspor","1-2",1,2,"T1",1,3,-1,"A"
1995-04-08,1994,"Galatasaray","Kocaelispor","4-1",4,1,"T1",1,5,3,"H"
1995-04-08,1994,"Genclerbirligi","Denizlispor","2-2",2,2,"T1",1,4,0,"D"
1995-04-08,1994,"Kayseri","Besiktas","1-2",1,2,"T1",1,3,-1,"A"
1995-04-08,1994,"Trabzonspor","Ad. Demirspor","7-0",7,0,"T1",1,7,7,"H"
1995-04-08,1994,"Zeytinburnu","Samsunspor","1-2",1,2,"T1",1,3,-1,"A"
1995-04-16,1994,"Ad. Demirspor","Bursaspor","2-3",2,3,"T1",1,5,-1,"A"
1995-04-16,1994,"Ankaragucu","Altay","1-0",1,0,"T1",1,1,1,"H"
1995-04-16,1994,"Besiktas","Samsunspor","1-0",1,0,"T1",1,1,1,"H"
1995-04-16,1994,"Denizlispor","P. Ofisi","1-1",1,1,"T1",1,2,0,"D"
1995-04-16,1994,"Fenerbahce","Antalya","3-0",3,0,"T1",1,3,3,"H"
1995-04-16,1994,"Gaziantepspor","Kayseri","2-0",2,0,"T1",1,2,2,"H"
1995-04-16,1994,"Kocaelispor","Genclerbirligi","3-2",3,2,"T1",1,5,1,"H"
1995-04-16,1994,"Trabzonspor","Zeytinburnu","3-0",3,0,"T1",1,3,3,"H"
1995-04-16,1994,"Vanspor","Galatasaray","1-2",1,2,"T1",1,3,-1,"A"
1995-04-30,1994,"Altay","Denizlispor","1-1",1,1,"T1",1,2,0,"D"
1995-04-30,1994,"Antalya","Ankaragucu","2-0",2,0,"T1",1,2,2,"H"
1995-04-30,1994,"Bursaspor","Trabzonspor","0-1",0,1,"T1",1,1,-1,"A"
1995-04-30,1994,"Galatasaray","Ad. Demirspor","3-0",3,0,"T1",1,3,3,"H"
1995-04-30,1994,"Genclerbirligi","Vanspor","3-1",3,1,"T1",1,4,2,"H"
1995-04-30,1994,"Kayseri","Fenerbahce","1-2",1,2,"T1",1,3,-1,"A"
1995-04-30,1994,"P. Ofisi","Kocaelispor","1-0",1,0,"T1",1,1,1,"H"
1995-04-30,1994,"Samsunspor","Gaziantepspor","2-1",2,1,"T1",1,3,1,"H"
1995-04-30,1994,"Zeytinburnu","Besiktas","0-3",0,3,"T1",1,3,-3,"A"
1995-05-06,1994,"Trabzonspor","Galatasaray","2-2",2,2,"T1",1,4,0,"D"
1995-05-07,1994,"Ad. Demirspor","Genclerbirligi","0-7",0,7,"T1",1,7,-7,"A"
1995-05-07,1994,"Ankaragucu","Kayseri","1-5",1,5,"T1",1,6,-4,"A"
1995-05-07,1994,"Besiktas","Gaziantepspor","2-0",2,0,"T1",1,2,2,"H"
1995-05-07,1994,"Denizlispor","Antalya","0-0",0,0,"T1",1,0,0,"D"
1995-05-07,1994,"Fenerbahce","Samsunspor","4-1",4,1,"T1",1,5,3,"H"
1995-05-07,1994,"Kocaelispor","Altay","7-1",7,1,"T1",1,8,6,"H"
1995-05-07,1994,"Vanspor","P. Ofisi","3-2",3,2,"T1",1,5,1,"H"
1995-05-07,1994,"Zeytinburnu","Bursaspor","2-2",2,2,"T1",1,4,0,"D"
1995-05-13,1994,"Galatasaray","Bursaspor","0-0",0,0,"T1",1,0,0,"D"
1995-05-13,1994,"P. Ofisi","Ad. Demirspor","2-0",2,0,"T1",1,2,2,"H"
1995-05-13,1994,"Samsunspor","Ankaragucu","4-2",4,2,"T1",1,6,2,"H"
1995-05-14,1994,"Altay","Vanspor","3-2",3,2,"T1",1,5,1,"H"
1995-05-14,1994,"Antalya","Kocaelispor","1-0",1,0,"T1",1,1,1,"H"
1995-05-14,1994,"Besiktas","Fenerbahce","0-0",0,0,"T1",1,0,0,"D"
1995-05-14,1994,"Gaziantepspor","Zeytinburnu","3-1",3,1,"T1",1,4,2,"H"
1995-05-14,1994,"Genclerbirligi","Trabzonspor","1-2",1,2,"T1",1,3,-1,"A"
1995-05-14,1994,"Kayseri","Denizlispor","5-1",5,1,"T1",1,6,4,"H"
1995-05-21,1994,"Ad. Demirspor","Altay","1-4",1,4,"T1",1,5,-3,"A"
1995-05-21,1994,"Ankaragucu","Besiktas","0-0",0,0,"T1",1,0,0,"D"
1995-05-21,1994,"Bursaspor","Genclerbirligi","2-1",2,1,"T1",1,3,1,"H"
1995-05-21,1994,"Denizlispor","Samsunspor","1-2",1,2,"T1",1,3,-1,"A"
1995-05-21,1994,"Fenerbahce","Gaziantepspor","2-0",2,0,"T1",1,2,2,"H"
1995-05-21,1994,"Kocaelispor","Kayseri","4-3",4,3,"T1",1,7,1,"H"
1995-05-21,1994,"Trabzonspor","P. Ofisi","3-2",3,2,"T1",1,5,1,"H"
1995-05-21,1994,"Vanspor","Antalya","1-4",1,4,"T1",1,5,-3,"A"
1995-05-21,1994,"Zeytinburnu","Galatasaray","3-7",3,7,"T1",1,10,-4,"A"
1995-08-11,1995,"Istanbulspor","Eskisehirspor","1-3",1,3,"T1",1,4,-2,"A"
1995-08-12,1995,"Fenerbahce","Karsiyaka","4-0",4,0,"T1",1,4,4,"H"
1995-08-12,1995,"Genclerbirligi","Kocaelispor","1-1",1,1,"T1",1,2,0,"D"
1995-08-13,1995,"Altay","Denizlispor","1-2",1,2,"T1",1,3,-1,"A"
1995-08-13,1995,"Antalyaspor","Bursaspor","4-2",4,2,"T1",1,6,2,"H"
1995-08-13,1995,"Kayseri","Besiktas","1-1",1,1,"T1",1,2,0,"D"
1995-08-13,1995,"Samsunspor","Gaziantepspor","1-0",1,0,"T1",1,1,1,"H"
1995-08-13,1995,"Trabzonspor","Ankaragucu","3-1",3,1,"T1",1,4,2,"H"
1995-08-13,1995,"Vanspor","Galatasaray","0-1",0,1,"T1",1,1,-1,"A"
1995-08-18,1995,"Ankaragucu","Istanbulspor","3-1",3,1,"T1",1,4,2,"H"
1995-08-19,1995,"Eskisehirspor","Fenerbahce","1-2",1,2,"T1",1,3,-1,"A"
1995-08-19,1995,"Galatasaray","Altay","3-1",3,1,"T1",1,4,2,"H"
1995-08-20,1995,"Besiktas","Genclerbirligi","2-2",2,2,"T1",1,4,0,"D"
1995-08-20,1995,"Bursaspor","Samsunspor","2-4",2,4,"T1",1,6,-2,"A"
1995-08-20,1995,"Gaziantepspor","Trabzonspor","0-0",0,0,"T1",1,0,0,"D"
1995-08-20,1995,"Karsiyaka","Vanspor","2-1",2,1,"T1",1,3,1,"H"
1995-08-20,1995,"Kayseri","Denizlispor","0-0",0,0,"T1",1,0,0,"D"
1995-08-20,1995,"Kocaelispor","Antalyaspor","2-2",2,2,"T1",1,4,0,"D"
1995-08-25,1995,"Samsunspor","Kocaelispor","0-0",0,0,"T1",1,0,0,"D"
1995-08-26,1995,"Istanbulspor","Gaziantepspor","2-0",2,0,"T1",1,2,2,"H"
1995-08-26,1995,"Trabzonspor","Bursaspor","0-0",0,0,"T1",1,0,0,"D"
1995-08-27,1995,"Antalyaspor","Besiktas","0-3",0,3,"T1",1,3,-3,"A"
1995-08-27,1995,"Fenerbahce","Ankaragucu","2-0",2,0,"T1",1,2,2,"H"
1995-08-27,1995,"Genclerbirligi","Denizlispor","1-1",1,1,"T1",1,2,0,"D"
1995-08-27,1995,"Karsiyaka","Eskisehirspor","3-2",3,2,"T1",1,5,1,"H"
1995-08-27,1995,"Kayseri","Galatasaray","1-2",1,2,"T1",1,3,-1,"A"
1995-08-27,1995,"Vanspor","Altay","2-0",2,0,"T1",1,2,2,"H"
1995-09-08,1995,"Ankaragucu","Karsiyaka","1-0",1,0,"T1",1,1,1,"H"
1995-09-09,1995,"Bursaspor","Istanbulspor","2-1",2,1,"T1",1,3,1,"H"
1995-09-09,1995,"Galatasaray","Genclerbirligi","0-1",0,1,"T1",1,1,-1,"A"
1995-09-09,1995,"Gaziantepspor","Fenerbahce","2-2",2,2,"T1",1,4,0,"D"
1995-09-10,1995,"Altay","Kayseri","2-0",2,0,"T1",1,2,2,"H"
1995-09-10,1995,"Antalyaspor","Denizlispor","1-0",1,0,"T1",1,1,1,"H"
1995-09-10,1995,"Besiktas","Samsunspor","4-2",4,2,"T1",1,6,2,"H"
1995-09-10,1995,"Eskisehirspor","Vanspor","2-1",2,1,"T1",1,3,1,"H"
1995-09-10,1995,"Kocaelispor","Trabzonspor","1-3",1,3,"T1",1,4,-2,"A"
1995-09-15,1995,"Istanbulspor","Kocaelispor","1-2",1,2,"T1",1,3,-1,"A"
1995-09-16,1995,"Fenerbahce","Bursaspor","1-1",1,1,"T1",1,2,0,"D"
1995-09-16,1995,"Samsunspor","Denizlispor","1-3",1,3,"T1",1,4,-2,"A"
1995-09-17,1995,"Antalyaspor","Galatasaray","0-2",0,2,"T1",1,2,-2,"A"
1995-09-17,1995,"Eskisehirspor","Ankaragucu","2-1",2,1,"T1",1,3,1,"H"
1995-09-17,1995,"Genclerbirligi","Altay","1-2",1,2,"T1",1,3,-1,"A"
1995-09-17,1995,"Karsiyaka","Gaziantepspor","2-1",2,1,"T1",1,3,1,"H"
1995-09-17,1995,"Trabzonspor","Besiktas","3-1",3,1,"T1",1,4,2,"H"
1995-09-17,1995,"Vanspor","Kayseri","1-0",1,0,"T1",1,1,1,"H"
1995-09-22,1995,"Galatasaray","Samsunspor","1-0",1,0,"T1",1,1,1,"H"
1995-09-23,1995,"Denizlispor","Trabzonspor","0-3",0,3,"T1",1,3,-3,"A"
1995-09-23,1995,"Kocaelispor","Fenerbahce","0-1",0,1,"T1",1,1,-1,"A"
1995-09-24,1995,"Altay","Antalyaspor","1-2",1,2,"T1",1,3,-1,"A"
1995-09-24,1995,"Ankaragucu","Vanspor","0-0",0,0,"T1",1,0,0,"D"
1995-09-24,1995,"Besiktas","Istanbulspor","5-2",5,2,"T1",1,7,3,"H"
1995-09-24,1995,"Bursaspor","Karsiyaka","3-1",3,1,"T1",1,4,2,"H"
1995-09-24,1995,"Gaziantepspor","Eskisehirspor","3-0",3,0,"T1",1,3,3,"H"
1995-09-24,1995,"Kayseri","Genclerbirligi","2-2",2,2,"T1",1,4,0,"D"
1995-09-29,1995,"Ankaragucu","Gaziantepspor","0-0",0,0,"T1",1,0,0,"D"
1995-09-30,1995,"Fenerbahce","Besiktas","2-0",2,0,"T1",1,2,2,"H"
1995-10-01,1995,"Antalyaspor","Kayseri","3-3",3,3,"T1",1,6,0,"D"
1995-10-01,1995,"Eskisehirspor","Bursaspor","1-3",1,3,"T1",1,4,-2,"A"
1995-10-01,1995,"Istanbulspor","Denizlispor","2-3",2,3,"T1",1,5,-1,"A"
1995-10-01,1995,"Karsiyaka","Kocaelispor","1-2",1,2,"T1",1,3,-1,"A"
1995-10-01,1995,"Samsunspor","Altay","4-0",4,0,"T1",1,4,4,"H"
1995-10-01,1995,"Trabzonspor","Galatasaray","4-1",4,1,"T1",1,5,3,"H"
1995-10-01,1995,"Vanspor","Genclerbirligi","0-1",0,1,"T1",1,1,-1,"A"
1995-10-13,1995,"Bursaspor","Ankaragucu","8-0",8,0,"T1",1,8,8,"H"
1995-10-14,1995,"Denizlispor","Fenerbahce","0-0",0,0,"T1",1,0,0,"D"
1995-10-14,1995,"Galatasaray","Istanbulspor","4-2",4,2,"T1",1,6,2,"H"
1995-10-15,1995,"Altay","Trabzonspor","2-5",2,5,"T1",1,7,-3,"A"
1995-10-15,1995,"Besiktas","Karsiyaka","4-0",4,0,"T1",1,4,4,"H"
1995-10-15,1995,"Gaziantepspor","Vanspor","1-0",1,0,"T1",1,1,1,"H"
1995-10-15,1995,"Genclerbirligi","Antalyaspor","6-3",6,3,"T1",1,9,3,"H"
1995-10-15,1995,"Kayseri","Samsunspor","3-2",3,2,"T1",1,5,1,"H"
1995-10-15,1995,"Kocaelispor","Eskisehirspor","2-1",2,1,"T1",1,3,1,"H"
1995-10-21,1995,"Istanbulspor","Altay","1-1",1,1,"T1",1,2,0,"D"
1995-10-21,1995,"Samsunspor","Genclerbirligi","3-0",3,0,"T1",1,3,3,"H"
1995-10-22,1995,"Ankaragucu","Kocaelispor","4-0",4,0,"T1",1,4,4,"H"
1995-10-22,1995,"Eskisehirspor","Besiktas","2-3",2,3,"T1",1,5,-1,"A"
1995-10-22,1995,"Fenerbahce","Galatasaray","3-1",3,1,"T1",1,4,2,"H"
1995-10-22,1995,"Gaziantepspor","Bursaspor","3-0",3,0,"T1",1,3,3,"H"
1995-10-22,1995,"Karsiyaka","Denizlispor","2-0",2,0,"T1",1,2,2,"H"
1995-10-22,1995,"Trabzonspor","Kayseri","3-1",3,1,"T1",1,4,2,"H"
1995-10-22,1995,"Vanspor","Antalyaspor","1-1",1,1,"T1",1,2,0,"D"
1995-10-29,1995,"Altay","Fenerbahce","0-1",0,1,"T1",1,1,-1,"A"
1995-10-29,1995,"Antalyaspor","Samsunspor","2-1",2,1,"T1",1,3,1,"H"
1995-10-29,1995,"Besiktas","Ankaragucu","2-1",2,1,"T1",1,3,1,"H"
1995-10-29,1995,"Bursaspor","Vanspor","5-0",5,0,"T1",1,5,5,"H"
1995-10-29,1995,"Eskisehirspor","Denizlispor","1-1",1,1,"T1",1,2,0,"D"
1995-10-29,1995,"Galatasaray","Karsiyaka","3-0",3,0,"T1",1,3,3,"H"
1995-10-29,1995,"Genclerbirligi","Trabzonspor","1-3",1,3,"T1",1,4,-2,"A"
1995-10-29,1995,"Kayseri","Istanbulspor","0-1",0,1,"T1",1,1,-1,"A"
1995-10-29,1995,"Kocaelispor","Gaziantepspor","2-2",2,2,"T1",1,4,0,"D"
1995-11-03,1995,"Istanbulspor","Genclerbirligi","1-1",1,1,"T1",1,2,0,"D"
1995-11-04,1995,"Eskisehirspor","Galatasaray","1-2",1,2,"T1",1,3,-1,"A"
1995-11-04,1995,"Fenerbahce","Kayseri","2-1",2,1,"T1",1,3,1,"H"
1995-11-05,1995,"Ankaragucu","Denizlispor","1-1",1,1,"T1",1,2,0,"D"
1995-11-05,1995,"Bursaspor","Kocaelispor","2-2",2,2,"T1",1,4,0,"D"
1995-11-05,1995,"Gaziantepspor","Besiktas","1-1",1,1,"T1",1,2,0,"D"
1995-11-05,1995,"Trabzonspor","Antalyaspor","2-0",2,0,"T1",1,2,2,"H"
1995-11-05,1995,"Vanspor","Samsunspor","0-0",0,0,"T1",1,0,0,"D"
1995-11-12,1995,"Karsiyaka","Altay","1-1",1,1,"T1",1,2,0,"D"
1995-11-18,1995,"Besiktas","Bursaspor","4-1",4,1,"T1",1,5,3,"H"
1995-11-18,1995,"Genclerbirligi","Fenerbahce","3-1",3,1,"T1",1,4,2,"H"
1995-11-19,1995,"Altay","Eskisehirspor","1-0",1,0,"T1",1,1,1,"H"
1995-11-19,1995,"Antalyaspor","Istanbulspor","0-0",0,0,"T1",1,0,0,"D"
1995-11-19,1995,"Denizlispor","Gaziantepspor","2-3",2,3,"T1",1,5,-1,"A"
1995-11-19,1995,"Galatasaray","Ankaragucu","5-0",5,0,"T1",1,5,5,"H"
1995-11-19,1995,"Kayseri","Karsiyaka","1-1",1,1,"T1",1,2,0,"D"
1995-11-19,1995,"Kocaelispor","Vanspor","1-0",1,0,"T1",1,1,1,"H"
1995-11-19,1995,"Samsunspor","Trabzonspor","0-1",0,1,"T1",1,1,-1,"A"
1995-11-25,1995,"Fenerbahce","Antalyaspor","3-1",3,1,"T1",1,4,2,"H"
1995-11-25,1995,"Gaziantepspor","Galatasaray","1-1",1,1,"T1",1,2,0,"D"
1995-11-26,1995,"Ankaragucu","Altay","4-0",4,0,"T1",1,4,4,"H"
1995-11-26,1995,"Bursaspor","Denizlispor","2-2",2,2,"T1",1,4,0,"D"
1995-11-26,1995,"Eskisehirspor","Kayseri","4-0",4,0,"T1",1,4,4,"H"
1995-11-26,1995,"Istanbulspor","Samsunspor","0-2",0,2,"T1",1,2,-2,"A"
1995-11-26,1995,"Karsiyaka","Genclerbirligi","1-1",1,1,"T1",1,2,0,"D"
1995-11-26,1995,"Kocaelispor","Besiktas","1-0",1,0,"T1",1,1,1,"H"
1995-11-29,1995,"Vanspor","Trabzonspor","0-5",0,5,"T1",1,5,-5,"A"
1995-12-01,1995,"Trabzonspor","Istanbulspor","2-1",2,1,"T1",1,3,1,"H"
1995-12-02,1995,"Galatasaray","Bursaspor","3-1",3,1,"T1",1,4,2,"H"
1995-12-03,1995,"Altay","Gaziantepspor","2-1",2,1,"T1",1,3,1,"H"
1995-12-03,1995,"Antalyaspor","Karsiyaka","4-0",4,0,"T1",1,4,4,"H"
1995-12-03,1995,"Besiktas","Vanspor","3-1",3,1,"T1",1,4,2,"H"
1995-12-03,1995,"Denizlispor","Kocaelispor","0-0",0,0,"T1",1,0,0,"D"
1995-12-03,1995,"Genclerbirligi","Eskisehirspor","3-2",3,2,"T1",1,5,1,"H"
1995-12-03,1995,"Kayseri","Ankaragucu","4-1",4,1,"T1",1,5,3,"H"
1995-12-03,1995,"Samsunspor","Fenerbahce","0-3",0,3,"T1",1,3,-3,"A"
1995-12-09,1995,"Denizlispor","Besiktas","0-3",0,3,"T1",1,3,-3,"A"
1995-12-09,1995,"Fenerbahce","Trabzonspor","3-1",3,1,"T1",1,4,2,"H"
1995-12-10,1995,"Ankaragucu","Genclerbirligi","2-0",2,0,"T1",1,2,2,"H"
1995-12-10,1995,"Bursaspor","Altay","0-1",0,1,"T1",1,1,-1,"A"
1995-12-10,1995,"Eskisehirspor","Antalyaspor","0-2",0,2,"T1",1,2,-2,"A"
1995-12-10,1995,"Gaziantepspor","Kayseri","1-0",1,0,"T1",1,1,1,"H"
1995-12-10,1995,"Istanbulspor","Vanspor","1-1",1,1,"T1",1,2,0,"D"
1995-12-10,1995,"Karsiyaka","Samsunspor","1-0",1,0,"T1",1,1,1,"H"
1995-12-10,1995,"Kocaelispor","Galatasaray","1-1",1,1,"T1",1,2,0,"D"
1995-12-16,1995,"Istanbulspor","Fenerbahce","1-2",1,2,"T1",1,3,-1,"A"
1995-12-16,1995,"Trabzonspor","Karsiyaka","3-0",3,0,"T1",1,3,3,"H"
1995-12-17,1995,"Altay","Kocaelispor","3-2",3,2,"T1",1,5,1,"H"
1995-12-17,1995,"Antalyaspor","Ankaragucu","2-1",2,1,"T1",1,3,1,"H"
1995-12-17,1995,"Galatasaray","Besiktas","1-3",1,3,"T1",1,4,-2,"A"
1995-12-17,1995,"Genclerbirligi","Gaziantepspor","1-0",1,0,"T1",1,1,1,"H"
1995-12-17,1995,"Kayseri","Bursaspor","0-0",0,0,"T1",1,0,0,"D"
1995-12-17,1995,"Samsunspor","Eskisehirspor","3-1",3,1,"T1",1,4,2,"H"
1995-12-17,1995,"Vanspor","Denizlispor","3-1",3,1,"T1",1,4,2,"H"
1995-12-22,1995,"Besiktas","Altay","3-0",3,0,"T1",1,3,3,"H"
1995-12-22,1995,"Bursaspor","Genclerbirligi","1-1",1,1,"T1",1,2,0,"D"
1995-12-23,1995,"Ankaragucu","Samsunspor","1-0",1,0,"T1",1,1,1,"H"
1995-12-23,1995,"Denizlispor","Galatasaray","1-3",1,3,"T1",1,4,-2,"A"
1995-12-23,1995,"Eskisehirspor","Trabzonspor","0-2",0,2,"T1",1,2,-2,"A"
1995-12-23,1995,"Fenerbahce","Vanspor","3-0",3,0,"T1",1,3,3,"H"
1995-12-23,1995,"Gaziantepspor","Antalyaspor","2-0",2,0,"T1",1,2,2,"H"
1995-12-23,1995,"Karsiyaka","Istanbulspor","0-3",0,3,"T1",1,3,-3,"A"
1995-12-23,1995,"Kocaelispor","Kayseri","5-0",5,0,"T1",1,5,5,"H"
1996-01-26,1995,"Bursaspor","Antalyaspor","2-1",2,1,"T1",1,3,1,"H"
1996-01-27,1995,"Besiktas","Kayseri","4-1",4,1,"T1",1,5,3,"H"
1996-01-27,1995,"Karsiyaka","Fenerbahce","0-1",0,1,"T1",1,1,-1,"A"
1996-01-28,1995,"Ankaragucu","Trabzonspor","1-3",1,3,"T1",1,4,-2,"A"
1996-01-28,1995,"Denizlispor","Altay","1-0",1,0,"T1",1,1,1,"H"
1996-01-28,1995,"Eskisehirspor","Istanbulspor","1-2",1,2,"T1",1,3,-1,"A"
1996-01-28,1995,"Galatasaray","Vanspor","2-0",2,0,"T1",1,2,2,"H"
1996-01-28,1995,"Gaziantepspor","Samsunspor","3-0",3,0,"T1",1,3,3,"H"
1996-01-28,1995,"Kocaelispor","Genclerbirligi","2-0",2,0,"T1",1,2,2,"H"
1996-02-02,1995,"Genclerbirligi","Besiktas","1-2",1,2,"T1",1,3,-1,"A"
1996-02-03,1995,"Altay","Galatasaray","2-5",2,5,"T1",1,7,-3,"A"
1996-02-03,1995,"Trabzonspor","Gaziantepspor","0-0",0,0,"T1",1,0,0,"D"
1996-02-04,1995,"Antalyaspor","Kocaelispor","1-1",1,1,"T1",1,2,0,"D"
1996-02-04,1995,"Denizlispor","Kayseri","2-2",2,2,"T1",1,4,0,"D"
1996-02-04,1995,"Fenerbahce","Eskisehirspor","6-0",6,0,"T1",1,6,6,"H"
1996-02-04,1995,"Istanbulspor","Ankaragucu","0-0",0,0,"T1",1,0,0,"D"
1996-02-04,1995,"Samsunspor","Bursaspor","1-0",1,0,"T1",1,1,1,"H"
1996-02-04,1995,"Vanspor","Karsiyaka","1-1",1,1,"T1",1,2,0,"D"
1996-02-10,1995,"Ankaragucu","Fenerbahce","0-3",0,3,"T1",1,3,-3,"A"
1996-02-10,1995,"Besiktas","Antalyaspor","3-0",3,0,"T1",1,3,3,"H"
1996-02-11,1995,"Altay","Vanspor","1-1",1,1,"T1",1,2,0,"D"
1996-02-11,1995,"Bursaspor","Trabzonspor","1-2",1,2,"T1",1,3,-1,"A"
1996-02-11,1995,"Denizlispor","Genclerbirligi","3-0",3,0,"T1",1,3,3,"H"
1996-02-11,1995,"Eskisehirspor","Karsiyaka","0-2",0,2,"T1",1,2,-2,"A"
1996-02-11,1995,"Galatasaray","Kayseri","4-0",4,0,"T1",1,4,4,"H"
1996-02-11,1995,"Gaziantepspor","Istanbulspor","1-6",1,6,"T1",1,7,-5,"A"
1996-02-11,1995,"Kocaelispor","Samsunspor","3-1",3,1,"T1",1,4,2,"H"
1996-02-16,1995,"Istanbulspor","Bursaspor","1-1",1,1,"T1",1,2,0,"D"
1996-02-17,1995,"Fenerbahce","Gaziantepspor","1-0",1,0,"T1",1,1,1,"H"
1996-02-17,1995,"Genclerbirligi","Galatasaray","1-2",1,2,"T1",1,3,-1,"A"
1996-02-18,1995,"Denizlispor","Antalyaspor","3-1",3,1,"T1",1,4,2,"H"
1996-02-18,1995,"Karsiyaka","Ankaragucu","0-0",0,0,"T1",1,0,0,"D"
1996-02-18,1995,"Kayseri","Altay","1-1",1,1,"T1",1,2,0,"D"
1996-02-18,1995,"Samsunspor","Besiktas","0-1",0,1,"T1",1,1,-1,"A"
1996-02-18,1995,"Trabzonspor","Kocaelispor","2-0",2,0,"T1",1,2,2,"H"
1996-02-18,1995,"Vanspor","Eskisehirspor","3-0",3,0,"T1",1,3,3,"H"
1996-02-23,1995,"Bursaspor","Fenerbahce","0-0",0,0,"T1",1,0,0,"D"
1996-02-24,1995,"Besiktas","Trabzonspor","2-0",2,0,"T1",1,2,2,"H"
1996-02-25,1995,"Altay","Genclerbirligi","1-3",1,3,"T1",1,4,-2,"A"
1996-02-25,1995,"Ankaragucu","Eskisehirspor","1-2",1,2,"T1",1,3,-1,"A"
1996-02-25,1995,"Denizlispor","Samsunspor","1-2",1,2,"T1",1,3,-1,"A"
1996-02-25,1995,"Galatasaray","Antalyaspor","1-2",1,2,"T1",1,3,-1,"A"
1996-02-25,1995,"Gaziantepspor","Karsiyaka","3-0",3,0,"T1",1,3,3,"H"
1996-02-25,1995,"Kayseri","Vanspor","3-1",3,1,"T1",1,4,2,"H"
1996-02-25,1995,"Kocaelispor","Istanbulspor","0-0",0,0,"T1",1,0,0,"D"
1996-03-02,1995,"Istanbulspor","Besiktas","2-3",2,3,"T1",1,5,-1,"A"
1996-03-02,1995,"Samsunspor","Galatasaray","3-2",3,2,"T1",1,5,1,"H"
1996-03-03,1995,"Antalyaspor","Altay","2-1",2,1,"T1",1,3,1,"H"
1996-03-03,1995,"Eskisehirspor","Gaziantepspor","2-0",2,0,"T1",1,2,2,"H"
1996-03-03,1995,"Fenerbahce","Kocaelispor","4-0",4,0,"T1",1,4,4,"H"
1996-03-03,1995,"Genclerbirligi","Kayseri","1-1",1,1,"T1",1,2,0,"D"
1996-03-03,1995,"Karsiyaka","Bursaspor","0-3",0,3,"T1",1,3,-3,"A"
1996-03-03,1995,"Trabzonspor","Denizlispor","3-0",3,0,"T1",1,3,3,"H"
1996-03-03,1995,"Vanspor","Ankaragucu","4-1",4,1,"T1",1,5,3,"H"
1996-03-08,1995,"Kocaelispor","Karsiyaka","2-0",2,0,"T1",1,2,2,"H"
1996-03-09,1995,"Galatasaray","Trabzonspor","0-0",0,0,"T1",1,0,0,"D"
1996-03-10,1995,"Altay","Samsunspor","0-0",0,0,"T1",1,0,0,"D"
1996-03-10,1995,"Besiktas","Fenerbahce","1-2",1,2,"T1",1,3,-1,"A"
1996-03-10,1995,"Bursaspor","Eskisehirspor","2-2",2,2,"T1",1,4,0,"D"
1996-03-10,1995,"Denizlispor","Istanbulspor","1-2",1,2,"T1",1,3,-1,"A"
1996-03-10,1995,"Gaziantepspor","Ankaragucu","1-0",1,0,"T1",1,1,1,"H"
1996-03-10,1995,"Genclerbirligi","Vanspor","1-1",1,1,"T1",1,2,0,"D"
1996-03-10,1995,"Kayseri","Antalyaspor","4-0",4,0,"T1",1,4,4,"H"
1996-03-16,1995,"Istanbulspor","Galatasaray","1-1",1,1,"T1",1,2,0,"D"
1996-03-16,1995,"Trabzonspor","Altay","2-0",2,0,"T1",1,2,2,"H"
1996-03-17,1995,"Ankaragucu","Bursaspor","1-0",1,0,"T1",1,1,1,"H"
1996-03-17,1995,"Antalyaspor","Genclerbirligi","1-0",1,0,"T1",1,1,1,"H"
1996-03-17,1995,"Eskisehirspor","Kocaelispor","0-3",0,3,"T1",1,3,-3,"A"
1996-03-17,1995,"Fenerbahce","Denizlispor","2-0",2,0,"T1",1,2,2,"H"
1996-03-17,1995,"Karsiyaka","Besiktas","0-2",0,2,"T1",1,2,-2,"A"
1996-03-17,1995,"Samsunspor","Kayseri","0-0",0,0,"T1",1,0,0,"D"
1996-03-17,1995,"Vanspor","Gaziantepspor","2-0",2,0,"T1",1,2,2,"H"
1996-03-22,1995,"Galatasaray","Fenerbahce","2-0",2,0,"T1",1,2,2,"H"
1996-03-23,1995,"Besiktas","Eskisehirspor","2-0",2,0,"T1",1,2,2,"H"
1996-03-23,1995,"Kayseri","Trabzonspor","1-2",1,2,"T1",1,3,-1,"A"
1996-03-24,1995,"Altay","Istanbulspor","0-0",0,0,"T1",1,0,0,"D"
1996-03-24,1995,"Antalyaspor","Vanspor","4-1",4,1,"T1",1,5,3,"H"
1996-03-24,1995,"Bursaspor","Gaziantepspor","3-0",3,0,"T1",1,3,3,"H"
1996-03-24,1995,"Denizlispor","Karsiyaka","1-0",1,0,"T1",1,1,1,"H"
1996-03-24,1995,"Genclerbirligi","Samsunspor","0-0",0,0,"T1",1,0,0,"D"
1996-03-24,1995,"Kocaelispor","Ankaragucu","2-0",2,0,"T1",1,2,2,"H"
1996-03-29,1995,"Istanbulspor","Kayseri","5-2",5,2,"T1",1,7,3,"H"
1996-03-30,1995,"Fenerbahce","Altay","2-2",2,2,"T1",1,4,0,"D"
1996-03-30,1995,"Karsiyaka","Galatasaray","0-3",0,3,"T1",1,3,-3,"A"
1996-03-31,1995,"Ankaragucu","Besiktas","0-1",0,1,"T1",1,1,-1,"A"
1996-03-31,1995,"Denizlispor","Eskisehirspor","1-2",1,2,"T1",1,3,-1,"A"
1996-03-31,1995,"Gaziantepspor","Kocaelispor","2-4",2,4,"T1",1,6,-2,"A"
1996-03-31,1995,"Samsunspor","Antalyaspor","2-2",2,2,"T1",1,4,0,"D"
1996-03-31,1995,"Trabzonspor","Genclerbirligi","3-1",3,1,"T1",1,4,2,"H"
1996-03-31,1995,"Vanspor","Bursaspor","1-1",1,1,"T1",1,2,0,"D"
1996-04-05,1995,"Besiktas","Gaziantepspor","5-3",5,3,"T1",1,8,2,"H"
1996-04-06,1995,"Antalyaspor","Trabzonspor","0-2",0,2,"T1",1,2,-2,"A"
1996-04-06,1995,"Kocaelispor","Bursaspor","4-2",4,2,"T1",1,6,2,"H"
1996-04-07,1995,"Altay","Karsiyaka","0-0",0,0,"T1",1,0,0,"D"
1996-04-07,1995,"Denizlispor","Ankaragucu","2-3",2,3,"T1",1,5,-1,"A"
1996-04-07,1995,"Galatasaray","Eskisehirspor","3-0",3,0,"T1",1,3,3,"H"
1996-04-07,1995,"Genclerbirligi","Istanbulspor","2-0",2,0,"T1",1,2,2,"H"
1996-04-07,1995,"Kayseri","Fenerbahce","1-3",1,3,"T1",1,4,-2,"A"
1996-04-07,1995,"Samsunspor","Vanspor","4-1",4,1,"T1",1,5,3,"H"
1996-04-12,1995,"Istanbulspor","Antalyaspor","1-0",1,0,"T1",1,1,1,"H"
1996-04-13,1995,"Trabzonspor","Samsunspor","1-0",1,0,"T1",1,1,1,"H"
1996-04-14,1995,"Ankaragucu","Galatasaray","2-2",2,2,"T1",1,4,0,"D"
1996-04-14,1995,"Bursaspor","Besiktas","1-2",1,2,"T1",1,3,-1,"A"
1996-04-14,1995,"Eskisehirspor","Altay","1-2",1,2,"T1",1,3,-1,"A"
1996-04-14,1995,"Fenerbahce","Genclerbirligi","0-0",0,0,"T1",1,0,0,"D"
1996-04-14,1995,"Gaziantepspor","Denizlispor","1-0",1,0,"T1",1,1,1,"H"
1996-04-14,1995,"Karsiyaka","Kayseri","1-3",1,3,"T1",1,4,-2,"A"
1996-04-14,1995,"Vanspor","Kocaelispor","2-2",2,2,"T1",1,4,0,"D"
1996-04-19,1995,"Trabzonspor","Vanspor","0-1",0,1,"T1",1,1,-1,"A"
1996-04-20,1995,"Galatasaray","Gaziantepspor","2-0",2,0,"T1",1,2,2,"H"
1996-04-20,1995,"Genclerbirligi","Karsiyaka","2-0",2,0,"T1",1,2,2,"H"
1996-04-21,1995,"Altay","Ankaragucu","1-0",1,0,"T1",1,1,1,"H"
1996-04-21,1995,"Antalyaspor","Fenerbahce","0-1",0,1,"T1",1,1,-1,"A"
1996-04-21,1995,"Besiktas","Kocaelispor","3-5",3,5,"T1",1,8,-2,"A"
1996-04-21,1995,"Denizlispor","Bursaspor","0-0",0,0,"T1",1,0,0,"D"
1996-04-21,1995,"Kayseri","Eskisehirspor","0-1",0,1,"T1",1,1,-1,"A"
1996-04-21,1995,"Samsunspor","Istanbulspor","4-4",4,4,"T1",1,8,0,"D"
1996-04-27,1995,"Bursaspor","Galatasaray","2-0",2,0,"T1",1,2,2,"H"
1996-04-27,1995,"Istanbulspor","Trabzonspor","1-4",1,4,"T1",1,5,-3,"A"
1996-04-28,1995,"Ankaragucu","Kayseri","1-1",1,1,"T1",1,2,0,"D"
1996-04-28,1995,"Eskisehirspor","Genclerbirligi","2-0",2,0,"T1",1,2,2,"H"
1996-04-28,1995,"Fenerbahce","Samsunspor","1-0",1,0,"T1",1,1,1,"H"
1996-04-28,1995,"Gaziantepspor","Altay","2-1",2,1,"T1",1,3,1,"H"
1996-04-28,1995,"Karsiyaka","Antalyaspor","1-2",1,2,"T1",1,3,-1,"A"
1996-04-28,1995,"Kocaelispor","Denizlispor","4-2",4,2,"T1",1,6,2,"H"
1996-04-28,1995,"Vanspor","Besiktas","2-0",2,0,"T1",1,2,2,"H"
1996-05-03,1995,"Altay","Bursaspor","1-3",1,3,"T1",1,4,-2,"A"
1996-05-04,1995,"Galatasaray","Kocaelispor","0-4",0,4,"T1",1,4,-4,"A"
1996-05-05,1995,"Antalyaspor","Eskisehirspor","1-0",1,0,"T1",1,1,1,"H"
1996-05-05,1995,"Besiktas","Denizlispor","0-4",0,4,"T1",1,4,-4,"A"
1996-05-05,1995,"Genclerbirligi","Ankaragucu","1-2",1,2,"T1",1,3,-1,"A"
1996-05-05,1995,"Kayseri","Gaziantepspor","1-2",1,2,"T1",1,3,-1,"A"
1996-05-05,1995,"Samsunspor","Karsiyaka","4-1",4,1,"T1",1,5,3,"H"
1996-05-05,1995,"Trabzonspor","Fenerbahce","1-2",1,2,"T1",1,3,-1,"A"
1996-05-05,1995,"Vanspor","Istanbulspor","0-0",0,0,"T1",1,0,0,"D"
1996-05-11,1995,"Besiktas","Galatasaray","1-2",1,2,"T1",1,3,-1,"A"
1996-05-12,1995,"Ankaragucu","Antalyaspor","2-1",2,1,"T1",1,3,1,"H"
1996-05-12,1995,"Bursaspor","Kayseri","1-2",1,2,"T1",1,3,-1,"A"
1996-05-12,1995,"Denizlispor","Vanspor","0-0",0,0,"T1",1,0,0,"D"
1996-05-12,1995,"Eskisehirspor","Samsunspor","3-0",3,0,"T1",1,3,3,"H"
1996-05-12,1995,"Fenerbahce","Istanbulspor","2-0",2,0,"T1",1,2,2,"H"
1996-05-12,1995,"Gaziantepspor","Genclerbirligi","2-0",2,0,"T1",1,2,2,"H"
1996-05-12,1995,"Karsiyaka","Trabzonspor","1-4",1,4,"T1",1,5,-3,"A"
1996-05-12,1995,"Kocaelispor","Altay","1-1",1,1,"T1",1,2,0,"D"
1996-05-19,1995,"Altay","Besiktas","3-0",3,0,"T1",1,3,3,"H"
1996-05-19,1995,"Antalyaspor","Gaziantepspor","0-1",0,1,"T1",1,1,-1,"A"
1996-05-19,1995,"Galatasaray","Denizlispor","1-0",1,0,"T1",1,1,1,"H"
1996-05-19,1995,"Genclerbirligi","Bursaspor","2-1",2,1,"T1",1,3,1,"H"
1996-05-19,1995,"Istanbulspor","Karsiyaka","0-4",0,4,"T1",1,4,-4,"A"
1996-05-19,1995,"Kayseri","Kocaelispor","1-0",1,0,"T1",1,1,1,"H"
1996-05-19,1995,"Samsunspor","Ankaragucu","2-1",2,1,"T1",1,3,1,"H"
1996-05-19,1995,"Trabzonspor","Eskisehirspor","7-1",7,1,"T1",1,8,6,"H"
1996-05-19,1995,"Vanspor","Fenerbahce","0-3",0,3,"T1",1,3,-3,"A"
1996-08-11,1996,"Ankaragucu","Zeytinburnu","4-1",4,1,"T1",1,5,3,"H"
1996-08-11,1996,"Bursaspor","Besiktas","2-0",2,0,"T1",1,2,2,"H"
1996-08-11,1996,"Fenerbahce","Samsunspor","4-1",4,1,"T1",1,5,3,"H"
1996-08-11,1996,"Genclerbirligi","Dardanelspor","1-1",1,1,"T1",1,2,0,"D"
1996-08-11,1996,"Istanbulspor","Antalyaspor","1-0",1,0,"T1",1,1,1,"H"
1996-08-11,1996,"Kocaelispor","Gaziantepspor","3-1",3,1,"T1",1,4,2,"H"
1996-08-11,1996,"Sariyer","Denizlispor","2-1",2,1,"T1",1,3,1,"H"
1996-08-11,1996,"Trabzonspor","Altay","1-0",1,0,"T1",1,1,1,"H"
1996-08-11,1996,"Vanspor","Galatasaray","1-2",1,2,"T1",1,3,-1,"A"
1996-08-18,1996,"Altay","Kocaelispor","0-0",0,0,"T1",1,0,0,"D"
1996-08-18,1996,"Ankaragucu","Antalyaspor","1-3",1,3,"T1",1,4,-2,"A"
1996-08-18,1996,"Besiktas","Vanspor","7-0",7,0,"T1",1,7,7,"H"
1996-08-18,1996,"Denizlispor","Dardanelspor","0-1",0,1,"T1",1,1,-1,"A"
1996-08-18,1996,"Galatasaray","Trabzonspor","1-0",1,0,"T1",1,1,1,"H"
1996-08-18,1996,"Gaziantepspor","Fenerbahce","2-0",2,0,"T1",1,2,2,"H"
1996-08-18,1996,"Genclerbirligi","Istanbulspor","1-0",1,0,"T1",1,1,1,"H"
1996-08-18,1996,"Samsunspor","Sariyer","2-2",2,2,"T1",1,4,0,"D"
1996-08-18,1996,"Zeytinburnu","Bursaspor","0-1",0,1,"T1",1,1,-1,"A"
1996-08-25,1996,"Bursaspor","Antalyaspor","0-0",0,0,"T1",1,0,0,"D"
1996-08-25,1996,"Fenerbahce","Altay","5-1",5,1,"T1",1,6,4,"H"
1996-08-25,1996,"Genclerbirligi","Denizlispor","3-2",3,2,"T1",1,5,1,"H"
1996-08-25,1996,"Istanbulspor","Ankaragucu","1-2",1,2,"T1",1,3,-1,"A"
1996-08-25,1996,"Kocaelispor","Galatasaray","1-1",1,1,"T1",1,2,0,"D"
1996-08-25,1996,"Samsunspor","Dardanelspor","2-0",2,0,"T1",1,2,2,"H"
1996-08-25,1996,"Sariyer","Gaziantepspor","0-0",0,0,"T1",1,0,0,"D"
1996-08-25,1996,"Trabzonspor","Besiktas","3-3",3,3,"T1",1,6,0,"D"
1996-08-25,1996,"Vanspor","Zeytinburnu","1-1",1,1,"T1",1,2,0,"D"
1996-09-08,1996,"Altay","Sariyer","4-3",4,3,"T1",1,7,1,"H"
1996-09-08,1996,"Ankaragucu","Bursaspor","0-2",0,2,"T1",1,2,-2,"A"
1996-09-08,1996,"Besiktas","Kocaelispor","1-1",1,1,"T1",1,2,0,"D"
1996-09-08,1996,"Denizlispor","Istanbulspor","1-1",1,1,"T1",1,2,0,"D"
1996-09-08,1996,"Galatasaray","Fenerbahce","0-4",0,4,"T1",1,4,-4,"A"
1996-09-08,1996,"Gaziantepspor","Dardanelspor","1-1",1,1,"T1",1,2,0,"D"
1996-09-08,1996,"Samsunspor","Genclerbirligi","1-0",1,0,"T1",1,1,1,"H"
1996-09-08,1996,"Vanspor","Antalyaspor","1-0",1,0,"T1",1,1,1,"H"
1996-09-08,1996,"Zeytinburnu","Trabzonspor","1-5",1,5,"T1",1,6,-4,"A"
1996-09-15,1996,"Altay","Dardanelspor","2-1",2,1,"T1",1,3,1,"H"
1996-09-15,1996,"Denizlispor","Samsunspor","2-2",2,2,"T1",1,4,0,"D"
1996-09-15,1996,"Fenerbahce","Besiktas","0-1",0,1,"T1",1,1,-1,"A"
1996-09-15,1996,"Genclerbirligi","Gaziantepspor","1-1",1,1,"T1",1,2,0,"D"
1996-09-15,1996,"Istanbulspor","Bursaspor","1-1",1,1,"T1",1,2,0,"D"
1996-09-15,1996,"Kocaelispor","Zeytinburnu","2-1",2,1,"T1",1,3,1,"H"
1996-09-15,1996,"Sariyer","Galatasaray","0-4",0,4,"T1",1,4,-4,"A"
1996-09-15,1996,"Trabzonspor","Antalyaspor","2-0",2,0,"T1",1,2,2,"H"
1996-09-15,1996,"Vanspor","Ankaragucu","2-0",2,0,"T1",1,2,2,"H"
1996-09-22,1996,"Altay","Genclerbirligi","1-0",1,0,"T1",1,1,1,"H"
1996-09-22,1996,"Ankaragucu","Trabzonspor","0-1",0,1,"T1",1,1,-1,"A"
1996-09-22,1996,"Besiktas","Sariyer","2-0",2,0,"T1",1,2,2,"H"
1996-09-22,1996,"Bursaspor","Vanspor","2-0",2,0,"T1",1,2,2,"H"
1996-09-22,1996,"Galatasaray","Dardanelspor","1-0",1,0,"T1",1,1,1,"H"
1996-09-22,1996,"Gaziantepspor","Denizlispor","2-0",2,0,"T1",1,2,2,"H"
1996-09-22,1996,"Kocaelispor","Antalyaspor","0-1",0,1,"T1",1,1,-1,"A"
1996-09-22,1996,"Samsunspor","Istanbulspor","1-0",1,0,"T1",1,1,1,"H"
1996-09-22,1996,"Zeytinburnu","Fenerbahce","1-5",1,5,"T1",1,6,-4,"A"
1996-09-29,1996,"Dardanelspor","Besiktas","0-5",0,5,"T1",1,5,-5,"A"
1996-09-29,1996,"Denizlispor","Altay","1-0",1,0,"T1",1,1,1,"H"
1996-09-29,1996,"Fenerbahce","Antalyaspor","4-0",4,0,"T1",1,4,4,"H"
1996-09-29,1996,"Genclerbirligi","Galatasaray","0-2",0,2,"T1",1,2,-2,"A"
1996-09-29,1996,"Istanbulspor","Vanspor","2-1",2,1,"T1",1,3,1,"H"
1996-09-29,1996,"Kocaelispor","Ankaragucu","2-1",2,1,"T1",1,3,1,"H"
1996-09-29,1996,"Samsunspor","Gaziantepspor","2-1",2,1,"T1",1,3,1,"H"
1996-09-29,1996,"Sariyer","Zeytinburnu","1-0",1,0,"T1",1,1,1,"H"
1996-09-29,1996,"Trabzonspor","Bursaspor","3-0",3,0,"T1",1,3,3,"H"
1996-10-06,1996,"Altay","Samsunspor","3-1",3,1,"T1",1,4,2,"H"
1996-10-06,1996,"Ankaragucu","Fenerbahce","0-2",0,2,"T1",1,2,-2,"A"
1996-10-06,1996,"Antalyaspor","Sariyer","1-1",1,1,"T1",1,2,0,"D"
1996-10-06,1996,"Besiktas","Genclerbirligi","2-0",2,0,"T1",1,2,2,"H"
1996-10-06,1996,"Bursaspor","Kocaelispor","1-2",1,2,"T1",1,3,-1,"A"
1996-10-06,1996,"Galatasaray","Denizlispor","2-0",2,0,"T1",1,2,2,"H"
1996-10-06,1996,"Gaziantepspor","Istanbulspor","1-0",1,0,"T1",1,1,1,"H"
1996-10-06,1996,"Vanspor","Trabzonspor","1-2",1,2,"T1",1,3,-1,"A"
1996-10-06,1996,"Zeytinburnu","Dardanelspor","0-2",0,2,"T1",1,2,-2,"A"
1996-10-13,1996,"Dardanelspor","Antalyaspor","3-2",3,2,"T1",1,5,1,"H"
1996-10-13,1996,"Denizlispor","Besiktas","0-4",0,4,"T1",1,4,-4,"A"
1996-10-13,1996,"Fenerbahce","Bursaspor","1-0",1,0,"T1",1,1,1,"H"
1996-10-13,1996,"Gaziantepspor","Altay","2-0",2,0,"T1",1,2,2,"H"
1996-10-13,1996,"Genclerbirligi","Zeytinburnu","3-2",3,2,"T1",1,5,1,"H"
1996-10-13,1996,"Istanbulspor","Trabzonspor","2-2",2,2,"T1",1,4,0,"D"
1996-10-13,1996,"Kocaelispor","Vanspor","4-2",4,2,"T1",1,6,2,"H"
1996-10-13,1996,"Samsunspor","Galatasaray","0-2",0,2,"T1",1,2,-2,"A"
1996-10-13,1996,"Sariyer","Ankaragucu","2-1",2,1,"T1",1,3,1,"H"
1996-10-20,1996,"Altay","Istanbulspor","0-2",0,2,"T1",1,2,-2,"A"
1996-10-20,1996,"Ankaragucu","Dardanelspor","2-1",2,1,"T1",1,3,1,"H"
1996-10-20,1996,"Antalyaspor","Genclerbirligi","1-1",1,1,"T1",1,2,0,"D"
1996-10-20,1996,"Besiktas","Samsunspor","1-0",1,0,"T1",1,1,1,"H"
1996-10-20,1996,"Bursaspor","Sariyer","1-0",1,0,"T1",1,1,1,"H"
1996-10-20,1996,"Galatasaray","Gaziantepspor","6-1",6,1,"T1",1,7,5,"H"
1996-10-20,1996,"Trabzonspor","Kocaelispor","2-1",2,1,"T1",1,3,1,"H"
1996-10-20,1996,"Vanspor","Fenerbahce","2-2",2,2,"T1",1,4,0,"D"
1996-10-20,1996,"Zeytinburnu","Denizlispor","1-2",1,2,"T1",1,3,-1,"A"
1996-10-27,1996,"Altay","Galatasaray","1-8",1,8,"T1",1,9,-7,"A"
1996-10-27,1996,"Dardanelspor","Bursaspor","0-0",0,0,"T1",1,0,0,"D"
1996-10-27,1996,"Denizlispor","Antalyaspor","1-5",1,5,"T1",1,6,-4,"A"
1996-10-27,1996,"Fenerbahce","Trabzonspor","1-0",1,0,"T1",1,1,1,"H"
1996-10-27,1996,"Gaziantepspor","Besiktas","0-0",0,0,"T1",1,0,0,"D"
1996-10-27,1996,"Genclerbirligi","Ankaragucu","0-1",0,1,"T1",1,1,-1,"A"
1996-10-27,1996,"Istanbulspor","Kocaelispor","0-1",0,1,"T1",1,1,-1,"A"
1996-10-27,1996,"Samsunspor","Zeytinburnu","2-0",2,0,"T1",1,2,2,"H"
1996-10-27,1996,"Sariyer","Vanspor","2-0",2,0,"T1",1,2,2,"H"
1996-11-03,1996,"Ankaragucu","Denizlispor","3-2",3,2,"T1",1,5,1,"H"
1996-11-03,1996,"Antalyaspor","Samsunspor","1-1",1,1,"T1",1,2,0,"D"
1996-11-03,1996,"Besiktas","Altay","3-0",3,0,"T1",1,3,3,"H"
1996-11-03,1996,"Bursaspor","Genclerbirligi","2-0",2,0,"T1",1,2,2,"H"
1996-11-03,1996,"Galatasaray","Istanbulspor","6-1",6,1,"T1",1,7,5,"H"
1996-11-03,1996,"Kocaelispor","Fenerbahce","0-1",0,1,"T1",1,1,-1,"A"
1996-11-03,1996,"Trabzonspor","Sariyer","3-2",3,2,"T1",1,5,1,"H"
1996-11-03,1996,"Vanspor","Dardanelspor","1-0",1,0,"T1",1,1,1,"H"
1996-11-03,1996,"Zeytinburnu","Gaziantepspor","0-3",0,3,"T1",1,3,-3,"A"
1996-11-17,1996,"Altay","Zeytinburnu","0-0",0,0,"T1",1,0,0,"D"
1996-11-17,1996,"Dardanelspor","Trabzonspor","0-2",0,2,"T1",1,2,-2,"A"
1996-11-17,1996,"Denizlispor","Bursaspor","2-3",2,3,"T1",1,5,-1,"A"
1996-11-17,1996,"Galatasaray","Besiktas","2-2",2,2,"T1",1,4,0,"D"
1996-11-17,1996,"Gaziantepspor","Antalyaspor","1-0",1,0,"T1",1,1,1,"H"
1996-11-17,1996,"Genclerbirligi","Vanspor","1-0",1,0,"T1",1,1,1,"H"
1996-11-17,1996,"Istanbulspor","Fenerbahce","1-1",1,1,"T1",1,2,0,"D"
1996-11-17,1996,"Samsunspor","Ankaragucu","2-4",2,4,"T1",1,6,-2,"A"
1996-11-17,1996,"Sariyer","Kocaelispor","2-1",2,1,"T1",1,3,1,"H"
1996-11-24,1996,"Ankaragucu","Gaziantepspor","0-0",0,0,"T1",1,0,0,"D"
1996-11-24,1996,"Antalyaspor","Altay","1-1",1,1,"T1",1,2,0,"D"
1996-11-24,1996,"Besiktas","Istanbulspor","3-0",3,0,"T1",1,3,3,"H"
1996-11-24,1996,"Bursaspor","Samsunspor","6-1",6,1,"T1",1,7,5,"H"
1996-11-24,1996,"Fenerbahce","Sariyer","2-0",2,0,"T1",1,2,2,"H"
1996-11-24,1996,"Kocaelispor","Dardanelspor","2-0",2,0,"T1",1,2,2,"H"
1996-11-24,1996,"Trabzonspor","Genclerbirligi","1-0",1,0,"T1",1,1,1,"H"
1996-11-24,1996,"Vanspor","Denizlispor","0-2",0,2,"T1",1,2,-2,"A"
1996-11-24,1996,"Zeytinburnu","Galatasaray","2-5",2,5,"T1",1,7,-3,"A"
1996-12-01,1996,"Altay","Ankaragucu","1-1",1,1,"T1",1,2,0,"D"
1996-12-01,1996,"Dardanelspor","Fenerbahce","1-1",1,1,"T1",1,2,0,"D"
1996-12-01,1996,"Denizlispor","Trabzonspor","2-3",2,3,"T1",1,5,-1,"A"
1996-12-01,1996,"Galatasaray","Antalyaspor","3-1",3,1,"T1",1,4,2,"H"
1996-12-01,1996,"Gaziantepspor","Bursaspor","2-1",2,1,"T1",1,3,1,"H"
1996-12-01,1996,"Genclerbirligi","Kocaelispor","1-0",1,0,"T1",1,1,1,"H"
1996-12-01,1996,"Samsunspor","Vanspor","0-0",0,0,"T1",1,0,0,"D"
1996-12-01,1996,"Sariyer","Istanbulspor","0-1",0,1,"T1",1,1,-1,"A"
1996-12-01,1996,"Zeytinburnu","Besiktas","0-3",0,3,"T1",1,3,-3,"A"
1996-12-08,1996,"Ankaragucu","Galatasaray","0-1",0,1,"T1",1,1,-1,"A"
1996-12-08,1996,"Antalyaspor","Besiktas","3-2",3,2,"T1",1,5,1,"H"
1996-12-08,1996,"Bursaspor","Altay","3-0",3,0,"T1",1,3,3,"H"
1996-12-08,1996,"Fenerbahce","Genclerbirligi","2-0",2,0,"T1",1,2,2,"H"
1996-12-08,1996,"Istanbulspor","Zeytinburnu","5-1",5,1,"T1",1,6,4,"H"
1996-12-08,1996,"Kocaelispor","Denizlispor","1-0",1,0,"T1",1,1,1,"H"
1996-12-08,1996,"Sariyer","Dardanelspor","8-0",8,0,"T1",1,8,8,"H"
1996-12-08,1996,"Trabzonspor","Samsunspor","1-0",1,0,"T1",1,1,1,"H"
1996-12-08,1996,"Vanspor","Gaziantepspor","0-1",0,1,"T1",1,1,-1,"A"
1996-12-22,1996,"Altay","Vanspor","2-1",2,1,"T1",1,3,1,"H"
1996-12-22,1996,"Besiktas","Ankaragucu","4-0",4,0,"T1",1,4,4,"H"
1996-12-22,1996,"Dardanelspor","Istanbulspor","1-3",1,3,"T1",1,4,-2,"A"
1996-12-22,1996,"Denizlispor","Fenerbahce","0-1",0,1,"T1",1,1,-1,"A"
1996-12-22,1996,"Galatasaray","Bursaspor","4-1",4,1,"T1",1,5,3,"H"
1996-12-22,1996,"Gaziantepspor","Trabzonspor","1-0",1,0,"T1",1,1,1,"H"
1996-12-22,1996,"Genclerbirligi","Sariyer","2-1",2,1,"T1",1,3,1,"H"
1996-12-22,1996,"Samsunspor","Kocaelispor","3-0",3,0,"T1",1,3,3,"H"
1996-12-22,1996,"Zeytinburnu","Antalyaspor","2-1",2,1,"T1",1,3,1,"H"
1997-01-19,1996,"Altay","Trabzonspor","2-3",2,3,"T1",1,5,-1,"A"
1997-01-19,1996,"Antalyaspor","Istanbulspor","2-1",2,1,"T1",1,3,1,"H"
1997-01-19,1996,"Besiktas","Bursaspor","2-2",2,2,"T1",1,4,0,"D"
1997-01-19,1996,"Dardanelspor","Genclerbirligi","1-3",1,3,"T1",1,4,-2,"A"
1997-01-19,1996,"Denizlispor","Sariyer","0-1",0,1,"T1",1,1,-1,"A"
1997-01-19,1996,"Galatasaray","Vanspor","1-1",1,1,"T1",1,2,0,"D"
1997-01-19,1996,"Gaziantepspor","Kocaelispor","1-1",1,1,"T1",1,2,0,"D"
1997-01-19,1996,"Samsunspor","Fenerbahce","1-1",1,1,"T1",1,2,0,"D"
1997-01-19,1996,"Zeytinburnu","Ankaragucu","1-1",1,1,"T1",1,2,0,"D"
1997-01-26,1996,"Antalyaspor","Ankaragucu","1-0",1,0,"T1",1,1,1,"H"
1997-01-26,1996,"Bursaspor","Zeytinburnu","1-1",1,1,"T1",1,2,0,"D"
1997-01-26,1996,"Dardanelspor","Denizlispor","3-0",3,0,"T1",1,3,3,"H"
1997-01-26,1996,"Fenerbahce","Gaziantepspor","1-0",1,0,"T1",1,1,1,"H"
1997-01-26,1996,"Istanbulspor","Genclerbirligi","0-3",0,3,"T1",1,3,-3,"A"
1997-01-26,1996,"Kocaelispor","Altay","0-0",0,0,"T1",1,0,0,"D"
1997-01-26,1996,"Sariyer","Samsunspor","4-1",4,1,"T1",1,5,3,"H"
1997-01-26,1996,"Trabzonspor","Galatasaray","0-0",0,0,"T1",1,0,0,"D"
1997-01-26,1996,"Vanspor","Besiktas","0-0",0,0,"T1",1,0,0,"D"
1997-02-02,1996,"Altay","Fenerbahce","0-0",0,0,"T1",1,0,0,"D"
1997-02-02,1996,"Ankaragucu","Istanbulspor","0-0",0,0,"T1",1,0,0,"D"
1997-02-02,1996,"Antalyaspor","Bursaspor","0-1",0,1,"T1",1,1,-1,"A"
1997-02-02,1996,"Besiktas","Trabzonspor","3-0",3,0,"T1",1,3,3,"H"
1997-02-02,1996,"Dardanelspor","Samsunspor","0-0",0,0,"T1",1,0,0,"D"
1997-02-02,1996,"Denizlispor","Genclerbirligi","3-3",3,3,"T1",1,6,0,"D"
1997-02-02,1996,"Galatasaray","Kocaelispor","0-0",0,0,"T1",1,0,0,"D"
1997-02-02,1996,"Gaziantepspor","Sariyer","2-1",2,1,"T1",1,3,1,"H"
1997-02-02,1996,"Zeytinburnu","Vanspor","2-1",2,1,"T1",1,3,1,"H"
1997-02-09,1996,"Antalyaspor","Vanspor","1-0",1,0,"T1",1,1,1,"H"
1997-02-09,1996,"Bursaspor","Ankaragucu","2-1",2,1,"T1",1,3,1,"H"
1997-02-09,1996,"Dardanelspor","Gaziantepspor","1-1",1,1,"T1",1,2,0,"D"
1997-02-09,1996,"Fenerbahce","Galatasaray","3-2",3,2,"T1",1,5,1,"H"
1997-02-09,1996,"Genclerbirligi","Samsunspor","3-1",3,1,"T1",1,4,2,"H"
1997-02-09,1996,"Istanbulspor","Denizlispor","5-0",5,0,"T1",1,5,5,"H"
1997-02-09,1996,"Kocaelispor","Besiktas","0-0",0,0,"T1",1,0,0,"D"
1997-02-09,1996,"Sariyer","Altay","0-0",0,0,"T1",1,0,0,"D"
1997-02-09,1996,"Trabzonspor","Zeytinburnu","6-1",6,1,"T1",1,7,5,"H"
1997-02-16,1996,"Ankaragucu","Vanspor","2-2",2,2,"T1",1,4,0,"D"
1997-02-16,1996,"Antalyaspor","Trabzonspor","0-3",0,3,"T1",1,3,-3,"A"
1997-02-16,1996,"Besiktas","Fenerbahce","1-0",1,0,"T1",1,1,1,"H"
1997-02-16,1996,"Bursaspor","Istanbulspor","0-2",0,2,"T1",1,2,-2,"A"
1997-02-16,1996,"Dardanelspor","Altay","3-1",3,1,"T1",1,4,2,"H"
1997-02-16,1996,"Galatasaray","Sariyer","4-0",4,0,"T1",1,4,4,"H"
1997-02-16,1996,"Gaziantepspor","Genclerbirligi","2-0",2,0,"T1",1,2,2,"H"
1997-02-16,1996,"Samsunspor","Denizlispor","3-0",3,0,"T1",1,3,3,"H"
1997-02-16,1996,"Zeytinburnu","Kocaelispor","0-1",0,1,"T1",1,1,-1,"A"
1997-02-23,1996,"Antalyaspor","Kocaelispor","3-2",3,2,"T1",1,5,1,"H"
1997-02-23,1996,"Dardanelspor","Galatasaray","0-3",0,3,"T1",1,3,-3,"A"
1997-02-23,1996,"Denizlispor","Gaziantepspor","3-1",3,1,"T1",1,4,2,"H"
1997-02-23,1996,"Fenerbahce","Zeytinburnu","4-1",4,1,"T1",1,5,3,"H"
1997-02-23,1996,"Genclerbirligi","Altay","1-2",1,2,"T1",1,3,-1,"A"
1997-02-23,1996,"Istanbulspor","Samsunspor","1-1",1,1,"T1",1,2,0,"D"
1997-02-23,1996,"Sariyer","Besiktas","1-6",1,6,"T1",1,7,-5,"A"
1997-02-23,1996,"Trabzonspor","Ankaragucu","1-1",1,1,"T1",1,2,0,"D"
1997-02-23,1996,"Vanspor","Bursaspor","1-0",1,0,"T1",1,1,1,"H"
1997-03-02,1996,"Altay","Denizlispor","2-1",2,1,"T1",1,3,1,"H"
1997-03-02,1996,"Ankaragucu","Kocaelispor","0-3",0,3,"T1",1,3,-3,"A"
1997-03-02,1996,"Antalyaspor","Fenerbahce","0-5",0,5,"T1",1,5,-5,"A"
1997-03-02,1996,"Besiktas","Dardanelspor","4-0",4,0,"T1",1,4,4,"H"
1997-03-02,1996,"Bursaspor","Trabzonspor","3-2",3,2,"T1",1,5,1,"H"
1997-03-02,1996,"Galatasaray","Genclerbirligi","1-1",1,1,"T1",1,2,0,"D"
1997-03-02,1996,"Gaziantepspor","Samsunspor","0-2",0,2,"T1",1,2,-2,"A"
1997-03-02,1996,"Vanspor","Istanbulspor","0-1",0,1,"T1",1,1,-1,"A"
1997-03-02,1996,"Zeytinburnu","Sariyer","1-1",1,1,"T1",1,2,0,"D"
1997-03-09,1996,"Dardanelspor","Zeytinburnu","4-0",4,0,"T1",1,4,4,"H"
1997-03-09,1996,"Denizlispor","Galatasaray","2-3",2,3,"T1",1,5,-1,"A"
1997-03-09,1996,"Fenerbahce","Ankaragucu","1-1",1,1,"T1",1,2,0,"D"
1997-03-09,1996,"Genclerbirligi","Besiktas","0-3",0,3,"T1",1,3,-3,"A"
1997-03-09,1996,"Istanbulspor","Gaziantepspor","3-0",3,0,"T1",1,3,3,"H"
1997-03-09,1996,"Kocaelispor","Bursaspor","0-0",0,0,"T1",1,0,0,"D"
1997-03-09,1996,"Samsunspor","Altay","0-0",0,0,"T1",1,0,0,"D"
1997-03-09,1996,"Sariyer","Antalyaspor","1-1",1,1,"T1",1,2,0,"D"
1997-03-09,1996,"Trabzonspor","Vanspor","4-0",4,0,"T1",1,4,4,"H"
1997-03-16,1996,"Altay","Gaziantepspor","2-2",2,2,"T1",1,4,0,"D"
1997-03-16,1996,"Ankaragucu","Sariyer","1-0",1,0,"T1",1,1,1,"H"
1997-03-16,1996,"Antalyaspor","Dardanelspor","1-0",1,0,"T1",1,1,1,"H"
1997-03-16,1996,"Besiktas","Denizlispor","2-1",2,1,"T1",1,3,1,"H"
1997-03-16,1996,"Bursaspor","Fenerbahce","0-1",0,1,"T1",1,1,-1,"A"
1997-03-16,1996,"Galatasaray","Samsunspor","3-1",3,1,"T1",1,4,2,"H"
1997-03-16,1996,"Trabzonspor","Istanbulspor","1-2",1,2,"T1",1,3,-1,"A"
1997-03-16,1996,"Vanspor","Kocaelispor","0-0",0,0,"T1",1,0,0,"D"
1997-03-16,1996,"Zeytinburnu","Genclerbirligi","0-1",0,1,"T1",1,1,-1,"A"
1997-03-23,1996,"Dardanelspor","Ankaragucu","2-1",2,1,"T1",1,3,1,"H"
1997-03-23,1996,"Denizlispor","Zeytinburnu","3-2",3,2,"T1",1,5,1,"H"
1997-03-23,1996,"Fenerbahce","Vanspor","5-0",5,0,"T1",1,5,5,"H"
1997-03-23,1996,"Gaziantepspor","Galatasaray","0-3",0,3,"T1",1,3,-3,"A"
1997-03-23,1996,"Genclerbirligi","Antalyaspor","0-1",0,1,"T1",1,1,-1,"A"
1997-03-23,1996,"Istanbulspor","Altay","5-0",5,0,"T1",1,5,5,"H"
1997-03-23,1996,"Kocaelispor","Trabzonspor","0-2",0,2,"T1",1,2,-2,"A"
1997-03-23,1996,"Samsunspor","Besiktas","4-1",4,1,"T1",1,5,3,"H"
1997-03-23,1996,"Sariyer","Bursaspor","1-2",1,2,"T1",1,3,-1,"A"
1997-04-06,1996,"Ankaragucu","Genclerbirligi","1-0",1,0,"T1",1,1,1,"H"
1997-04-06,1996,"Antalyaspor","Denizlispor","3-0",3,0,"T1",1,3,3,"H"
1997-04-06,1996,"Besiktas","Gaziantepspor","5-1",5,1,"T1",1,6,4,"H"
1997-04-06,1996,"Bursaspor","Dardanelspor","3-1",3,1,"T1",1,4,2,"H"
1997-04-06,1996,"Galatasaray","Altay","2-1",2,1,"T1",1,3,1,"H"
1997-04-06,1996,"Kocaelispor","Istanbulspor","1-1",1,1,"T1",1,2,0,"D"
1997-04-06,1996,"Trabzonspor","Fenerbahce","4-3",4,3,"T1",1,7,1,"H"
1997-04-06,1996,"Vanspor","Sariyer","1-0",1,0,"T1",1,1,1,"H"
1997-04-06,1996,"Zeytinburnu","Samsunspor","1-3",1,3,"T1",1,4,-2,"A"
1997-04-13,1996,"Altay","Besiktas","0-4",0,4,"T1",1,4,-4,"A"
1997-04-13,1996,"Dardanelspor","Vanspor","2-1",2,1,"T1",1,3,1,"H"
1997-04-13,1996,"Denizlispor","Ankaragucu","2-6",2,6,"T1",1,8,-4,"A"
1997-04-13,1996,"Fenerbahce","Kocaelispor","0-0",0,0,"T1",1,0,0,"D"
1997-04-13,1996,"Gaziantepspor","Zeytinburnu","3-1",3,1,"T1",1,4,2,"H"
1997-04-13,1996,"Genclerbirligi","Bursaspor","0-4",0,4,"T1",1,4,-4,"A"
1997-04-13,1996,"Istanbulspor","Galatasaray","2-3",2,3,"T1",1,5,-1,"A"
1997-04-13,1996,"Samsunspor","Antalyaspor","2-1",2,1,"T1",1,3,1,"H"
1997-04-13,1996,"Sariyer","Trabzonspor","1-1",1,1,"T1",1,2,0,"D"
1997-04-20,1996,"Ankaragucu","Samsunspor","0-0",0,0,"T1",1,0,0,"D"
1997-04-20,1996,"Antalyaspor","Gaziantepspor","2-1",2,1,"T1",1,3,1,"H"
1997-04-20,1996,"Besiktas","Galatasaray","1-1",1,1,"T1",1,2,0,"D"
1997-04-20,1996,"Bursaspor","Denizlispor","2-2",2,2,"T1",1,4,0,"D"
1997-04-20,1996,"Fenerbahce","Istanbulspor","3-0",3,0,"T1",1,3,3,"H"
1997-04-20,1996,"Kocaelispor","Sariyer","1-0",1,0,"T1",1,1,1,"H"
1997-04-20,1996,"Trabzonspor","Dardanelspor","4-0",4,0,"T1",1,4,4,"H"
1997-04-20,1996,"Vanspor","Genclerbirligi","3-0",3,0,"T1",1,3,3,"H"
1997-04-20,1996,"Zeytinburnu","Altay","0-1",0,1,"T1",1,1,-1,"A"
1997-05-04,1996,"Altay","Antalyaspor","2-1",2,1,"T1",1,3,1,"H"
1997-05-04,1996,"Dardanelspor","Kocaelispor","3-2",3,2,"T1",1,5,1,"H"
1997-05-04,1996,"Denizlispor","Vanspor","0-1",0,1,"T1",1,1,-1,"A"
1997-05-04,1996,"Galatasaray","Zeytinburnu","4-0",4,0,"T1",1,4,4,"H"
1997-05-04,1996,"Gaziantepspor","Ankaragucu","3-2",3,2,"T1",1,5,1,"H"
1997-05-04,1996,"Genclerbirligi","Trabzonspor","1-1",1,1,"T1",1,2,0,"D"
1997-05-04,1996,"Istanbulspor","Besiktas","4-3",4,3,"T1",1,7,1,"H"
1997-05-04,1996,"Samsunspor","Bursaspor","2-3",2,3,"T1",1,5,-1,"A"
1997-05-04,1996,"Sariyer","Fenerbahce","1-4",1,4,"T1",1,5,-3,"A"
1997-05-11,1996,"Ankaragucu","Altay","1-0",1,0,"T1",1,1,1,"H"
1997-05-11,1996,"Antalyaspor","Galatasaray","0-2",0,2,"T1",1,2,-2,"A"
1997-05-11,1996,"Besiktas","Zeytinburnu","4-1",4,1,"T1",1,5,3,"H"
1997-05-11,1996,"Bursaspor","Gaziantepspor","3-1",3,1,"T1",1,4,2,"H"
1997-05-11,1996,"Fenerbahce","Dardanelspor","4-0",4,0,"T1",1,4,4,"H"
1997-05-11,1996,"Istanbulspor","Sariyer","2-1",2,1,"T1",1,3,1,"H"
1997-05-11,1996,"Kocaelispor","Genclerbirligi","3-1",3,1,"T1",1,4,2,"H"
1997-05-11,1996,"Trabzonspor","Denizlispor","2-1",2,1,"T1",1,3,1,"H"
1997-05-11,1996,"Vanspor","Samsunspor","3-2",3,2,"T1",1,5,1,"H"
1997-05-18,1996,"Altay","Bursaspor","1-1",1,1,"T1",1,2,0,"D"
1997-05-18,1996,"Besiktas","Antalyaspor","4-0",4,0,"T1",1,4,4,"H"
1997-05-18,1996,"Dardanelspor","Sariyer","1-0",1,0,"T1",1,1,1,"H"
1997-05-18,1996,"Denizlispor","Kocaelispor","0-0",0,0,"T1",1,0,0,"D"
1997-05-18,1996,"Galatasaray","Ankaragucu","5-1",5,1,"T1",1,6,4,"H"
1997-05-18,1996,"Gaziantepspor","Vanspor","0-1",0,1,"T1",1,1,-1,"A"
1997-05-18,1996,"Genclerbirligi","Fenerbahce","4-1",4,1,"T1",1,5,3,"H"
1997-05-18,1996,"Samsunspor","Trabzonspor","0-2",0,2,"T1",1,2,-2,"A"
1997-05-18,1996,"Zeytinburnu","Istanbulspor","0-2",0,2,"T1",1,2,-2,"A"
1997-05-25,1996,"Ankaragucu","Besiktas","0-2",0,2,"T1",1,2,-2,"A"
1997-05-25,1996,"Antalyaspor","Zeytinburnu","1-0",1,0,"T1",1,1,1,"H"
1997-05-25,1996,"Bursaspor","Galatasaray","2-3",2,3,"T1",1,5,-1,"A"
1997-05-25,1996,"Fenerbahce","Denizlispor","7-0",7,0,"T1",1,7,7,"H"
1997-05-25,1996,"Istanbulspor","Dardanelspor","4-2",4,2,"T1",1,6,2,"H"
1997-05-25,1996,"Kocaelispor","Samsunspor","2-5",2,5,"T1",1,7,-3,"A"
1997-05-25,1996,"Sariyer","Genclerbirligi","2-1",2,1,"T1",1,3,1,"H"
1997-05-25,1996,"Trabzonspor","Gaziantepspor","5-0",5,0,"T1",1,5,5,"H"
1997-05-25,1996,"Vanspor","Altay","3-0",3,0,"T1",1,3,3,"H"
1997-08-03,1997,"Ankaragucu","Galatasaray","0-0",0,0,"T1",1,0,0,"D"
1997-08-03,1997,"Besiktas","Sekerspor","2-1",2,1,"T1",1,3,1,"H"
1997-08-03,1997,"Bursaspor","Altay","1-0",1,0,"T1",1,1,1,"H"
1997-08-03,1997,"Dardanelspor","Istanbulspor","1-1",1,1,"T1",1,2,0,"D"
1997-08-03,1997,"Fenerbahce","Gaziantepspor","1-0",1,0,"T1",1,1,1,"H"
1997-08-03,1997,"Genclerbirligi","Antalyaspor","0-0",0,0,"T1",1,0,0,"D"
1997-08-03,1997,"Karabukspor","Kayseri","3-0",3,0,"T1",1,3,3,"H"
1997-08-03,1997,"Kocaelispor","Trabzonspor","1-3",1,3,"T1",1,4,-2,"A"
1997-08-03,1997,"Samsunspor","Vanspor","2-0",2,0,"T1",1,2,2,"H"
1997-08-10,1997,"Altay","Kocaelispor","1-0",1,0,"T1",1,1,1,"H"
1997-08-10,1997,"Galatasaray","Bursaspor","4-0",4,0,"T1",1,4,4,"H"
1997-08-10,1997,"Gaziantepspor","Antalyaspor","1-3",1,3,"T1",1,4,-2,"A"
1997-08-10,1997,"Genclerbirligi","Besiktas","2-2",2,2,"T1",1,4,0,"D"
1997-08-10,1997,"Istanbulspor","Karabukspor","2-1",2,1,"T1",1,3,1,"H"
1997-08-10,1997,"Kayseri","Ankaragucu","1-1",1,1,"T1",1,2,0,"D"
1997-08-10,1997,"Samsunspor","Fenerbahce","0-2",0,2,"T1",1,2,-2,"A"
1997-08-10,1997,"Sekerspor","Dardanelspor","1-4",1,4,"T1",1,5,-3,"A"
1997-08-10,1997,"Trabzonspor","Vanspor","2-0",2,0,"T1",1,2,2,"H"
1997-08-24,1997,"Altay","Vanspor","3-2",3,2,"T1",1,5,1,"H"
1997-08-24,1997,"Ankaragucu","Istanbulspor","0-5",0,5,"T1",1,5,-5,"A"
1997-08-24,1997,"Besiktas","Gaziantepspor","2-1",2,1,"T1",1,3,1,"H"
1997-08-24,1997,"Bursaspor","Kayseri","1-0",1,0,"T1",1,1,1,"H"
1997-08-24,1997,"Dardanelspor","Karabukspor","1-1",1,1,"T1",1,2,0,"D"
1997-08-24,1997,"Fenerbahce","Trabzonspor","1-3",1,3,"T1",1,4,-2,"A"
1997-08-24,1997,"Kocaelispor","Galatasaray","1-1",1,1,"T1",1,2,0,"D"
1997-08-24,1997,"Samsunspor","Antalyaspor","2-2",2,2,"T1",1,4,0,"D"
1997-08-24,1997,"Sekerspor","Genclerbirligi","0-0",0,0,"T1",1,0,0,"D"
1997-08-31,1997,"Altay","Fenerbahce","0-2",0,2,"T1",1,2,-2,"A"
1997-08-31,1997,"Galatasaray","Vanspor","6-2",6,2,"T1",1,8,4,"H"
1997-08-31,1997,"Gaziantepspor","Sekerspor","1-1",1,1,"T1",1,2,0,"D"
1997-08-31,1997,"Genclerbirligi","Dardanelspor","3-0",3,0,"T1",1,3,3,"H"
1997-08-31,1997,"Istanbulspor","Bursaspor","1-1",1,1,"T1",1,2,0,"D"
1997-08-31,1997,"Karabukspor","Ankaragucu","1-0",1,0,"T1",1,1,1,"H"
1997-08-31,1997,"Kayseri","Kocaelispor","2-1",2,1,"T1",1,3,1,"H"
1997-08-31,1997,"Samsunspor","Besiktas","0-0",0,0,"T1",1,0,0,"D"
1997-08-31,1997,"Trabzonspor","Antalyaspor","2-2",2,2,"T1",1,4,0,"D"
1997-09-07,1997,"Altay","Antalyaspor","0-3",0,3,"T1",1,3,-3,"A"
1997-09-07,1997,"Besiktas","Trabzonspor","3-0",3,0,"T1",1,3,3,"H"
1997-09-07,1997,"Bursaspor","Karabukspor","4-0",4,0,"T1",1,4,4,"H"
1997-09-07,1997,"Dardanelspor","Ankaragucu","1-1",1,1,"T1",1,2,0,"D"
1997-09-07,1997,"Fenerbahce","Galatasaray","3-1",3,1,"T1",1,4,2,"H"
1997-09-07,1997,"Genclerbirligi","Gaziantepspor","0-1",0,1,"T1",1,1,-1,"A"
1997-09-07,1997,"Kayseri","Vanspor","1-1",1,1,"T1",1,2,0,"D"
1997-09-07,1997,"Kocaelispor","Istanbulspor","3-0",3,0,"T1",1,3,3,"H"
1997-09-07,1997,"Sekerspor","Samsunspor","2-1",2,1,"T1",1,3,1,"H"
1997-09-14,1997,"Altay","Besiktas","1-2",1,2,"T1",1,3,-1,"A"
1997-09-14,1997,"Ankaragucu","Bursaspor","1-2",1,2,"T1",1,3,-1,"A"
1997-09-14,1997,"Galatasaray","Antalyaspor","2-1",2,1,"T1",1,3,1,"H"
1997-09-14,1997,"Gaziantepspor","Dardanelspor","2-2",2,2,"T1",1,4,0,"D"
1997-09-14,1997,"Istanbulspor","Vanspor","6-3",6,3,"T1",1,9,3,"H"
1997-09-14,1997,"Karabukspor","Kocaelispor","1-0",1,0,"T1",1,1,1,"H"
1997-09-14,1997,"Kayseri","Fenerbahce","0-3",0,3,"T1",1,3,-3,"A"
1997-09-14,1997,"Samsunspor","Genclerbirligi","3-1",3,1,"T1",1,4,2,"H"
1997-09-14,1997,"Trabzonspor","Sekerspor","6-3",6,3,"T1",1,9,3,"H"
1997-09-21,1997,"Fenerbahce","Istanbulspor","3-0",3,0,"T1",1,3,3,"H"
1997-09-21,1997,"Genclerbirligi","Trabzonspor","0-1",0,1,"T1",1,1,-1,"A"
1997-09-21,1997,"Sekerspor","Altay","0-0",0,0,"T1",1,0,0,"D"
1997-09-22,1997,"Besiktas","Galatasaray","2-1",2,1,"T1",1,3,1,"H"
1997-09-22,1997,"Dardanelspor","Bursaspor","0-0",0,0,"T1",1,0,0,"D"
1997-09-22,1997,"Gaziantepspor","Samsunspor","2-0",2,0,"T1",1,2,2,"H"
1997-09-22,1997,"Kayseri","Antalyaspor","3-1",3,1,"T1",1,4,2,"H"
1997-09-22,1997,"Kocaelispor","Ankaragucu","2-0",2,0,"T1",1,2,2,"H"
1997-09-22,1997,"Vanspor","Karabukspor","0-1",0,1,"T1",1,1,-1,"A"
1997-09-28,1997,"Altay","Genclerbirligi","0-0",0,0,"T1",1,0,0,"D"
1997-09-28,1997,"Ankaragucu","Vanspor","2-0",2,0,"T1",1,2,2,"H"
1997-09-28,1997,"Bursaspor","Kocaelispor","1-2",1,2,"T1",1,3,-1,"A"
1997-09-28,1997,"Galatasaray","Sekerspor","4-1",4,1,"T1",1,5,3,"H"
1997-09-28,1997,"Istanbulspor","Antalyaspor","5-2",5,2,"T1",1,7,3,"H"
1997-09-28,1997,"Karabukspor","Fenerbahce","1-2",1,2,"T1",1,3,-1,"A"
1997-09-28,1997,"Kayseri","Besiktas","1-0",1,0,"T1",1,1,1,"H"
1997-09-28,1997,"Samsunspor","Dardanelspor","3-0",3,0,"T1",1,3,3,"H"
1997-09-28,1997,"Trabzonspor","Gaziantepspor","1-0",1,0,"T1",1,1,1,"H"
1997-10-05,1997,"Besiktas","Istanbulspor","0-0",0,0,"T1",1,0,0,"D"
1997-10-05,1997,"Dardanelspor","Kocaelispor","2-0",2,0,"T1",1,2,2,"H"
1997-10-05,1997,"Fenerbahce","Ankaragucu","0-0",0,0,"T1",1,0,0,"D"
1997-10-05,1997,"Gaziantepspor","Altay","3-0",3,0,"T1",1,3,3,"H"
1997-10-05,1997,"Genclerbirligi","Galatasaray","3-2",3,2,"T1",1,5,1,"H"
1997-10-05,1997,"Karabukspor","Antalyaspor","3-0",3,0,"T1",1,3,3,"H"
1997-10-05,1997,"Samsunspor","Trabzonspor","2-1",2,1,"T1",1,3,1,"H"
1997-10-05,1997,"Sekerspor","Kayseri","0-1",0,1,"T1",1,1,-1,"A"
1997-10-05,1997,"Vanspor","Bursaspor","1-1",1,1,"T1",1,2,0,"D"
1997-10-19,1997,"Altay","Samsunspor","2-5",2,5,"T1",1,7,-3,"A"
1997-10-19,1997,"Ankaragucu","Antalyaspor","2-0",2,0,"T1",1,2,2,"H"
1997-10-19,1997,"Bursaspor","Fenerbahce","1-1",1,1,"T1",1,2,0,"D"
1997-10-19,1997,"Galatasaray","Gaziantepspor","1-0",1,0,"T1",1,1,1,"H"
1997-10-19,1997,"Istanbulspor","Sekerspor","4-1",4,1,"T1",1,5,3,"H"
1997-10-19,1997,"Karabukspor","Besiktas","0-5",0,5,"T1",1,5,-5,"A"
1997-10-19,1997,"Kayseri","Genclerbirligi","2-0",2,0,"T1",1,2,2,"H"
1997-10-19,1997,"Kocaelispor","Vanspor","4-2",4,2,"T1",1,6,2,"H"
1997-10-19,1997,"Trabzonspor","Dardanelspor","0-2",0,2,"T1",1,2,-2,"A"
1997-11-02,1997,"Besiktas","Ankaragucu","1-0",1,0,"T1",1,1,1,"H"
1997-11-02,1997,"Bursaspor","Antalyaspor","4-1",4,1,"T1",1,5,3,"H"
1997-11-02,1997,"Dardanelspor","Vanspor","2-0",2,0,"T1",1,2,2,"H"
1997-11-02,1997,"Fenerbahce","Kocaelispor","2-0",2,0,"T1",1,2,2,"H"
1997-11-02,1997,"Gaziantepspor","Kayseri","3-2",3,2,"T1",1,5,1,"H"
1997-11-02,1997,"Genclerbirligi","Istanbulspor","1-0",1,0,"T1",1,1,1,"H"
1997-11-02,1997,"Samsunspor","Galatasaray","0-2",0,2,"T1",1,2,-2,"A"
1997-11-02,1997,"Sekerspor","Karabukspor","1-0",1,0,"T1",1,1,1,"H"
1997-11-02,1997,"Trabzonspor","Altay","3-0",3,0,"T1",1,3,3,"H"
1997-11-09,1997,"Altay","Dardanelspor","1-0",1,0,"T1",1,1,1,"H"
1997-11-09,1997,"Ankaragucu","Sekerspor","1-1",1,1,"T1",1,2,0,"D"
1997-11-09,1997,"Bursaspor","Besiktas","2-1",2,1,"T1",1,3,1,"H"
1997-11-09,1997,"Galatasaray","Trabzonspor","2-2",2,2,"T1",1,4,0,"D"
1997-11-09,1997,"Istanbulspor","Gaziantepspor","4-1",4,1,"T1",1,5,3,"H"
1997-11-09,1997,"Karabukspor","Genclerbirligi","1-0",1,0,"T1",1,1,1,"H"
1997-11-09,1997,"Kayseri","Samsunspor","0-1",0,1,"T1",1,1,-1,"A"
1997-11-09,1997,"Kocaelispor","Antalyaspor","2-1",2,1,"T1",1,3,1,"H"
1997-11-09,1997,"Vanspor","Fenerbahce","0-1",0,1,"T1",1,1,-1,"A"
1997-11-16,1997,"Altay","Galatasaray","4-5",4,5,"T1",1,9,-1,"A"
1997-11-16,1997,"Besiktas","Kocaelispor","1-1",1,1,"T1",1,2,0,"D"
1997-11-16,1997,"Dardanelspor","Fenerbahce","0-1",0,1,"T1",1,1,-1,"A"
1997-11-16,1997,"Gaziantepspor","Karabukspor","2-2",2,2,"T1",1,4,0,"D"
1997-11-16,1997,"Genclerbirligi","Ankaragucu","1-2",1,2,"T1",1,3,-1,"A"
1997-11-16,1997,"Samsunspor","Istanbulspor","0-0",0,0,"T1",1,0,0,"D"
1997-11-16,1997,"Sekerspor","Bursaspor","3-1",3,1,"T1",1,4,2,"H"
1997-11-16,1997,"Trabzonspor","Kayseri","2-0",2,0,"T1",1,2,2,"H"
1997-11-16,1997,"Vanspor","Antalyaspor","0-3",0,3,"T1",1,3,-3,"A"
1997-11-23,1997,"Ankaragucu","Gaziantepspor","2-0",2,0,"T1",1,2,2,"H"
1997-11-23,1997,"Bursaspor","Genclerbirligi","2-1",2,1,"T1",1,3,1,"H"
1997-11-23,1997,"Fenerbahce","Antalyaspor","2-1",2,1,"T1",1,3,1,"H"
1997-11-23,1997,"Galatasaray","Dardanelspor","1-0",1,0,"T1",1,1,1,"H"
1997-11-23,1997,"Istanbulspor","Trabzonspor","0-0",0,0,"T1",1,0,0,"D"
1997-11-23,1997,"Karabukspor","Samsunspor","2-1",2,1,"T1",1,3,1,"H"
1997-11-23,1997,"Kayseri","Altay","1-1",1,1,"T1",1,2,0,"D"
1997-11-23,1997,"Kocaelispor","Sekerspor","3-0",3,0,"T1",1,3,3,"H"
1997-11-23,1997,"Vanspor","Besiktas","1-7",1,7,"T1",1,8,-6,"A"
1997-12-07,1997,"Altay","Istanbulspor","1-3",1,3,"T1",1,4,-2,"A"
1997-12-07,1997,"Antalyaspor","Dardanelspor","0-0",0,0,"T1",1,0,0,"D"
1997-12-07,1997,"Besiktas","Fenerbahce","2-2",2,2,"T1",1,4,0,"D"
1997-12-07,1997,"Gaziantepspor","Bursaspor","1-2",1,2,"T1",1,3,-1,"A"
1997-12-07,1997,"Genclerbirligi","Kocaelispor","0-0",0,0,"T1",1,0,0,"D"
1997-12-07,1997,"Kayseri","Galatasaray","1-2",1,2,"T1",1,3,-1,"A"
1997-12-07,1997,"Samsunspor","Ankaragucu","0-2",0,2,"T1",1,2,-2,"A"
1997-12-07,1997,"Sekerspor","Vanspor","1-1",1,1,"T1",1,2,0,"D"
1997-12-07,1997,"Trabzonspor","Karabukspor","2-0",2,0,"T1",1,2,2,"H"
1997-12-14,1997,"Ankaragucu","Trabzonspor","1-3",1,3,"T1",1,4,-2,"A"
1997-12-14,1997,"Antalyaspor","Besiktas","3-3",3,3,"T1",1,6,0,"D"
1997-12-14,1997,"Bursaspor","Samsunspor","2-3",2,3,"T1",1,5,-1,"A"
1997-12-14,1997,"Dardanelspor","Kayseri","3-0",3,0,"T1",1,3,3,"H"
1997-12-14,1997,"Fenerbahce","Sekerspor","7-0",7,0,"T1",1,7,7,"H"
1997-12-14,1997,"Istanbulspor","Galatasaray","2-1",2,1,"T1",1,3,1,"H"
1997-12-14,1997,"Karabukspor","Altay","1-1",1,1,"T1",1,2,0,"D"
1997-12-14,1997,"Kocaelispor","Gaziantepspor","1-1",1,1,"T1",1,2,0,"D"
1997-12-14,1997,"Vanspor","Genclerbirligi","0-0",0,0,"T1",1,0,0,"D"
1997-12-21,1997,"Altay","Ankaragucu","3-0",3,0,"T1",1,3,3,"H"
1997-12-21,1997,"Besiktas","Dardanelspor","1-2",1,2,"T1",1,3,-1,"A"
1997-12-21,1997,"Galatasaray","Karabukspor","3-0",3,0,"T1",1,3,3,"H"
1997-12-21,1997,"Gaziantepspor","Vanspor","0-0",0,0,"T1",1,0,0,"D"
1997-12-21,1997,"Genclerbirligi","Fenerbahce","3-0",3,0,"T1",1,3,3,"H"
1997-12-21,1997,"Kayseri","Istanbulspor","0-0",0,0,"T1",1,0,0,"D"
1997-12-21,1997,"Samsunspor","Kocaelispor","1-1",1,1,"T1",1,2,0,"D"
1997-12-21,1997,"Sekerspor","Antalyaspor","2-1",2,1,"T1",1,3,1,"H"
1997-12-21,1997,"Trabzonspor","Bursaspor","1-0",1,0,"T1",1,1,1,"H"
1998-01-18,1997,"Altay","Bursaspor","2-1",2,1,"T1",1,3,1,"H"
1998-01-18,1997,"Antalyaspor","Genclerbirligi","2-1",2,1,"T1",1,3,1,"H"
1998-01-18,1997,"Galatasaray","Ankaragucu","2-1",2,1,"T1",1,3,1,"H"
1998-01-18,1997,"Gaziantepspor","Fenerbahce","2-0",2,0,"T1",1,2,2,"H"
1998-01-18,1997,"Istanbulspor","Dardanelspor","3-1",3,1,"T1",1,4,2,"H"
1998-01-18,1997,"Kayseri","Karabukspor","0-1",0,1,"T1",1,1,-1,"A"
1998-01-18,1997,"Sekerspor","Besiktas","2-0",2,0,"T1",1,2,2,"H"
1998-01-18,1997,"Trabzonspor","Kocaelispor","2-2",2,2,"T1",1,4,0,"D"
1998-01-18,1997,"Vanspor","Samsunspor","1-0",1,0,"T1",1,1,1,"H"
1998-01-25,1997,"Ankaragucu","Kayseri","6-3",6,3,"T1",1,9,3,"H"
1998-01-25,1997,"Antalyaspor","Gaziantepspor","2-1",2,1,"T1",1,3,1,"H"
1998-01-25,1997,"Besiktas","Genclerbirligi","3-1",3,1,"T1",1,4,2,"H"
1998-01-25,1997,"Bursaspor","Galatasaray","3-2",3,2,"T1",1,5,1,"H"
1998-01-25,1997,"Dardanelspor","Sekerspor","4-1",4,1,"T1",1,5,3,"H"
1998-01-25,1997,"Fenerbahce","Samsunspor","0-0",0,0,"T1",1,0,0,"D"
1998-01-25,1997,"Karabukspor","Istanbulspor","0-1",0,1,"T1",1,1,-1,"A"
1998-01-25,1997,"Kocaelispor","Altay","0-1",0,1,"T1",1,1,-1,"A"
1998-01-25,1997,"Vanspor","Trabzonspor","0-2",0,2,"T1",1,2,-2,"A"
1998-02-01,1997,"Antalyaspor","Samsunspor","1-2",1,2,"T1",1,3,-1,"A"
1998-02-01,1997,"Galatasaray","Kocaelispor","2-0",2,0,"T1",1,2,2,"H"
1998-02-01,1997,"Gaziantepspor","Besiktas","1-1",1,1,"T1",1,2,0,"D"
1998-02-01,1997,"Genclerbirligi","Sekerspor","3-0",3,0,"T1",1,3,3,"H"
1998-02-01,1997,"Istanbulspor","Ankaragucu","1-1",1,1,"T1",1,2,0,"D"
1998-02-01,1997,"Karabukspor","Dardanelspor","0-0",0,0,"T1",1,0,0,"D"
1998-02-01,1997,"Kayseri","Bursaspor","2-1",2,1,"T1",1,3,1,"H"
1998-02-01,1997,"Trabzonspor","Fenerbahce","0-0",0,0,"T1",1,0,0,"D"
1998-02-01,1997,"Vanspor","Altay","0-0",0,0,"T1",1,0,0,"D"
1998-02-08,1997,"Ankaragucu","Karabukspor","3-2",3,2,"T1",1,5,1,"H"
1998-02-08,1997,"Antalyaspor","Trabzonspor","1-1",1,1,"T1",1,2,0,"D"
1998-02-08,1997,"Besiktas","Samsunspor","0-1",0,1,"T1",1,1,-1,"A"
1998-02-08,1997,"Bursaspor","Istanbulspor","1-1",1,1,"T1",1,2,0,"D"
1998-02-08,1997,"Dardanelspor","Genclerbirligi","1-2",1,2,"T1",1,3,-1,"A"
1998-02-08,1997,"Fenerbahce","Altay","2-0",2,0,"T1",1,2,2,"H"
1998-02-08,1997,"Kocaelispor","Kayseri","3-1",3,1,"T1",1,4,2,"H"
1998-02-08,1997,"Sekerspor","Gaziantepspor","4-3",4,3,"T1",1,7,1,"H"
1998-02-08,1997,"Vanspor","Galatasaray","0-3",0,3,"T1",1,3,-3,"A"
1998-02-15,1997,"Ankaragucu","Dardanelspor","1-0",1,0,"T1",1,1,1,"H"
1998-02-15,1997,"Antalyaspor","Altay","0-0",0,0,"T1",1,0,0,"D"
1998-02-15,1997,"Galatasaray","Fenerbahce","2-2",2,2,"T1",1,4,0,"D"
1998-02-15,1997,"Gaziantepspor","Genclerbirligi","1-1",1,1,"T1",1,2,0,"D"
1998-02-15,1997,"Istanbulspor","Kocaelispor","0-1",0,1,"T1",1,1,-1,"A"
1998-02-15,1997,"Karabukspor","Bursaspor","2-0",2,0,"T1",1,2,2,"H"
1998-02-15,1997,"Samsunspor","Sekerspor","3-0",3,0,"T1",1,3,3,"H"
1998-02-15,1997,"Trabzonspor","Besiktas","3-1",3,1,"T1",1,4,2,"H"
1998-02-15,1997,"Vanspor","Kayseri","1-2",1,2,"T1",1,3,-1,"A"
1998-02-22,1997,"Antalyaspor","Galatasaray","1-3",1,3,"T1",1,4,-2,"A"
1998-02-22,1997,"Besiktas","Altay","0-1",0,1,"T1",1,1,-1,"A"
1998-02-22,1997,"Bursaspor","Ankaragucu","1-0",1,0,"T1",1,1,1,"H"
1998-02-22,1997,"Dardanelspor","Gaziantepspor","1-0",1,0,"T1",1,1,1,"H"
1998-02-22,1997,"Fenerbahce","Kayseri","1-2",1,2,"T1",1,3,-1,"A"
1998-02-22,1997,"Genclerbirligi","Samsunspor","1-1",1,1,"T1",1,2,0,"D"
1998-02-22,1997,"Kocaelispor","Karabukspor","2-3",2,3,"T1",1,5,-1,"A"
1998-02-22,1997,"Sekerspor","Trabzonspor","0-2",0,2,"T1",1,2,-2,"A"
1998-02-22,1997,"Vanspor","Istanbulspor","1-1",1,1,"T1",1,2,0,"D"
1998-03-01,1997,"Altay","Sekerspor","2-0",2,0,"T1",1,2,2,"H"
1998-03-01,1997,"Ankaragucu","Kocaelispor","2-0",2,0,"T1",1,2,2,"H"
1998-03-01,1997,"Antalyaspor","Kayseri","2-1",2,1,"T1",1,3,1,"H"
1998-03-01,1997,"Bursaspor","Dardanelspor","0-0",0,0,"T1",1,0,0,"D"
1998-03-01,1997,"Galatasaray","Besiktas","3-2",3,2,"T1",1,5,1,"H"
1998-03-01,1997,"Istanbulspor","Fenerbahce","0-1",0,1,"T1",1,1,-1,"A"
1998-03-01,1997,"Karabukspor","Vanspor","2-1",2,1,"T1",1,3,1,"H"
1998-03-01,1997,"Samsunspor","Gaziantepspor","1-0",1,0,"T1",1,1,1,"H"
1998-03-01,1997,"Trabzonspor","Genclerbirligi","4-5",4,5,"T1",1,9,-1,"A"
1998-03-08,1997,"Antalyaspor","Istanbulspor","1-3",1,3,"T1",1,4,-2,"A"
1998-03-08,1997,"Besiktas","Kayseri","4-1",4,1,"T1",1,5,3,"H"
1998-03-08,1997,"Dardanelspor","Samsunspor","0-0",0,0,"T1",1,0,0,"D"
1998-03-08,1997,"Fenerbahce","Karabukspor","2-0",2,0,"T1",1,2,2,"H"
1998-03-08,1997,"Gaziantepspor","Trabzonspor","1-3",1,3,"T1",1,4,-2,"A"
1998-03-08,1997,"Genclerbirligi","Altay","1-3",1,3,"T1",1,4,-2,"A"
1998-03-08,1997,"Kocaelispor","Bursaspor","1-2",1,2,"T1",1,3,-1,"A"
1998-03-08,1997,"Sekerspor","Galatasaray","2-4",2,4,"T1",1,6,-2,"A"
1998-03-08,1997,"Vanspor","Ankaragucu","1-0",1,0,"T1",1,1,1,"H"
1998-03-15,1997,"Altay","Gaziantepspor","0-0",0,0,"T1",1,0,0,"D"
1998-03-15,1997,"Ankaragucu","Fenerbahce","0-2",0,2,"T1",1,2,-2,"A"
1998-03-15,1997,"Antalyaspor","Karabukspor","4-0",4,0,"T1",1,4,4,"H"
1998-03-15,1997,"Bursaspor","Vanspor","6-0",6,0,"T1",1,6,6,"H"
1998-03-15,1997,"Galatasaray","Genclerbirligi","3-1",3,1,"T1",1,4,2,"H"
1998-03-15,1997,"Istanbulspor","Besiktas","1-2",1,2,"T1",1,3,-1,"A"
1998-03-15,1997,"Kayseri","Sekerspor","0-1",0,1,"T1",1,1,-1,"A"
1998-03-15,1997,"Kocaelispor","Dardanelspor","3-1",3,1,"T1",1,4,2,"H"
1998-03-15,1997,"Trabzonspor","Samsunspor","4-0",4,0,"T1",1,4,4,"H"
1998-03-22,1997,"Antalyaspor","Ankaragucu","1-1",1,1,"T1",1,2,0,"D"
1998-03-22,1997,"Besiktas","Karabukspor","1-0",1,0,"T1",1,1,1,"H"
1998-03-22,1997,"Dardanelspor","Trabzonspor","2-1",2,1,"T1",1,3,1,"H"
1998-03-22,1997,"Fenerbahce","Bursaspor","3-0",3,0,"T1",1,3,3,"H"
1998-03-22,1997,"Gaziantepspor","Galatasaray","1-1",1,1,"T1",1,2,0,"D"
1998-03-22,1997,"Genclerbirligi","Kayseri","2-1",2,1,"T1",1,3,1,"H"
1998-03-22,1997,"Samsunspor","Altay","2-3",2,3,"T1",1,5,-1,"A"
1998-03-22,1997,"Sekerspor","Istanbulspor","0-2",0,2,"T1",1,2,-2,"A"
1998-03-22,1997,"Vanspor","Kocaelispor","2-1",2,1,"T1",1,3,1,"H"
1998-03-27,1997,"Kocaelispor","Fenerbahce","2-1",2,1,"T1",1,3,1,"H"
1998-03-28,1997,"Altay","Trabzonspor","1-1",1,1,"T1",1,2,0,"D"
1998-03-28,1997,"Istanbulspor","Genclerbirligi","3-3",3,3,"T1",1,6,0,"D"
1998-03-29,1997,"Ankaragucu","Besiktas","2-1",2,1,"T1",1,3,1,"H"
1998-03-29,1997,"Antalyaspor","Bursaspor","2-2",2,2,"T1",1,4,0,"D"
1998-03-29,1997,"Galatasaray","Samsunspor","2-1",2,1,"T1",1,3,1,"H"
1998-03-29,1997,"Karabukspor","Sekerspor","1-0",1,0,"T1",1,1,1,"H"
1998-03-29,1997,"Kayseri","Gaziantepspor","1-0",1,0,"T1",1,1,1,"H"
1998-03-29,1997,"Vanspor","Dardanelspor","3-0",3,0,"T1",1,3,3,"H"
1998-04-03,1997,"Antalyaspor","Kocaelispor","2-0",2,0,"T1",1,2,2,"H"
1998-04-04,1997,"Besiktas","Bursaspor","1-1",1,1,"T1",1,2,0,"D"
1998-04-04,1997,"Genclerbirligi","Karabukspor","2-0",2,0,"T1",1,2,2,"H"
1998-04-04,1997,"Trabzonspor","Galatasaray","1-1",1,1,"T1",1,2,0,"D"
1998-04-05,1997,"Dardanelspor","Altay","2-2",2,2,"T1",1,4,0,"D"
1998-04-05,1997,"Fenerbahce","Vanspor","4-1",4,1,"T1",1,5,3,"H"
1998-04-05,1997,"Gaziantepspor","Istanbulspor","0-0",0,0,"T1",1,0,0,"D"
1998-04-05,1997,"Samsunspor","Kayseri","2-0",2,0,"T1",1,2,2,"H"
1998-04-05,1997,"Sekerspor","Ankaragucu","1-1",1,1,"T1",1,2,0,"D"
1998-04-10,1997,"Istanbulspor","Samsunspor","4-2",4,2,"T1",1,6,2,"H"
1998-04-11,1997,"Fenerbahce","Dardanelspor","2-1",2,1,"T1",1,3,1,"H"
1998-04-11,1997,"Kocaelispor","Besiktas","3-2",3,2,"T1",1,5,1,"H"
1998-04-12,1997,"Ankaragucu","Genclerbirligi","2-0",2,0,"T1",1,2,2,"H"
1998-04-12,1997,"Antalyaspor","Vanspor","2-0",2,0,"T1",1,2,2,"H"
1998-04-12,1997,"Bursaspor","Sekerspor","0-6",0,6,"T1",1,6,-6,"A"
1998-04-12,1997,"Galatasaray","Altay","6-1",6,1,"T1",1,7,5,"H"
1998-04-12,1997,"Karabukspor","Gaziantepspor","0-1",0,1,"T1",1,1,-1,"A"
1998-04-12,1997,"Kayseri","Trabzonspor","5-6",5,6,"T1",1,11,-1,"A"
1998-04-17,1997,"Genclerbirligi","Bursaspor","1-1",1,1,"T1",1,2,0,"D"
1998-04-18,1997,"Altay","Kayseri","1-1",1,1,"T1",1,2,0,"D"
1998-04-18,1997,"Dardanelspor","Galatasaray","1-2",1,2,"T1",1,3,-1,"A"
1998-04-18,1997,"Gaziantepspor","Ankaragucu","4-2",4,2,"T1",1,6,2,"H"
1998-04-18,1997,"Samsunspor","Karabukspor","0-1",0,1,"T1",1,1,-1,"A"
1998-04-18,1997,"Sekerspor","Kocaelispor","2-1",2,1,"T1",1,3,1,"H"
1998-04-18,1997,"Trabzonspor","Istanbulspor","0-3",0,3,"T1",1,3,-3,"A"
1998-04-19,1997,"Antalyaspor","Fenerbahce","1-1",1,1,"T1",1,2,0,"D"
1998-04-19,1997,"Besiktas","Vanspor","4-0",4,0,"T1",1,4,4,"H"
1998-04-25,1997,"Ankaragucu","Samsunspor","0-1",0,1,"T1",1,1,-1,"A"
1998-04-25,1997,"Bursaspor","Gaziantepspor","1-2",1,2,"T1",1,3,-1,"A"
1998-04-25,1997,"Dardanelspor","Antalyaspor","3-1",3,1,"T1",1,4,2,"H"
1998-04-25,1997,"Fenerbahce","Besiktas","2-0",2,0,"T1",1,2,2,"H"
1998-04-25,1997,"Galatasaray","Kayseri","5-1",5,1,"T1",1,6,4,"H"
1998-04-25,1997,"Istanbulspor","Altay","2-2",2,2,"T1",1,4,0,"D"
1998-04-25,1997,"Karabukspor","Trabzonspor","1-1",1,1,"T1",1,2,0,"D"
1998-04-25,1997,"Kocaelispor","Genclerbirligi","1-1",1,1,"T1",1,2,0,"D"
1998-04-25,1997,"Vanspor","Sekerspor","0-0",0,0,"T1",1,0,0,"D"
1998-05-01,1997,"Samsunspor","Bursaspor","2-0",2,0,"T1",1,2,2,"H"
1998-05-02,1997,"Genclerbirligi","Vanspor","1-2",1,2,"T1",1,3,-1,"A"
1998-05-02,1997,"Trabzonspor","Ankaragucu","3-1",3,1,"T1",1,4,2,"H"
1998-05-03,1997,"Altay","Karabukspor","5-1",5,1,"T1",1,6,4,"H"
1998-05-03,1997,"Besiktas","Antalyaspor","0-1",0,1,"T1",1,1,-1,"A"
1998-05-03,1997,"Galatasaray","Istanbulspor","4-1",4,1,"T1",1,5,3,"H"
1998-05-03,1997,"Gaziantepspor","Kocaelispor","3-0",3,0,"T1",1,3,3,"H"
1998-05-03,1997,"Kayseri","Dardanelspor","3-0",3,0,"T1",1,3,3,"H"
1998-05-03,1997,"Sekerspor","Fenerbahce","1-1",1,1,"T1",1,2,0,"D"
1998-05-08,1997,"Ankaragucu","Altay","2-3",2,3,"T1",1,5,-1,"A"
1998-05-09,1997,"Karabukspor","Galatasaray","2-3",2,3,"T1",1,5,-1,"A"
1998-05-09,1997,"Kocaelispor","Samsunspor","4-0",4,0,"T1",1,4,4,"H"
1998-05-10,1997,"Antalyaspor","Sekerspor","3-3",3,3,"T1",1,6,0,"D"
1998-05-10,1997,"Bursaspor","Trabzonspor","1-2",1,2,"T1",1,3,-1,"A"
1998-05-10,1997,"Dardanelspor","Besiktas","0-0",0,0,"T1",1,0,0,"D"
1998-05-10,1997,"Fenerbahce","Genclerbirligi","2-1",2,1,"T1",1,3,1,"H"
1998-05-10,1997,"Istanbulspor","Kayseri","1-3",1,3,"T1",1,4,-2,"A"
1998-05-10,1997,"Vanspor","Gaziantepspor","0-0",0,0,"T1",1,0,0,"D"
1998-08-07,1998,"Dardanelspor","Fenerbahce","0-0",0,0,"T1",1,0,0,"D"
1998-08-08,1998,"Adanaspor","Istanbulspor","0-1",0,1,"T1",1,1,-1,"A"
1998-08-08,1998,"Galatasaray","Altay","3-1",3,1,"T1",1,4,2,"H"
1998-08-08,1998,"Samsunspor","Kocaelispor","0-1",0,1,"T1",1,1,-1,"A"
1998-08-08,1998,"Trabzonspor","Gaziantepspor","0-1",0,1,"T1",1,1,-1,"A"
1998-08-09,1998,"Besiktas","Ankaragucu","4-1",4,1,"T1",1,5,3,"H"
1998-08-09,1998,"Bursaspor","Karabukspor","1-2",1,2,"T1",1,3,-1,"A"
1998-08-09,1998,"Genclerbirligi","Erzurum","5-1",5,1,"T1",1,6,4,"H"
1998-08-09,1998,"Sakaryaspor","Antalyaspor","0-0",0,0,"T1",1,0,0,"D"
1998-08-14,1998,"Antalyaspor","Besiktas","0-3",0,3,"T1",1,3,-3,"A"
1998-08-15,1998,"Fenerbahce","Genclerbirligi","3-0",3,0,"T1",1,3,3,"H"
1998-08-16,1998,"Altay","Trabzonspor","2-5",2,5,"T1",1,7,-3,"A"
1998-08-16,1998,"Ankaragucu","Dardanelspor","3-0",3,0,"T1",1,3,3,"H"
1998-08-16,1998,"Bursaspor","Galatasaray","0-5",0,5,"T1",1,5,-5,"A"
1998-08-16,1998,"Erzurum","Adanaspor","1-0",1,0,"T1",1,1,1,"H"
1998-08-16,1998,"Gaziantepspor","Sakaryaspor","2-0",2,0,"T1",1,2,2,"H"
1998-08-16,1998,"Istanbulspor","Samsunspor","2-1",2,1,"T1",1,3,1,"H"
1998-08-16,1998,"Kocaelispor","Karabukspor","2-0",2,0,"T1",1,2,2,"H"
1998-08-21,1998,"Adanaspor","Fenerbahce","0-3",0,3,"T1",1,3,-3,"A"
1998-08-22,1998,"Besiktas","Gaziantepspor","1-1",1,1,"T1",1,2,0,"D"
1998-08-22,1998,"Galatasaray","Kocaelispor","3-1",3,1,"T1",1,4,2,"H"
1998-08-22,1998,"Istanbulspor","Karabukspor","3-0",3,0,"T1",1,3,3,"H"
1998-08-22,1998,"Samsunspor","Erzurum","2-4",2,4,"T1",1,6,-2,"A"
1998-08-22,1998,"Trabzonspor","Bursaspor","2-0",2,0,"T1",1,2,2,"H"
1998-08-23,1998,"Ankaragucu","Antalyaspor","0-0",0,0,"T1",1,0,0,"D"
1998-08-23,1998,"Dardanelspor","Genclerbirligi","1-2",1,2,"T1",1,3,-1,"A"
1998-08-23,1998,"Sakaryaspor","Altay","1-2",1,2,"T1",1,3,-1,"A"
1998-08-28,1998,"Altay","Besiktas","0-1",0,1,"T1",1,1,-1,"A"
1998-08-29,1998,"Antalyaspor","Dardanelspor","2-0",2,0,"T1",1,2,2,"H"
1998-08-29,1998,"Bursaspor","Sakaryaspor","2-1",2,1,"T1",1,3,1,"H"
1998-08-29,1998,"Erzurum","Karabukspor","2-1",2,1,"T1",1,3,1,"H"
1998-08-29,1998,"Fenerbahce","Samsunspor","6-2",6,2,"T1",1,8,4,"H"
1998-08-29,1998,"Gaziantepspor","Ankaragucu","1-0",1,0,"T1",1,1,1,"H"
1998-08-29,1998,"Genclerbirligi","Adanaspor","2-1",2,1,"T1",1,3,1,"H"
1998-08-29,1998,"Istanbulspor","Galatasaray","1-4",1,4,"T1",1,5,-3,"A"
1998-08-29,1998,"Kocaelispor","Trabzonspor","1-1",1,1,"T1",1,2,0,"D"
1998-09-11,1998,"Trabzonspor","Istanbulspor","0-0",0,0,"T1",1,0,0,"D"
1998-09-12,1998,"Fenerbahce","Karabukspor","4-1",4,1,"T1",1,5,3,"H"
1998-09-12,1998,"Galatasaray","Erzurum","5-0",5,0,"T1",1,5,5,"H"
1998-09-12,1998,"Samsunspor","Genclerbirligi","2-4",2,4,"T1",1,6,-2,"A"
1998-09-13,1998,"Ankaragucu","Altay","2-1",2,1,"T1",1,3,1,"H"
1998-09-13,1998,"Antalyaspor","Gaziantepspor","3-1",3,1,"T1",1,4,2,"H"
1998-09-13,1998,"Besiktas","Bursaspor","3-3",3,3,"T1",1,6,0,"D"
1998-09-13,1998,"Dardanelspor","Adanaspor","0-1",0,1,"T1",1,1,-1,"A"
1998-09-13,1998,"Sakaryaspor","Kocaelispor","2-2",2,2,"T1",1,4,0,"D"
1998-09-18,1998,"Bursaspor","Ankaragucu","4-0",4,0,"T1",1,4,4,"H"
1998-09-19,1998,"Genclerbirligi","Karabukspor","2-1",2,1,"T1",1,3,1,"H"
1998-09-19,1998,"Istanbulspor","Sakaryaspor","4-0",4,0,"T1",1,4,4,"H"
1998-09-20,1998,"Adanaspor","Samsunspor","0-0",0,0,"T1",1,0,0,"D"
1998-09-20,1998,"Altay","Antalyaspor","2-4",2,4,"T1",1,6,-2,"A"
1998-09-20,1998,"Erzurum","Trabzonspor","2-2",2,2,"T1",1,4,0,"D"
1998-09-20,1998,"Fenerbahce","Galatasaray","2-2",2,2,"T1",1,4,0,"D"
1998-09-20,1998,"Gaziantepspor","Dardanelspor","1-0",1,0,"T1",1,1,1,"H"
1998-09-20,1998,"Kocaelispor","Besiktas","0-2",0,2,"T1",1,2,-2,"A"
1998-09-25,1998,"Ankaragucu","Kocaelispor","0-2",0,2,"T1",1,2,-2,"A"
1998-09-25,1998,"Antalyaspor","Bursaspor","0-0",0,0,"T1",1,0,0,"D"
1998-09-25,1998,"Besiktas","Istanbulspor","2-1",2,1,"T1",1,3,1,"H"
1998-09-25,1998,"Dardanelspor","Samsunspor","0-0",0,0,"T1",1,0,0,"D"
1998-09-25,1998,"Galatasaray","Genclerbirligi","0-2",0,2,"T1",1,2,-2,"A"
1998-09-25,1998,"Gaziantepspor","Altay","1-1",1,1,"T1",1,2,0,"D"
1998-09-25,1998,"Karabukspor","Adanaspor","2-0",2,0,"T1",1,2,2,"H"
1998-09-25,1998,"Sakaryaspor","Erzurum","1-1",1,1,"T1",1,2,0,"D"
1998-09-25,1998,"Trabzonspor","Fenerbahce","1-0",1,0,"T1",1,1,1,"H"
1998-10-18,1998,"Adanaspor","Galatasaray","2-2",2,2,"T1",1,4,0,"D"
1998-10-18,1998,"Altay","Dardanelspor","1-1",1,1,"T1",1,2,0,"D"
1998-10-18,1998,"Bursaspor","Gaziantepspor","2-1",2,1,"T1",1,3,1,"H"
1998-10-18,1998,"Erzurum","Besiktas","2-2",2,2,"T1",1,4,0,"D"
1998-10-18,1998,"Fenerbahce","Sakaryaspor","3-0",3,0,"T1",1,3,3,"H"
1998-10-18,1998,"Genclerbirligi","Trabzonspor","0-1",0,1,"T1",1,1,-1,"A"
1998-10-18,1998,"Istanbulspor","Ankaragucu","1-4",1,4,"T1",1,5,-3,"A"
1998-10-18,1998,"Kocaelispor","Antalyaspor","2-1",2,1,"T1",1,3,1,"H"
1998-10-18,1998,"Samsunspor","Karabukspor","2-1",2,1,"T1",1,3,1,"H"
1998-10-23,1998,"Trabzonspor","Adanaspor","2-0",2,0,"T1",1,2,2,"H"
1998-10-24,1998,"Antalyaspor","Istanbulspor","2-3",2,3,"T1",1,5,-1,"A"
1998-10-24,1998,"Galatasaray","Samsunspor","3-1",3,1,"T1",1,4,2,"H"
1998-10-25,1998,"Altay","Bursaspor","4-1",4,1,"T1",1,5,3,"H"
1998-10-25,1998,"Ankaragucu","Erzurum","3-0",3,0,"T1",1,3,3,"H"
1998-10-25,1998,"Besiktas","Fenerbahce","3-2",3,2,"T1",1,5,1,"H"
1998-10-25,1998,"Dardanelspor","Karabukspor","0-0",0,0,"T1",1,0,0,"D"
1998-10-25,1998,"Gaziantepspor","Kocaelispor","1-2",1,2,"T1",1,3,-1,"A"
1998-10-25,1998,"Sakaryaspor","Genclerbirligi","3-1",3,1,"T1",1,4,2,"H"
1998-10-30,1998,"Samsunspor","Trabzonspor","2-1",2,1,"T1",1,3,1,"H"
1998-10-31,1998,"Fenerbahce","Ankaragucu","2-1",2,1,"T1",1,3,1,"H"
1998-10-31,1998,"Istanbulspor","Gaziantepspor","0-0",0,0,"T1",1,0,0,"D"
1998-10-31,1998,"Karabukspor","Galatasaray","0-3",0,3,"T1",1,3,-3,"A"
1998-11-01,1998,"Adanaspor","Sakaryaspor","2-1",2,1,"T1",1,3,1,"H"
1998-11-01,1998,"Bursaspor","Dardanelspor","2-0",2,0,"T1",1,2,2,"H"
1998-11-01,1998,"Erzurum","Antalyaspor","0-1",0,1,"T1",1,1,-1,"A"
1998-11-01,1998,"Genclerbirligi","Besiktas","0-1",0,1,"T1",1,1,-1,"A"
1998-11-01,1998,"Kocaelispor","Altay","2-1",2,1,"T1",1,3,1,"H"
1998-11-06,1998,"Antalyaspor","Fenerbahce","1-0",1,0,"T1",1,1,1,"H"
1998-11-07,1998,"Trabzonspor","Karabukspor","1-0",1,0,"T1",1,1,1,"H"
1998-11-08,1998,"Altay","Istanbulspor","2-1",2,1,"T1",1,3,1,"H"
1998-11-08,1998,"Ankaragucu","Genclerbirligi","0-1",0,1,"T1",1,1,-1,"A"
1998-11-08,1998,"Besiktas","Adanaspor","2-0",2,0,"T1",1,2,2,"H"
1998-11-08,1998,"Bursaspor","Kocaelispor","2-1",2,1,"T1",1,3,1,"H"
1998-11-08,1998,"Dardanelspor","Galatasaray","0-5",0,5,"T1",1,5,-5,"A"
1998-11-08,1998,"Gaziantepspor","Erzurum","3-0",3,0,"T1",1,3,3,"H"
1998-11-08,1998,"Sakaryaspor","Samsunspor","0-1",0,1,"T1",1,1,-1,"A"
1998-11-13,1998,"Kocaelispor","Dardanelspor","2-0",2,0,"T1",1,2,2,"H"
1998-11-14,1998,"Erzurum","Altay","2-1",2,1,"T1",1,3,1,"H"
1998-11-14,1998,"Fenerbahce","Gaziantepspor","4-0",4,0,"T1",1,4,4,"H"
1998-11-14,1998,"Karabukspor","Sakaryaspor","1-2",1,2,"T1",1,3,-1,"A"
1998-11-15,1998,"Adanaspor","Ankaragucu","1-0",1,0,"T1",1,1,1,"H"
1998-11-15,1998,"Galatasaray","Trabzonspor","3-5",3,5,"T1",1,8,-2,"A"
1998-11-15,1998,"Genclerbirligi","Antalyaspor","1-2",1,2,"T1",1,3,-1,"A"
1998-11-15,1998,"Istanbulspor","Bursaspor","2-3",2,3,"T1",1,5,-1,"A"
1998-11-15,1998,"Samsunspor","Besiktas","0-3",0,3,"T1",1,3,-3,"A"
1998-11-20,1998,"Altay","Fenerbahce","0-4",0,4,"T1",1,4,-4,"A"
1998-11-21,1998,"Dardanelspor","Trabzonspor","2-3",2,3,"T1",1,5,-1,"A"
1998-11-21,1998,"Kocaelispor","Istanbulspor","0-1",0,1,"T1",1,1,-1,"A"
1998-11-21,1998,"Sakaryaspor","Galatasaray","0-0",0,0,"T1",1,0,0,"D"
1998-11-22,1998,"Ankaragucu","Samsunspor","3-4",3,4,"T1",1,7,-1,"A"
1998-11-22,1998,"Antalyaspor","Adanaspor","2-0",2,0,"T1",1,2,2,"H"
1998-11-22,1998,"Besiktas","Karabukspor","1-1",1,1,"T1",1,2,0,"D"
1998-11-22,1998,"Bursaspor","Erzurum","6-1",6,1,"T1",1,7,5,"H"
1998-11-22,1998,"Gaziantepspor","Genclerbirligi","2-2",2,2,"T1",1,4,0,"D"
1998-11-27,1998,"Adanaspor","Gaziantepspor","3-1",3,1,"T1",1,4,2,"H"
1998-11-28,1998,"Erzurum","Kocaelispor","0-0",0,0,"T1",1,0,0,"D"
1998-11-28,1998,"Istanbulspor","Dardanelspor","1-1",1,1,"T1",1,2,0,"D"
1998-11-28,1998,"Karabukspor","Ankaragucu","0-1",0,1,"T1",1,1,-1,"A"
1998-11-28,1998,"Trabzonspor","Sakaryaspor","2-1",2,1,"T1",1,3,1,"H"
1998-11-29,1998,"Fenerbahce","Bursaspor","4-1",4,1,"T1",1,5,3,"H"
1998-11-29,1998,"Genclerbirligi","Altay","1-1",1,1,"T1",1,2,0,"D"
1998-11-29,1998,"Samsunspor","Antalyaspor","0-1",0,1,"T1",1,1,-1,"A"
1998-12-04,1998,"Kocaelispor","Fenerbahce","0-3",0,3,"T1",1,3,-3,"A"
1998-12-05,1998,"Erzurum","Istanbulspor","2-4",2,4,"T1",1,6,-2,"A"
1998-12-06,1998,"Altay","Adanaspor","3-2",3,2,"T1",1,5,1,"H"
1998-12-06,1998,"Antalyaspor","Karabukspor","3-1",3,1,"T1",1,4,2,"H"
1998-12-06,1998,"Besiktas","Trabzonspor","2-0",2,0,"T1",1,2,2,"H"
1998-12-06,1998,"Bursaspor","Genclerbirligi","1-1",1,1,"T1",1,2,0,"D"
1998-12-06,1998,"Gaziantepspor","Samsunspor","1-1",1,1,"T1",1,2,0,"D"
1998-12-06,1998,"Sakaryaspor","Dardanelspor","1-3",1,3,"T1",1,4,-2,"A"
1998-12-11,1998,"Genclerbirligi","Kocaelispor","1-1",1,1,"T1",1,2,0,"D"
1998-12-12,1998,"Galatasaray","Antalyaspor","3-1",3,1,"T1",1,4,2,"H"
1998-12-12,1998,"Sakaryaspor","Besiktas","0-2",0,2,"T1",1,2,-2,"A"
1998-12-13,1998,"Adanaspor","Bursaspor","4-1",4,1,"T1",1,5,3,"H"
1998-12-13,1998,"Dardanelspor","Erzurum","0-0",0,0,"T1",1,0,0,"D"
1998-12-13,1998,"Fenerbahce","Istanbulspor","2-0",2,0,"T1",1,2,2,"H"
1998-12-13,1998,"Karabukspor","Gaziantepspor","2-6",2,6,"T1",1,8,-4,"A"
1998-12-13,1998,"Samsunspor","Altay","1-0",1,0,"T1",1,1,1,"H"
1998-12-13,1998,"Trabzonspor","Ankaragucu","1-0",1,0,"T1",1,1,1,"H"
1998-12-16,1998,"Galatasaray","Besiktas","2-0",2,0,"T1",1,2,2,"H"
1998-12-18,1998,"Bursaspor","Samsunspor","2-3",2,3,"T1",1,5,-1,"A"
1998-12-19,1998,"Antalyaspor","Trabzonspor","0-1",0,1,"T1",1,1,-1,"A"
1998-12-20,1998,"Altay","Karabukspor","1-0",1,0,"T1",1,1,1,"H"
1998-12-20,1998,"Ankaragucu","Sakaryaspor","1-0",1,0,"T1",1,1,1,"H"
1998-12-20,1998,"Besiktas","Dardanelspor","0-0",0,0,"T1",1,0,0,"D"
1998-12-20,1998,"Erzurum","Fenerbahce","0-2",0,2,"T1",1,2,-2,"A"
1998-12-20,1998,"Gaziantepspor","Galatasaray","1-2",1,2,"T1",1,3,-1,"A"
1998-12-20,1998,"Istanbulspor","Genclerbirligi","0-0",0,0,"T1",1,0,0,"D"
1998-12-20,1998,"Kocaelispor","Adanaspor","2-1",2,1,"T1",1,3,1,"H"
1999-01-23,1998,"Ankaragucu","Galatasaray","2-2",2,2,"T1",1,4,0,"D"
1999-01-29,1998,"Ankaragucu","Besiktas","0-1",0,1,"T1",1,1,-1,"A"
1999-01-30,1998,"Fenerbahce","Dardanelspor","3-1",3,1,"T1",1,4,2,"H"
1999-01-30,1998,"Kocaelispor","Samsunspor","1-0",1,0,"T1",1,1,1,"H"
1999-01-31,1998,"Altay","Galatasaray","0-2",0,2,"T1",1,2,-2,"A"
1999-01-31,1998,"Antalyaspor","Sakaryaspor","2-2",2,2,"T1",1,4,0,"D"
1999-01-31,1998,"Erzurum","Genclerbirligi","2-2",2,2,"T1",1,4,0,"D"
1999-01-31,1998,"Gaziantepspor","Trabzonspor","1-1",1,1,"T1",1,2,0,"D"
1999-01-31,1998,"Istanbulspor","Adanaspor","6-0",6,0,"T1",1,6,6,"H"
1999-01-31,1998,"Karabukspor","Bursaspor","1-0",1,0,"T1",1,1,1,"H"
1999-02-05,1998,"Besiktas","Antalyaspor","2-1",2,1,"T1",1,3,1,"H"
1999-02-06,1998,"Genclerbirligi","Fenerbahce","0-3",0,3,"T1",1,3,-3,"A"
1999-02-07,1998,"Adanaspor","Erzurum","2-0",2,0,"T1",1,2,2,"H"
1999-02-07,1998,"Dardanelspor","Ankaragucu","3-0",3,0,"T1",1,3,3,"H"
1999-02-07,1998,"Galatasaray","Bursaspor","5-0",5,0,"T1",1,5,5,"H"
1999-02-07,1998,"Karabukspor","Kocaelispor","0-1",0,1,"T1",1,1,-1,"A"
1999-02-07,1998,"Sakaryaspor","Gaziantepspor","6-2",6,2,"T1",1,8,4,"H"
1999-02-07,1998,"Samsunspor","Istanbulspor","0-1",0,1,"T1",1,1,-1,"A"
1999-02-07,1998,"Trabzonspor","Altay","0-3",0,3,"T1",1,3,-3,"A"
1999-02-12,1998,"Kocaelispor","Galatasaray","1-2",1,2,"T1",1,3,-1,"A"
1999-02-13,1998,"Altay","Sakaryaspor","2-0",2,0,"T1",1,2,2,"H"
1999-02-13,1998,"Antalyaspor","Ankaragucu","1-4",1,4,"T1",1,5,-3,"A"
1999-02-13,1998,"Erzurum","Samsunspor","1-0",1,0,"T1",1,1,1,"H"
1999-02-13,1998,"Gaziantepspor","Besiktas","2-0",2,0,"T1",1,2,2,"H"
1999-02-13,1998,"Karabukspor","Istanbulspor","2-2",2,2,"T1",1,4,0,"D"
1999-02-14,1998,"Bursaspor","Trabzonspor","0-1",0,1,"T1",1,1,-1,"A"
1999-02-14,1998,"Fenerbahce","Adanaspor","6-0",6,0,"T1",1,6,6,"H"
1999-02-14,1998,"Genclerbirligi","Dardanelspor","0-0",0,0,"T1",1,0,0,"D"
1999-02-19,1998,"Samsunspor","Fenerbahce","1-1",1,1,"T1",1,2,0,"D"
1999-02-20,1998,"Besiktas","Altay","1-1",1,1,"T1",1,2,0,"D"
1999-02-21,1998,"Adanaspor","Genclerbirligi","1-1",1,1,"T1",1,2,0,"D"
1999-02-21,1998,"Ankaragucu","Gaziantepspor","1-1",1,1,"T1",1,2,0,"D"
1999-02-21,1998,"Dardanelspor","Antalyaspor","2-0",2,0,"T1",1,2,2,"H"
1999-02-21,1998,"Galatasaray","Istanbulspor","3-3",3,3,"T1",1,6,0,"D"
1999-02-21,1998,"Karabukspor","Erzurum","1-1",1,1,"T1",1,2,0,"D"
1999-02-21,1998,"Sakaryaspor","Bursaspor","4-1",4,1,"T1",1,5,3,"H"
1999-02-21,1998,"Trabzonspor","Kocaelispor","0-3",0,3,"T1",1,3,-3,"A"
1999-02-26,1998,"Kocaelispor","Sakaryaspor","0-1",0,1,"T1",1,1,-1,"A"
1999-02-27,1998,"Bursaspor","Besiktas","1-2",1,2,"T1",1,3,-1,"A"
1999-02-27,1998,"Istanbulspor","Trabzonspor","0-0",0,0,"T1",1,0,0,"D"
1999-02-28,1998,"Adanaspor","Dardanelspor","3-0",3,0,"T1",1,3,3,"H"
1999-02-28,1998,"Altay","Ankaragucu","5-1",5,1,"T1",1,6,4,"H"
1999-02-28,1998,"Erzurum","Galatasaray","0-1",0,1,"T1",1,1,-1,"A"
1999-02-28,1998,"Gaziantepspor","Antalyaspor","1-1",1,1,"T1",1,2,0,"D"
1999-02-28,1998,"Genclerbirligi","Samsunspor","3-0",3,0,"T1",1,3,3,"H"
1999-02-28,1998,"Karabukspor","Fenerbahce","0-0",0,0,"T1",1,0,0,"D"
1999-03-05,1998,"Trabzonspor","Erzurum","3-1",3,1,"T1",1,4,2,"H"
1999-03-06,1998,"Ankaragucu","Bursaspor","2-2",2,2,"T1",1,4,0,"D"
1999-03-06,1998,"Besiktas","Kocaelispor","0-3",0,3,"T1",1,3,-3,"A"
1999-03-06,1998,"Dardanelspor","Gaziantepspor","0-1",0,1,"T1",1,1,-1,"A"
1999-03-06,1998,"Sakaryaspor","Istanbulspor","3-0",3,0,"T1",1,3,3,"H"
1999-03-07,1998,"Antalyaspor","Altay","4-2",4,2,"T1",1,6,2,"H"
1999-03-07,1998,"Galatasaray","Fenerbahce","2-0",2,0,"T1",1,2,2,"H"
1999-03-07,1998,"Karabukspor","Genclerbirligi","1-6",1,6,"T1",1,7,-5,"A"
1999-03-07,1998,"Samsunspor","Adanaspor","2-0",2,0,"T1",1,2,2,"H"
1999-03-12,1998,"Bursaspor","Antalyaspor","1-0",1,0,"T1",1,1,1,"H"
1999-03-13,1998,"Fenerbahce","Trabzonspor","1-0",1,0,"T1",1,1,1,"H"
1999-03-14,1998,"Adanaspor","Karabukspor","2-0",2,0,"T1",1,2,2,"H"
1999-03-14,1998,"Altay","Gaziantepspor","0-0",0,0,"T1",1,0,0,"D"
1999-03-14,1998,"Erzurum","Sakaryaspor","4-2",4,2,"T1",1,6,2,"H"
1999-03-14,1998,"Genclerbirligi","Galatasaray","1-2",1,2,"T1",1,3,-1,"A"
1999-03-14,1998,"Istanbulspor","Besiktas","0-2",0,2,"T1",1,2,-2,"A"
1999-03-14,1998,"Kocaelispor","Ankaragucu","0-1",0,1,"T1",1,1,-1,"A"
1999-03-14,1998,"Samsunspor","Dardanelspor","2-1",2,1,"T1",1,3,1,"H"
1999-03-19,1998,"Galatasaray","Adanaspor","1-1",1,1,"T1",1,2,0,"D"
1999-03-20,1998,"Ankaragucu","Istanbulspor","5-0",5,0,"T1",1,5,5,"H"
1999-03-20,1998,"Gaziantepspor","Bursaspor","5-2",5,2,"T1",1,7,3,"H"
1999-03-20,1998,"Karabukspor","Samsunspor","0-3",0,3,"T1",1,3,-3,"A"
1999-03-20,1998,"Sakaryaspor","Fenerbahce","2-1",2,1,"T1",1,3,1,"H"
1999-03-20,1998,"Trabzonspor","Genclerbirligi","4-0",4,0,"T1",1,4,4,"H"
1999-03-21,1998,"Antalyaspor","Kocaelispor","2-1",2,1,"T1",1,3,1,"H"
1999-03-21,1998,"Besiktas","Erzurum","2-1",2,1,"T1",1,3,1,"H"
1999-03-21,1998,"Dardanelspor","Altay","4-1",4,1,"T1",1,5,3,"H"
1999-04-02,1998,"Adanaspor","Trabzonspor","0-2",0,2,"T1",1,2,-2,"A"
1999-04-03,1998,"Istanbulspor","Antalyaspor","0-1",0,1,"T1",1,1,-1,"A"
1999-04-03,1998,"Samsunspor","Galatasaray","0-3",0,3,"T1",1,3,-3,"A"
1999-04-04,1998,"Bursaspor","Altay","2-0",2,0,"T1",1,2,2,"H"
1999-04-04,1998,"Erzurum","Ankaragucu","2-2",2,2,"T1",1,4,0,"D"
1999-04-04,1998,"Fenerbahce","Besiktas","1-2",1,2,"T1",1,3,-1,"A"
1999-04-04,1998,"Genclerbirligi","Sakaryaspor","1-0",1,0,"T1",1,1,1,"H"
1999-04-04,1998,"Karabukspor","Dardanelspor","1-0",1,0,"T1",1,1,1,"H"
1999-04-04,1998,"Kocaelispor","Gaziantepspor","1-1",1,1,"T1",1,2,0,"D"
1999-04-09,1998,"Besiktas","Genclerbirligi","2-0",2,0,"T1",1,2,2,"H"
1999-04-10,1998,"Galatasaray","Karabukspor","2-0",2,0,"T1",1,2,2,"H"
1999-04-11,1998,"Altay","Kocaelispor","3-1",3,1,"T1",1,4,2,"H"
1999-04-11,1998,"Ankaragucu","Fenerbahce","2-4",2,4,"T1",1,6,-2,"A"
1999-04-11,1998,"Antalyaspor","Erzurum","1-0",1,0,"T1",1,1,1,"H"
1999-04-11,1998,"Dardanelspor","Bursaspor","3-1",3,1,"T1",1,4,2,"H"
1999-04-11,1998,"Gaziantepspor","Istanbulspor","2-1",2,1,"T1",1,3,1,"H"
1999-04-11,1998,"Sakaryaspor","Adanaspor","0-0",0,0,"T1",1,0,0,"D"
1999-04-11,1998,"Trabzonspor","Samsunspor","3-1",3,1,"T1",1,4,2,"H"
1999-04-15,1998,"Karabukspor","Trabzonspor","0-0",0,0,"T1",1,0,0,"D"
1999-04-16,1998,"Fenerbahce","Antalyaspor","3-1",3,1,"T1",1,4,2,"H"
1999-04-17,1998,"Adanaspor","Besiktas","0-1",0,1,"T1",1,1,-1,"A"
1999-04-17,1998,"Erzurum","Gaziantepspor","2-1",2,1,"T1",1,3,1,"H"
1999-04-17,1998,"Galatasaray","Dardanelspor","5-2",5,2,"T1",1,7,3,"H"
1999-04-17,1998,"Genclerbirligi","Ankaragucu","3-1",3,1,"T1",1,4,2,"H"
1999-04-17,1998,"Istanbulspor","Altay","3-0",3,0,"T1",1,3,3,"H"
1999-04-17,1998,"Kocaelispor","Bursaspor","4-0",4,0,"T1",1,4,4,"H"
1999-04-17,1998,"Samsunspor","Sakaryaspor","2-2",2,2,"T1",1,4,0,"D"
1999-04-23,1998,"Besiktas","Samsunspor","0-0",0,0,"T1",1,0,0,"D"
1999-04-24,1998,"Gaziantepspor","Fenerbahce","2-2",2,2,"T1",1,4,0,"D"
1999-04-25,1998,"Altay","Erzurum","3-1",3,1,"T1",1,4,2,"H"
1999-04-25,1998,"Ankaragucu","Adanaspor","2-2",2,2,"T1",1,4,0,"D"
1999-04-25,1998,"Antalyaspor","Genclerbirligi","1-1",1,1,"T1",1,2,0,"D"
1999-04-25,1998,"Bursaspor","Istanbulspor","2-0",2,0,"T1",1,2,2,"H"
1999-04-25,1998,"Dardanelspor","Kocaelispor","3-1",3,1,"T1",1,4,2,"H"
1999-04-25,1998,"Sakaryaspor","Karabukspor","4-0",4,0,"T1",1,4,4,"H"
1999-04-25,1998,"Trabzonspor","Galatasaray","0-3",0,3,"T1",1,3,-3,"A"
1999-04-30,1998,"Galatasaray","Sakaryaspor","3-0",3,0,"T1",1,3,3,"H"
1999-05-01,1998,"Karabukspor","Besiktas","1-2",1,2,"T1",1,3,-1,"A"
1999-05-02,1998,"Adanaspor","Antalyaspor","4-2",4,2,"T1",1,6,2,"H"
1999-05-02,1998,"Erzurum","Bursaspor","2-1",2,1,"T1",1,3,1,"H"
1999-05-02,1998,"Fenerbahce","Altay","5-0",5,0,"T1",1,5,5,"H"
1999-05-02,1998,"Genclerbirligi","Gaziantepspor","3-0",3,0,"T1",1,3,3,"H"
1999-05-02,1998,"Istanbulspor","Kocaelispor","2-1",2,1,"T1",1,3,1,"H"
1999-05-02,1998,"Samsunspor","Ankaragucu","0-0",0,0,"T1",1,0,0,"D"
1999-05-02,1998,"Trabzonspor","Dardanelspor","2-1",2,1,"T1",1,3,1,"H"
1999-05-07,1998,"Antalyaspor","Samsunspor","1-2",1,2,"T1",1,3,-1,"A"
1999-05-08,1998,"Bursaspor","Fenerbahce","1-3",1,3,"T1",1,4,-2,"A"
1999-05-09,1998,"Altay","Genclerbirligi","0-0",0,0,"T1",1,0,0,"D"
1999-05-09,1998,"Ankaragucu","Karabukspor","1-1",1,1,"T1",1,2,0,"D"
1999-05-09,1998,"Besiktas","Galatasaray","1-1",1,1,"T1",1,2,0,"D"
1999-05-09,1998,"Dardanelspor","Istanbulspor","5-1",5,1,"T1",1,6,4,"H"
1999-05-09,1998,"Gaziantepspor","Adanaspor","3-1",3,1,"T1",1,4,2,"H"
1999-05-09,1998,"Kocaelispor","Erzurum","1-1",1,1,"T1",1,2,0,"D"
1999-05-09,1998,"Sakaryaspor","Trabzonspor","1-1",1,1,"T1",1,2,0,"D"
1999-05-14,1998,"Galatasaray","Ankaragucu","2-1",2,1,"T1",1,3,1,"H"
1999-05-15,1998,"Fenerbahce","Kocaelispor","1-1",1,1,"T1",1,2,0,"D"
1999-05-16,1998,"Adanaspor","Altay","2-0",2,0,"T1",1,2,2,"H"
1999-05-16,1998,"Dardanelspor","Sakaryaspor","1-0",1,0,"T1",1,1,1,"H"
1999-05-16,1998,"Genclerbirligi","Bursaspor","1-4",1,4,"T1",1,5,-3,"A"
1999-05-16,1998,"Istanbulspor","Erzurum","0-2",0,2,"T1",1,2,-2,"A"
1999-05-16,1998,"Karabukspor","Antalyaspor","2-1",2,1,"T1",1,3,1,"H"
1999-05-16,1998,"Samsunspor","Gaziantepspor","2-1",2,1,"T1",1,3,1,"H"
1999-05-16,1998,"Trabzonspor","Besiktas","1-2",1,2,"T1",1,3,-1,"A"
1999-05-21,1998,"Kocaelispor","Genclerbirligi","2-0",2,0,"T1",1,2,2,"H"
1999-05-22,1998,"Gaziantepspor","Karabukspor","4-2",4,2,"T1",1,6,2,"H"
1999-05-23,1998,"Altay","Samsunspor","2-0",2,0,"T1",1,2,2,"H"
1999-05-23,1998,"Ankaragucu","Trabzonspor","1-0",1,0,"T1",1,1,1,"H"
1999-05-23,1998,"Antalyaspor","Galatasaray","1-1",1,1,"T1",1,2,0,"D"
1999-05-23,1998,"Besiktas","Sakaryaspor","3-0",3,0,"T1",1,3,3,"H"
1999-05-23,1998,"Bursaspor","Adanaspor","1-1",1,1,"T1",1,2,0,"D"
1999-05-23,1998,"Erzurum","Dardanelspor","1-0",1,0,"T1",1,1,1,"H"
1999-05-23,1998,"Istanbulspor","Fenerbahce","1-2",1,2,"T1",1,3,-1,"A"
1999-05-28,1998,"Dardanelspor","Besiktas","1-3",1,3,"T1",1,4,-2,"A"
1999-05-29,1998,"Adanaspor","Kocaelispor","1-1",1,1,"T1",1,2,0,"D"
1999-05-29,1998,"Fenerbahce","Erzurum","4-1",4,1,"T1",1,5,3,"H"
1999-05-29,1998,"Genclerbirligi","Istanbulspor","2-3",2,3,"T1",1,5,-1,"A"
1999-05-29,1998,"Karabukspor","Altay","1-1",1,1,"T1",1,2,0,"D"
1999-05-29,1998,"Sakaryaspor","Ankaragucu","4-0",4,0,"T1",1,4,4,"H"
1999-05-29,1998,"Samsunspor","Bursaspor","1-1",1,1,"T1",1,2,0,"D"
1999-05-30,1998,"Galatasaray","Gaziantepspor","0-0",0,0,"T1",1,0,0,"D"
1999-05-30,1998,"Trabzonspor","Antalyaspor","2-3",2,3,"T1",1,5,-1,"A"
1999-08-06,1999,"Galatasaray","Gaziantepspor","1-2",1,2,"T1",1,3,-1,"A"
1999-08-07,1999,"Genclerbirligi","Besiktas","1-0",1,0,"T1",1,1,1,"H"
1999-08-07,1999,"Samsunspor","Ankaragucu","2-0",2,0,"T1",1,2,2,"H"
1999-08-08,1999,"Adanaspor","Trabzonspor","1-2",1,2,"T1",1,3,-1,"A"
1999-08-08,1999,"Antalyaspor","Istanbulspor","0-3",0,3,"T1",1,3,-3,"A"
1999-08-08,1999,"Bursaspor","Altay","1-4",1,4,"T1",1,5,-3,"A"
1999-08-08,1999,"Erzurumspor","Denizlispor","0-1",0,1,"T1",1,1,-1,"A"
1999-08-08,1999,"Fenerbahce","Vanspor","3-0",3,0,"T1",1,3,3,"H"
1999-08-08,1999,"Goztep","Kocaelispor","0-0",0,0,"T1",1,0,0,"D"
1999-08-13,1999,"Altay","Goztep","0-0",0,0,"T1",1,0,0,"D"
1999-08-14,1999,"Fenerbahce","Kocaelispor","1-1",1,1,"T1",1,2,0,"D"
1999-08-14,1999,"Istanbulspor","Bursaspor","1-0",1,0,"T1",1,1,1,"H"
1999-08-15,1999,"Ankaragucu","Adanaspor","0-0",0,0,"T1",1,0,0,"D"
1999-08-15,1999,"Besiktas","Samsunspor","4-0",4,0,"T1",1,4,4,"H"
1999-08-15,1999,"Denizlispor","Genclerbirligi","1-3",1,3,"T1",1,4,-2,"A"
1999-08-15,1999,"Gaziantepspor","Antalyaspor","1-2",1,2,"T1",1,3,-1,"A"
1999-08-15,1999,"Trabzonspor","Galatasaray","1-2",1,2,"T1",1,3,-1,"A"
1999-08-15,1999,"Vanspor","Erzurumspor","0-2",0,2,"T1",1,2,-2,"A"
1999-09-10,1999,"Antalyaspor","Trabzonspor","0-2",0,2,"T1",1,2,-2,"A"
1999-09-11,1999,"Galatasaray","Ankaragucu","5-0",5,0,"T1",1,5,5,"H"
1999-09-12,1999,"Besiktas","Denizlispor","1-1",1,1,"T1",1,2,0,"D"
1999-09-12,1999,"Bursaspor","Gaziantepspor","0-1",0,1,"T1",1,1,-1,"A"
1999-09-12,1999,"Erzurumspor","Kocaelispor","3-3",3,3,"T1",1,6,0,"D"
1999-09-12,1999,"Fenerbahce","Altay","3-1",3,1,"T1",1,4,2,"H"
1999-09-12,1999,"Genclerbirligi","Vanspor","1-1",1,1,"T1",1,2,0,"D"
1999-09-12,1999,"Goztep","Istanbulspor","2-0",2,0,"T1",1,2,2,"H"
1999-09-12,1999,"Samsunspor","Adanaspor","2-1",2,1,"T1",1,3,1,"H"
1999-09-17,1999,"Adanaspor","Galatasaray","3-4",3,4,"T1",1,7,-1,"A"
1999-09-18,1999,"Genclerbirligi","Kocaelispor","0-4",0,4,"T1",1,4,-4,"A"
1999-09-18,1999,"Trabzonspor","Bursaspor","2-0",2,0,"T1",1,2,2,"H"
1999-09-19,1999,"Altay","Erzurumspor","3-0",3,0,"T1",1,3,3,"H"
1999-09-19,1999,"Ankaragucu","Antalyaspor","1-3",1,3,"T1",1,4,-2,"A"
1999-09-19,1999,"Denizlispor","Samsunspor","4-1",4,1,"T1",1,5,3,"H"
1999-09-19,1999,"Gaziantepspor","Goztep","2-1",2,1,"T1",1,3,1,"H"
1999-09-19,1999,"Istanbulspor","Fenerbahce","1-4",1,4,"T1",1,5,-3,"A"
1999-09-19,1999,"Vanspor","Besiktas","0-6",0,6,"T1",1,6,-6,"A"
1999-09-24,1999,"Samsunspor","Galatasaray","0-1",0,1,"T1",1,1,-1,"A"
1999-09-25,1999,"Besiktas","Kocaelispor","1-0",1,0,"T1",1,1,1,"H"
1999-09-26,1999,"Antalyaspor","Adanaspor","2-2",2,2,"T1",1,4,0,"D"
1999-09-26,1999,"Bursaspor","Ankaragucu","3-1",3,1,"T1",1,4,2,"H"
1999-09-26,1999,"Denizlispor","Vanspor","1-0",1,0,"T1",1,1,1,"H"
1999-09-26,1999,"Erzurumspor","Istanbulspor","0-0",0,0,"T1",1,0,0,"D"
1999-09-26,1999,"Fenerbahce","Gaziantepspor","0-0",0,0,"T1",1,0,0,"D"
1999-09-26,1999,"Genclerbirligi","Altay","0-0",0,0,"T1",1,0,0,"D"
1999-09-26,1999,"Goztep","Trabzonspor","1-1",1,1,"T1",1,2,0,"D"
1999-10-15,1999,"Galatasaray","Antalyaspor","2-0",2,0,"T1",1,2,2,"H"
1999-10-16,1999,"Ankaragucu","Goztep","1-2",1,2,"T1",1,3,-1,"A"
1999-10-16,1999,"Trabzonspor","Fenerbahce","2-0",2,0,"T1",1,2,2,"H"
1999-10-17,1999,"Adanaspor","Bursaspor","1-1",1,1,"T1",1,2,0,"D"
1999-10-17,1999,"Altay","Besiktas","2-2",2,2,"T1",1,4,0,"D"
1999-10-17,1999,"Denizlispor","Kocaelispor","3-1",3,1,"T1",1,4,2,"H"
1999-10-17,1999,"Gaziantepspor","Erzurumspor","6-0",6,0,"T1",1,6,6,"H"
1999-10-17,1999,"Istanbulspor","Genclerbirligi","3-1",3,1,"T1",1,4,2,"H"
1999-10-17,1999,"Vanspor","Samsunspor","0-0",0,0,"T1",1,0,0,"D"
1999-10-22,1999,"Bursaspor","Galatasaray","0-0",0,0,"T1",1,0,0,"D"
1999-10-23,1999,"Besiktas","Istanbulspor","3-0",3,0,"T1",1,3,3,"H"
1999-10-24,1999,"Denizlispor","Altay","2-1",2,1,"T1",1,3,1,"H"
1999-10-24,1999,"Erzurumspor","Trabzonspor","2-1",2,1,"T1",1,3,1,"H"
1999-10-24,1999,"Fenerbahce","Ankaragucu","1-1",1,1,"T1",1,2,0,"D"
1999-10-24,1999,"Genclerbirligi","Gaziantepspor","0-1",0,1,"T1",1,1,-1,"A"
1999-10-24,1999,"Goztep","Adanaspor","0-1",0,1,"T1",1,1,-1,"A"
1999-10-24,1999,"Samsunspor","Antalyaspor","0-1",0,1,"T1",1,1,-1,"A"
1999-10-24,1999,"Vanspor","Kocaelispor","5-0",5,0,"T1",1,5,5,"H"
1999-10-29,1999,"Galatasaray","Goztep","2-0",2,0,"T1",1,2,2,"H"
1999-10-30,1999,"Adanaspor","Fenerbahce","1-3",1,3,"T1",1,4,-2,"A"
1999-10-30,1999,"Ankaragucu","Erzurumspor","1-0",1,0,"T1",1,1,1,"H"
1999-10-31,1999,"Altay","Vanspor","2-0",2,0,"T1",1,2,2,"H"
1999-10-31,1999,"Antalyaspor","Bursaspor","1-1",1,1,"T1",1,2,0,"D"
1999-10-31,1999,"Gaziantepspor","Besiktas","0-0",0,0,"T1",1,0,0,"D"
1999-10-31,1999,"Istanbulspor","Denizlispor","1-1",1,1,"T1",1,2,0,"D"
1999-10-31,1999,"Samsunspor","Kocaelispor","5-1",5,1,"T1",1,6,4,"H"
1999-10-31,1999,"Trabzonspor","Genclerbirligi","1-2",1,2,"T1",1,3,-1,"A"
1999-11-19,1999,"Denizlispor","Gaziantepspor","1-0",1,0,"T1",1,1,1,"H"
1999-11-20,1999,"Goztep","Antalyaspor","1-2",1,2,"T1",1,3,-1,"A"
1999-11-21,1999,"Altay","Kocaelispor","0-1",0,1,"T1",1,1,-1,"A"
1999-11-21,1999,"Besiktas","Trabzonspor","1-1",1,1,"T1",1,2,0,"D"
1999-11-21,1999,"Erzurumspor","Adanaspor","4-1",4,1,"T1",1,5,3,"H"
1999-11-21,1999,"Genclerbirligi","Ankaragucu","1-2",1,2,"T1",1,3,-1,"A"
1999-11-21,1999,"Samsunspor","Bursaspor","1-0",1,0,"T1",1,1,1,"H"
1999-11-21,1999,"Vanspor","Istanbulspor","1-1",1,1,"T1",1,2,0,"D"
1999-11-26,1999,"Ankaragucu","Besiktas","2-3",2,3,"T1",1,5,-1,"A"
1999-11-27,1999,"Adanaspor","Genclerbirligi","1-2",1,2,"T1",1,3,-1,"A"
1999-11-27,1999,"Antalyaspor","Fenerbahce","2-3",2,3,"T1",1,5,-1,"A"
1999-11-28,1999,"Altay","Samsunspor","2-1",2,1,"T1",1,3,1,"H"
1999-11-28,1999,"Bursaspor","Goztep","1-2",1,2,"T1",1,3,-1,"A"
1999-11-28,1999,"Galatasaray","Erzurumspor","4-1",4,1,"T1",1,5,3,"H"
1999-11-28,1999,"Gaziantepspor","Vanspor","1-3",1,3,"T1",1,4,-2,"A"
1999-11-28,1999,"Istanbulspor","Kocaelispor","4-1",4,1,"T1",1,5,3,"H"
1999-11-28,1999,"Trabzonspor","Denizlispor","1-1",1,1,"T1",1,2,0,"D"
1999-12-03,1999,"Genclerbirligi","Galatasaray","1-1",1,1,"T1",1,2,0,"D"
1999-12-04,1999,"Besiktas","Adanaspor","0-1",0,1,"T1",1,1,-1,"A"
1999-12-05,1999,"Altay","Istanbulspor","0-0",0,0,"T1",1,0,0,"D"
1999-12-05,1999,"Denizlispor","Ankaragucu","1-1",1,1,"T1",1,2,0,"D"
1999-12-05,1999,"Erzurumspor","Antalyaspor","4-0",4,0,"T1",1,4,4,"H"
1999-12-05,1999,"Fenerbahce","Bursaspor","2-2",2,2,"T1",1,4,0,"D"
1999-12-05,1999,"Gaziantepspor","Kocaelispor","1-0",1,0,"T1",1,1,1,"H"
1999-12-05,1999,"Samsunspor","Goztep","4-0",4,0,"T1",1,4,4,"H"
1999-12-05,1999,"Vanspor","Trabzonspor","2-2",2,2,"T1",1,4,0,"D"
1999-12-10,1999,"Adanaspor","Denizlispor","3-2",3,2,"T1",1,5,1,"H"
1999-12-11,1999,"Goztep","Fenerbahce","0-0",0,0,"T1",1,0,0,"D"
1999-12-11,1999,"Istanbulspor","Samsunspor","0-1",0,1,"T1",1,1,-1,"A"
1999-12-12,1999,"Ankaragucu","Vanspor","1-0",1,0,"T1",1,1,1,"H"
1999-12-12,1999,"Antalyaspor","Genclerbirligi","2-1",2,1,"T1",1,3,1,"H"
1999-12-12,1999,"Bursaspor","Erzurumspor","4-2",4,2,"T1",1,6,2,"H"
1999-12-12,1999,"Galatasaray","Besiktas","1-0",1,0,"T1",1,1,1,"H"
1999-12-12,1999,"Gaziantepspor","Altay","1-0",1,0,"T1",1,1,1,"H"
1999-12-12,1999,"Trabzonspor","Kocaelispor","1-0",1,0,"T1",1,1,1,"H"
1999-12-17,1999,"Samsunspor","Fenerbahce","1-1",1,1,"T1",1,2,0,"D"
1999-12-18,1999,"Ankaragucu","Kocaelispor","3-2",3,2,"T1",1,5,1,"H"
1999-12-18,1999,"Denizlispor","Galatasaray","2-4",2,4,"T1",1,6,-2,"A"
1999-12-19,1999,"Altay","Trabzonspor","3-1",3,1,"T1",1,4,2,"H"
1999-12-19,1999,"Besiktas","Antalyaspor","4-0",4,0,"T1",1,4,4,"H"
1999-12-19,1999,"Erzurumspor","Goztep","0-0",0,0,"T1",1,0,0,"D"
1999-12-19,1999,"Genclerbirligi","Bursaspor","1-0",1,0,"T1",1,1,1,"H"
1999-12-19,1999,"Istanbulspor","Gaziantepspor","1-1",1,1,"T1",1,2,0,"D"
1999-12-19,1999,"Vanspor","Adanaspor","0-2",0,2,"T1",1,2,-2,"A"
1999-12-22,1999,"Fenerbahce","Galatasaray","1-2",1,2,"T1",1,3,-1,"A"
1999-12-24,1999,"Bursaspor","Besiktas","0-1",0,1,"T1",1,1,-1,"A"
1999-12-25,1999,"Adanaspor","Kocaelispor","3-0",3,0,"T1",1,3,3,"H"
1999-12-25,1999,"Ankaragucu","Altay","3-0",3,0,"T1",1,3,3,"H"
1999-12-25,1999,"Antalyaspor","Denizlispor","2-2",2,2,"T1",1,4,0,"D"
1999-12-25,1999,"Fenerbahce","Erzurumspor","2-0",2,0,"T1",1,2,2,"H"
1999-12-26,1999,"Galatasaray","Vanspor","2-1",2,1,"T1",1,3,1,"H"
1999-12-26,1999,"Gaziantepspor","Samsunspor","5-2",5,2,"T1",1,7,3,"H"
1999-12-26,1999,"Goztep","Genclerbirligi","3-2",3,2,"T1",1,5,1,"H"
1999-12-26,1999,"Trabzonspor","Istanbulspor","1-1",1,1,"T1",1,2,0,"D"
2000-01-07,1999,"Besiktas","Goztep","2-1",2,1,"T1",1,3,1,"H"
2000-01-08,1999,"Altay","Adanaspor","2-1",2,1,"T1",1,3,1,"H"
2000-01-08,1999,"Denizlispor","Bursaspor","1-3",1,3,"T1",1,4,-2,"A"
2000-01-08,1999,"Erzurumspor","Samsunspor","1-0",1,0,"T1",1,1,1,"H"
2000-01-08,1999,"Genclerbirligi","Fenerbahce","2-2",2,2,"T1",1,4,0,"D"
2000-01-09,1999,"Istanbulspor","Ankaragucu","2-6",2,6,"T1",1,8,-4,"A"
2000-01-09,1999,"Kocaelispor","Galatasaray","1-2",1,2,"T1",1,3,-1,"A"
2000-01-09,1999,"Trabzonspor","Gaziantepspor","0-0",0,0,"T1",1,0,0,"D"
2000-01-09,1999,"Vanspor","Antalyaspor","2-4",2,4,"T1",1,6,-2,"A"
2000-01-14,1999,"Samsunspor","Trabzonspor","0-0",0,0,"T1",1,0,0,"D"
2000-01-15,1999,"Ankaragucu","Gaziantepspor","1-1",1,1,"T1",1,2,0,"D"
2000-01-15,1999,"Antalyaspor","Kocaelispor","3-0",3,0,"T1",1,3,3,"H"
2000-01-15,1999,"Bursaspor","Vanspor","3-2",3,2,"T1",1,5,1,"H"
2000-01-15,1999,"Galatasaray","Altay","3-1",3,1,"T1",1,4,2,"H"
2000-01-16,1999,"Adanaspor","Istanbulspor","2-1",2,1,"T1",1,3,1,"H"
2000-01-16,1999,"Erzurumspor","Genclerbirligi","1-1",1,1,"T1",1,2,0,"D"
2000-01-16,1999,"Fenerbahce","Besiktas","2-1",2,1,"T1",1,3,1,"H"
2000-01-16,1999,"Goztep","Denizlispor","2-4",2,4,"T1",1,6,-2,"A"
2000-01-21,1999,"Denizlispor","Fenerbahce","1-1",1,1,"T1",1,2,0,"D"
2000-01-22,1999,"Gaziantepspor","Adanaspor","1-1",1,1,"T1",1,2,0,"D"
2000-01-23,1999,"Altay","Antalyaspor","2-0",2,0,"T1",1,2,2,"H"
2000-01-23,1999,"Besiktas","Erzurumspor","2-0",2,0,"T1",1,2,2,"H"
2000-01-23,1999,"Genclerbirligi","Samsunspor","1-0",1,0,"T1",1,1,1,"H"
2000-01-23,1999,"Istanbulspor","Galatasaray","0-0",0,0,"T1",1,0,0,"D"
2000-01-23,1999,"Kocaelispor","Bursaspor","3-2",3,2,"T1",1,5,1,"H"
2000-01-23,1999,"Trabzonspor","Ankaragucu","3-1",3,1,"T1",1,4,2,"H"
2000-01-28,1999,"Trabzonspor","Adanaspor","0-1",0,1,"T1",1,1,-1,"A"
2000-01-28,1999,"Vanspor","Fenerbahce","1-2",1,2,"T1",1,3,-1,"A"
2000-01-29,1999,"Ankaragucu","Samsunspor","1-2",1,2,"T1",1,3,-1,"A"
2000-01-29,1999,"Besiktas","Genclerbirligi","4-0",4,0,"T1",1,4,4,"H"
2000-01-29,1999,"Istanbulspor","Antalyaspor","0-0",0,0,"T1",1,0,0,"D"
2000-01-29,1999,"Kocaelispor","Goztep","2-0",2,0,"T1",1,2,2,"H"
2000-01-30,1999,"Altay","Bursaspor","1-2",1,2,"T1",1,3,-1,"A"
2000-01-30,1999,"Denizlispor","Erzurumspor","2-1",2,1,"T1",1,3,1,"H"
2000-01-30,1999,"Gaziantepspor","Galatasaray","0-1",0,1,"T1",1,1,-1,"A"
2000-02-02,1999,"Vanspor","Goztep","1-0",1,0,"T1",1,1,1,"H"
2000-02-04,1999,"Samsunspor","Besiktas","0-2",0,2,"T1",1,2,-2,"A"
2000-02-05,1999,"Bursaspor","Istanbulspor","1-0",1,0,"T1",1,1,1,"H"
2000-02-05,1999,"Genclerbirligi","Denizlispor","3-1",3,1,"T1",1,4,2,"H"
2000-02-05,1999,"Kocaelispor","Fenerbahce","1-1",1,1,"T1",1,2,0,"D"
2000-02-06,1999,"Adanaspor","Ankaragucu","2-2",2,2,"T1",1,4,0,"D"
2000-02-06,1999,"Antalyaspor","Gaziantepspor","0-0",0,0,"T1",1,0,0,"D"
2000-02-06,1999,"Erzurumspor","Vanspor","2-0",2,0,"T1",1,2,2,"H"
2000-02-06,1999,"Galatasaray","Trabzonspor","2-0",2,0,"T1",1,2,2,"H"
2000-02-06,1999,"Goztep","Altay","0-1",0,1,"T1",1,1,-1,"A"
2000-02-11,1999,"Denizlispor","Besiktas","0-2",0,2,"T1",1,2,-2,"A"
2000-02-12,1999,"Adanaspor","Samsunspor","0-1",0,1,"T1",1,1,-1,"A"
2000-02-12,1999,"Altay","Fenerbahce","2-3",2,3,"T1",1,5,-1,"A"
2000-02-12,1999,"Gaziantepspor","Bursaspor","1-1",1,1,"T1",1,2,0,"D"
2000-02-12,1999,"Kocaelispor","Erzurumspor","4-0",4,0,"T1",1,4,4,"H"
2000-02-12,1999,"Trabzonspor","Antalyaspor","2-0",2,0,"T1",1,2,2,"H"
2000-02-12,1999,"Vanspor","Genclerbirligi","2-5",2,5,"T1",1,7,-3,"A"
2000-02-13,1999,"Ankaragucu","Galatasaray","0-2",0,2,"T1",1,2,-2,"A"
2000-02-13,1999,"Istanbulspor","Goztep","3-0",3,0,"T1",1,3,3,"H"
2000-02-18,1999,"Besiktas","Vanspor","2-1",2,1,"T1",1,3,1,"H"
2000-02-19,1999,"Fenerbahce","Istanbulspor","1-0",1,0,"T1",1,1,1,"H"
2000-02-19,1999,"Goztep","Gaziantepspor","0-1",0,1,"T1",1,1,-1,"A"
2000-02-19,1999,"Kocaelispor","Genclerbirligi","0-0",0,0,"T1",1,0,0,"D"
2000-02-19,1999,"Samsunspor","Denizlispor","6-2",6,2,"T1",1,8,4,"H"
2000-02-20,1999,"Antalyaspor","Ankaragucu","0-0",0,0,"T1",1,0,0,"D"
2000-02-20,1999,"Bursaspor","Trabzonspor","2-3",2,3,"T1",1,5,-1,"A"
2000-02-20,1999,"Erzurumspor","Altay","0-0",0,0,"T1",1,0,0,"D"
2000-02-20,1999,"Galatasaray","Adanaspor","4-0",4,0,"T1",1,4,4,"H"
2000-02-25,1999,"Galatasaray","Samsunspor","3-1",3,1,"T1",1,4,2,"H"
2000-02-26,1999,"Adanaspor","Antalyaspor","1-2",1,2,"T1",1,3,-1,"A"
2000-02-26,1999,"Ankaragucu","Bursaspor","2-1",2,1,"T1",1,3,1,"H"
2000-02-26,1999,"Kocaelispor","Besiktas","1-2",1,2,"T1",1,3,-1,"A"
2000-02-26,1999,"Trabzonspor","Goztep","2-0",2,0,"T1",1,2,2,"H"
2000-02-27,1999,"Altay","Genclerbirligi","0-2",0,2,"T1",1,2,-2,"A"
2000-02-27,1999,"Gaziantepspor","Fenerbahce","5-1",5,1,"T1",1,6,4,"H"
2000-02-27,1999,"Istanbulspor","Erzurumspor","1-1",1,1,"T1",1,2,0,"D"
2000-02-27,1999,"Vanspor","Denizlispor","2-3",2,3,"T1",1,5,-1,"A"
2000-03-03,1999,"Besiktas","Altay","3-0",3,0,"T1",1,3,3,"H"
2000-03-04,1999,"Erzurumspor","Gaziantepspor","1-1",1,1,"T1",1,2,0,"D"
2000-03-04,1999,"Fenerbahce","Trabzonspor","2-1",2,1,"T1",1,3,1,"H"
2000-03-04,1999,"Genclerbirligi","Istanbulspor","1-1",1,1,"T1",1,2,0,"D"
2000-03-04,1999,"Kocaelispor","Denizlispor","1-0",1,0,"T1",1,1,1,"H"
2000-03-05,1999,"Antalyaspor","Galatasaray","1-3",1,3,"T1",1,4,-2,"A"
2000-03-05,1999,"Bursaspor","Adanaspor","3-1",3,1,"T1",1,4,2,"H"
2000-03-05,1999,"Goztep","Ankaragucu","2-0",2,0,"T1",1,2,2,"H"
2000-03-05,1999,"Samsunspor","Vanspor","5-1",5,1,"T1",1,6,4,"H"
2000-03-10,1999,"Trabzonspor","Erzurumspor","2-0",2,0,"T1",1,2,2,"H"
2000-03-11,1999,"Altay","Denizlispor","1-0",1,0,"T1",1,1,1,"H"
2000-03-11,1999,"Ankaragucu","Fenerbahce","1-1",1,1,"T1",1,2,0,"D"
2000-03-11,1999,"Gaziantepspor","Genclerbirligi","2-1",2,1,"T1",1,3,1,"H"
2000-03-11,1999,"Kocaelispor","Vanspor","6-1",6,1,"T1",1,7,5,"H"
2000-03-12,1999,"Adanaspor","Goztep","2-0",2,0,"T1",1,2,2,"H"
2000-03-12,1999,"Antalyaspor","Samsunspor","0-1",0,1,"T1",1,1,-1,"A"
2000-03-12,1999,"Galatasaray","Bursaspor","6-0",6,0,"T1",1,6,6,"H"
2000-03-12,1999,"Istanbulspor","Besiktas","0-2",0,2,"T1",1,2,-2,"A"
2000-03-17,1999,"Fenerbahce","Adanaspor","2-4",2,4,"T1",1,6,-2,"A"
2000-03-18,1999,"Besiktas","Gaziantepspor","1-0",1,0,"T1",1,1,1,"H"
2000-03-18,1999,"Bursaspor","Antalyaspor","4-2",4,2,"T1",1,6,2,"H"
2000-03-18,1999,"Erzurumspor","Ankaragucu","2-1",2,1,"T1",1,3,1,"H"
2000-03-18,1999,"Kocaelispor","Samsunspor","0-4",0,4,"T1",1,4,-4,"A"
2000-03-19,1999,"Denizlispor","Istanbulspor","3-1",3,1,"T1",1,4,2,"H"
2000-03-19,1999,"Genclerbirligi","Trabzonspor","0-1",0,1,"T1",1,1,-1,"A"
2000-03-19,1999,"Goztep","Galatasaray","0-2",0,2,"T1",1,2,-2,"A"
2000-03-19,1999,"Vanspor","Altay","1-1",1,1,"T1",1,2,0,"D"
2000-03-24,1999,"Gaziantepspor","Denizlispor","0-0",0,0,"T1",1,0,0,"D"
2000-03-25,1999,"Adanaspor","Erzurumspor","2-0",2,0,"T1",1,2,2,"H"
2000-03-25,1999,"Bursaspor","Samsunspor","2-2",2,2,"T1",1,4,0,"D"
2000-03-25,1999,"Istanbulspor","Vanspor","0-0",0,0,"T1",1,0,0,"D"
2000-03-25,1999,"Trabzonspor","Besiktas","1-2",1,2,"T1",1,3,-1,"A"
2000-03-26,1999,"Ankaragucu","Genclerbirligi","0-0",0,0,"T1",1,0,0,"D"
2000-03-26,1999,"Antalyaspor","Goztep","1-0",1,0,"T1",1,1,1,"H"
2000-03-26,1999,"Galatasaray","Fenerbahce","0-1",0,1,"T1",1,1,-1,"A"
2000-03-26,1999,"Kocaelispor","Altay","2-1",2,1,"T1",1,3,1,"H"
2000-03-31,1999,"Denizlispor","Trabzonspor","0-2",0,2,"T1",1,2,-2,"A"
2000-04-01,1999,"Erzurumspor","Galatasaray","0-0",0,0,"T1",1,0,0,"D"
2000-04-01,1999,"Fenerbahce","Antalyaspor","1-0",1,0,"T1",1,1,1,"H"
2000-04-01,1999,"Genclerbirligi","Adanaspor","5-2",5,2,"T1",1,7,3,"H"
2000-04-01,1999,"Goztep","Bursaspor","0-1",0,1,"T1",1,1,-1,"A"
2000-04-01,1999,"Vanspor","Gaziantepspor","1-2",1,2,"T1",1,3,-1,"A"
2000-04-02,1999,"Besiktas","Ankaragucu","3-1",3,1,"T1",1,4,2,"H"
2000-04-02,1999,"Kocaelispor","Istanbulspor","2-1",2,1,"T1",1,3,1,"H"
2000-04-02,1999,"Samsunspor","Altay","1-0",1,0,"T1",1,1,1,"H"
2000-04-07,1999,"Bursaspor","Fenerbahce","2-1",2,1,"T1",1,3,1,"H"
2000-04-08,1999,"Adanaspor","Besiktas","1-3",1,3,"T1",1,4,-2,"A"
2000-04-08,1999,"Goztep","Samsunspor","1-2",1,2,"T1",1,3,-1,"A"
2000-04-08,1999,"Istanbulspor","Altay","1-0",1,0,"T1",1,1,1,"H"
2000-04-08,1999,"Kocaelispor","Gaziantepspor","1-2",1,2,"T1",1,3,-1,"A"
2000-04-09,1999,"Ankaragucu","Denizlispor","3-1",3,1,"T1",1,4,2,"H"
2000-04-09,1999,"Antalyaspor","Erzurumspor","1-2",1,2,"T1",1,3,-1,"A"
2000-04-09,1999,"Galatasaray","Genclerbirligi","6-0",6,0,"T1",1,6,6,"H"
2000-04-09,1999,"Trabzonspor","Vanspor","4-2",4,2,"T1",1,6,2,"H"
2000-04-14,1999,"Besiktas","Galatasaray","1-1",1,1,"T1",1,2,0,"D"
2000-04-15,1999,"Altay","Gaziantepspor","1-3",1,3,"T1",1,4,-2,"A"
2000-04-15,1999,"Denizlispor","Adanaspor","4-2",4,2,"T1",1,6,2,"H"
2000-04-15,1999,"Genclerbirligi","Antalyaspor","4-1",4,1,"T1",1,5,3,"H"
2000-04-15,1999,"Kocaelispor","Trabzonspor","1-0",1,0,"T1",1,1,1,"H"
2000-04-16,1999,"Erzurumspor","Bursaspor","4-1",4,1,"T1",1,5,3,"H"
2000-04-16,1999,"Fenerbahce","Goztep","2-3",2,3,"T1",1,5,-1,"A"
2000-04-16,1999,"Samsunspor","Istanbulspor","1-0",1,0,"T1",1,1,1,"H"
2000-04-16,1999,"Vanspor","Ankaragucu","2-3",2,3,"T1",1,5,-1,"A"
2000-04-21,1999,"Fenerbahce","Samsunspor","1-0",1,0,"T1",1,1,1,"H"
2000-04-22,1999,"Adanaspor","Vanspor","2-0",2,0,"T1",1,2,2,"H"
2000-04-22,1999,"Antalyaspor","Besiktas","2-2",2,2,"T1",1,4,0,"D"
2000-04-22,1999,"Bursaspor","Genclerbirligi","2-5",2,5,"T1",1,7,-3,"A"
2000-04-22,1999,"Trabzonspor","Altay","2-1",2,1,"T1",1,3,1,"H"
2000-04-23,1999,"Galatasaray","Denizlispor","2-2",2,2,"T1",1,4,0,"D"
2000-04-23,1999,"Gaziantepspor","Istanbulspor","1-0",1,0,"T1",1,1,1,"H"
2000-04-23,1999,"Goztep","Erzurumspor","1-4",1,4,"T1",1,5,-3,"A"
2000-04-23,1999,"Kocaelispor","Ankaragucu","4-1",4,1,"T1",1,5,3,"H"
2000-04-28,1999,"Besiktas","Bursaspor","5-1",5,1,"T1",1,6,4,"H"
2000-04-29,1999,"Altay","Ankaragucu","0-0",0,0,"T1",1,0,0,"D"
2000-04-29,1999,"Denizlispor","Antalyaspor","4-0",4,0,"T1",1,4,4,"H"
2000-04-29,1999,"Istanbulspor","Trabzonspor","5-1",5,1,"T1",1,6,4,"H"
2000-04-29,1999,"Kocaelispor","Adanaspor","0-0",0,0,"T1",1,0,0,"D"
2000-04-29,1999,"Vanspor","Galatasaray","1-3",1,3,"T1",1,4,-2,"A"
2000-04-30,1999,"Erzurumspor","Fenerbahce","1-5",1,5,"T1",1,6,-4,"A"
2000-04-30,1999,"Genclerbirligi","Goztep","1-0",1,0,"T1",1,1,1,"H"
2000-04-30,1999,"Samsunspor","Gaziantepspor","0-2",0,2,"T1",1,2,-2,"A"
2000-05-05,1999,"Fenerbahce","Genclerbirligi","1-3",1,3,"T1",1,4,-2,"A"
2000-05-06,1999,"Bursaspor","Denizlispor","4-1",4,1,"T1",1,5,3,"H"
2000-05-06,1999,"Gaziantepspor","Trabzonspor","3-0",3,0,"T1",1,3,3,"H"
2000-05-06,1999,"Goztep","Besiktas","2-4",2,4,"T1",1,6,-2,"A"
2000-05-07,1999,"Adanaspor","Altay","1-0",1,0,"T1",1,1,1,"H"
2000-05-07,1999,"Ankaragucu","Istanbulspor","2-2",2,2,"T1",1,4,0,"D"
2000-05-07,1999,"Antalyaspor","Vanspor","4-1",4,1,"T1",1,5,3,"H"
2000-05-07,1999,"Galatasaray","Kocaelispor","5-0",5,0,"T1",1,5,5,"H"
2000-05-07,1999,"Samsunspor","Erzurumspor","2-1",2,1,"T1",1,3,1,"H"
2000-05-12,1999,"Altay","Galatasaray","1-0",1,0,"T1",1,1,1,"H"
2000-05-12,1999,"Gaziantepspor","Ankaragucu","2-2",2,2,"T1",1,4,0,"D"
2000-05-12,1999,"Genclerbirligi","Erzurumspor","5-0",5,0,"T1",1,5,5,"H"
2000-05-12,1999,"Istanbulspor","Adanaspor","3-2",3,2,"T1",1,5,1,"H"
2000-05-12,1999,"Kocaelispor","Antalyaspor","1-1",1,1,"T1",1,2,0,"D"
2000-05-12,1999,"Vanspor","Bursaspor","3-1",3,1,"T1",1,4,2,"H"
2000-05-13,1999,"Denizlispor","Goztep","2-0",2,0,"T1",1,2,2,"H"
2000-05-13,1999,"Trabzonspor","Samsunspor","3-2",3,2,"T1",1,5,1,"H"
2000-05-14,1999,"Besiktas","Fenerbahce","1-3",1,3,"T1",1,4,-2,"A"
2000-05-19,1999,"Samsunspor","Genclerbirligi","1-2",1,2,"T1",1,3,-1,"A"
2000-05-20,1999,"Adanaspor","Gaziantepspor","3-0",3,0,"T1",1,3,3,"H"
2000-05-20,1999,"Fenerbahce","Denizlispor","2-1",2,1,"T1",1,3,1,"H"
2000-05-20,1999,"Goztep","Vanspor","2-1",2,1,"T1",1,3,1,"H"
2000-05-21,1999,"Ankaragucu","Trabzonspor","1-1",1,1,"T1",1,2,0,"D"
2000-05-21,1999,"Antalyaspor","Altay","3-1",3,1,"T1",1,4,2,"H"
2000-05-21,1999,"Bursaspor","Kocaelispor","2-0",2,0,"T1",1,2,2,"H"
2000-05-21,1999,"Erzurumspor","Besiktas","1-4",1,4,"T1",1,5,-3,"A"
2000-05-21,1999,"Galatasaray","Istanbulspor","1-1",1,1,"T1",1,2,0,"D"
2000-08-11,2000,"Kocaelispor","Fenerbahce","0-4",0,4,"T1",1,4,-4,"A"
2000-08-12,2000,"Besiktas","Yozgatspor","3-0",3,0,"T1",1,3,3,"H"
2000-08-12,2000,"Bursaspor","Gaziantepspor","3-3",3,3,"T1",1,6,0,"D"
2000-08-12,2000,"Erzurumspor","Trabzonspor","1-3",1,3,"T1",1,4,-2,"A"
2000-08-12,2000,"Genclerbirligi","Rizespor","0-0",0,0,"T1",1,0,0,"D"
2000-08-13,2000,"Denizlispor","Galatasaray","0-1",0,1,"T1",1,1,-1,"A"
2000-08-13,2000,"Istanbulspor","Adanaspor","1-6",1,6,"T1",1,7,-5,"A"
2000-08-13,2000,"Samsunspor","Ankaragucu","3-0",3,0,"T1",1,3,3,"H"
2000-08-13,2000,"Siirt Jet-PA","Antalyaspor","1-2",1,2,"T1",1,3,-1,"A"
2000-08-18,2000,"Antalyaspor","Besiktas","1-2",1,2,"T1",1,3,-1,"A"
2000-08-19,2000,"Ankaragucu","Kocaelispor","1-0",1,0,"T1",1,1,1,"H"
2000-08-19,2000,"Galatasaray","Erzurumspor","7-0",7,0,"T1",1,7,7,"H"
2000-08-19,2000,"Siirt Jet-PA","Rizespor","2-3",2,3,"T1",1,5,-1,"A"
2000-08-19,2000,"Yozgatspor","Denizlispor","2-0",2,0,"T1",1,2,2,"H"
2000-08-20,2000,"Fenerbahce","Istanbulspor","2-0",2,0,"T1",1,2,2,"H"
2000-08-20,2000,"Gaziantepspor","Samsunspor","4-0",4,0,"T1",1,4,4,"H"
2000-08-20,2000,"Genclerbirligi","Adanaspor","1-0",1,0,"T1",1,1,1,"H"
2000-08-20,2000,"Trabzonspor","Bursaspor","2-1",2,1,"T1",1,3,1,"H"
2000-08-25,2000,"Samsunspor","Trabzonspor","1-1",1,1,"T1",1,2,0,"D"
2000-08-26,2000,"Denizlispor","Erzurumspor","3-1",3,1,"T1",1,4,2,"H"
2000-08-26,2000,"Genclerbirligi","Fenerbahce","3-1",3,1,"T1",1,4,2,"H"
2000-08-26,2000,"Siirt Jet-PA","Adanaspor","2-2",2,2,"T1",1,4,0,"D"
2000-08-27,2000,"Besiktas","Rizespor","2-1",2,1,"T1",1,3,1,"H"
2000-08-27,2000,"Istanbulspor","Ankaragucu","0-2",0,2,"T1",1,2,-2,"A"
2000-08-27,2000,"Kocaelispor","Gaziantepspor","1-2",1,2,"T1",1,3,-1,"A"
2000-08-27,2000,"Yozgatspor","Antalyaspor","0-0",0,0,"T1",1,0,0,"D"
2000-09-06,2000,"Bursaspor","Galatasaray","0-2",0,2,"T1",1,2,-2,"A"
2000-09-08,2000,"Adanaspor","Besiktas","1-1",1,1,"T1",1,2,0,"D"
2000-09-09,2000,"Ankaragucu","Genclerbirligi","2-3",2,3,"T1",1,5,-1,"A"
2000-09-09,2000,"Antalyaspor","Denizlispor","4-1",4,1,"T1",1,5,3,"H"
2000-09-09,2000,"Galatasaray","Samsunspor","1-2",1,2,"T1",1,3,-1,"A"
2000-09-09,2000,"Trabzonspor","Kocaelispor","2-1",2,1,"T1",1,3,1,"H"
2000-09-10,2000,"Erzurumspor","Bursaspor","5-0",5,0,"T1",1,5,5,"H"
2000-09-10,2000,"Fenerbahce","Siirt Jet-PA","4-2",4,2,"T1",1,6,2,"H"
2000-09-10,2000,"Gaziantepspor","Istanbulspor","0-0",0,0,"T1",1,0,0,"D"
2000-09-10,2000,"Yozgatspor","Rizespor","0-0",0,0,"T1",1,0,0,"D"
2000-09-15,2000,"Kocaelispor","Galatasaray","1-4",1,4,"T1",1,5,-3,"A"
2000-09-16,2000,"Besiktas","Fenerbahce","3-0",3,0,"T1",1,3,3,"H"
2000-09-16,2000,"Denizlispor","Bursaspor","1-1",1,1,"T1",1,2,0,"D"
2000-09-16,2000,"Samsunspor","Erzurumspor","2-2",2,2,"T1",1,4,0,"D"
2000-09-17,2000,"Antalyaspor","Rizespor","2-1",2,1,"T1",1,3,1,"H"
2000-09-17,2000,"Genclerbirligi","Gaziantepspor","2-0",2,0,"T1",1,2,2,"H"
2000-09-17,2000,"Istanbulspor","Trabzonspor","1-0",1,0,"T1",1,1,1,"H"
2000-09-17,2000,"Siirt Jet-PA","Ankaragucu","1-1",1,1,"T1",1,2,0,"D"
2000-09-17,2000,"Yozgatspor","Adanaspor","4-1",4,1,"T1",1,5,3,"H"
2000-09-22,2000,"Ankaragucu","Besiktas","1-5",1,5,"T1",1,6,-4,"A"
2000-09-23,2000,"Adanaspor","Antalyaspor","1-1",1,1,"T1",1,2,0,"D"
2000-09-23,2000,"Bursaspor","Samsunspor","0-2",0,2,"T1",1,2,-2,"A"
2000-09-23,2000,"Gaziantepspor","Siirt Jet-PA","4-0",4,0,"T1",1,4,4,"H"
2000-09-23,2000,"Galatasaray","Istanbulspor","1-1",1,1,"T1",1,2,0,"D"
2000-09-24,2000,"Denizlispor","Rizespor","0-0",0,0,"T1",1,0,0,"D"
2000-09-24,2000,"Erzurumspor","Kocaelispor","1-0",1,0,"T1",1,1,1,"H"
2000-09-24,2000,"Fenerbahce","Yozgatspor","3-1",3,1,"T1",1,4,2,"H"
2000-09-24,2000,"Trabzonspor","Genclerbirligi","2-0",2,0,"T1",1,2,2,"H"
2000-09-29,2000,"Denizlispor","Samsunspor","3-1",3,1,"T1",1,4,2,"H"
2000-09-30,2000,"Genclerbirligi","Galatasaray","1-4",1,4,"T1",1,5,-3,"A"
2000-09-30,2000,"Istanbulspor","Erzurumspor","1-0",1,0,"T1",1,1,1,"H"
2000-09-30,2000,"Kocaelispor","Bursaspor","0-0",0,0,"T1",1,0,0,"D"
2000-10-01,2000,"Adanaspor","Rizespor","1-0",1,0,"T1",1,1,1,"H"
2000-10-01,2000,"Antalyaspor","Fenerbahce","0-1",0,1,"T1",1,1,-1,"A"
2000-10-01,2000,"Besiktas","Gaziantepspor","2-4",2,4,"T1",1,6,-2,"A"
2000-10-01,2000,"Siirt Jet-PA","Trabzonspor","1-4",1,4,"T1",1,5,-3,"A"
2000-10-01,2000,"Yozgatspor","Ankaragucu","0-1",0,1,"T1",1,1,-1,"A"
2000-10-13,2000,"Adanaspor","Denizlispor","2-3",2,3,"T1",1,5,-1,"A"
2000-10-14,2000,"Bursaspor","Istanbulspor","2-5",2,5,"T1",1,7,-3,"A"
2000-10-14,2000,"Gaziantepspor","Yozgatspor","3-1",3,1,"T1",1,4,2,"H"
2000-10-14,2000,"Galatasaray","Siirt Jet-PA","4-1",4,1,"T1",1,5,3,"H"
2000-10-14,2000,"Trabzonspor","Besiktas","2-0",2,0,"T1",1,2,2,"H"
2000-10-15,2000,"Ankaragucu","Antalyaspor","1-1",1,1,"T1",1,2,0,"D"
2000-10-15,2000,"Erzurumspor","Genclerbirligi","1-2",1,2,"T1",1,3,-1,"A"
2000-10-15,2000,"Fenerbahce","Rizespor","1-0",1,0,"T1",1,1,1,"H"
2000-10-15,2000,"Samsunspor","Kocaelispor","0-1",0,1,"T1",1,1,-1,"A"
2000-10-19,2000,"Antalyaspor","Gaziantepspor","2-2",2,2,"T1",1,4,0,"D"
2000-10-20,2000,"Adanaspor","Fenerbahce","1-1",1,1,"T1",1,2,0,"D"
2000-10-21,2000,"Besiktas","Galatasaray","3-1",3,1,"T1",1,4,2,"H"
2000-10-21,2000,"Denizlispor","Kocaelispor","2-1",2,1,"T1",1,3,1,"H"
2000-10-21,2000,"Genclerbirligi","Bursaspor","0-1",0,1,"T1",1,1,-1,"A"
2000-10-21,2000,"Istanbulspor","Samsunspor","0-0",0,0,"T1",1,0,0,"D"
2000-10-21,2000,"Rizespor","Ankaragucu","1-1",1,1,"T1",1,2,0,"D"
2000-10-21,2000,"Siirt Jet-PA","Erzurumspor","1-1",1,1,"T1",1,2,0,"D"
2000-10-21,2000,"Yozgatspor","Trabzonspor","1-1",1,1,"T1",1,2,0,"D"
2000-10-27,2000,"Fenerbahce","Denizlispor","5-2",5,2,"T1",1,7,3,"H"
2000-10-28,2000,"Ankaragucu","Adanaspor","4-0",4,0,"T1",1,4,4,"H"
2000-10-28,2000,"Bursaspor","Siirt Jet-PA","3-2",3,2,"T1",1,5,1,"H"
2000-10-28,2000,"Erzurumspor","Besiktas","1-3",1,3,"T1",1,4,-2,"A"
2000-10-28,2000,"Trabzonspor","Antalyaspor","4-0",4,0,"T1",1,4,4,"H"
2000-10-29,2000,"Gaziantepspor","Rizespor","2-1",2,1,"T1",1,3,1,"H"
2000-10-29,2000,"Galatasaray","Yozgatspor","3-0",3,0,"T1",1,3,3,"H"
2000-10-29,2000,"Kocaelispor","Istanbulspor","1-1",1,1,"T1",1,2,0,"D"
2000-10-29,2000,"Samsunspor","Genclerbirligi","1-2",1,2,"T1",1,3,-1,"A"
2000-11-03,2000,"Rizespor","Trabzonspor","2-1",2,1,"T1",1,3,1,"H"
2000-11-04,2000,"Besiktas","Bursaspor","2-1",2,1,"T1",1,3,1,"H"
2000-11-04,2000,"Denizlispor","Istanbulspor","0-4",0,4,"T1",1,4,-4,"A"
2000-11-04,2000,"Genclerbirligi","Kocaelispor","0-0",0,0,"T1",1,0,0,"D"
2000-11-05,2000,"Adanaspor","Gaziantepspor","0-1",0,1,"T1",1,1,-1,"A"
2000-11-05,2000,"Fenerbahce","Ankaragucu","5-1",5,1,"T1",1,6,4,"H"
2000-11-05,2000,"Siirt Jet-PA","Samsunspor","1-2",1,2,"T1",1,3,-1,"A"
2000-11-05,2000,"Yozgatspor","Erzurumspor","4-0",4,0,"T1",1,4,4,"H"
2000-11-10,2000,"Gaziantepspor","Fenerbahce","2-1",2,1,"T1",1,3,1,"H"
2000-11-11,2000,"Bursaspor","Yozgatspor","1-4",1,4,"T1",1,5,-3,"A"
2000-11-11,2000,"Erzurumspor","Antalyaspor","0-1",0,1,"T1",1,1,-1,"A"
2000-11-11,2000,"Galatasaray","Rizespor","2-0",2,0,"T1",1,2,2,"H"
2000-11-11,2000,"Istanbulspor","Genclerbirligi","2-1",2,1,"T1",1,3,1,"H"
2000-11-12,2000,"Ankaragucu","Denizlispor","3-1",3,1,"T1",1,4,2,"H"
2000-11-12,2000,"Kocaelispor","Siirt Jet-PA","1-1",1,1,"T1",1,2,0,"D"
2000-11-12,2000,"Samsunspor","Besiktas","2-3",2,3,"T1",1,5,-1,"A"
2000-11-12,2000,"Trabzonspor","Adanaspor","3-3",3,3,"T1",1,6,0,"D"
2000-11-17,2000,"Besiktas","Kocaelispor","3-2",3,2,"T1",1,5,1,"H"
2000-11-18,2000,"Adanaspor","Galatasaray","1-2",1,2,"T1",1,3,-1,"A"
2000-11-18,2000,"Ankaragucu","Gaziantepspor","1-1",1,1,"T1",1,2,0,"D"
2000-11-18,2000,"Rizespor","Erzurumspor","4-1",4,1,"T1",1,5,3,"H"
2000-11-18,2000,"Siirt Jet-PA","Istanbulspor","0-2",0,2,"T1",1,2,-2,"A"
2000-11-19,2000,"Antalyaspor","Bursaspor","2-1",2,1,"T1",1,3,1,"H"
2000-11-19,2000,"Denizlispor","Genclerbirligi","0-0",0,0,"T1",1,0,0,"D"
2000-11-19,2000,"Fenerbahce","Trabzonspor","5-2",5,2,"T1",1,7,3,"H"
2000-11-19,2000,"Yozgatspor","Samsunspor","0-0",0,0,"T1",1,0,0,"D"
2000-11-24,2000,"Trabzonspor","Ankaragucu","2-2",2,2,"T1",1,4,0,"D"
2000-11-25,2000,"Erzurumspor","Adanaspor","2-0",2,0,"T1",1,2,2,"H"
2000-11-25,2000,"Istanbulspor","Besiktas","2-3",2,3,"T1",1,5,-1,"A"
2000-11-25,2000,"Samsunspor","Antalyaspor","4-2",4,2,"T1",1,6,2,"H"
2000-11-26,2000,"Bursaspor","Rizespor","2-1",2,1,"T1",1,3,1,"H"
2000-11-26,2000,"Gaziantepspor","Denizlispor","1-1",1,1,"T1",1,2,0,"D"
2000-11-26,2000,"Genclerbirligi","Siirt Jet-PA","2-0",2,0,"T1",1,2,2,"H"
2000-11-26,2000,"Galatasaray","Fenerbahce","0-0",0,0,"T1",1,0,0,"D"
2000-11-26,2000,"Kocaelispor","Yozgatspor","2-2",2,2,"T1",1,4,0,"D"
2000-12-01,2000,"Ankaragucu","Galatasaray","1-3",1,3,"T1",1,4,-2,"A"
2000-12-02,2000,"Antalyaspor","Kocaelispor","2-2",2,2,"T1",1,4,0,"D"
2000-12-02,2000,"Besiktas","Genclerbirligi","0-3",0,3,"T1",1,3,-3,"A"
2000-12-02,2000,"Trabzonspor","Gaziantepspor","3-1",3,1,"T1",1,4,2,"H"
2000-12-02,2000,"Yozgatspor","Istanbulspor","3-0",3,0,"T1",1,3,3,"H"
2000-12-03,2000,"Adanaspor","Bursaspor","1-1",1,1,"T1",1,2,0,"D"
2000-12-03,2000,"Fenerbahce","Erzurumspor","4-2",4,2,"T1",1,6,2,"H"
2000-12-03,2000,"Rizespor","Samsunspor","0-1",0,1,"T1",1,1,-1,"A"
2000-12-03,2000,"Siirt Jet-PA","Denizlispor","1-1",1,1,"T1",1,2,0,"D"
2000-12-08,2000,"Denizlispor","Trabzonspor","2-0",2,0,"T1",1,2,2,"H"
2000-12-09,2000,"Bursaspor","Fenerbahce","2-2",2,2,"T1",1,4,0,"D"
2000-12-09,2000,"Istanbulspor","Antalyaspor","2-0",2,0,"T1",1,2,2,"H"
2000-12-09,2000,"Kocaelispor","Rizespor","2-1",2,1,"T1",1,3,1,"H"
2000-12-09,2000,"Samsunspor","Adanaspor","3-1",3,1,"T1",1,4,2,"H"
2000-12-10,2000,"Erzurumspor","Ankaragucu","1-1",1,1,"T1",1,2,0,"D"
2000-12-10,2000,"Genclerbirligi","Yozgatspor","2-1",2,1,"T1",1,3,1,"H"
2000-12-10,2000,"Galatasaray","Gaziantepspor","2-0",2,0,"T1",1,2,2,"H"
2000-12-10,2000,"Siirt Jet-PA","Besiktas","1-1",1,1,"T1",1,2,0,"D"
2000-12-15,2000,"Fenerbahce","Samsunspor","2-1",2,1,"T1",1,3,1,"H"
2000-12-16,2000,"Besiktas","Denizlispor","1-1",1,1,"T1",1,2,0,"D"
2000-12-16,2000,"Gaziantepspor","Erzurumspor","6-1",6,1,"T1",1,7,5,"H"
2000-12-16,2000,"Rizespor","Istanbulspor","2-1",2,1,"T1",1,3,1,"H"
2000-12-16,2000,"Yozgatspor","Siirt Jet-PA","2-1",2,1,"T1",1,3,1,"H"
2000-12-17,2000,"Adanaspor","Kocaelispor","4-4",4,4,"T1",1,8,0,"D"
2000-12-17,2000,"Ankaragucu","Bursaspor","1-1",1,1,"T1",1,2,0,"D"
2000-12-17,2000,"Antalyaspor","Genclerbirligi","4-2",4,2,"T1",1,6,2,"H"
2000-12-17,2000,"Trabzonspor","Galatasaray","1-1",1,1,"T1",1,2,0,"D"
2000-12-20,2000,"Antalyaspor","Galatasaray","0-1",0,1,"T1",1,1,-1,"A"
2000-12-21,2000,"Trabzonspor","Erzurumspor","3-0",3,0,"T1",1,3,3,"H"
2000-12-22,2000,"Adanaspor","Istanbulspor","2-2",2,2,"T1",1,4,0,"D"
2000-12-22,2000,"Ankaragucu","Samsunspor","2-0",2,0,"T1",1,2,2,"H"
2000-12-22,2000,"Fenerbahce","Kocaelispor","4-0",4,0,"T1",1,4,4,"H"
2000-12-22,2000,"Rizespor","Genclerbirligi","2-0",2,0,"T1",1,2,2,"H"
2000-12-23,2000,"Antalyaspor","Siirt Jet-PA","1-3",1,3,"T1",1,4,-2,"A"
2000-12-23,2000,"Gaziantepspor","Bursaspor","2-1",2,1,"T1",1,3,1,"H"
2000-12-23,2000,"Galatasaray","Denizlispor","1-2",1,2,"T1",1,3,-1,"A"
2000-12-23,2000,"Yozgatspor","Besiktas","1-1",1,1,"T1",1,2,0,"D"
2001-02-02,2000,"Samsunspor","Gaziantepspor","3-3",3,3,"T1",1,6,0,"D"
2001-02-03,2000,"Besiktas","Antalyaspor","4-2",4,2,"T1",1,6,2,"H"
2001-02-03,2000,"Denizlispor","Yozgatspor","2-0",2,0,"T1",1,2,2,"H"
2001-02-03,2000,"Erzurumspor","Galatasaray","1-2",1,2,"T1",1,3,-1,"A"
2001-02-03,2000,"Rizespor","Siirt Jet-PA","3-0",3,0,"T1",1,3,3,"H"
2001-02-04,2000,"Adanaspor","Genclerbirligi","2-3",2,3,"T1",1,5,-1,"A"
2001-02-04,2000,"Bursaspor","Trabzonspor","4-2",4,2,"T1",1,6,2,"H"
2001-02-04,2000,"Istanbulspor","Fenerbahce","1-2",1,2,"T1",1,3,-1,"A"
2001-02-04,2000,"Kocaelispor","Ankaragucu","4-0",4,0,"T1",1,4,4,"H"
2001-02-09,2000,"Trabzonspor","Samsunspor","3-2",3,2,"T1",1,5,1,"H"
2001-02-10,2000,"Adanaspor","Siirt Jet-PA","0-2",0,2,"T1",1,2,-2,"A"
2001-02-10,2000,"Ankaragucu","Istanbulspor","1-1",1,1,"T1",1,2,0,"D"
2001-02-10,2000,"Galatasaray","Bursaspor","2-1",2,1,"T1",1,3,1,"H"
2001-02-11,2000,"Antalyaspor","Yozgatspor","1-1",1,1,"T1",1,2,0,"D"
2001-02-11,2000,"Erzurumspor","Denizlispor","2-2",2,2,"T1",1,4,0,"D"
2001-02-11,2000,"Fenerbahce","Genclerbirligi","3-0",3,0,"T1",1,3,3,"H"
2001-02-11,2000,"Gaziantepspor","Kocaelispor","0-0",0,0,"T1",1,0,0,"D"
2001-02-11,2000,"Rizespor","Besiktas","5-1",5,1,"T1",1,6,4,"H"
2001-02-16,2000,"Istanbulspor","Gaziantepspor","0-1",0,1,"T1",1,1,-1,"A"
2001-02-17,2000,"Denizlispor","Antalyaspor","1-1",1,1,"T1",1,2,0,"D"
2001-02-17,2000,"Samsunspor","Galatasaray","1-1",1,1,"T1",1,2,0,"D"
2001-02-17,2000,"Siirt Jet-PA","Fenerbahce","0-4",0,4,"T1",1,4,-4,"A"
2001-02-18,2000,"Besiktas","Adanaspor","2-1",2,1,"T1",1,3,1,"H"
2001-02-18,2000,"Bursaspor","Erzurumspor","6-0",6,0,"T1",1,6,6,"H"
2001-02-18,2000,"Genclerbirligi","Ankaragucu","3-4",3,4,"T1",1,7,-1,"A"
2001-02-18,2000,"Kocaelispor","Trabzonspor","3-2",3,2,"T1",1,5,1,"H"
2001-02-18,2000,"Rizespor","Yozgatspor","1-0",1,0,"T1",1,1,1,"H"
2001-02-23,2000,"Gaziantepspor","Genclerbirligi","1-0",1,0,"T1",1,1,1,"H"
2001-02-24,2000,"Ankaragucu","Siirt Jet-PA","4-1",4,1,"T1",1,5,3,"H"
2001-02-24,2000,"Fenerbahce","Besiktas","3-1",3,1,"T1",1,4,2,"H"
2001-02-24,2000,"Rizespor","Antalyaspor","0-2",0,2,"T1",1,2,-2,"A"
2001-02-25,2000,"Adanaspor","Yozgatspor","3-3",3,3,"T1",1,6,0,"D"
2001-02-25,2000,"Bursaspor","Denizlispor","2-1",2,1,"T1",1,3,1,"H"
2001-02-25,2000,"Erzurumspor","Samsunspor","1-2",1,2,"T1",1,3,-1,"A"
2001-02-25,2000,"Galatasaray","Kocaelispor","2-3",2,3,"T1",1,5,-1,"A"
2001-02-25,2000,"Trabzonspor","Istanbulspor","1-2",1,2,"T1",1,3,-1,"A"
2001-03-02,2000,"Genclerbirligi","Trabzonspor","0-2",0,2,"T1",1,2,-2,"A"
2001-03-03,2000,"Antalyaspor","Adanaspor","2-1",2,1,"T1",1,3,1,"H"
2001-03-03,2000,"Samsunspor","Bursaspor","2-0",2,0,"T1",1,2,2,"H"
2001-03-03,2000,"Siirt Jet-PA","Gaziantepspor","1-2",1,2,"T1",1,3,-1,"A"
2001-03-03,2000,"Yozgatspor","Fenerbahce","2-3",2,3,"T1",1,5,-1,"A"
2001-03-04,2000,"Besiktas","Ankaragucu","4-0",4,0,"T1",1,4,4,"H"
2001-03-04,2000,"Kocaelispor","Erzurumspor","1-0",1,0,"T1",1,1,1,"H"
2001-03-04,2000,"Rizespor","Denizlispor","2-1",2,1,"T1",1,3,1,"H"
2001-03-09,2000,"Gaziantepspor","Besiktas","3-1",3,1,"T1",1,4,2,"H"
2001-03-10,2000,"Bursaspor","Kocaelispor","1-1",1,1,"T1",1,2,0,"D"
2001-03-10,2000,"Erzurumspor","Istanbulspor","1-3",1,3,"T1",1,4,-2,"A"
2001-03-10,2000,"Galatasaray","Genclerbirligi","2-1",2,1,"T1",1,3,1,"H"
2001-03-10,2000,"Samsunspor","Denizlispor","2-1",2,1,"T1",1,3,1,"H"
2001-03-11,2000,"Ankaragucu","Yozgatspor","4-0",4,0,"T1",1,4,4,"H"
2001-03-11,2000,"Fenerbahce","Antalyaspor","2-1",2,1,"T1",1,3,1,"H"
2001-03-11,2000,"Rizespor","Adanaspor","4-2",4,2,"T1",1,6,2,"H"
2001-03-11,2000,"Trabzonspor","Siirt Jet-PA","2-4",2,4,"T1",1,6,-2,"A"
2001-03-16,2000,"Kocaelispor","Samsunspor","1-0",1,0,"T1",1,1,1,"H"
2001-03-17,2000,"Antalyaspor","Ankaragucu","3-4",3,4,"T1",1,7,-1,"A"
2001-03-17,2000,"Genclerbirligi","Erzurumspor","1-2",1,2,"T1",1,3,-1,"A"
2001-03-17,2000,"Istanbulspor","Bursaspor","2-4",2,4,"T1",1,6,-2,"A"
2001-03-17,2000,"Rizespor","Fenerbahce","1-1",1,1,"T1",1,2,0,"D"
2001-03-18,2000,"Besiktas","Trabzonspor","3-1",3,1,"T1",1,4,2,"H"
2001-03-18,2000,"Denizlispor","Adanaspor","4-2",4,2,"T1",1,6,2,"H"
2001-03-18,2000,"Siirt Jet-PA","Galatasaray","0-1",0,1,"T1",1,1,-1,"A"
2001-03-18,2000,"Yozgatspor","Gaziantepspor","1-2",1,2,"T1",1,3,-1,"A"
2001-03-30,2000,"Kocaelispor","Denizlispor","4-2",4,2,"T1",1,6,2,"H"
2001-03-31,2000,"Ankaragucu","Rizespor","4-0",4,0,"T1",1,4,4,"H"
2001-03-31,2000,"Bursaspor","Genclerbirligi","2-0",2,0,"T1",1,2,2,"H"
2001-03-31,2000,"Erzurumspor","Siirt Jet-PA","2-1",2,1,"T1",1,3,1,"H"
2001-03-31,2000,"Galatasaray","Besiktas","2-0",2,0,"T1",1,2,2,"H"
2001-04-01,2000,"Fenerbahce","Adanaspor","4-0",4,0,"T1",1,4,4,"H"
2001-04-01,2000,"Gaziantepspor","Antalyaspor","2-0",2,0,"T1",1,2,2,"H"
2001-04-01,2000,"Samsunspor","Istanbulspor","2-3",2,3,"T1",1,5,-1,"A"
2001-04-01,2000,"Trabzonspor","Yozgatspor","1-1",1,1,"T1",1,2,0,"D"
2001-04-06,2000,"Rizespor","Gaziantepspor","2-1",2,1,"T1",1,3,1,"H"
2001-04-07,2000,"Adanaspor","Ankaragucu","1-3",1,3,"T1",1,4,-2,"A"
2001-04-07,2000,"Antalyaspor","Trabzonspor","2-3",2,3,"T1",1,5,-1,"A"
2001-04-07,2000,"Denizlispor","Fenerbahce","2-1",2,1,"T1",1,3,1,"H"
2001-04-07,2000,"Genclerbirligi","Samsunspor","1-0",1,0,"T1",1,1,1,"H"
2001-04-08,2000,"Besiktas","Erzurumspor","2-0",2,0,"T1",1,2,2,"H"
2001-04-08,2000,"Istanbulspor","Kocaelispor","1-1",1,1,"T1",1,2,0,"D"
2001-04-08,2000,"Siirt Jet-PA","Bursaspor","2-5",2,5,"T1",1,7,-3,"A"
2001-04-08,2000,"Yozgatspor","Galatasaray","4-2",4,2,"T1",1,6,2,"H"
2001-04-11,2000,"Istanbulspor","Galatasaray","3-5",3,5,"T1",1,8,-2,"A"
2001-04-13,2000,"Bursaspor","Besiktas","0-1",0,1,"T1",1,1,-1,"A"
2001-04-14,2000,"Galatasaray","Antalyaspor","2-0",2,0,"T1",1,2,2,"H"
2001-04-14,2000,"Istanbulspor","Denizlispor","1-3",1,3,"T1",1,4,-2,"A"
2001-04-14,2000,"Samsunspor","Siirt Jet-PA","4-3",4,3,"T1",1,7,1,"H"
2001-04-15,2000,"Ankaragucu","Fenerbahce","2-1",2,1,"T1",1,3,1,"H"
2001-04-15,2000,"Erzurumspor","Yozgatspor","1-2",1,2,"T1",1,3,-1,"A"
2001-04-15,2000,"Gaziantepspor","Adanaspor","3-0",3,0,"T1",1,3,3,"H"
2001-04-15,2000,"Kocaelispor","Genclerbirligi","4-1",4,1,"T1",1,5,3,"H"
2001-04-15,2000,"Trabzonspor","Rizespor","2-0",2,0,"T1",1,2,2,"H"
2001-04-20,2000,"Besiktas","Samsunspor","0-0",0,0,"T1",1,0,0,"D"
2001-04-21,2000,"Adanaspor","Trabzonspor","1-7",1,7,"T1",1,8,-6,"A"
2001-04-21,2000,"Denizlispor","Ankaragucu","2-0",2,0,"T1",1,2,2,"H"
2001-04-21,2000,"Fenerbahce","Gaziantepspor","4-3",4,3,"T1",1,7,1,"H"
2001-04-22,2000,"Antalyaspor","Erzurumspor","1-0",1,0,"T1",1,1,1,"H"
2001-04-22,2000,"Genclerbirligi","Istanbulspor","3-0",3,0,"T1",1,3,3,"H"
2001-04-22,2000,"Rizespor","Galatasaray","2-4",2,4,"T1",1,6,-2,"A"
2001-04-22,2000,"Siirt Jet-PA","Kocaelispor","4-3",4,3,"T1",1,7,1,"H"
2001-04-22,2000,"Yozgatspor","Bursaspor","1-0",1,0,"T1",1,1,1,"H"
2001-04-27,2000,"Gaziantepspor","Ankaragucu","2-1",2,1,"T1",1,3,1,"H"
2001-04-28,2000,"Erzurumspor","Rizespor","0-0",0,0,"T1",1,0,0,"D"
2001-04-28,2000,"Galatasaray","Adanaspor","4-1",4,1,"T1",1,5,3,"H"
2001-04-28,2000,"Istanbulspor","Siirt Jet-PA","2-1",2,1,"T1",1,3,1,"H"
2001-04-28,2000,"Kocaelispor","Besiktas","1-1",1,1,"T1",1,2,0,"D"
2001-04-29,2000,"Bursaspor","Antalyaspor","4-0",4,0,"T1",1,4,4,"H"
2001-04-29,2000,"Genclerbirligi","Denizlispor","2-4",2,4,"T1",1,6,-2,"A"
2001-04-29,2000,"Samsunspor","Yozgatspor","0-2",0,2,"T1",1,2,-2,"A"
2001-04-29,2000,"Trabzonspor","Fenerbahce","1-0",1,0,"T1",1,1,1,"H"
2001-05-04,2000,"Ankaragucu","Trabzonspor","2-4",2,4,"T1",1,6,-2,"A"
2001-05-05,2000,"Adanaspor","Erzurumspor","3-3",3,3,"T1",1,6,0,"D"
2001-05-05,2000,"Antalyaspor","Samsunspor","2-2",2,2,"T1",1,4,0,"D"
2001-05-05,2000,"Besiktas","Istanbulspor","2-0",2,0,"T1",1,2,2,"H"
2001-05-05,2000,"Yozgatspor","Kocaelispor","4-2",4,2,"T1",1,6,2,"H"
2001-05-06,2000,"Denizlispor","Gaziantepspor","2-3",2,3,"T1",1,5,-1,"A"
2001-05-06,2000,"Fenerbahce","Galatasaray","2-1",2,1,"T1",1,3,1,"H"
2001-05-06,2000,"Rizespor","Bursaspor","3-1",3,1,"T1",1,4,2,"H"
2001-05-06,2000,"Siirt Jet-PA","Genclerbirligi","3-0",3,0,"T1",1,3,3,"H"
2001-05-12,2000,"Bursaspor","Adanaspor","2-1",2,1,"T1",1,3,1,"H"
2001-05-12,2000,"Denizlispor","Siirt Jet-PA","1-2",1,2,"T1",1,3,-1,"A"
2001-05-12,2000,"Istanbulspor","Yozgatspor","0-4",0,4,"T1",1,4,-4,"A"
2001-05-12,2000,"Kocaelispor","Antalyaspor","5-0",5,0,"T1",1,5,5,"H"
2001-05-12,2000,"Samsunspor","Rizespor","1-1",1,1,"T1",1,2,0,"D"
2001-05-13,2000,"Erzurumspor","Fenerbahce","1-2",1,2,"T1",1,3,-1,"A"
2001-05-13,2000,"Gaziantepspor","Trabzonspor","1-1",1,1,"T1",1,2,0,"D"
2001-05-13,2000,"Genclerbirligi","Besiktas","2-1",2,1,"T1",1,3,1,"H"
2001-05-13,2000,"Galatasaray","Ankaragucu","1-2",1,2,"T1",1,3,-1,"A"
2001-05-19,2000,"Adanaspor","Samsunspor","3-5",3,5,"T1",1,8,-2,"A"
2001-05-19,2000,"Ankaragucu","Erzurumspor","5-2",5,2,"T1",1,7,3,"H"
2001-05-19,2000,"Antalyaspor","Istanbulspor","2-2",2,2,"T1",1,4,0,"D"
2001-05-19,2000,"Besiktas","Siirt Jet-PA","5-1",5,1,"T1",1,6,4,"H"
2001-05-19,2000,"Rizespor","Kocaelispor","2-1",2,1,"T1",1,3,1,"H"
2001-05-19,2000,"Yozgatspor","Genclerbirligi","1-1",1,1,"T1",1,2,0,"D"
2001-05-20,2000,"Fenerbahce","Bursaspor","2-0",2,0,"T1",1,2,2,"H"
2001-05-20,2000,"Gaziantepspor","Galatasaray","0-2",0,2,"T1",1,2,-2,"A"
2001-05-20,2000,"Trabzonspor","Denizlispor","1-0",1,0,"T1",1,1,1,"H"
2001-05-25,2000,"Bursaspor","Ankaragucu","2-3",2,3,"T1",1,5,-1,"A"
2001-05-25,2000,"Denizlispor","Besiktas","2-2",2,2,"T1",1,4,0,"D"
2001-05-25,2000,"Erzurumspor","Gaziantepspor","0-2",0,2,"T1",1,2,-2,"A"
2001-05-25,2000,"Istanbulspor","Rizespor","1-0",1,0,"T1",1,1,1,"H"
2001-05-26,2000,"Genclerbirligi","Antalyaspor","2-1",2,1,"T1",1,3,1,"H"
2001-05-26,2000,"Galatasaray","Trabzonspor","4-0",4,0,"T1",1,4,4,"H"
2001-05-26,2000,"Kocaelispor","Adanaspor","4-3",4,3,"T1",1,7,1,"H"
2001-05-26,2000,"Samsunspor","Fenerbahce","1-3",1,3,"T1",1,4,-2,"A"
2001-05-26,2000,"Siirt Jet-PA","Yozgatspor","1-3",1,3,"T1",1,4,-2,"A"
2001-08-10,2001,"Besiktas","Trabzonspor","1-2",1,2,"T1",1,3,-1,"A"
2001-08-11,2001,"Fenerbahce","Samsunspor","3-0",3,0,"T1",1,3,3,"H"
2001-08-11,2001,"Genclerbirligi","Diyarbakirspor","4-4",4,4,"T1",1,8,0,"D"
2001-08-11,2001,"Goztep","Bursaspor","2-0",2,0,"T1",1,2,2,"H"
2001-08-11,2001,"Rizespor","Kocaelispor","0-0",0,0,"T1",1,0,0,"D"
2001-08-12,2001,"Antalyaspor","Ankaragucu","1-8",1,8,"T1",1,9,-7,"A"
2001-08-12,2001,"Denizlispor","Yozgatspor","5-0",5,0,"T1",1,5,5,"H"
2001-08-12,2001,"Gaziantepspor","Galatasaray","1-1",1,1,"T1",1,2,0,"D"
2001-08-12,2001,"Istanbulspor","Malatyaspor","1-0",1,0,"T1",1,1,1,"H"
2001-08-17,2001,"Bursaspor","Besiktas","2-2",2,2,"T1",1,4,0,"D"
2001-08-18,2001,"Diyarbakirspor","Goztep","1-2",1,2,"T1",1,3,-1,"A"
2001-08-18,2001,"Galatasaray","Denizlispor","1-0",1,0,"T1",1,1,1,"H"
2001-08-18,2001,"Kocaelispor","Antalyaspor","3-1",3,1,"T1",1,4,2,"H"
2001-08-18,2001,"Samsunspor","Genclerbirligi","2-2",2,2,"T1",1,4,0,"D"
2001-08-19,2001,"Ankaragucu","Malatyaspor","6-0",6,0,"T1",1,6,6,"H"
2001-08-19,2001,"Istanbulspor","Fenerbahce","1-0",1,0,"T1",1,1,1,"H"
2001-08-19,2001,"Trabzonspor","Gaziantepspor","2-1",2,1,"T1",1,3,1,"H"
2001-08-19,2001,"Yozgatspor","Rizespor","2-1",2,1,"T1",1,3,1,"H"
2001-08-24,2001,"Trabzonspor","Bursaspor","5-0",5,0,"T1",1,5,5,"H"
2001-08-25,2001,"Antalyaspor","Yozgatspor","3-3",3,3,"T1",1,6,0,"D"
2001-08-25,2001,"Besiktas","Diyarbakirspor","4-0",4,0,"T1",1,4,4,"H"
2001-08-25,2001,"Genclerbirligi","Istanbulspor","0-1",0,1,"T1",1,1,-1,"A"
2001-08-25,2001,"Goztep","Samsunspor","2-1",2,1,"T1",1,3,1,"H"
2001-08-26,2001,"Fenerbahce","Ankaragucu","4-1",4,1,"T1",1,5,3,"H"
2001-08-26,2001,"Gaziantepspor","Denizlispor","0-0",0,0,"T1",1,0,0,"D"
2001-08-26,2001,"Kocaelispor","Malatyaspor","2-0",2,0,"T1",1,2,2,"H"
2001-08-26,2001,"Rizespor","Galatasaray","3-6",3,6,"T1",1,9,-3,"A"
2001-09-07,2001,"Ankaragucu","Genclerbirligi","2-5",2,5,"T1",1,7,-3,"A"
2001-09-08,2001,"Bursaspor","Gaziantepspor","0-2",0,2,"T1",1,2,-2,"A"
2001-09-08,2001,"Diyarbakirspor","Trabzonspor","3-1",3,1,"T1",1,4,2,"H"
2001-09-08,2001,"Galatasaray","Antalyaspor","2-1",2,1,"T1",1,3,1,"H"
2001-09-08,2001,"Kocaelispor","Fenerbahce","3-3",3,3,"T1",1,6,0,"D"
2001-09-09,2001,"Denizlispor","Rizespor","1-2",1,2,"T1",1,3,-1,"A"
2001-09-09,2001,"Istanbulspor","Goztep","0-0",0,0,"T1",1,0,0,"D"
2001-09-09,2001,"Yozgatspor","Malatyaspor","3-0",3,0,"T1",1,3,3,"H"
2001-09-14,2001,"Besiktas","Istanbulspor","0-1",0,1,"T1",1,1,-1,"A"
2001-09-15,2001,"Antalyaspor","Denizlispor","1-0",1,0,"T1",1,1,1,"H"
2001-09-15,2001,"Bursaspor","Diyarbakirspor","2-1",2,1,"T1",1,3,1,"H"
2001-09-15,2001,"Fenerbahce","Yozgatspor","1-0",1,0,"T1",1,1,1,"H"
2001-09-15,2001,"Malatyaspor","Galatasaray","0-2",0,2,"T1",1,2,-2,"A"
2001-09-16,2001,"Gaziantepspor","Rizespor","0-2",0,2,"T1",1,2,-2,"A"
2001-09-16,2001,"Genclerbirligi","Kocaelispor","2-2",2,2,"T1",1,4,0,"D"
2001-09-16,2001,"Goztep","Ankaragucu","2-1",2,1,"T1",1,3,1,"H"
2001-09-16,2001,"Trabzonspor","Samsunspor","1-2",1,2,"T1",1,3,-1,"A"
2001-09-21,2001,"Kocaelispor","Goztep","2-0",2,0,"T1",1,2,2,"H"
2001-09-22,2001,"Bursaspor","Samsunspor","2-1",2,1,"T1",1,3,1,"H"
2001-09-22,2001,"Denizlispor","Malatyaspor","4-1",4,1,"T1",1,5,3,"H"
2001-09-22,2001,"Galatasaray","Fenerbahce","2-0",2,0,"T1",1,2,2,"H"
2001-09-23,2001,"Ankaragucu","Besiktas","3-4",3,4,"T1",1,7,-1,"A"
2001-09-23,2001,"Istanbulspor","Trabzonspor","2-1",2,1,"T1",1,3,1,"H"
2001-09-23,2001,"Rizespor","Antalyaspor","1-1",1,1,"T1",1,2,0,"D"
2001-09-23,2001,"Yozgatspor","Genclerbirligi","0-2",0,2,"T1",1,2,-2,"A"
2001-09-28,2001,"Trabzonspor","Ankaragucu","2-2",2,2,"T1",1,4,0,"D"
2001-09-29,2001,"Diyarbakirspor","Samsunspor","1-1",1,1,"T1",1,2,0,"D"
2001-09-29,2001,"Fenerbahce","Denizlispor","2-1",2,1,"T1",1,3,1,"H"
2001-09-29,2001,"Malatyaspor","Rizespor","2-1",2,1,"T1",1,3,1,"H"
2001-09-30,2001,"Besiktas","Kocaelispor","4-2",4,2,"T1",1,6,2,"H"
2001-09-30,2001,"Bursaspor","Istanbulspor","1-2",1,2,"T1",1,3,-1,"A"
2001-09-30,2001,"Gaziantepspor","Antalyaspor","2-3",2,3,"T1",1,5,-1,"A"
2001-09-30,2001,"Genclerbirligi","Galatasaray","1-3",1,3,"T1",1,4,-2,"A"
2001-09-30,2001,"Goztep","Yozgatspor","0-0",0,0,"T1",1,0,0,"D"
2001-10-10,2001,"Diyarbakirspor","Gaziantepspor","2-3",2,3,"T1",1,5,-1,"A"
2001-10-10,2001,"Samsunspor","Besiktas","2-1",2,1,"T1",1,3,1,"H"
2001-10-12,2001,"Galatasaray","Goztep","4-1",4,1,"T1",1,5,3,"H"
2001-10-13,2001,"Ankaragucu","Bursaspor","0-1",0,1,"T1",1,1,-1,"A"
2001-10-13,2001,"Antalyaspor","Malatyaspor","2-1",2,1,"T1",1,3,1,"H"
2001-10-13,2001,"Denizlispor","Genclerbirligi","4-1",4,1,"T1",1,5,3,"H"
2001-10-13,2001,"Kocaelispor","Trabzonspor","1-0",1,0,"T1",1,1,1,"H"
2001-10-14,2001,"Gaziantepspor","Samsunspor","1-0",1,0,"T1",1,1,1,"H"
2001-10-14,2001,"Istanbulspor","Diyarbakirspor","1-0",1,0,"T1",1,1,1,"H"
2001-10-14,2001,"Rizespor","Fenerbahce","1-2",1,2,"T1",1,3,-1,"A"
2001-10-14,2001,"Yozgatspor","Besiktas","1-3",1,3,"T1",1,4,-2,"A"
2001-10-19,2001,"Diyarbakirspor","Ankaragucu","2-1",2,1,"T1",1,3,1,"H"
2001-10-20,2001,"Fenerbahce","Antalyaspor","3-2",3,2,"T1",1,5,1,"H"
2001-10-20,2001,"Gaziantepspor","Malatyaspor","1-0",1,0,"T1",1,1,1,"H"
2001-10-20,2001,"Istanbulspor","Samsunspor","0-1",0,1,"T1",1,1,-1,"A"
2001-10-20,2001,"Trabzonspor","Yozgatspor","2-0",2,0,"T1",1,2,2,"H"
2001-10-21,2001,"Besiktas","Galatasaray","2-2",2,2,"T1",1,4,0,"D"
2001-10-21,2001,"Bursaspor","Kocaelispor","2-1",2,1,"T1",1,3,1,"H"
2001-10-21,2001,"Genclerbirligi","Rizespor","2-2",2,2,"T1",1,4,0,"D"
2001-10-21,2001,"Goztep","Denizlispor","1-1",1,1,"T1",1,2,0,"D"
2001-10-26,2001,"Kocaelispor","Diyarbakirspor","3-1",3,1,"T1",1,4,2,"H"
2001-10-27,2001,"Galatasaray","Trabzonspor","3-1",3,1,"T1",1,4,2,"H"
2001-10-27,2001,"Malatyaspor","Fenerbahce","1-3",1,3,"T1",1,4,-2,"A"
2001-10-27,2001,"Rizespor","Goztep","0-0",0,0,"T1",1,0,0,"D"
2001-10-27,2001,"Yozgatspor","Bursaspor","3-4",3,4,"T1",1,7,-1,"A"
2001-10-28,2001,"Ankaragucu","Samsunspor","2-0",2,0,"T1",1,2,2,"H"
2001-10-28,2001,"Antalyaspor","Genclerbirligi","2-2",2,2,"T1",1,4,0,"D"
2001-10-28,2001,"Denizlispor","Besiktas","3-3",3,3,"T1",1,6,0,"D"
2001-10-28,2001,"Istanbulspor","Gaziantepspor","0-1",0,1,"T1",1,1,-1,"A"
2001-11-02,2001,"Bursaspor","Galatasaray","5-0",5,0,"T1",1,5,5,"H"
2001-11-03,2001,"Besiktas","Rizespor","2-1",2,1,"T1",1,3,1,"H"
2001-11-03,2001,"Genclerbirligi","Malatyaspor","1-2",1,2,"T1",1,3,-1,"A"
2001-11-03,2001,"Istanbulspor","Ankaragucu","1-2",1,2,"T1",1,3,-1,"A"
2001-11-03,2001,"Kocaelispor","Samsunspor","0-1",0,1,"T1",1,1,-1,"A"
2001-11-04,2001,"Diyarbakirspor","Yozgatspor","1-1",1,1,"T1",1,2,0,"D"
2001-11-04,2001,"Gaziantepspor","Fenerbahce","0-2",0,2,"T1",1,2,-2,"A"
2001-11-04,2001,"Goztep","Antalyaspor","0-0",0,0,"T1",1,0,0,"D"
2001-11-04,2001,"Trabzonspor","Denizlispor","2-2",2,2,"T1",1,4,0,"D"
2001-11-16,2001,"Antalyaspor","Besiktas","1-4",1,4,"T1",1,5,-3,"A"
2001-11-17,2001,"Ankaragucu","Gaziantepspor","1-1",1,1,"T1",1,2,0,"D"
2001-11-17,2001,"Galatasaray","Diyarbakirspor","5-1",5,1,"T1",1,6,4,"H"
2001-11-17,2001,"Rizespor","Trabzonspor","1-1",1,1,"T1",1,2,0,"D"
2001-11-17,2001,"Yozgatspor","Samsunspor","2-0",2,0,"T1",1,2,2,"H"
2001-11-18,2001,"Denizlispor","Bursaspor","0-0",0,0,"T1",1,0,0,"D"
2001-11-18,2001,"Fenerbahce","Genclerbirligi","2-0",2,0,"T1",1,2,2,"H"
2001-11-18,2001,"Kocaelispor","Istanbulspor","2-0",2,0,"T1",1,2,2,"H"
2001-11-18,2001,"Malatyaspor","Goztep","3-1",3,1,"T1",1,4,2,"H"
2001-11-23,2001,"Goztep","Fenerbahce","0-5",0,5,"T1",1,5,-5,"A"
2001-11-24,2001,"Diyarbakirspor","Denizlispor","3-0",3,0,"T1",1,3,3,"H"
2001-11-24,2001,"Galatasaray","Samsunspor","2-0",2,0,"T1",1,2,2,"H"
2001-11-24,2001,"Istanbulspor","Yozgatspor","2-0",2,0,"T1",1,2,2,"H"
2001-11-24,2001,"Trabzonspor","Antalyaspor","2-0",2,0,"T1",1,2,2,"H"
2001-11-25,2001,"Ankaragucu","Kocaelispor","2-0",2,0,"T1",1,2,2,"H"
2001-11-25,2001,"Besiktas","Malatyaspor","3-1",3,1,"T1",1,4,2,"H"
2001-11-25,2001,"Bursaspor","Rizespor","1-0",1,0,"T1",1,1,1,"H"
2001-11-25,2001,"Gaziantepspor","Genclerbirligi","5-0",5,0,"T1",1,5,5,"H"
2001-11-30,2001,"Galatasaray","Istanbulspor","4-1",4,1,"T1",1,5,3,"H"
2001-12-01,2001,"Denizlispor","Samsunspor","4-1",4,1,"T1",1,5,3,"H"
2001-12-01,2001,"Kocaelispor","Gaziantepspor","0-0",0,0,"T1",1,0,0,"D"
2001-12-01,2001,"Rizespor","Diyarbakirspor","2-0",2,0,"T1",1,2,2,"H"
2001-12-01,2001,"Yozgatspor","Ankaragucu","0-2",0,2,"T1",1,2,-2,"A"
2001-12-02,2001,"Antalyaspor","Bursaspor","3-0",3,0,"T1",1,3,3,"H"
2001-12-02,2001,"Fenerbahce","Besiktas","1-2",1,2,"T1",1,3,-1,"A"
2001-12-02,2001,"Genclerbirligi","Goztep","0-1",0,1,"T1",1,1,-1,"A"
2001-12-02,2001,"Malatyaspor","Trabzonspor","1-0",1,0,"T1",1,1,1,"H"
2001-12-07,2001,"Besiktas","Genclerbirligi","1-0",1,0,"T1",1,1,1,"H"
2001-12-08,2001,"Bursaspor","Malatyaspor","1-0",1,0,"T1",1,1,1,"H"
2001-12-08,2001,"Goztep","Gaziantepspor","1-3",1,3,"T1",1,4,-2,"A"
2001-12-08,2001,"Istanbulspor","Denizlispor","1-1",1,1,"T1",1,2,0,"D"
2001-12-08,2001,"Trabzonspor","Fenerbahce","2-1",2,1,"T1",1,3,1,"H"
2001-12-09,2001,"Ankaragucu","Galatasaray","2-1",2,1,"T1",1,3,1,"H"
2001-12-09,2001,"Diyarbakirspor","Antalyaspor","3-1",3,1,"T1",1,4,2,"H"
2001-12-09,2001,"Rizespor","Samsunspor","1-0",1,0,"T1",1,1,1,"H"
2001-12-09,2001,"Yozgatspor","Kocaelispor","4-0",4,0,"T1",1,4,4,"H"
2001-12-14,2001,"Fenerbahce","Bursaspor","3-1",3,1,"T1",1,4,2,"H"
2001-12-15,2001,"Antalyaspor","Samsunspor","1-1",1,1,"T1",1,2,0,"D"
2001-12-15,2001,"Denizlispor","Ankaragucu","3-4",3,4,"T1",1,7,-1,"A"
2001-12-15,2001,"Gaziantepspor","Yozgatspor","3-2",3,2,"T1",1,5,1,"H"
2001-12-15,2001,"Goztep","Besiktas","0-6",0,6,"T1",1,6,-6,"A"
2001-12-16,2001,"Genclerbirligi","Trabzonspor","1-1",1,1,"T1",1,2,0,"D"
2001-12-16,2001,"Malatyaspor","Diyarbakirspor","1-3",1,3,"T1",1,4,-2,"A"
2001-12-16,2001,"Rizespor","Istanbulspor","1-1",1,1,"T1",1,2,0,"D"
2001-12-21,2001,"Diyarbakirspor","Fenerbahce","2-1",2,1,"T1",1,3,1,"H"
2001-12-22,2001,"Ankaragucu","Rizespor","1-1",1,1,"T1",1,2,0,"D"
2001-12-22,2001,"Besiktas","Gaziantepspor","3-1",3,1,"T1",1,4,2,"H"
2001-12-22,2001,"Bursaspor","Genclerbirligi","0-1",0,1,"T1",1,1,-1,"A"
2001-12-22,2001,"Istanbulspor","Antalyaspor","4-1",4,1,"T1",1,5,3,"H"
2001-12-22,2001,"Kocaelispor","Denizlispor","2-1",2,1,"T1",1,3,1,"H"
2001-12-22,2001,"Malatyaspor","Samsunspor","1-3",1,3,"T1",1,4,-2,"A"
2001-12-22,2001,"Trabzonspor","Goztep","3-0",3,0,"T1",1,3,3,"H"
2001-12-23,2001,"Yozgatspor","Galatasaray","3-3",3,3,"T1",1,6,0,"D"
2002-01-15,2001,"Galatasaray","Kocaelispor","5-1",5,1,"T1",1,6,4,"H"
2002-01-18,2001,"Samsunspor","Fenerbahce","1-0",1,0,"T1",1,1,1,"H"
2002-01-19,2001,"Ankaragucu","Antalyaspor","2-0",2,0,"T1",1,2,2,"H"
2002-01-19,2001,"Diyarbakirspor","Genclerbirligi","1-2",1,2,"T1",1,3,-1,"A"
2002-01-19,2001,"Galatasaray","Gaziantepspor","2-0",2,0,"T1",1,2,2,"H"
2002-01-19,2001,"Malatyaspor","Istanbulspor","2-0",2,0,"T1",1,2,2,"H"
2002-01-20,2001,"Bursaspor","Goztep","0-0",0,0,"T1",1,0,0,"D"
2002-01-20,2001,"Kocaelispor","Rizespor","2-1",2,1,"T1",1,3,1,"H"
2002-01-20,2001,"Trabzonspor","Besiktas","0-5",0,5,"T1",1,5,-5,"A"
2002-01-20,2001,"Yozgatspor","Denizlispor","0-1",0,1,"T1",1,1,-1,"A"
2002-01-22,2001,"Fenerbahce","Istanbulspor","2-0",2,0,"T1",1,2,2,"H"
2002-01-22,2001,"Malatyaspor","Ankaragucu","4-1",4,1,"T1",1,5,3,"H"
2002-01-23,2001,"Antalyaspor","Kocaelispor","2-0",2,0,"T1",1,2,2,"H"
2002-01-23,2001,"Denizlispor","Galatasaray","1-1",1,1,"T1",1,2,0,"D"
2002-01-23,2001,"Gaziantepspor","Trabzonspor","5-2",5,2,"T1",1,7,3,"H"
2002-01-23,2001,"Goztep","Diyarbakirspor","3-1",3,1,"T1",1,4,2,"H"
2002-01-23,2001,"Rizespor","Yozgatspor","1-1",1,1,"T1",1,2,0,"D"
2002-01-23,2001,"Genclerbirligi","Samsunspor","2-0",2,0,"T1",1,2,2,"H"
2002-01-24,2001,"Besiktas","Bursaspor","2-1",2,1,"T1",1,3,1,"H"
2002-01-26,2001,"Ankaragucu","Fenerbahce","3-2",3,2,"T1",1,5,1,"H"
2002-01-27,2001,"Bursaspor","Trabzonspor","2-2",2,2,"T1",1,4,0,"D"
2002-01-27,2001,"Denizlispor","Gaziantepspor","5-2",5,2,"T1",1,7,3,"H"
2002-01-27,2001,"Diyarbakirspor","Besiktas","0-0",0,0,"T1",1,0,0,"D"
2002-01-27,2001,"Galatasaray","Rizespor","4-1",4,1,"T1",1,5,3,"H"
2002-01-27,2001,"Istanbulspor","Genclerbirligi","0-0",0,0,"T1",1,0,0,"D"
2002-01-27,2001,"Malatyaspor","Kocaelispor","2-1",2,1,"T1",1,3,1,"H"
2002-01-27,2001,"Samsunspor","Goztep","1-2",1,2,"T1",1,3,-1,"A"
2002-01-27,2001,"Yozgatspor","Antalyaspor","3-2",3,2,"T1",1,5,1,"H"
2002-02-01,2001,"Fenerbahce","Kocaelispor","3-0",3,0,"T1",1,3,3,"H"
2002-02-02,2001,"Besiktas","Samsunspor","0-0",0,0,"T1",1,0,0,"D"
2002-02-02,2001,"Gaziantepspor","Bursaspor","5-2",5,2,"T1",1,7,3,"H"
2002-02-02,2001,"Rizespor","Denizlispor","3-1",3,1,"T1",1,4,2,"H"
2002-02-02,2001,"Trabzonspor","Diyarbakirspor","0-2",0,2,"T1",1,2,-2,"A"
2002-02-03,2001,"Antalyaspor","Galatasaray","1-1",1,1,"T1",1,2,0,"D"
2002-02-03,2001,"Genclerbirligi","Ankaragucu","0-1",0,1,"T1",1,1,-1,"A"
2002-02-03,2001,"Goztep","Istanbulspor","0-0",0,0,"T1",1,0,0,"D"
2002-02-03,2001,"Malatyaspor","Yozgatspor","2-1",2,1,"T1",1,3,1,"H"
2002-02-08,2001,"Galatasaray","Malatyaspor","1-0",1,0,"T1",1,1,1,"H"
2002-02-09,2001,"Ankaragucu","Goztep","4-2",4,2,"T1",1,6,2,"H"
2002-02-09,2001,"Denizlispor","Antalyaspor","3-2",3,2,"T1",1,5,1,"H"
2002-02-09,2001,"Diyarbakirspor","Bursaspor","2-3",2,3,"T1",1,5,-1,"A"
2002-02-09,2001,"Yozgatspor","Fenerbahce","1-2",1,2,"T1",1,3,-1,"A"
2002-02-10,2001,"Istanbulspor","Besiktas","1-2",1,2,"T1",1,3,-1,"A"
2002-02-10,2001,"Kocaelispor","Genclerbirligi","0-1",0,1,"T1",1,1,-1,"A"
2002-02-10,2001,"Rizespor","Gaziantepspor","1-0",1,0,"T1",1,1,1,"H"
2002-02-10,2001,"Samsunspor","Trabzonspor","1-2",1,2,"T1",1,3,-1,"A"
2002-02-15,2001,"Gaziantepspor","Diyarbakirspor","0-1",0,1,"T1",1,1,-1,"A"
2002-02-16,2001,"Fenerbahce","Galatasaray","1-0",1,0,"T1",1,1,1,"H"
2002-02-16,2001,"Genclerbirligi","Yozgatspor","3-2",3,2,"T1",1,5,1,"H"
2002-02-16,2001,"Malatyaspor","Denizlispor","0-0",0,0,"T1",1,0,0,"D"
2002-02-16,2001,"Samsunspor","Bursaspor","2-3",2,3,"T1",1,5,-1,"A"
2002-02-17,2001,"Antalyaspor","Rizespor","2-2",2,2,"T1",1,4,0,"D"
2002-02-17,2001,"Besiktas","Ankaragucu","1-2",1,2,"T1",1,3,-1,"A"
2002-02-17,2001,"Goztep","Kocaelispor","3-0",3,0,"T1",1,3,3,"H"
2002-02-17,2001,"Trabzonspor","Istanbulspor","2-0",2,0,"T1",1,2,2,"H"
2002-02-22,2001,"Kocaelispor","Besiktas","0-2",0,2,"T1",1,2,-2,"A"
2002-02-23,2001,"Antalyaspor","Gaziantepspor","3-3",3,3,"T1",1,6,0,"D"
2002-02-23,2001,"Galatasaray","Genclerbirligi","3-1",3,1,"T1",1,4,2,"H"
2002-02-23,2001,"Istanbulspor","Bursaspor","3-0",3,0,"T1",1,3,3,"H"
2002-02-23,2001,"Samsunspor","Diyarbakirspor","0-0",0,0,"T1",1,0,0,"D"
2002-02-24,2001,"Ankaragucu","Trabzonspor","4-2",4,2,"T1",1,6,2,"H"
2002-02-24,2001,"Denizlispor","Fenerbahce","1-2",1,2,"T1",1,3,-1,"A"
2002-02-24,2001,"Rizespor","Malatyaspor","0-0",0,0,"T1",1,0,0,"D"
2002-02-24,2001,"Yozgatspor","Goztep","1-1",1,1,"T1",1,2,0,"D"
2002-03-01,2001,"Fenerbahce","Rizespor","2-1",2,1,"T1",1,3,1,"H"
2002-03-02,2001,"Besiktas","Yozgatspor","4-2",4,2,"T1",1,6,2,"H"
2002-03-02,2001,"Genclerbirligi","Denizlispor","4-2",4,2,"T1",1,6,2,"H"
2002-03-02,2001,"Samsunspor","Gaziantepspor","2-1",2,1,"T1",1,3,1,"H"
2002-03-02,2001,"Trabzonspor","Kocaelispor","1-2",1,2,"T1",1,3,-1,"A"
2002-03-03,2001,"Bursaspor","Ankaragucu","2-1",2,1,"T1",1,3,1,"H"
2002-03-03,2001,"Diyarbakirspor","Istanbulspor","1-0",1,0,"T1",1,1,1,"H"
2002-03-03,2001,"Goztep","Galatasaray","2-0",2,0,"T1",1,2,2,"H"
2002-03-03,2001,"Malatyaspor","Antalyaspor","2-1",2,1,"T1",1,3,1,"H"
2002-03-08,2001,"Ankaragucu","Diyarbakirspor","1-1",1,1,"T1",1,2,0,"D"
2002-03-09,2001,"Galatasaray","Besiktas","1-0",1,0,"T1",1,1,1,"H"
2002-03-09,2001,"Rizespor","Genclerbirligi","1-2",1,2,"T1",1,3,-1,"A"
2002-03-09,2001,"Samsunspor","Istanbulspor","0-1",0,1,"T1",1,1,-1,"A"
2002-03-09,2001,"Yozgatspor","Trabzonspor","2-3",2,3,"T1",1,5,-1,"A"
2002-03-10,2001,"Antalyaspor","Fenerbahce","0-1",0,1,"T1",1,1,-1,"A"
2002-03-10,2001,"Denizlispor","Goztep","2-1",2,1,"T1",1,3,1,"H"
2002-03-10,2001,"Kocaelispor","Bursaspor","1-2",1,2,"T1",1,3,-1,"A"
2002-03-10,2001,"Malatyaspor","Gaziantepspor","1-1",1,1,"T1",1,2,0,"D"
2002-03-15,2001,"Besiktas","Denizlispor","2-2",2,2,"T1",1,4,0,"D"
2002-03-16,2001,"Bursaspor","Yozgatspor","3-1",3,1,"T1",1,4,2,"H"
2002-03-16,2001,"Gaziantepspor","Istanbulspor","2-2",2,2,"T1",1,4,0,"D"
2002-03-16,2001,"Goztep","Rizespor","2-3",2,3,"T1",1,5,-1,"A"
2002-03-17,2001,"Diyarbakirspor","Kocaelispor","1-1",1,1,"T1",1,2,0,"D"
2002-03-17,2001,"Fenerbahce","Malatyaspor","2-2",2,2,"T1",1,4,0,"D"
2002-03-17,2001,"Genclerbirligi","Antalyaspor","1-0",1,0,"T1",1,1,1,"H"
2002-03-17,2001,"Samsunspor","Ankaragucu","2-0",2,0,"T1",1,2,2,"H"
2002-03-22,2001,"Fenerbahce","Gaziantepspor","4-1",4,1,"T1",1,5,3,"H"
2002-03-23,2001,"Denizlispor","Trabzonspor","2-1",2,1,"T1",1,3,1,"H"
2002-03-23,2001,"Galatasaray","Bursaspor","2-1",2,1,"T1",1,3,1,"H"
2002-03-23,2001,"Samsunspor","Kocaelispor","0-0",0,0,"T1",1,0,0,"D"
2002-03-23,2001,"Yozgatspor","Diyarbakirspor","2-0",2,0,"T1",1,2,2,"H"
2002-03-24,2001,"Ankaragucu","Istanbulspor","4-2",4,2,"T1",1,6,2,"H"
2002-03-24,2001,"Antalyaspor","Goztep","2-0",2,0,"T1",1,2,2,"H"
2002-03-24,2001,"Malatyaspor","Genclerbirligi","1-0",1,0,"T1",1,1,1,"H"
2002-03-24,2001,"Rizespor","Besiktas","1-3",1,3,"T1",1,4,-2,"A"
2002-03-29,2001,"Besiktas","Antalyaspor","0-0",0,0,"T1",1,0,0,"D"
2002-03-30,2001,"Diyarbakirspor","Galatasaray","0-0",0,0,"T1",1,0,0,"D"
2002-03-30,2001,"Gaziantepspor","Ankaragucu","1-1",1,1,"T1",1,2,0,"D"
2002-03-30,2001,"Istanbulspor","Kocaelispor","0-1",0,1,"T1",1,1,-1,"A"
2002-03-30,2001,"Trabzonspor","Rizespor","2-1",2,1,"T1",1,3,1,"H"
2002-03-31,2001,"Bursaspor","Denizlispor","3-3",3,3,"T1",1,6,0,"D"
2002-03-31,2001,"Genclerbirligi","Fenerbahce","1-1",1,1,"T1",1,2,0,"D"
2002-03-31,2001,"Goztep","Malatyaspor","2-1",2,1,"T1",1,3,1,"H"
2002-03-31,2001,"Samsunspor","Yozgatspor","0-0",0,0,"T1",1,0,0,"D"
2002-04-03,2001,"Trabzonspor","Galatasaray","0-2",0,2,"T1",1,2,-2,"A"
2002-04-05,2001,"Fenerbahce","Goztep","3-0",3,0,"T1",1,3,3,"H"
2002-04-06,2001,"Denizlispor","Diyarbakirspor","2-1",2,1,"T1",1,3,1,"H"
2002-04-06,2001,"Genclerbirligi","Gaziantepspor","1-1",1,1,"T1",1,2,0,"D"
2002-04-06,2001,"Rizespor","Bursaspor","3-1",3,1,"T1",1,4,2,"H"
2002-04-07,2001,"Antalyaspor","Trabzonspor","4-2",4,2,"T1",1,6,2,"H"
2002-04-07,2001,"Kocaelispor","Ankaragucu","4-4",4,4,"T1",1,8,0,"D"
2002-04-07,2001,"Malatyaspor","Besiktas","0-1",0,1,"T1",1,1,-1,"A"
2002-04-07,2001,"Samsunspor","Galatasaray","0-1",0,1,"T1",1,1,-1,"A"
2002-04-07,2001,"Yozgatspor","Istanbulspor","1-1",1,1,"T1",1,2,0,"D"
2002-04-12,2001,"Trabzonspor","Malatyaspor","0-0",0,0,"T1",1,0,0,"D"
2002-04-13,2001,"Ankaragucu","Yozgatspor","1-1",1,1,"T1",1,2,0,"D"
2002-04-13,2001,"Goztep","Genclerbirligi","1-1",1,1,"T1",1,2,0,"D"
2002-04-13,2001,"Istanbulspor","Galatasaray","0-2",0,2,"T1",1,2,-2,"A"
2002-04-13,2001,"Samsunspor","Denizlispor","3-4",3,4,"T1",1,7,-1,"A"
2002-04-14,2001,"Besiktas","Fenerbahce","0-2",0,2,"T1",1,2,-2,"A"
2002-04-14,2001,"Bursaspor","Antalyaspor","0-1",0,1,"T1",1,1,-1,"A"
2002-04-14,2001,"Diyarbakirspor","Rizespor","1-0",1,0,"T1",1,1,1,"H"
2002-04-14,2001,"Gaziantepspor","Kocaelispor","3-5",3,5,"T1",1,8,-2,"A"
2002-04-20,2001,"Genclerbirligi","Besiktas","1-1",1,1,"T1",1,2,0,"D"
2002-04-21,2001,"Antalyaspor","Diyarbakirspor","0-0",0,0,"T1",1,0,0,"D"
2002-04-21,2001,"Denizlispor","Istanbulspor","1-1",1,1,"T1",1,2,0,"D"
2002-04-21,2001,"Fenerbahce","Trabzonspor","3-0",3,0,"T1",1,3,3,"H"
2002-04-21,2001,"Gaziantepspor","Goztep","4-0",4,0,"T1",1,4,4,"H"
2002-04-21,2001,"Galatasaray","Ankaragucu","2-0",2,0,"T1",1,2,2,"H"
2002-04-21,2001,"Kocaelispor","Yozgatspor","4-3",4,3,"T1",1,7,1,"H"
2002-04-21,2001,"Malatyaspor","Bursaspor","2-1",2,1,"T1",1,3,1,"H"
2002-04-21,2001,"Samsunspor","Rizespor","1-0",1,0,"T1",1,1,1,"H"
2002-04-27,2001,"Ankaragucu","Denizlispor","1-1",1,1,"T1",1,2,0,"D"
2002-04-27,2001,"Besiktas","Goztep","1-2",1,2,"T1",1,3,-1,"A"
2002-04-27,2001,"Diyarbakirspor","Malatyaspor","0-0",0,0,"T1",1,0,0,"D"
2002-04-27,2001,"Istanbulspor","Rizespor","3-1",3,1,"T1",1,4,2,"H"
2002-04-27,2001,"Samsunspor","Antalyaspor","2-0",2,0,"T1",1,2,2,"H"
2002-04-27,2001,"Trabzonspor","Genclerbirligi","0-0",0,0,"T1",1,0,0,"D"
2002-04-27,2001,"Yozgatspor","Gaziantepspor","1-2",1,2,"T1",1,3,-1,"A"
2002-04-28,2001,"Bursaspor","Fenerbahce","0-1",0,1,"T1",1,1,-1,"A"
2002-04-28,2001,"Kocaelispor","Galatasaray","0-2",0,2,"T1",1,2,-2,"A"
2002-05-03,2001,"Goztep","Trabzonspor","4-2",4,2,"T1",1,6,2,"H"
2002-05-04,2001,"Antalyaspor","Istanbulspor","2-0",2,0,"T1",1,2,2,"H"
2002-05-04,2001,"Denizlispor","Kocaelispor","4-0",4,0,"T1",1,4,4,"H"
2002-05-04,2001,"Fenerbahce","Diyarbakirspor","3-1",3,1,"T1",1,4,2,"H"
2002-05-04,2001,"Gaziantepspor","Besiktas","1-0",1,0,"T1",1,1,1,"H"
2002-05-04,2001,"Genclerbirligi","Bursaspor","3-2",3,2,"T1",1,5,1,"H"
2002-05-04,2001,"Galatasaray","Yozgatspor","5-0",5,0,"T1",1,5,5,"H"
2002-05-04,2001,"Rizespor","Ankaragucu","3-2",3,2,"T1",1,5,1,"H"
2002-05-04,2001,"Samsunspor","Malatyaspor","1-1",1,1,"T1",1,2,0,"D"
2002-08-09,2002,"Trabzonspor","Fenerbahce","0-0",0,0,"T1",1,0,0,"D"
2002-08-10,2002,"Ankaragucu","Malatyaspor","1-1",1,1,"T1",1,2,0,"D"
2002-08-10,2002,"Bursaspor","Besiktas","2-2",2,2,"T1",1,4,0,"D"
2002-08-10,2002,"Diyarbakirspor","Altay","1-1",1,1,"T1",1,2,0,"D"
2002-08-10,2002,"Istanbulspor","Adanaspor","2-2",2,2,"T1",1,4,0,"D"
2002-08-11,2002,"Galatasaray","Samsunspor","4-1",4,1,"T1",1,5,3,"H"
2002-08-11,2002,"Gaziantepspor","Denizlispor","1-1",1,1,"T1",1,2,0,"D"
2002-08-11,2002,"Goztep","Elazigspor","2-1",2,1,"T1",1,3,1,"H"
2002-08-11,2002,"Kocaelispor","Genclerbirligi","1-3",1,3,"T1",1,4,-2,"A"
2002-08-16,2002,"Denizlispor","Galatasaray","1-3",1,3,"T1",1,4,-2,"A"
2002-08-17,2002,"Besiktas","Kocaelispor","2-1",2,1,"T1",1,3,1,"H"
2002-08-17,2002,"Elazigspor","Trabzonspor","2-0",2,0,"T1",1,2,2,"H"
2002-08-17,2002,"Genclerbirligi","Istanbulspor","4-1",4,1,"T1",1,5,3,"H"
2002-08-17,2002,"Malatyaspor","Gaziantepspor","1-1",1,1,"T1",1,2,0,"D"
2002-08-17,2002,"Samsunspor","Bursaspor","1-0",1,0,"T1",1,1,1,"H"
2002-08-18,2002,"Adanaspor","Diyarbakirspor","2-1",2,1,"T1",1,3,1,"H"
2002-08-18,2002,"Altay","Goztep","4-2",4,2,"T1",1,6,2,"H"
2002-08-18,2002,"Fenerbahce","Ankaragucu","1-0",1,0,"T1",1,1,1,"H"
2002-08-24,2002,"Goztep","Adanaspor","1-4",1,4,"T1",1,5,-3,"A"
2002-08-24,2002,"Istanbulspor","Besiktas","1-2",1,2,"T1",1,3,-1,"A"
2002-08-24,2002,"Kocaelispor","Samsunspor","1-2",1,2,"T1",1,3,-1,"A"
2002-08-24,2002,"Trabzonspor","Altay","0-0",0,0,"T1",1,0,0,"D"
2002-08-25,2002,"Ankaragucu","Elazigspor","3-1",3,1,"T1",1,4,2,"H"
2002-08-25,2002,"Denizlispor","Malatyaspor","1-0",1,0,"T1",1,1,1,"H"
2002-08-25,2002,"Diyarbakirspor","Genclerbirligi","1-4",1,4,"T1",1,5,-3,"A"
2002-08-25,2002,"Galatasaray","Bursaspor","2-0",2,0,"T1",1,2,2,"H"
2002-08-30,2002,"Besiktas","Diyarbakirspor","2-0",2,0,"T1",1,2,2,"H"
2002-08-31,2002,"Adanaspor","Trabzonspor","0-1",0,1,"T1",1,1,-1,"A"
2002-08-31,2002,"Altay","Ankaragucu","2-3",2,3,"T1",1,5,-1,"A"
2002-08-31,2002,"Bursaspor","Kocaelispor","4-2",4,2,"T1",1,6,2,"H"
2002-08-31,2002,"Malatyaspor","Galatasaray","2-2",2,2,"T1",1,4,0,"D"
2002-09-01,2002,"Elazigspor","Gaziantepspor","1-3",1,3,"T1",1,4,-2,"A"
2002-09-01,2002,"Fenerbahce","Denizlispor","3-2",3,2,"T1",1,5,1,"H"
2002-09-01,2002,"Genclerbirligi","Goztep","3-1",3,1,"T1",1,4,2,"H"
2002-09-01,2002,"Samsunspor","Istanbulspor","1-2",1,2,"T1",1,3,-1,"A"
2002-09-11,2002,"Gaziantepspor","Fenerbahce","3-3",3,3,"T1",1,6,0,"D"
2002-09-13,2002,"Galatasaray","Kocaelispor","2-0",2,0,"T1",1,2,2,"H"
2002-09-14,2002,"Ankaragucu","Adanaspor","1-1",1,1,"T1",1,2,0,"D"
2002-09-14,2002,"Denizlispor","Elazigspor","3-1",3,1,"T1",1,4,2,"H"
2002-09-14,2002,"Malatyaspor","Fenerbahce","2-0",2,0,"T1",1,2,2,"H"
2002-09-14,2002,"Trabzonspor","Genclerbirligi","1-1",1,1,"T1",1,2,0,"D"
2002-09-15,2002,"Diyarbakirspor","Samsunspor","1-1",1,1,"T1",1,2,0,"D"
2002-09-15,2002,"Gaziantepspor","Altay","2-1",2,1,"T1",1,3,1,"H"
2002-09-15,2002,"Goztep","Besiktas","2-2",2,2,"T1",1,4,0,"D"
2002-09-15,2002,"Istanbulspor","Bursaspor","1-1",1,1,"T1",1,2,0,"D"
2002-09-21,2002,"Adanaspor","Gaziantepspor","0-2",0,2,"T1",1,2,-2,"A"
2002-09-21,2002,"Bursaspor","Diyarbakirspor","4-1",4,1,"T1",1,5,3,"H"
2002-09-21,2002,"Elazigspor","Malatyaspor","2-1",2,1,"T1",1,3,1,"H"
2002-09-21,2002,"Samsunspor","Goztep","0-0",0,0,"T1",1,0,0,"D"
2002-09-22,2002,"Altay","Denizlispor","3-1",3,1,"T1",1,4,2,"H"
2002-09-22,2002,"Besiktas","Trabzonspor","0-0",0,0,"T1",1,0,0,"D"
2002-09-22,2002,"Genclerbirligi","Ankaragucu","0-1",0,1,"T1",1,1,-1,"A"
2002-09-22,2002,"Kocaelispor","Istanbulspor","0-1",0,1,"T1",1,1,-1,"A"
2002-09-27,2002,"Galatasaray","Istanbulspor","2-0",2,0,"T1",1,2,2,"H"
2002-09-28,2002,"Ankaragucu","Besiktas","0-1",0,1,"T1",1,1,-1,"A"
2002-09-28,2002,"Denizlispor","Adanaspor","2-0",2,0,"T1",1,2,2,"H"
2002-09-28,2002,"Diyarbakirspor","Kocaelispor","1-1",1,1,"T1",1,2,0,"D"
2002-09-28,2002,"Trabzonspor","Samsunspor","0-1",0,1,"T1",1,1,-1,"A"
2002-09-29,2002,"Fenerbahce","Elazigspor","4-2",4,2,"T1",1,6,2,"H"
2002-09-29,2002,"Gaziantepspor","Genclerbirligi","2-0",2,0,"T1",1,2,2,"H"
2002-09-29,2002,"Goztep","Bursaspor","1-1",1,1,"T1",1,2,0,"D"
2002-09-29,2002,"Malatyaspor","Altay","6-0",6,0,"T1",1,6,6,"H"
2002-10-05,2002,"Adanaspor","Malatyaspor","1-1",1,1,"T1",1,2,0,"D"
2002-10-05,2002,"Bursaspor","Trabzonspor","1-2",1,2,"T1",1,3,-1,"A"
2002-10-05,2002,"Elazigspor","Galatasaray","0-0",0,0,"T1",1,0,0,"D"
2002-10-05,2002,"Istanbulspor","Diyarbakirspor","1-0",1,0,"T1",1,1,1,"H"
2002-10-06,2002,"Altay","Fenerbahce","1-3",1,3,"T1",1,4,-2,"A"
2002-10-06,2002,"Besiktas","Gaziantepspor","0-0",0,0,"T1",1,0,0,"D"
2002-10-06,2002,"Genclerbirligi","Denizlispor","0-0",0,0,"T1",1,0,0,"D"
2002-10-06,2002,"Kocaelispor","Goztep","1-3",1,3,"T1",1,4,-2,"A"
2002-10-06,2002,"Samsunspor","Ankaragucu","1-0",1,0,"T1",1,1,1,"H"
2002-10-18,2002,"Fenerbahce","Adanaspor","1-1",1,1,"T1",1,2,0,"D"
2002-10-19,2002,"Galatasaray","Diyarbakirspor","1-0",1,0,"T1",1,1,1,"H"
2002-10-19,2002,"Gaziantepspor","Samsunspor","4-2",4,2,"T1",1,6,2,"H"
2002-10-19,2002,"Goztep","Istanbulspor","1-1",1,1,"T1",1,2,0,"D"
2002-10-19,2002,"Malatyaspor","Genclerbirligi","5-4",5,4,"T1",1,9,1,"H"
2002-10-20,2002,"Ankaragucu","Bursaspor","4-0",4,0,"T1",1,4,4,"H"
2002-10-20,2002,"Denizlispor","Besiktas","1-2",1,2,"T1",1,3,-1,"A"
2002-10-20,2002,"Elazigspor","Altay","2-0",2,0,"T1",1,2,2,"H"
2002-10-20,2002,"Trabzonspor","Kocaelispor","2-0",2,0,"T1",1,2,2,"H"
2002-10-25,2002,"Besiktas","Malatyaspor","3-0",3,0,"T1",1,3,3,"H"
2002-10-26,2002,"Altay","Galatasaray","1-2",1,2,"T1",1,3,-1,"A"
2002-10-26,2002,"Istanbulspor","Trabzonspor","1-2",1,2,"T1",1,3,-1,"A"
2002-10-26,2002,"Kocaelispor","Ankaragucu","3-0",3,0,"T1",1,3,3,"H"
2002-10-26,2002,"Samsunspor","Denizlispor","0-0",0,0,"T1",1,0,0,"D"
2002-10-27,2002,"Adanaspor","Elazigspor","0-0",0,0,"T1",1,0,0,"D"
2002-10-27,2002,"Bursaspor","Gaziantepspor","1-1",1,1,"T1",1,2,0,"D"
2002-10-27,2002,"Diyarbakirspor","Goztep","1-0",1,0,"T1",1,1,1,"H"
2002-10-27,2002,"Genclerbirligi","Fenerbahce","1-1",1,1,"T1",1,2,0,"D"
2002-11-01,2002,"Trabzonspor","Diyarbakirspor","3-0",3,0,"T1",1,3,3,"H"
2002-11-02,2002,"Altay","Adanaspor","0-4",0,4,"T1",1,4,-4,"A"
2002-11-02,2002,"Ankaragucu","Istanbulspor","1-0",1,0,"T1",1,1,1,"H"
2002-11-02,2002,"Elazigspor","Genclerbirligi","0-3",0,3,"T1",1,3,-3,"A"
2002-11-02,2002,"Galatasaray","Goztep","3-1",3,1,"T1",1,4,2,"H"
2002-11-02,2002,"Gaziantepspor","Kocaelispor","2-1",2,1,"T1",1,3,1,"H"
2002-11-02,2002,"Malatyaspor","Samsunspor","2-1",2,1,"T1",1,3,1,"H"
2002-11-06,2002,"Denizlispor","Bursaspor","2-2",2,2,"T1",1,4,0,"D"
2002-11-06,2002,"Fenerbahce","Galatasaray","6-0",6,0,"T1",1,6,6,"H"
2002-11-08,2002,"Besiktas","Elazigspor","3-1",3,1,"T1",1,4,2,"H"
2002-11-09,2002,"Adanaspor","Galatasaray","0-0",0,0,"T1",1,0,0,"D"
2002-11-09,2002,"Diyarbakirspor","Ankaragucu","3-0",3,0,"T1",1,3,3,"H"
2002-11-09,2002,"Goztep","Trabzonspor","1-2",1,2,"T1",1,3,-1,"A"
2002-11-09,2002,"Istanbulspor","Gaziantepspor","1-3",1,3,"T1",1,4,-2,"A"
2002-11-10,2002,"Bursaspor","Malatyaspor","1-1",1,1,"T1",1,2,0,"D"
2002-11-10,2002,"Genclerbirligi","Altay","1-0",1,0,"T1",1,1,1,"H"
2002-11-10,2002,"Kocaelispor","Denizlispor","2-1",2,1,"T1",1,3,1,"H"
2002-11-10,2002,"Samsunspor","Fenerbahce","1-3",1,3,"T1",1,4,-2,"A"
2002-11-16,2002,"Adanaspor","Genclerbirligi","2-7",2,7,"T1",1,9,-5,"A"
2002-11-16,2002,"Ankaragucu","Goztep","1-0",1,0,"T1",1,1,1,"H"
2002-11-16,2002,"Galatasaray","Trabzonspor","2-1",2,1,"T1",1,3,1,"H"
2002-11-16,2002,"Gaziantepspor","Diyarbakirspor","2-0",2,0,"T1",1,2,2,"H"
2002-11-17,2002,"Altay","Besiktas","0-1",0,1,"T1",1,1,-1,"A"
2002-11-17,2002,"Denizlispor","Istanbulspor","2-1",2,1,"T1",1,3,1,"H"
2002-11-17,2002,"Elazigspor","Samsunspor","3-1",3,1,"T1",1,4,2,"H"
2002-11-17,2002,"Fenerbahce","Bursaspor","7-1",7,1,"T1",1,8,6,"H"
2002-11-17,2002,"Malatyaspor","Kocaelispor","2-1",2,1,"T1",1,3,1,"H"
2002-11-23,2002,"Besiktas","Adanaspor","3-0",3,0,"T1",1,3,3,"H"
2002-11-23,2002,"Diyarbakirspor","Denizlispor","0-0",0,0,"T1",1,0,0,"D"
2002-11-23,2002,"Istanbulspor","Malatyaspor","0-0",0,0,"T1",1,0,0,"D"
2002-11-23,2002,"Kocaelispor","Fenerbahce","1-2",1,2,"T1",1,3,-1,"A"
2002-11-23,2002,"Trabzonspor","Ankaragucu","3-0",3,0,"T1",1,3,3,"H"
2002-11-24,2002,"Bursaspor","Elazigspor","1-1",1,1,"T1",1,2,0,"D"
2002-11-24,2002,"Genclerbirligi","Galatasaray","1-0",1,0,"T1",1,1,1,"H"
2002-11-24,2002,"Goztep","Gaziantepspor","2-1",2,1,"T1",1,3,1,"H"
2002-11-24,2002,"Samsunspor","Altay","2-4",2,4,"T1",1,6,-2,"A"
2002-11-29,2002,"Fenerbahce","Istanbulspor","2-0",2,0,"T1",1,2,2,"H"
2002-11-30,2002,"Altay","Bursaspor","2-1",2,1,"T1",1,3,1,"H"
2002-11-30,2002,"Ankaragucu","Galatasaray","1-2",1,2,"T1",1,3,-1,"A"
2002-11-30,2002,"Elazigspor","Kocaelispor","0-1",0,1,"T1",1,1,-1,"A"
2002-11-30,2002,"Gaziantepspor","Trabzonspor","0-0",0,0,"T1",1,0,0,"D"
2002-12-01,2002,"Adanaspor","Samsunspor","1-1",1,1,"T1",1,2,0,"D"
2002-12-01,2002,"Besiktas","Genclerbirligi","1-1",1,1,"T1",1,2,0,"D"
2002-12-01,2002,"Denizlispor","Goztep","0-0",0,0,"T1",1,0,0,"D"
2002-12-01,2002,"Malatyaspor","Diyarbakirspor","0-1",0,1,"T1",1,1,-1,"A"
2002-12-07,2002,"Diyarbakirspor","Fenerbahce","3-0",3,0,"T1",1,3,3,"H"
2002-12-07,2002,"Istanbulspor","Elazigspor","2-1",2,1,"T1",1,3,1,"H"
2002-12-07,2002,"Kocaelispor","Altay","3-0",3,0,"T1",1,3,3,"H"
2002-12-07,2002,"Trabzonspor","Denizlispor","1-0",1,0,"T1",1,1,1,"H"
2002-12-08,2002,"Ankaragucu","Gaziantepspor","5-3",5,3,"T1",1,8,2,"H"
2002-12-08,2002,"Bursaspor","Adanaspor","3-0",3,0,"T1",1,3,3,"H"
2002-12-08,2002,"Galatasaray","Besiktas","0-1",0,1,"T1",1,1,-1,"A"
2002-12-08,2002,"Goztep","Malatyaspor","0-3",0,3,"T1",1,3,-3,"A"
2002-12-08,2002,"Samsunspor","Genclerbirligi","2-7",2,7,"T1",1,9,-5,"A"
2002-12-13,2002,"Gaziantepspor","Galatasaray","1-2",1,2,"T1",1,3,-1,"A"
2002-12-14,2002,"Adanaspor","Kocaelispor","1-0",1,0,"T1",1,1,1,"H"
2002-12-14,2002,"Altay","Istanbulspor","4-3",4,3,"T1",1,7,1,"H"
2002-12-14,2002,"Fenerbahce","Goztep","0-0",0,0,"T1",1,0,0,"D"
2002-12-14,2002,"Malatyaspor","Trabzonspor","2-2",2,2,"T1",1,4,0,"D"
2002-12-15,2002,"Besiktas","Samsunspor","2-0",2,0,"T1",1,2,2,"H"
2002-12-15,2002,"Elazigspor","Diyarbakirspor","0-1",0,1,"T1",1,1,-1,"A"
2002-12-15,2002,"Genclerbirligi","Bursaspor","2-0",2,0,"T1",1,2,2,"H"
2002-12-21,2002,"Adanaspor","Istanbulspor","0-3",0,3,"T1",1,3,-3,"A"
2002-12-21,2002,"Besiktas","Bursaspor","1-0",1,0,"T1",1,1,1,"H"
2002-12-22,2002,"Altay","Diyarbakirspor","2-2",2,2,"T1",1,4,0,"D"
2002-12-22,2002,"Fenerbahce","Trabzonspor","3-2",3,2,"T1",1,5,1,"H"
2002-12-22,2002,"Genclerbirligi","Kocaelispor","5-1",5,1,"T1",1,6,4,"H"
2002-12-22,2002,"Samsunspor","Galatasaray","0-1",0,1,"T1",1,1,-1,"A"
2003-01-28,2002,"Denizlispor","Ankaragucu","2-1",2,1,"T1",1,3,1,"H"
2003-02-02,2002,"Denizlispor","Gaziantepspor","1-0",1,0,"T1",1,1,1,"H"
2003-02-02,2002,"Elazigspor","Goztep","0-0",0,0,"T1",1,0,0,"D"
2003-02-02,2002,"Fenerbahce","Besiktas","0-1",0,1,"T1",1,1,-1,"A"
2003-02-02,2002,"Malatyaspor","Ankaragucu","3-1",3,1,"T1",1,4,2,"H"
2003-02-08,2002,"Bursaspor","Samsunspor","2-1",2,1,"T1",1,3,1,"H"
2003-02-08,2002,"Gaziantepspor","Malatyaspor","3-0",3,0,"T1",1,3,3,"H"
2003-02-08,2002,"Goztep","Altay","0-2",0,2,"T1",1,2,-2,"A"
2003-02-08,2002,"Kocaelispor","Besiktas","0-5",0,5,"T1",1,5,-5,"A"
2003-02-09,2002,"Ankaragucu","Fenerbahce","0-0",0,0,"T1",1,0,0,"D"
2003-02-09,2002,"Diyarbakirspor","Adanaspor","2-0",2,0,"T1",1,2,2,"H"
2003-02-09,2002,"Istanbulspor","Genclerbirligi","1-3",1,3,"T1",1,4,-2,"A"
2003-02-09,2002,"Trabzonspor","Elazigspor","1-1",1,1,"T1",1,2,0,"D"
2003-02-15,2002,"Fenerbahce","Gaziantepspor","2-0",2,0,"T1",1,2,2,"H"
2003-02-15,2002,"Malatyaspor","Denizlispor","2-1",2,1,"T1",1,3,1,"H"
2003-02-15,2002,"Samsunspor","Kocaelispor","1-0",1,0,"T1",1,1,1,"H"
2003-02-16,2002,"Adanaspor","Goztep","1-2",1,2,"T1",1,3,-1,"A"
2003-02-16,2002,"Altay","Trabzonspor","1-4",1,4,"T1",1,5,-3,"A"
2003-02-16,2002,"Besiktas","Istanbulspor","2-1",2,1,"T1",1,3,1,"H"
2003-02-16,2002,"Bursaspor","Galatasaray","0-4",0,4,"T1",1,4,-4,"A"
2003-02-16,2002,"Elazigspor","Ankaragucu","1-0",1,0,"T1",1,1,1,"H"
2003-02-16,2002,"Genclerbirligi","Diyarbakirspor","3-1",3,1,"T1",1,4,2,"H"
2003-02-22,2002,"Goztep","Genclerbirligi","0-0",0,0,"T1",1,0,0,"D"
2003-02-22,2002,"Trabzonspor","Adanaspor","3-1",3,1,"T1",1,4,2,"H"
2003-02-23,2002,"Ankaragucu","Altay","3-0",3,0,"T1",1,3,3,"H"
2003-02-23,2002,"Galatasaray","Malatyaspor","2-1",2,1,"T1",1,3,1,"H"
2003-02-23,2002,"Istanbulspor","Samsunspor","0-1",0,1,"T1",1,1,-1,"A"
2003-02-28,2002,"Fenerbahce","Malatyaspor","2-0",2,0,"T1",1,2,2,"H"
2003-03-01,2002,"Altay","Gaziantepspor","0-0",0,0,"T1",1,0,0,"D"
2003-03-01,2002,"Bursaspor","Istanbulspor","1-2",1,2,"T1",1,3,-1,"A"
2003-03-01,2002,"Genclerbirligi","Trabzonspor","2-1",2,1,"T1",1,3,1,"H"
2003-03-01,2002,"Kocaelispor","Galatasaray","0-1",0,1,"T1",1,1,-1,"A"
2003-03-02,2002,"Adanaspor","Ankaragucu","0-2",0,2,"T1",1,2,-2,"A"
2003-03-02,2002,"Besiktas","Goztep","7-3",7,3,"T1",1,10,4,"H"
2003-03-02,2002,"Elazigspor","Denizlispor","0-2",0,2,"T1",1,2,-2,"A"
2003-03-02,2002,"Samsunspor","Diyarbakirspor","3-1",3,1,"T1",1,4,2,"H"
2003-03-07,2002,"Gaziantepspor","Adanaspor","1-1",1,1,"T1",1,2,0,"D"
2003-03-08,2002,"Denizlispor","Altay","1-1",1,1,"T1",1,2,0,"D"
2003-03-08,2002,"Galatasaray","Fenerbahce","2-0",2,0,"T1",1,2,2,"H"
2003-03-08,2002,"Goztep","Samsunspor","0-0",0,0,"T1",1,0,0,"D"
2003-03-08,2002,"Malatyaspor","Elazigspor","1-1",1,1,"T1",1,2,0,"D"
2003-03-09,2002,"Ankaragucu","Genclerbirligi","0-1",0,1,"T1",1,1,-1,"A"
2003-03-09,2002,"Diyarbakirspor","Bursaspor","4-0",4,0,"T1",1,4,4,"H"
2003-03-09,2002,"Istanbulspor","Kocaelispor","2-1",2,1,"T1",1,3,1,"H"
2003-03-09,2002,"Trabzonspor","Besiktas","1-1",1,1,"T1",1,2,0,"D"
2003-03-14,2002,"Genclerbirligi","Gaziantepspor","2-1",2,1,"T1",1,3,1,"H"
2003-03-15,2002,"Adanaspor","Denizlispor","2-1",2,1,"T1",1,3,1,"H"
2003-03-15,2002,"Elazigspor","Fenerbahce","3-3",3,3,"T1",1,6,0,"D"
2003-03-15,2002,"Istanbulspor","Galatasaray","1-2",1,2,"T1",1,3,-1,"A"
2003-03-15,2002,"Samsunspor","Trabzonspor","1-3",1,3,"T1",1,4,-2,"A"
2003-03-16,2002,"Altay","Malatyaspor","0-2",0,2,"T1",1,2,-2,"A"
2003-03-16,2002,"Besiktas","Ankaragucu","1-0",1,0,"T1",1,1,1,"H"
2003-03-16,2002,"Bursaspor","Goztep","1-0",1,0,"T1",1,1,1,"H"
2003-03-16,2002,"Kocaelispor","Diyarbakirspor","1-1",1,1,"T1",1,2,0,"D"
2003-03-19,2002,"Galatasaray","Denizlispor","0-1",0,1,"T1",1,1,-1,"A"
2003-03-19,2002,"Gaziantepspor","Elazigspor","4-0",4,0,"T1",1,4,4,"H"
2003-03-19,2002,"Kocaelispor","Bursaspor","0-0",0,0,"T1",1,0,0,"D"
2003-03-22,2002,"Ankaragucu","Samsunspor","3-2",3,2,"T1",1,5,1,"H"
2003-03-22,2002,"Diyarbakirspor","Istanbulspor","1-1",1,1,"T1",1,2,0,"D"
2003-03-22,2002,"Fenerbahce","Altay","0-1",0,1,"T1",1,1,-1,"A"
2003-03-22,2002,"Malatyaspor","Adanaspor","1-0",1,0,"T1",1,1,1,"H"
2003-03-23,2002,"Denizlispor","Genclerbirligi","1-3",1,3,"T1",1,4,-2,"A"
2003-03-23,2002,"Galatasaray","Elazigspor","3-0",3,0,"T1",1,3,3,"H"
2003-03-23,2002,"Gaziantepspor","Besiktas","1-1",1,1,"T1",1,2,0,"D"
2003-03-23,2002,"Goztep","Kocaelispor","1-2",1,2,"T1",1,3,-1,"A"
2003-03-23,2002,"Trabzonspor","Bursaspor","3-0",3,0,"T1",1,3,3,"H"
2003-04-05,2002,"Besiktas","Denizlispor","2-0",2,0,"T1",1,2,2,"H"
2003-04-05,2002,"Genclerbirligi","Malatyaspor","3-0",3,0,"T1",1,3,3,"H"
2003-04-05,2002,"Kocaelispor","Trabzonspor","2-2",2,2,"T1",1,4,0,"D"
2003-04-05,2002,"Samsunspor","Gaziantepspor","2-1",2,1,"T1",1,3,1,"H"
2003-04-06,2002,"Adanaspor","Fenerbahce","3-1",3,1,"T1",1,4,2,"H"
2003-04-06,2002,"Altay","Elazigspor","5-1",5,1,"T1",1,6,4,"H"
2003-04-06,2002,"Bursaspor","Ankaragucu","0-2",0,2,"T1",1,2,-2,"A"
2003-04-06,2002,"Diyarbakirspor","Galatasaray","1-3",1,3,"T1",1,4,-2,"A"
2003-04-06,2002,"Istanbulspor","Goztep","3-1",3,1,"T1",1,4,2,"H"
2003-04-11,2002,"Galatasaray","Altay","5-0",5,0,"T1",1,5,5,"H"
2003-04-12,2002,"Denizlispor","Samsunspor","0-1",0,1,"T1",1,1,-1,"A"
2003-04-12,2002,"Goztep","Diyarbakirspor","3-0",3,0,"T1",1,3,3,"H"
2003-04-12,2002,"Malatyaspor","Besiktas","1-2",1,2,"T1",1,3,-1,"A"
2003-04-13,2002,"Ankaragucu","Kocaelispor","2-0",2,0,"T1",1,2,2,"H"
2003-04-13,2002,"Elazigspor","Adanaspor","4-2",4,2,"T1",1,6,2,"H"
2003-04-13,2002,"Fenerbahce","Genclerbirligi","3-3",3,3,"T1",1,6,0,"D"
2003-04-13,2002,"Gaziantepspor","Bursaspor","2-1",2,1,"T1",1,3,1,"H"
2003-04-13,2002,"Trabzonspor","Istanbulspor","0-0",0,0,"T1",1,0,0,"D"
2003-04-16,2002,"Denizlispor","Fenerbahce","1-1",1,1,"T1",1,2,0,"D"
2003-04-16,2002,"Diyarbakirspor","Besiktas","1-0",1,0,"T1",1,1,1,"H"
2003-04-18,2002,"Goztep","Galatasaray","0-1",0,1,"T1",1,1,-1,"A"
2003-04-19,2002,"Diyarbakirspor","Trabzonspor","2-0",2,0,"T1",1,2,2,"H"
2003-04-19,2002,"Genclerbirligi","Elazigspor","2-0",2,0,"T1",1,2,2,"H"
2003-04-19,2002,"Istanbulspor","Ankaragucu","1-0",1,0,"T1",1,1,1,"H"
2003-04-19,2002,"Samsunspor","Malatyaspor","1-1",1,1,"T1",1,2,0,"D"
2003-04-20,2002,"Adanaspor","Altay","5-2",5,2,"T1",1,7,3,"H"
2003-04-20,2002,"Besiktas","Fenerbahce","2-0",2,0,"T1",1,2,2,"H"
2003-04-20,2002,"Bursaspor","Denizlispor","2-0",2,0,"T1",1,2,2,"H"
2003-04-20,2002,"Kocaelispor","Gaziantepspor","0-3",0,3,"T1",1,3,-3,"A"
2003-04-26,2002,"Ankaragucu","Diyarbakirspor","3-1",3,1,"T1",1,4,2,"H"
2003-04-26,2002,"Denizlispor","Kocaelispor","1-2",1,2,"T1",1,3,-1,"A"
2003-04-26,2002,"Elazigspor","Besiktas","0-1",0,1,"T1",1,1,-1,"A"
2003-04-26,2002,"Fenerbahce","Samsunspor","1-1",1,1,"T1",1,2,0,"D"
2003-04-27,2002,"Altay","Genclerbirligi","3-3",3,3,"T1",1,6,0,"D"
2003-04-27,2002,"Galatasaray","Adanaspor","2-2",2,2,"T1",1,4,0,"D"
2003-04-27,2002,"Gaziantepspor","Istanbulspor","4-3",4,3,"T1",1,7,1,"H"
2003-04-27,2002,"Malatyaspor","Bursaspor","4-2",4,2,"T1",1,6,2,"H"
2003-04-27,2002,"Trabzonspor","Goztep","0-0",0,0,"T1",1,0,0,"D"
2003-05-03,2002,"Besiktas","Altay","2-0",2,0,"T1",1,2,2,"H"
2003-05-03,2002,"Bursaspor","Fenerbahce","2-1",2,1,"T1",1,3,1,"H"
2003-05-03,2002,"Genclerbirligi","Adanaspor","0-2",0,2,"T1",1,2,-2,"A"
2003-05-03,2002,"Istanbulspor","Denizlispor","2-1",2,1,"T1",1,3,1,"H"
2003-05-03,2002,"Samsunspor","Elazigspor","4-3",4,3,"T1",1,7,1,"H"
2003-05-04,2002,"Diyarbakirspor","Gaziantepspor","0-1",0,1,"T1",1,1,-1,"A"
2003-05-04,2002,"Goztep","Ankaragucu","0-1",0,1,"T1",1,1,-1,"A"
2003-05-04,2002,"Kocaelispor","Malatyaspor","2-3",2,3,"T1",1,5,-1,"A"
2003-05-04,2002,"Trabzonspor","Galatasaray","1-2",1,2,"T1",1,3,-1,"A"
2003-05-09,2002,"Fenerbahce","Kocaelispor","1-0",1,0,"T1",1,1,1,"H"
2003-05-10,2002,"Adanaspor","Besiktas","0-1",0,1,"T1",1,1,-1,"A"
2003-05-11,2002,"Altay","Samsunspor","2-2",2,2,"T1",1,4,0,"D"
2003-05-11,2002,"Ankaragucu","Trabzonspor","2-0",2,0,"T1",1,2,2,"H"
2003-05-11,2002,"Denizlispor","Diyarbakirspor","2-0",2,0,"T1",1,2,2,"H"
2003-05-11,2002,"Elazigspor","Bursaspor","2-1",2,1,"T1",1,3,1,"H"
2003-05-11,2002,"Galatasaray","Genclerbirligi","1-1",1,1,"T1",1,2,0,"D"
2003-05-11,2002,"Gaziantepspor","Goztep","3-1",3,1,"T1",1,4,2,"H"
2003-05-11,2002,"Malatyaspor","Istanbulspor","1-2",1,2,"T1",1,3,-1,"A"
2003-05-16,2002,"Trabzonspor","Gaziantepspor","2-1",2,1,"T1",1,3,1,"H"
2003-05-17,2002,"Bursaspor","Altay","2-1",2,1,"T1",1,3,1,"H"
2003-05-17,2002,"Diyarbakirspor","Malatyaspor","1-1",1,1,"T1",1,2,0,"D"
2003-05-17,2002,"Galatasaray","Ankaragucu","3-0",3,0,"T1",1,3,3,"H"
2003-05-17,2002,"Genclerbirligi","Besiktas","1-2",1,2,"T1",1,3,-1,"A"
2003-05-17,2002,"Goztep","Denizlispor","2-3",2,3,"T1",1,5,-1,"A"
2003-05-17,2002,"Istanbulspor","Fenerbahce","2-0",2,0,"T1",1,2,2,"H"
2003-05-17,2002,"Kocaelispor","Elazigspor","1-3",1,3,"T1",1,4,-2,"A"
2003-05-17,2002,"Samsunspor","Adanaspor","0-2",0,2,"T1",1,2,-2,"A"
2003-05-25,2002,"Adanaspor","Bursaspor","2-2",2,2,"T1",1,4,0,"D"
2003-05-25,2002,"Altay","Kocaelispor","5-0",5,0,"T1",1,5,5,"H"
2003-05-25,2002,"Besiktas","Galatasaray","1-0",1,0,"T1",1,1,1,"H"
2003-05-25,2002,"Denizlispor","Trabzonspor","1-1",1,1,"T1",1,2,0,"D"
2003-05-25,2002,"Elazigspor","Istanbulspor","1-0",1,0,"T1",1,1,1,"H"
2003-05-25,2002,"Fenerbahce","Diyarbakirspor","0-0",0,0,"T1",1,0,0,"D"
2003-05-25,2002,"Gaziantepspor","Ankaragucu","4-2",4,2,"T1",1,6,2,"H"
2003-05-25,2002,"Genclerbirligi","Samsunspor","1-1",1,1,"T1",1,2,0,"D"
2003-05-25,2002,"Malatyaspor","Goztep","4-1",4,1,"T1",1,5,3,"H"
2003-05-30,2002,"Galatasaray","Gaziantepspor","2-1",2,1,"T1",1,3,1,"H"
2003-05-31,2002,"Ankaragucu","Denizlispor","1-1",1,1,"T1",1,2,0,"D"
2003-05-31,2002,"Bursaspor","Genclerbirligi","3-1",3,1,"T1",1,4,2,"H"
2003-05-31,2002,"Diyarbakirspor","Elazigspor","1-2",1,2,"T1",1,3,-1,"A"
2003-05-31,2002,"Goztep","Fenerbahce","1-1",1,1,"T1",1,2,0,"D"
2003-05-31,2002,"Istanbulspor","Altay","0-0",0,0,"T1",1,0,0,"D"
2003-05-31,2002,"Kocaelispor","Adanaspor","1-2",1,2,"T1",1,3,-1,"A"
2003-05-31,2002,"Samsunspor","Besiktas","3-4",3,4,"T1",1,7,-1,"A"
2003-05-31,2002,"Trabzonspor","Malatyaspor","0-2",0,2,"T1",1,2,-2,"A"
2003-08-08,2003,"Samsunspor","Besiktas","1-3",1,3,"T1",1,4,-2,"A"
2003-08-09,2003,"Bursaspor","Gaziantepspor","0-0",0,0,"T1",1,0,0,"D"
2003-08-09,2003,"Galatasaray","Diyarbakirspor","2-1",2,1,"T1",1,3,1,"H"
2003-08-09,2003,"Genclerbirligi","Elazigspor","2-3",2,3,"T1",1,5,-1,"A"
2003-08-09,2003,"Konyaspor","Trabzonspor","3-3",3,3,"T1",1,6,0,"D"
2003-08-10,2003,"A. Sebatspor","Denizlispor","0-2",0,2,"T1",1,2,-2,"A"
2003-08-10,2003,"Adanaspor","Malatyaspor","0-1",0,1,"T1",1,1,-1,"A"
2003-08-10,2003,"Fenerbahce","Istanbulspor","0-3",0,3,"T1",1,3,-3,"A"
2003-08-10,2003,"Rizespor","Ankaragucu","2-1",2,1,"T1",1,3,1,"H"
2003-08-15,2003,"Trabzonspor","Fenerbahce","0-1",0,1,"T1",1,1,-1,"A"
2003-08-16,2003,"Ankaragucu","Samsunspor","4-2",4,2,"T1",1,6,2,"H"
2003-08-16,2003,"Besiktas","Bursaspor","1-0",1,0,"T1",1,1,1,"H"
2003-08-16,2003,"Denizlispor","Rizespor","1-1",1,1,"T1",1,2,0,"D"
2003-08-16,2003,"Istanbulspor","Adanaspor","1-0",1,0,"T1",1,1,1,"H"
2003-08-17,2003,"Diyarbakirspor","Genclerbirligi","3-2",3,2,"T1",1,5,1,"H"
2003-08-17,2003,"Elazigspor","Konyaspor","0-0",0,0,"T1",1,0,0,"D"
2003-08-17,2003,"Gaziantepspor","Galatasaray","1-2",1,2,"T1",1,3,-1,"A"
2003-08-17,2003,"Malatyaspor","A. Sebatspor","3-1",3,1,"T1",1,4,2,"H"
2003-08-23,2003,"A. Sebatspor","Istanbulspor","1-3",1,3,"T1",1,4,-2,"A"
2003-08-23,2003,"Adanaspor","Trabzonspor","0-1",0,1,"T1",1,1,-1,"A"
2003-08-23,2003,"Bursaspor","Galatasaray","2-2",2,2,"T1",1,4,0,"D"
2003-08-23,2003,"Fenerbahce","Elazigspor","7-1",7,1,"T1",1,8,6,"H"
2003-08-23,2003,"Rizespor","Malatyaspor","2-1",2,1,"T1",1,3,1,"H"
2003-08-24,2003,"Besiktas","Ankaragucu","3-0",3,0,"T1",1,3,3,"H"
2003-08-24,2003,"Genclerbirligi","Gaziantepspor","1-0",1,0,"T1",1,1,1,"H"
2003-08-24,2003,"Konyaspor","Diyarbakirspor","3-1",3,1,"T1",1,4,2,"H"
2003-08-24,2003,"Samsunspor","Denizlispor","2-1",2,1,"T1",1,3,1,"H"
2003-08-29,2003,"Denizlispor","Besiktas","2-3",2,3,"T1",1,5,-1,"A"
2003-08-30,2003,"Diyarbakirspor","Fenerbahce","1-2",1,2,"T1",1,3,-1,"A"
2003-08-30,2003,"Elazigspor","Adanaspor","3-4",3,4,"T1",1,7,-1,"A"
2003-08-30,2003,"Gaziantepspor","Konyaspor","3-1",3,1,"T1",1,4,2,"H"
2003-08-30,2003,"Malatyaspor","Samsunspor","5-0",5,0,"T1",1,5,5,"H"
2003-08-31,2003,"Ankaragucu","Bursaspor","2-0",2,0,"T1",1,2,2,"H"
2003-08-31,2003,"Galatasaray","Genclerbirligi","2-1",2,1,"T1",1,3,1,"H"
2003-08-31,2003,"Istanbulspor","Rizespor","3-0",3,0,"T1",1,3,3,"H"
2003-08-31,2003,"Trabzonspor","A. Sebatspor","2-1",2,1,"T1",1,3,1,"H"
2003-09-12,2003,"Besiktas","Malatyaspor","3-1",3,1,"T1",1,4,2,"H"
2003-09-13,2003,"Adanaspor","Diyarbakirspor","2-1",2,1,"T1",1,3,1,"H"
2003-09-13,2003,"Konyaspor","Galatasaray","1-0",1,0,"T1",1,1,1,"H"
2003-09-13,2003,"Rizespor","Trabzonspor","1-0",1,0,"T1",1,1,1,"H"
2003-09-13,2003,"Samsunspor","Istanbulspor","3-3",3,3,"T1",1,6,0,"D"
2003-09-14,2003,"A. Sebatspor","Elazigspor","3-1",3,1,"T1",1,4,2,"H"
2003-09-14,2003,"Ankaragucu","Denizlispor","1-1",1,1,"T1",1,2,0,"D"
2003-09-14,2003,"Bursaspor","Genclerbirligi","0-0",0,0,"T1",1,0,0,"D"
2003-09-14,2003,"Fenerbahce","Gaziantepspor","3-1",3,1,"T1",1,4,2,"H"
2003-09-19,2003,"Trabzonspor","Samsunspor","2-1",2,1,"T1",1,3,1,"H"
2003-09-20,2003,"Gaziantepspor","Adanaspor","1-0",1,0,"T1",1,1,1,"H"
2003-09-20,2003,"Genclerbirligi","Konyaspor","4-0",4,0,"T1",1,4,4,"H"
2003-09-20,2003,"Istanbulspor","Besiktas","1-1",1,1,"T1",1,2,0,"D"
2003-09-20,2003,"Malatyaspor","Ankaragucu","1-0",1,0,"T1",1,1,1,"H"
2003-09-21,2003,"Denizlispor","Bursaspor","4-0",4,0,"T1",1,4,4,"H"
2003-09-21,2003,"Diyarbakirspor","A. Sebatspor","1-0",1,0,"T1",1,1,1,"H"
2003-09-21,2003,"Elazigspor","Rizespor","1-1",1,1,"T1",1,2,0,"D"
2003-09-21,2003,"Galatasaray","Fenerbahce","2-2",2,2,"T1",1,4,0,"D"
2003-09-26,2003,"Adanaspor","Galatasaray","0-2",0,2,"T1",1,2,-2,"A"
2003-09-27,2003,"Ankaragucu","Istanbulspor","2-1",2,1,"T1",1,3,1,"H"
2003-09-27,2003,"Bursaspor","Konyaspor","2-1",2,1,"T1",1,3,1,"H"
2003-09-27,2003,"Fenerbahce","Genclerbirligi","1-0",1,0,"T1",1,1,1,"H"
2003-09-27,2003,"Samsunspor","Elazigspor","2-0",2,0,"T1",1,2,2,"H"
2003-09-28,2003,"A. Sebatspor","Gaziantepspor","1-2",1,2,"T1",1,3,-1,"A"
2003-09-28,2003,"Besiktas","Trabzonspor","5-0",5,0,"T1",1,5,5,"H"
2003-09-28,2003,"Denizlispor","Malatyaspor","1-0",1,0,"T1",1,1,1,"H"
2003-09-28,2003,"Rizespor","Diyarbakirspor","2-1",2,1,"T1",1,3,1,"H"
2003-10-03,2003,"Konyaspor","Fenerbahce","2-4",2,4,"T1",1,6,-2,"A"
2003-10-04,2003,"Galatasaray","A. Sebatspor","4-3",4,3,"T1",1,7,1,"H"
2003-10-04,2003,"Genclerbirligi","Adanaspor","6-0",6,0,"T1",1,6,6,"H"
2003-10-04,2003,"Istanbulspor","Denizlispor","0-3",0,3,"T1",1,3,-3,"A"
2003-10-04,2003,"Malatyaspor","Bursaspor","2-1",2,1,"T1",1,3,1,"H"
2003-10-05,2003,"Diyarbakirspor","Samsunspor","2-2",2,2,"T1",1,4,0,"D"
2003-10-05,2003,"Elazigspor","Besiktas","1-5",1,5,"T1",1,6,-4,"A"
2003-10-05,2003,"Gaziantepspor","Rizespor","2-0",2,0,"T1",1,2,2,"H"
2003-10-05,2003,"Trabzonspor","Ankaragucu","3-0",3,0,"T1",1,3,3,"H"
2003-10-17,2003,"Rizespor","Galatasaray","0-1",0,1,"T1",1,1,-1,"A"
2003-10-18,2003,"Adanaspor","Konyaspor","1-1",1,1,"T1",1,2,0,"D"
2003-10-18,2003,"Ankaragucu","Elazigspor","1-0",1,0,"T1",1,1,1,"H"
2003-10-18,2003,"Besiktas","Diyarbakirspor","1-0",1,0,"T1",1,1,1,"H"
2003-10-19,2003,"A. Sebatspor","Genclerbirligi","0-3",0,3,"T1",1,3,-3,"A"
2003-10-19,2003,"Bursaspor","Fenerbahce","2-2",2,2,"T1",1,4,0,"D"
2003-10-19,2003,"Denizlispor","Trabzonspor","0-1",0,1,"T1",1,1,-1,"A"
2003-10-19,2003,"Malatyaspor","Istanbulspor","2-1",2,1,"T1",1,3,1,"H"
2003-10-19,2003,"Samsunspor","Gaziantepspor","1-2",1,2,"T1",1,3,-1,"A"
2003-10-24,2003,"Fenerbahce","Adanaspor","3-0",3,0,"T1",1,3,3,"H"
2003-10-25,2003,"Diyarbakirspor","Ankaragucu","1-1",1,1,"T1",1,2,0,"D"
2003-10-25,2003,"Elazigspor","Denizlispor","2-4",2,4,"T1",1,6,-2,"A"
2003-10-25,2003,"Galatasaray","Samsunspor","1-0",1,0,"T1",1,1,1,"H"
2003-10-25,2003,"Trabzonspor","Malatyaspor","0-0",0,0,"T1",1,0,0,"D"
2003-10-26,2003,"Gaziantepspor","Besiktas","0-3",0,3,"T1",1,3,-3,"A"
2003-10-26,2003,"Genclerbirligi","Rizespor","1-0",1,0,"T1",1,1,1,"H"
2003-10-26,2003,"Istanbulspor","Bursaspor","3-0",3,0,"T1",1,3,3,"H"
2003-10-26,2003,"Konyaspor","A. Sebatspor","0-0",0,0,"T1",1,0,0,"D"
2003-10-31,2003,"Besiktas","Galatasaray","0-0",0,0,"T1",1,0,0,"D"
2003-11-01,2003,"Ankaragucu","Gaziantepspor","1-4",1,4,"T1",1,5,-3,"A"
2003-11-01,2003,"Denizlispor","Diyarbakirspor","1-2",1,2,"T1",1,3,-1,"A"
2003-11-01,2003,"Istanbulspor","Trabzonspor","0-2",0,2,"T1",1,2,-2,"A"
2003-11-01,2003,"Samsunspor","Genclerbirligi","2-1",2,1,"T1",1,3,1,"H"
2003-11-02,2003,"A. Sebatspor","Fenerbahce","1-1",1,1,"T1",1,2,0,"D"
2003-11-02,2003,"Bursaspor","Adanaspor","6-0",6,0,"T1",1,6,6,"H"
2003-11-02,2003,"Malatyaspor","Elazigspor","3-0",3,0,"T1",1,3,3,"H"
2003-11-02,2003,"Rizespor","Konyaspor","1-1",1,1,"T1",1,2,0,"D"
2003-11-07,2003,"Trabzonspor","Bursaspor","2-0",2,0,"T1",1,2,2,"H"
2003-11-08,2003,"Adanaspor","A. Sebatspor","1-2",1,2,"T1",1,3,-1,"A"
2003-11-08,2003,"Konyaspor","Samsunspor","0-0",0,0,"T1",1,0,0,"D"
2003-11-09,2003,"Diyarbakirspor","Malatyaspor","2-0",2,0,"T1",1,2,2,"H"
2003-11-09,2003,"Elazigspor","Istanbulspor","1-1",1,1,"T1",1,2,0,"D"
2003-11-09,2003,"Galatasaray","Ankaragucu","2-1",2,1,"T1",1,3,1,"H"
2003-11-09,2003,"Gaziantepspor","Denizlispor","1-2",1,2,"T1",1,3,-1,"A"
2003-11-09,2003,"Genclerbirligi","Besiktas","1-2",1,2,"T1",1,3,-1,"A"
2003-11-22,2003,"Ankaragucu","Genclerbirligi","2-3",2,3,"T1",1,5,-1,"A"
2003-11-22,2003,"Besiktas","Konyaspor","1-1",1,1,"T1",1,2,0,"D"
2003-11-22,2003,"Denizlispor","Galatasaray","2-1",2,1,"T1",1,3,1,"H"
2003-11-22,2003,"Malatyaspor","Gaziantepspor","0-0",0,0,"T1",1,0,0,"D"
2003-11-23,2003,"Bursaspor","A. Sebatspor","1-1",1,1,"T1",1,2,0,"D"
2003-11-23,2003,"Istanbulspor","Diyarbakirspor","1-3",1,3,"T1",1,4,-2,"A"
2003-11-23,2003,"Rizespor","Adanaspor","0-2",0,2,"T1",1,2,-2,"A"
2003-11-23,2003,"Samsunspor","Fenerbahce","3-0",3,0,"T1",1,3,3,"H"
2003-11-23,2003,"Trabzonspor","Elazigspor","2-2",2,2,"T1",1,4,0,"D"
2003-11-28,2003,"Galatasaray","Malatyaspor","2-2",2,2,"T1",1,4,0,"D"
2003-11-29,2003,"A. Sebatspor","Rizespor","1-0",1,0,"T1",1,1,1,"H"
2003-11-29,2003,"Diyarbakirspor","Trabzonspor","2-2",2,2,"T1",1,4,0,"D"
2003-11-29,2003,"Elazigspor","Bursaspor","1-0",1,0,"T1",1,1,1,"H"
2003-11-29,2003,"Konyaspor","Ankaragucu","1-1",1,1,"T1",1,2,0,"D"
2003-11-30,2003,"Adanaspor","Samsunspor","2-3",2,3,"T1",1,5,-1,"A"
2003-11-30,2003,"Fenerbahce","Besiktas","2-2",2,2,"T1",1,4,0,"D"
2003-11-30,2003,"Gaziantepspor","Istanbulspor","2-1",2,1,"T1",1,3,1,"H"
2003-11-30,2003,"Genclerbirligi","Denizlispor","1-3",1,3,"T1",1,4,-2,"A"
2003-12-05,2003,"Besiktas","Adanaspor","2-1",2,1,"T1",1,3,1,"H"
2003-12-06,2003,"Diyarbakirspor","Elazigspor","2-0",2,0,"T1",1,2,2,"H"
2003-12-06,2003,"Istanbulspor","Galatasaray","3-1",3,1,"T1",1,4,2,"H"
2003-12-06,2003,"Samsunspor","A. Sebatspor","1-1",1,1,"T1",1,2,0,"D"
2003-12-06,2003,"Trabzonspor","Gaziantepspor","3-0",3,0,"T1",1,3,3,"H"
2003-12-07,2003,"Ankaragucu","Fenerbahce","1-4",1,4,"T1",1,5,-3,"A"
2003-12-07,2003,"Denizlispor","Konyaspor","3-2",3,2,"T1",1,5,1,"H"
2003-12-07,2003,"Malatyaspor","Genclerbirligi","1-1",1,1,"T1",1,2,0,"D"
2003-12-07,2003,"Rizespor","Bursaspor","1-0",1,0,"T1",1,1,1,"H"
2003-12-13,2003,"A. Sebatspor","Besiktas","1-2",1,2,"T1",1,3,-1,"A"
2003-12-13,2003,"Fenerbahce","Denizlispor","2-0",2,0,"T1",1,2,2,"H"
2003-12-13,2003,"Gaziantepspor","Elazigspor","3-1",3,1,"T1",1,4,2,"H"
2003-12-13,2003,"Genclerbirligi","Istanbulspor","1-0",1,0,"T1",1,1,1,"H"
2003-12-14,2003,"Adanaspor","Ankaragucu","1-3",1,3,"T1",1,4,-2,"A"
2003-12-14,2003,"Bursaspor","Diyarbakirspor","0-0",0,0,"T1",1,0,0,"D"
2003-12-14,2003,"Galatasaray","Trabzonspor","1-2",1,2,"T1",1,3,-1,"A"
2003-12-14,2003,"Konyaspor","Malatyaspor","3-3",3,3,"T1",1,6,0,"D"
2003-12-14,2003,"Rizespor","Samsunspor","1-2",1,2,"T1",1,3,-1,"A"
2003-12-20,2003,"Besiktas","Rizespor","5-3",5,3,"T1",1,8,2,"H"
2003-12-20,2003,"Elazigspor","Galatasaray","2-2",2,2,"T1",1,4,0,"D"
2003-12-20,2003,"Trabzonspor","Genclerbirligi","1-3",1,3,"T1",1,4,-2,"A"
2003-12-21,2003,"Ankaragucu","A. Sebatspor","1-1",1,1,"T1",1,2,0,"D"
2003-12-21,2003,"Denizlispor","Adanaspor","1-1",1,1,"T1",1,2,0,"D"
2003-12-21,2003,"Diyarbakirspor","Gaziantepspor","2-1",2,1,"T1",1,3,1,"H"
2003-12-21,2003,"Istanbulspor","Konyaspor","2-3",2,3,"T1",1,5,-1,"A"
2003-12-21,2003,"Malatyaspor","Fenerbahce","2-2",2,2,"T1",1,4,0,"D"
2003-12-21,2003,"Samsunspor","Bursaspor","0-0",0,0,"T1",1,0,0,"D"
2004-01-18,2003,"Fenerbahce","Rizespor","4-1",4,1,"T1",1,5,3,"H"
2004-01-23,2003,"Diyarbakirspor","Galatasaray","0-0",0,0,"T1",1,0,0,"D"
2004-01-24,2003,"Denizlispor","A. Sebatspor","1-2",1,2,"T1",1,3,-1,"A"
2004-01-25,2003,"Ankaragucu","Rizespor","4-1",4,1,"T1",1,5,3,"H"
2004-01-25,2003,"Besiktas","Samsunspor","1-4",1,4,"T1",1,5,-3,"A"
2004-01-25,2003,"Elazigspor","Genclerbirligi","1-1",1,1,"T1",1,2,0,"D"
2004-01-25,2003,"Gaziantepspor","Bursaspor","3-2",3,2,"T1",1,5,1,"H"
2004-01-25,2003,"Istanbulspor","Fenerbahce","0-1",0,1,"T1",1,1,-1,"A"
2004-01-25,2003,"Malatyaspor","Adanaspor","2-0",2,0,"T1",1,2,2,"H"
2004-01-25,2003,"Trabzonspor","Konyaspor","0-3",0,3,"T1",1,3,-3,"A"
2004-01-31,2003,"Galatasaray","Gaziantepspor","3-0",3,0,"T1",1,3,3,"H"
2004-02-01,2003,"A. Sebatspor","Malatyaspor","2-2",2,2,"T1",1,4,0,"D"
2004-02-01,2003,"Adanaspor","Istanbulspor","1-1",1,1,"T1",1,2,0,"D"
2004-02-01,2003,"Bursaspor","Besiktas","0-1",0,1,"T1",1,1,-1,"A"
2004-02-01,2003,"Fenerbahce","Trabzonspor","3-1",3,1,"T1",1,4,2,"H"
2004-02-01,2003,"Genclerbirligi","Diyarbakirspor","3-4",3,4,"T1",1,7,-1,"A"
2004-02-01,2003,"Konyaspor","Elazigspor","2-0",2,0,"T1",1,2,2,"H"
2004-02-01,2003,"Rizespor","Denizlispor","1-2",1,2,"T1",1,3,-1,"A"
2004-02-01,2003,"Samsunspor","Ankaragucu","3-2",3,2,"T1",1,5,1,"H"
2004-02-06,2003,"Ankaragucu","Besiktas","1-1",1,1,"T1",1,2,0,"D"
2004-02-07,2003,"Denizlispor","Samsunspor","1-0",1,0,"T1",1,1,1,"H"
2004-02-07,2003,"Diyarbakirspor","Konyaspor","1-1",1,1,"T1",1,2,0,"D"
2004-02-07,2003,"Elazigspor","Fenerbahce","0-1",0,1,"T1",1,1,-1,"A"
2004-02-07,2003,"Gaziantepspor","Genclerbirligi","2-0",2,0,"T1",1,2,2,"H"
2004-02-07,2003,"Malatyaspor","Rizespor","0-1",0,1,"T1",1,1,-1,"A"
2004-02-08,2003,"Galatasaray","Bursaspor","0-0",0,0,"T1",1,0,0,"D"
2004-02-08,2003,"Istanbulspor","A. Sebatspor","1-3",1,3,"T1",1,4,-2,"A"
2004-02-08,2003,"Trabzonspor","Adanaspor","2-1",2,1,"T1",1,3,1,"H"
2004-02-14,2003,"Adanaspor","Elazigspor","1-2",1,2,"T1",1,3,-1,"A"
2004-02-14,2003,"Samsunspor","Malatyaspor","1-0",1,0,"T1",1,1,1,"H"
2004-02-15,2003,"A. Sebatspor","Trabzonspor","0-0",0,0,"T1",1,0,0,"D"
2004-02-15,2003,"Besiktas","Denizlispor","3-1",3,1,"T1",1,4,2,"H"
2004-02-15,2003,"Bursaspor","Ankaragucu","1-0",1,0,"T1",1,1,1,"H"
2004-02-15,2003,"Fenerbahce","Diyarbakirspor","2-2",2,2,"T1",1,4,0,"D"
2004-02-15,2003,"Genclerbirligi","Galatasaray","2-2",2,2,"T1",1,4,0,"D"
2004-02-15,2003,"Konyaspor","Gaziantepspor","0-3",0,3,"T1",1,3,-3,"A"
2004-02-16,2003,"Rizespor","Istanbulspor","1-0",1,0,"T1",1,1,1,"H"
2004-02-21,2003,"Galatasaray","Konyaspor","2-1",2,1,"T1",1,3,1,"H"
2004-02-21,2003,"Genclerbirligi","Bursaspor","2-0",2,0,"T1",1,2,2,"H"
2004-02-21,2003,"Malatyaspor","Besiktas","0-0",0,0,"T1",1,0,0,"D"
2004-02-22,2003,"Denizlispor","Ankaragucu","0-1",0,1,"T1",1,1,-1,"A"
2004-02-22,2003,"Diyarbakirspor","Adanaspor","3-1",3,1,"T1",1,4,2,"H"
2004-02-22,2003,"Gaziantepspor","Fenerbahce","1-5",1,5,"T1",1,6,-4,"A"
2004-02-22,2003,"Istanbulspor","Samsunspor","0-0",0,0,"T1",1,0,0,"D"
2004-02-22,2003,"Trabzonspor","Rizespor","1-0",1,0,"T1",1,1,1,"H"
2004-02-23,2003,"Elazigspor","A. Sebatspor","3-1",3,1,"T1",1,4,2,"H"
2004-02-28,2003,"Rizespor","Elazigspor","5-4",5,4,"T1",1,9,1,"H"
2004-02-28,2003,"Samsunspor","Trabzonspor","1-3",1,3,"T1",1,4,-2,"A"
2004-02-29,2003,"A. Sebatspor","Diyarbakirspor","0-1",0,1,"T1",1,1,-1,"A"
2004-02-29,2003,"Adanaspor","Gaziantepspor","2-3",2,3,"T1",1,5,-1,"A"
2004-02-29,2003,"Ankaragucu","Malatyaspor","0-0",0,0,"T1",1,0,0,"D"
2004-02-29,2003,"Besiktas","Istanbulspor","1-2",1,2,"T1",1,3,-1,"A"
2004-02-29,2003,"Bursaspor","Denizlispor","0-1",0,1,"T1",1,1,-1,"A"
2004-02-29,2003,"Fenerbahce","Galatasaray","2-1",2,1,"T1",1,3,1,"H"
2004-02-29,2003,"Konyaspor","Genclerbirligi","4-1",4,1,"T1",1,5,3,"H"
2004-03-06,2003,"Diyarbakirspor","Rizespor","0-1",0,1,"T1",1,1,-1,"A"
2004-03-06,2003,"Elazigspor","Samsunspor","1-0",1,0,"T1",1,1,1,"H"
2004-03-06,2003,"Genclerbirligi","Fenerbahce","0-1",0,1,"T1",1,1,-1,"A"
2004-03-06,2003,"Konyaspor","Bursaspor","1-1",1,1,"T1",1,2,0,"D"
2004-03-07,2003,"Galatasaray","Adanaspor","3-2",3,2,"T1",1,5,1,"H"
2004-03-07,2003,"Gaziantepspor","A. Sebatspor","2-2",2,2,"T1",1,4,0,"D"
2004-03-07,2003,"Istanbulspor","Ankaragucu","2-3",2,3,"T1",1,5,-1,"A"
2004-03-07,2003,"Malatyaspor","Denizlispor","0-1",0,1,"T1",1,1,-1,"A"
2004-03-07,2003,"Trabzonspor","Besiktas","3-0",3,0,"T1",1,3,3,"H"
2004-03-12,2003,"Ankaragucu","Trabzonspor","1-2",1,2,"T1",1,3,-1,"A"
2004-03-13,2003,"A. Sebatspor","Galatasaray","2-1",2,1,"T1",1,3,1,"H"
2004-03-13,2003,"Bursaspor","Malatyaspor","3-2",3,2,"T1",1,5,1,"H"
2004-03-13,2003,"Denizlispor","Istanbulspor","2-0",2,0,"T1",1,2,2,"H"
2004-03-13,2003,"Fenerbahce","Konyaspor","5-2",5,2,"T1",1,7,3,"H"
2004-03-14,2003,"Besiktas","Elazigspor","5-3",5,3,"T1",1,8,2,"H"
2004-03-14,2003,"Rizespor","Gaziantepspor","1-2",1,2,"T1",1,3,-1,"A"
2004-03-14,2003,"Samsunspor","Diyarbakirspor","3-1",3,1,"T1",1,4,2,"H"
2004-03-19,2003,"Diyarbakirspor","Besiktas","3-1",3,1,"T1",1,4,2,"H"
2004-03-20,2003,"Galatasaray","Rizespor","1-2",1,2,"T1",1,3,-1,"A"
2004-03-20,2003,"Gaziantepspor","Samsunspor","1-0",1,0,"T1",1,1,1,"H"
2004-03-20,2003,"Konyaspor","Adanaspor","4-1",4,1,"T1",1,5,3,"H"
2004-03-21,2003,"Elazigspor","Ankaragucu","1-2",1,2,"T1",1,3,-1,"A"
2004-03-21,2003,"Fenerbahce","Bursaspor","3-1",3,1,"T1",1,4,2,"H"
2004-03-21,2003,"Genclerbirligi","A. Sebatspor","3-1",3,1,"T1",1,4,2,"H"
2004-03-21,2003,"Istanbulspor","Malatyaspor","0-0",0,0,"T1",1,0,0,"D"
2004-03-21,2003,"Trabzonspor","Denizlispor","1-0",1,0,"T1",1,1,1,"H"
2004-03-26,2003,"Samsunspor","Galatasaray","1-0",1,0,"T1",1,1,1,"H"
2004-03-27,2003,"A. Sebatspor","Konyaspor","1-1",1,1,"T1",1,2,0,"D"
2004-03-27,2003,"Adanaspor","Fenerbahce","1-2",1,2,"T1",1,3,-1,"A"
2004-03-27,2003,"Ankaragucu","Diyarbakirspor","3-1",3,1,"T1",1,4,2,"H"
2004-03-27,2003,"Besiktas","Gaziantepspor","4-1",4,1,"T1",1,5,3,"H"
2004-03-27,2003,"Bursaspor","Istanbulspor","1-1",1,1,"T1",1,2,0,"D"
2004-03-27,2003,"Denizlispor","Elazigspor","3-0",3,0,"T1",1,3,3,"H"
2004-03-27,2003,"Malatyaspor","Trabzonspor","2-3",2,3,"T1",1,5,-1,"A"
2004-03-27,2003,"Rizespor","Genclerbirligi","2-0",2,0,"T1",1,2,2,"H"
2004-03-31,2003,"Adanaspor","Genclerbirligi","2-2",2,2,"T1",1,4,0,"D"
2004-04-03,2003,"Diyarbakirspor","Denizlispor","0-1",0,1,"T1",1,1,-1,"A"
2004-04-03,2003,"Fenerbahce","A. Sebatspor","4-2",4,2,"T1",1,6,2,"H"
2004-04-03,2003,"Gaziantepspor","Ankaragucu","2-1",2,1,"T1",1,3,1,"H"
2004-04-03,2003,"Trabzonspor","Istanbulspor","2-0",2,0,"T1",1,2,2,"H"
2004-04-04,2003,"Adanaspor","Bursaspor","0-3",0,3,"T1",1,3,-3,"A"
2004-04-04,2003,"Elazigspor","Malatyaspor","0-0",0,0,"T1",1,0,0,"D"
2004-04-04,2003,"Galatasaray","Besiktas","1-2",1,2,"T1",1,3,-1,"A"
2004-04-04,2003,"Genclerbirligi","Samsunspor","2-1",2,1,"T1",1,3,1,"H"
2004-04-04,2003,"Konyaspor","Rizespor","2-1",2,1,"T1",1,3,1,"H"
2004-04-09,2003,"Rizespor","Fenerbahce","1-0",1,0,"T1",1,1,1,"H"
2004-04-10,2003,"A. Sebatspor","Adanaspor","4-3",4,3,"T1",1,7,1,"H"
2004-04-10,2003,"Ankaragucu","Galatasaray","1-0",1,0,"T1",1,1,1,"H"
2004-04-10,2003,"Bursaspor","Trabzonspor","1-2",1,2,"T1",1,3,-1,"A"
2004-04-10,2003,"Istanbulspor","Elazigspor","3-1",3,1,"T1",1,4,2,"H"
2004-04-11,2003,"Besiktas","Genclerbirligi","2-2",2,2,"T1",1,4,0,"D"
2004-04-11,2003,"Denizlispor","Gaziantepspor","2-0",2,0,"T1",1,2,2,"H"
2004-04-11,2003,"Malatyaspor","Diyarbakirspor","5-0",5,0,"T1",1,5,5,"H"
2004-04-16,2003,"Galatasaray","Denizlispor","4-3",4,3,"T1",1,7,1,"H"
2004-04-17,2003,"Elazigspor","Trabzonspor","0-3",0,3,"T1",1,3,-3,"A"
2004-04-17,2003,"Gaziantepspor","Malatyaspor","1-3",1,3,"T1",1,4,-2,"A"
2004-04-17,2003,"Genclerbirligi","Ankaragucu","1-2",1,2,"T1",1,3,-1,"A"
2004-04-17,2003,"Konyaspor","Besiktas","2-2",2,2,"T1",1,4,0,"D"
2004-04-18,2003,"A. Sebatspor","Bursaspor","0-1",0,1,"T1",1,1,-1,"A"
2004-04-18,2003,"Adanaspor","Rizespor","0-1",0,1,"T1",1,1,-1,"A"
2004-04-18,2003,"Diyarbakirspor","Istanbulspor","1-2",1,2,"T1",1,3,-1,"A"
2004-04-18,2003,"Fenerbahce","Samsunspor","1-1",1,1,"T1",1,2,0,"D"
2004-04-21,2003,"Samsunspor","Konyaspor","2-3",2,3,"T1",1,5,-1,"A"
2004-04-23,2003,"Malatyaspor","Galatasaray","1-2",1,2,"T1",1,3,-1,"A"
2004-04-24,2003,"Bursaspor","Elazigspor","4-0",4,0,"T1",1,4,4,"H"
2004-04-24,2003,"Istanbulspor","Gaziantepspor","0-1",0,1,"T1",1,1,-1,"A"
2004-04-24,2003,"Rizespor","A. Sebatspor","0-1",0,1,"T1",1,1,-1,"A"
2004-04-24,2003,"Trabzonspor","Diyarbakirspor","2-0",2,0,"T1",1,2,2,"H"
2004-04-25,2003,"Ankaragucu","Konyaspor","1-0",1,0,"T1",1,1,1,"H"
2004-04-25,2003,"Besiktas","Fenerbahce","1-3",1,3,"T1",1,4,-2,"A"
2004-04-25,2003,"Denizlispor","Genclerbirligi","1-2",1,2,"T1",1,3,-1,"A"
2004-04-25,2003,"Samsunspor","Adanaspor","2-1",2,1,"T1",1,3,1,"H"
2004-04-30,2003,"Adanaspor","Besiktas","1-0",1,0,"T1",1,1,1,"H"
2004-05-01,2003,"Fenerbahce","Ankaragucu","3-1",3,1,"T1",1,4,2,"H"
2004-05-01,2003,"Gaziantepspor","Trabzonspor","1-2",1,2,"T1",1,3,-1,"A"
2004-05-01,2003,"Genclerbirligi","Malatyaspor","2-2",2,2,"T1",1,4,0,"D"
2004-05-01,2003,"Konyaspor","Denizlispor","1-1",1,1,"T1",1,2,0,"D"
2004-05-02,2003,"A. Sebatspor","Samsunspor","1-0",1,0,"T1",1,1,1,"H"
2004-05-02,2003,"Bursaspor","Rizespor","4-2",4,2,"T1",1,6,2,"H"
2004-05-02,2003,"Elazigspor","Diyarbakirspor","0-1",0,1,"T1",1,1,-1,"A"
2004-05-02,2003,"Galatasaray","Istanbulspor","2-2",2,2,"T1",1,4,0,"D"
2004-05-08,2003,"Ankaragucu","Adanaspor","1-2",1,2,"T1",1,3,-1,"A"
2004-05-08,2003,"Elazigspor","Gaziantepspor","1-2",1,2,"T1",1,3,-1,"A"
2004-05-08,2003,"Malatyaspor","Konyaspor","1-3",1,3,"T1",1,4,-2,"A"
2004-05-09,2003,"Besiktas","A. Sebatspor","0-2",0,2,"T1",1,2,-2,"A"
2004-05-09,2003,"Denizlispor","Fenerbahce","0-4",0,4,"T1",1,4,-4,"A"
2004-05-09,2003,"Diyarbakirspor","Bursaspor","0-3",0,3,"T1",1,3,-3,"A"
2004-05-09,2003,"Istanbulspor","Genclerbirligi","3-0",3,0,"T1",1,3,3,"H"
2004-05-09,2003,"Samsunspor","Rizespor","2-1",2,1,"T1",1,3,1,"H"
2004-05-09,2003,"Trabzonspor","Galatasaray","2-4",2,4,"T1",1,6,-2,"A"
2004-05-14,2003,"Fenerbahce","Malatyaspor","2-4",2,4,"T1",1,6,-2,"A"
2004-05-15,2003,"A. Sebatspor","Ankaragucu","3-2",3,2,"T1",1,5,1,"H"
2004-05-15,2003,"Adanaspor","Denizlispor","4-1",4,1,"T1",1,5,3,"H"
2004-05-15,2003,"Bursaspor","Samsunspor","1-0",1,0,"T1",1,1,1,"H"
2004-05-15,2003,"Galatasaray","Elazigspor","3-1",3,1,"T1",1,4,2,"H"
2004-05-15,2003,"Gaziantepspor","Diyarbakirspor","4-1",4,1,"T1",1,5,3,"H"
2004-05-15,2003,"Genclerbirligi","Trabzonspor","2-2",2,2,"T1",1,4,0,"D"
2004-05-15,2003,"Konyaspor","Istanbulspor","0-2",0,2,"T1",1,2,-2,"A"
2004-05-15,2003,"Rizespor","Besiktas","1-0",1,0,"T1",1,1,1,"H"
2004-08-06,2004,"Rizespor","Fenerbahce","2-2",2,2,"T1",1,4,0,"D"
2004-08-07,2004,"Denizlispor","Gaziantepspor","2-1",2,1,"T1",1,3,1,"H"
2004-08-07,2004,"Genclerbirligi","Sakaryaspor","1-0",1,0,"T1",1,1,1,"H"
2004-08-07,2004,"Kayserispor","Trabzonspor","0-3",0,3,"T1",1,3,-3,"A"
2004-08-07,2004,"Malatyaspor","Besiktas","1-1",1,1,"T1",1,2,0,"D"
2004-08-08,2004,"A. Sebatspor","Ankaraspor","1-3",1,3,"T1",1,4,-2,"A"
2004-08-08,2004,"Galatasaray","Konyaspor","3-1",3,1,"T1",1,4,2,"H"
2004-08-08,2004,"Istanbulspor","Diyarbakirspor","1-1",1,1,"T1",1,2,0,"D"
2004-08-08,2004,"Samsunspor","Ankaragucu","1-1",1,1,"T1",1,2,0,"D"
2004-08-13,2004,"Gaziantepspor","Galatasaray","1-0",1,0,"T1",1,1,1,"H"
2004-08-14,2004,"Ankaragucu","Istanbulspor","0-0",0,0,"T1",1,0,0,"D"
2004-08-14,2004,"Ankaraspor","Malatyaspor","1-3",1,3,"T1",1,4,-2,"A"
2004-08-14,2004,"Diyarbakirspor","Kayserispor","2-1",2,1,"T1",1,3,1,"H"
2004-08-14,2004,"Fenerbahce","Samsunspor","2-1",2,1,"T1",1,3,1,"H"
2004-08-15,2004,"Genclerbirligi","Besiktas","1-1",1,1,"T1",1,2,0,"D"
2004-08-15,2004,"Konyaspor","Rizespor","0-0",0,0,"T1",1,0,0,"D"
2004-08-15,2004,"Sakaryaspor","Denizlispor","1-2",1,2,"T1",1,3,-1,"A"
2004-08-15,2004,"Trabzonspor","A. Sebatspor","3-1",3,1,"T1",1,4,2,"H"
2004-08-21,2004,"Denizlispor","Besiktas","3-1",3,1,"T1",1,4,2,"H"
2004-08-21,2004,"Genclerbirligi","Ankaraspor","1-1",1,1,"T1",1,2,0,"D"
2004-08-21,2004,"Istanbulspor","Fenerbahce","0-3",0,3,"T1",1,3,-3,"A"
2004-08-21,2004,"Malatyaspor","Trabzonspor","3-4",3,4,"T1",1,7,-1,"A"
2004-08-21,2004,"Samsunspor","Konyaspor","1-1",1,1,"T1",1,2,0,"D"
2004-08-22,2004,"A. Sebatspor","Diyarbakirspor","2-2",2,2,"T1",1,4,0,"D"
2004-08-22,2004,"Galatasaray","Rizespor","2-1",2,1,"T1",1,3,1,"H"
2004-08-22,2004,"Gaziantepspor","Sakaryaspor","1-0",1,0,"T1",1,1,1,"H"
2004-08-22,2004,"Kayserispor","Ankaragucu","1-1",1,1,"T1",1,2,0,"D"
2004-08-28,2004,"Ankaraspor","Denizlispor","3-2",3,2,"T1",1,5,1,"H"
2004-08-28,2004,"Kayserispor","Fenerbahce","0-2",0,2,"T1",1,2,-2,"A"
2004-08-28,2004,"Konyaspor","Istanbulspor","2-1",2,1,"T1",1,3,1,"H"
2004-08-28,2004,"Rizespor","Samsunspor","2-0",2,0,"T1",1,2,2,"H"
2004-08-28,2004,"Sakaryaspor","Galatasaray","1-2",1,2,"T1",1,3,-1,"A"
2004-08-29,2004,"Ankaragucu","A. Sebatspor","2-1",2,1,"T1",1,3,1,"H"
2004-08-29,2004,"Besiktas","Gaziantepspor","3-4",3,4,"T1",1,7,-1,"A"
2004-08-29,2004,"Diyarbakirspor","Malatyaspor","1-2",1,2,"T1",1,3,-1,"A"
2004-08-29,2004,"Trabzonspor","Genclerbirligi","3-1",3,1,"T1",1,4,2,"H"
2004-09-11,2004,"A. Sebatspor","Fenerbahce","1-4",1,4,"T1",1,5,-3,"A"
2004-09-11,2004,"Denizlispor","Trabzonspor","0-2",0,2,"T1",1,2,-2,"A"
2004-09-11,2004,"Gaziantepspor","Ankaraspor","2-1",2,1,"T1",1,3,1,"H"
2004-09-11,2004,"Genclerbirligi","Diyarbakirspor","2-0",2,0,"T1",1,2,2,"H"
2004-09-12,2004,"Galatasaray","Samsunspor","3-1",3,1,"T1",1,4,2,"H"
2004-09-12,2004,"Istanbulspor","Rizespor","0-3",0,3,"T1",1,3,-3,"A"
2004-09-12,2004,"Kayserispor","Konyaspor","2-2",2,2,"T1",1,4,0,"D"
2004-09-12,2004,"Malatyaspor","Ankaragucu","1-0",1,0,"T1",1,1,1,"H"
2004-09-12,2004,"Sakaryaspor","Besiktas","1-4",1,4,"T1",1,5,-3,"A"
2004-09-17,2004,"Diyarbakirspor","Denizlispor","0-1",0,1,"T1",1,1,-1,"A"
2004-09-18,2004,"Ankaraspor","Sakaryaspor","1-1",1,1,"T1",1,2,0,"D"
2004-09-18,2004,"Fenerbahce","Malatyaspor","3-1",3,1,"T1",1,4,2,"H"
2004-09-18,2004,"Konyaspor","A. Sebatspor","3-3",3,3,"T1",1,6,0,"D"
2004-09-18,2004,"Samsunspor","Istanbulspor","2-1",2,1,"T1",1,3,1,"H"
2004-09-19,2004,"Ankaragucu","Genclerbirligi","1-0",1,0,"T1",1,1,1,"H"
2004-09-19,2004,"Besiktas","Galatasaray","0-0",0,0,"T1",1,0,0,"D"
2004-09-19,2004,"Rizespor","Kayserispor","2-1",2,1,"T1",1,3,1,"H"
2004-09-19,2004,"Trabzonspor","Gaziantepspor","0-0",0,0,"T1",1,0,0,"D"
2004-09-24,2004,"Genclerbirligi","Fenerbahce","1-2",1,2,"T1",1,3,-1,"A"
2004-09-25,2004,"A. Sebatspor","Rizespor","0-0",0,0,"T1",1,0,0,"D"
2004-09-25,2004,"Besiktas","Ankaraspor","2-3",2,3,"T1",1,5,-1,"A"
2004-09-25,2004,"Kayserispor","Samsunspor","1-4",1,4,"T1",1,5,-3,"A"
2004-09-25,2004,"Sakaryaspor","Trabzonspor","1-3",1,3,"T1",1,4,-2,"A"
2004-09-26,2004,"Denizlispor","Ankaragucu","2-0",2,0,"T1",1,2,2,"H"
2004-09-26,2004,"Galatasaray","Istanbulspor","4-1",4,1,"T1",1,5,3,"H"
2004-09-26,2004,"Gaziantepspor","Diyarbakirspor","1-1",1,1,"T1",1,2,0,"D"
2004-09-26,2004,"Malatyaspor","Konyaspor","5-0",5,0,"T1",1,5,5,"H"
2004-10-01,2004,"Ankaraspor","Galatasaray","0-2",0,2,"T1",1,2,-2,"A"
2004-10-02,2004,"Ankaragucu","Gaziantepspor","2-1",2,1,"T1",1,3,1,"H"
2004-10-02,2004,"Diyarbakirspor","Sakaryaspor","1-0",1,0,"T1",1,1,1,"H"
2004-10-02,2004,"Fenerbahce","Denizlispor","2-0",2,0,"T1",1,2,2,"H"
2004-10-02,2004,"Rizespor","Malatyaspor","0-1",0,1,"T1",1,1,-1,"A"
2004-10-03,2004,"Istanbulspor","Kayserispor","2-0",2,0,"T1",1,2,2,"H"
2004-10-03,2004,"Konyaspor","Genclerbirligi","3-2",3,2,"T1",1,5,1,"H"
2004-10-03,2004,"Samsunspor","A. Sebatspor","3-0",3,0,"T1",1,3,3,"H"
2004-10-03,2004,"Trabzonspor","Besiktas","1-0",1,0,"T1",1,1,1,"H"
2004-10-16,2004,"Besiktas","Diyarbakirspor","4-0",4,0,"T1",1,4,4,"H"
2004-10-16,2004,"Gaziantepspor","Fenerbahce","0-1",0,1,"T1",1,1,-1,"A"
2004-10-16,2004,"Genclerbirligi","Rizespor","2-1",2,1,"T1",1,3,1,"H"
2004-10-16,2004,"Sakaryaspor","Ankaragucu","1-0",1,0,"T1",1,1,1,"H"
2004-10-17,2004,"A. Sebatspor","Istanbulspor","2-2",2,2,"T1",1,4,0,"D"
2004-10-17,2004,"Ankaraspor","Trabzonspor","1-1",1,1,"T1",1,2,0,"D"
2004-10-17,2004,"Denizlispor","Konyaspor","2-1",2,1,"T1",1,3,1,"H"
2004-10-17,2004,"Galatasaray","Kayserispor","5-1",5,1,"T1",1,6,4,"H"
2004-10-17,2004,"Malatyaspor","Samsunspor","1-2",1,2,"T1",1,3,-1,"A"
2004-10-23,2004,"Istanbulspor","Malatyaspor","0-2",0,2,"T1",1,2,-2,"A"
2004-10-23,2004,"Konyaspor","Gaziantepspor","2-2",2,2,"T1",1,4,0,"D"
2004-10-23,2004,"Samsunspor","Genclerbirligi","2-0",2,0,"T1",1,2,2,"H"
2004-10-23,2004,"Trabzonspor","Galatasaray","0-1",0,1,"T1",1,1,-1,"A"
2004-10-24,2004,"Ankaragucu","Besiktas","1-4",1,4,"T1",1,5,-3,"A"
2004-10-24,2004,"Diyarbakirspor","Ankaraspor","1-0",1,0,"T1",1,1,1,"H"
2004-10-24,2004,"Fenerbahce","Sakaryaspor","6-0",6,0,"T1",1,6,6,"H"
2004-10-24,2004,"Kayserispor","A. Sebatspor","4-1",4,1,"T1",1,5,3,"H"
2004-10-24,2004,"Rizespor","Denizlispor","2-0",2,0,"T1",1,2,2,"H"
2004-10-29,2004,"Trabzonspor","Diyarbakirspor","4-1",4,1,"T1",1,5,3,"H"
2004-10-30,2004,"Besiktas","Fenerbahce","2-1",2,1,"T1",1,3,1,"H"
2004-10-30,2004,"Denizlispor","Samsunspor","2-0",2,0,"T1",1,2,2,"H"
2004-10-30,2004,"Gaziantepspor","Rizespor","0-1",0,1,"T1",1,1,-1,"A"
2004-10-30,2004,"Genclerbirligi","Istanbulspor","1-0",1,0,"T1",1,1,1,"H"
2004-10-31,2004,"Ankaraspor","Ankaragucu","2-0",2,0,"T1",1,2,2,"H"
2004-10-31,2004,"Galatasaray","A. Sebatspor","2-0",2,0,"T1",1,2,2,"H"
2004-10-31,2004,"Malatyaspor","Kayserispor","0-1",0,1,"T1",1,1,-1,"A"
2004-10-31,2004,"Sakaryaspor","Konyaspor","1-4",1,4,"T1",1,5,-3,"A"
2004-11-05,2004,"Diyarbakirspor","Galatasaray","2-0",2,0,"T1",1,2,2,"H"
2004-11-06,2004,"A. Sebatspor","Malatyaspor","1-1",1,1,"T1",1,2,0,"D"
2004-11-06,2004,"Fenerbahce","Ankaraspor","1-0",1,0,"T1",1,1,1,"H"
2004-11-06,2004,"Istanbulspor","Denizlispor","1-1",1,1,"T1",1,2,0,"D"
2004-11-06,2004,"Samsunspor","Gaziantepspor","1-3",1,3,"T1",1,4,-2,"A"
2004-11-07,2004,"Ankaragucu","Trabzonspor","0-2",0,2,"T1",1,2,-2,"A"
2004-11-07,2004,"Kayserispor","Genclerbirligi","1-2",1,2,"T1",1,3,-1,"A"
2004-11-07,2004,"Konyaspor","Besiktas","2-2",2,2,"T1",1,4,0,"D"
2004-11-07,2004,"Rizespor","Sakaryaspor","2-0",2,0,"T1",1,2,2,"H"
2004-11-20,2004,"Ankaraspor","Konyaspor","1-3",1,3,"T1",1,4,-2,"A"
2004-11-20,2004,"Galatasaray","Malatyaspor","1-1",1,1,"T1",1,2,0,"D"
2004-11-20,2004,"Sakaryaspor","Samsunspor","4-2",4,2,"T1",1,6,2,"H"
2004-11-20,2004,"Trabzonspor","Fenerbahce","0-2",0,2,"T1",1,2,-2,"A"
2004-11-21,2004,"Besiktas","Rizespor","2-2",2,2,"T1",1,4,0,"D"
2004-11-21,2004,"Denizlispor","Kayserispor","2-1",2,1,"T1",1,3,1,"H"
2004-11-21,2004,"Diyarbakirspor","Ankaragucu","0-1",0,1,"T1",1,1,-1,"A"
2004-11-21,2004,"Gaziantepspor","Istanbulspor","0-1",0,1,"T1",1,1,-1,"A"
2004-11-21,2004,"Genclerbirligi","A. Sebatspor","1-1",1,1,"T1",1,2,0,"D"
2004-11-26,2004,"Ankaragucu","Galatasaray","0-1",0,1,"T1",1,1,-1,"A"
2004-11-27,2004,"Fenerbahce","Diyarbakirspor","3-0",3,0,"T1",1,3,3,"H"
2004-11-27,2004,"Kayserispor","Gaziantepspor","3-1",3,1,"T1",1,4,2,"H"
2004-11-27,2004,"Konyaspor","Trabzonspor","1-1",1,1,"T1",1,2,0,"D"
2004-11-27,2004,"Rizespor","Ankaraspor","2-1",2,1,"T1",1,3,1,"H"
2004-11-28,2004,"A. Sebatspor","Denizlispor","2-1",2,1,"T1",1,3,1,"H"
2004-11-28,2004,"Istanbulspor","Sakaryaspor","3-0",3,0,"T1",1,3,3,"H"
2004-11-28,2004,"Malatyaspor","Genclerbirligi","0-2",0,2,"T1",1,2,-2,"A"
2004-11-28,2004,"Samsunspor","Besiktas","2-4",2,4,"T1",1,6,-2,"A"
2004-12-03,2004,"Fenerbahce","Ankaragucu","5-0",5,0,"T1",1,5,5,"H"
2004-12-04,2004,"Denizlispor","Malatyaspor","0-0",0,0,"T1",1,0,0,"D"
2004-12-04,2004,"Diyarbakirspor","Konyaspor","3-3",3,3,"T1",1,6,0,"D"
2004-12-04,2004,"Genclerbirligi","Galatasaray","1-3",1,3,"T1",1,4,-2,"A"
2004-12-04,2004,"Trabzonspor","Rizespor","1-0",1,0,"T1",1,1,1,"H"
2004-12-05,2004,"Ankaraspor","Samsunspor","0-1",0,1,"T1",1,1,-1,"A"
2004-12-05,2004,"Besiktas","Istanbulspor","2-1",2,1,"T1",1,3,1,"H"
2004-12-05,2004,"Gaziantepspor","A. Sebatspor","6-4",6,4,"T1",1,10,2,"H"
2004-12-05,2004,"Sakaryaspor","Kayserispor","4-2",4,2,"T1",1,6,2,"H"
2004-12-10,2004,"Kayserispor","Besiktas","1-2",1,2,"T1",1,3,-1,"A"
2004-12-11,2004,"A. Sebatspor","Sakaryaspor","0-1",0,1,"T1",1,1,-1,"A"
2004-12-11,2004,"Istanbulspor","Ankaraspor","1-1",1,1,"T1",1,2,0,"D"
2004-12-11,2004,"Malatyaspor","Gaziantepspor","2-1",2,1,"T1",1,3,1,"H"
2004-12-11,2004,"Samsunspor","Trabzonspor","0-4",0,4,"T1",1,4,-4,"A"
2004-12-12,2004,"Galatasaray","Fenerbahce","1-0",1,0,"T1",1,1,1,"H"
2004-12-12,2004,"Genclerbirligi","Denizlispor","1-3",1,3,"T1",1,4,-2,"A"
2004-12-12,2004,"Konyaspor","Ankaragucu","3-4",3,4,"T1",1,7,-1,"A"
2004-12-12,2004,"Rizespor","Diyarbakirspor","3-0",3,0,"T1",1,3,3,"H"
2004-12-17,2004,"Denizlispor","Galatasaray","0-0",0,0,"T1",1,0,0,"D"
2004-12-18,2004,"Ankaragucu","Rizespor","0-0",0,0,"T1",1,0,0,"D"
2004-12-18,2004,"Fenerbahce","Konyaspor","3-0",3,0,"T1",1,3,3,"H"
2004-12-18,2004,"Gaziantepspor","Genclerbirligi","1-0",1,0,"T1",1,1,1,"H"
2004-12-18,2004,"Trabzonspor","Istanbulspor","1-1",1,1,"T1",1,2,0,"D"
2004-12-19,2004,"Ankaraspor","Kayserispor","4-1",4,1,"T1",1,5,3,"H"
2004-12-19,2004,"Besiktas","A. Sebatspor","6-1",6,1,"T1",1,7,5,"H"
2004-12-19,2004,"Diyarbakirspor","Samsunspor","3-0",3,0,"T1",1,3,3,"H"
2004-12-19,2004,"Sakaryaspor","Malatyaspor","4-1",4,1,"T1",1,5,3,"H"
2005-01-28,2004,"Konyaspor","Galatasaray","0-2",0,2,"T1",1,2,-2,"A"
2005-01-29,2004,"Ankaraspor","A. Sebatspor","2-1",2,1,"T1",1,3,1,"H"
2005-01-29,2004,"Besiktas","Malatyaspor","1-0",1,0,"T1",1,1,1,"H"
2005-01-29,2004,"Diyarbakirspor","Istanbulspor","1-0",1,0,"T1",1,1,1,"H"
2005-01-29,2004,"Sakaryaspor","Genclerbirligi","2-2",2,2,"T1",1,4,0,"D"
2005-01-30,2004,"Ankaragucu","Samsunspor","1-2",1,2,"T1",1,3,-1,"A"
2005-01-30,2004,"Fenerbahce","Rizespor","2-0",2,0,"T1",1,2,2,"H"
2005-01-30,2004,"Gaziantepspor","Denizlispor","3-1",3,1,"T1",1,4,2,"H"
2005-01-30,2004,"Trabzonspor","Kayserispor","3-1",3,1,"T1",1,4,2,"H"
2005-02-04,2004,"Galatasaray","Gaziantepspor","5-1",5,1,"T1",1,6,4,"H"
2005-02-05,2004,"Kayserispor","Diyarbakirspor","3-0",3,0,"T1",1,3,3,"H"
2005-02-05,2004,"Malatyaspor","Ankaraspor","2-1",2,1,"T1",1,3,1,"H"
2005-02-05,2004,"Rizespor","Konyaspor","1-1",1,1,"T1",1,2,0,"D"
2005-02-05,2004,"Samsunspor","Fenerbahce","1-1",1,1,"T1",1,2,0,"D"
2005-02-06,2004,"A. Sebatspor","Trabzonspor","0-1",0,1,"T1",1,1,-1,"A"
2005-02-06,2004,"Denizlispor","Sakaryaspor","6-1",6,1,"T1",1,7,5,"H"
2005-02-12,2004,"Ankaragucu","Kayserispor","2-2",2,2,"T1",1,4,0,"D"
2005-02-12,2004,"Besiktas","Denizlispor","2-0",2,0,"T1",1,2,2,"H"
2005-02-12,2004,"Konyaspor","Samsunspor","3-0",3,0,"T1",1,3,3,"H"
2005-02-12,2004,"Rizespor","Galatasaray","0-3",0,3,"T1",1,3,-3,"A"
2005-02-13,2004,"Ankaraspor","Genclerbirligi","2-1",2,1,"T1",1,3,1,"H"
2005-02-13,2004,"Diyarbakirspor","A. Sebatspor","1-0",1,0,"T1",1,1,1,"H"
2005-02-13,2004,"Fenerbahce","Istanbulspor","4-0",4,0,"T1",1,4,4,"H"
2005-02-13,2004,"Sakaryaspor","Gaziantepspor","2-2",2,2,"T1",1,4,0,"D"
2005-02-13,2004,"Trabzonspor","Malatyaspor","3-0",3,0,"T1",1,3,3,"H"
2005-02-18,2004,"Gaziantepspor","Besiktas","0-1",0,1,"T1",1,1,-1,"A"
2005-02-19,2004,"A. Sebatspor","Ankaragucu","0-0",0,0,"T1",1,0,0,"D"
2005-02-19,2004,"Denizlispor","Ankaraspor","1-1",1,1,"T1",1,2,0,"D"
2005-02-19,2004,"Galatasaray","Sakaryaspor","1-0",1,0,"T1",1,1,1,"H"
2005-02-19,2004,"Istanbulspor","Konyaspor","2-2",2,2,"T1",1,4,0,"D"
2005-02-20,2004,"Fenerbahce","Kayserispor","7-0",7,0,"T1",1,7,7,"H"
2005-02-20,2004,"Genclerbirligi","Trabzonspor","0-1",0,1,"T1",1,1,-1,"A"
2005-02-20,2004,"Malatyaspor","Diyarbakirspor","2-1",2,1,"T1",1,3,1,"H"
2005-02-20,2004,"Samsunspor","Rizespor","0-1",0,1,"T1",1,1,-1,"A"
2005-02-26,2004,"Ankaragucu","Malatyaspor","3-0",3,0,"T1",1,3,3,"H"
2005-02-26,2004,"Diyarbakirspor","Genclerbirligi","1-3",1,3,"T1",1,4,-2,"A"
2005-02-26,2004,"Rizespor","Istanbulspor","1-1",1,1,"T1",1,2,0,"D"
2005-02-26,2004,"Samsunspor","Galatasaray","2-1",2,1,"T1",1,3,1,"H"
2005-02-27,2004,"Ankaraspor","Gaziantepspor","1-0",1,0,"T1",1,1,1,"H"
2005-02-27,2004,"Besiktas","Sakaryaspor","2-1",2,1,"T1",1,3,1,"H"
2005-02-27,2004,"Fenerbahce","A. Sebatspor","2-0",2,0,"T1",1,2,2,"H"
2005-02-27,2004,"Konyaspor","Kayserispor","3-1",3,1,"T1",1,4,2,"H"
2005-02-27,2004,"Trabzonspor","Denizlispor","3-0",3,0,"T1",1,3,3,"H"
2005-03-05,2004,"Galatasaray","Besiktas","1-0",1,0,"T1",1,1,1,"H"
2005-03-05,2004,"Genclerbirligi","Ankaragucu","4-0",4,0,"T1",1,4,4,"H"
2005-03-05,2004,"Istanbulspor","Samsunspor","1-1",1,1,"T1",1,2,0,"D"
2005-03-05,2004,"Sakaryaspor","Ankaraspor","1-1",1,1,"T1",1,2,0,"D"
2005-03-06,2004,"A. Sebatspor","Konyaspor","3-5",3,5,"T1",1,8,-2,"A"
2005-03-06,2004,"Denizlispor","Diyarbakirspor","0-0",0,0,"T1",1,0,0,"D"
2005-03-06,2004,"Gaziantepspor","Trabzonspor","3-2",3,2,"T1",1,5,1,"H"
2005-03-06,2004,"Kayserispor","Rizespor","2-1",2,1,"T1",1,3,1,"H"
2005-03-06,2004,"Malatyaspor","Fenerbahce","0-2",0,2,"T1",1,2,-2,"A"
2005-03-09,2004,"Besiktas","Genclerbirligi","0-0",0,0,"T1",1,0,0,"D"
2005-03-09,2004,"Istanbulspor","Ankaragucu","1-2",1,2,"T1",1,3,-1,"A"
2005-03-12,2004,"Ankaragucu","Denizlispor","1-1",1,1,"T1",1,2,0,"D"
2005-03-12,2004,"Istanbulspor","Galatasaray","0-3",0,3,"T1",1,3,-3,"A"
2005-03-12,2004,"Konyaspor","Malatyaspor","2-0",2,0,"T1",1,2,2,"H"
2005-03-12,2004,"Trabzonspor","Sakaryaspor","4-3",4,3,"T1",1,7,1,"H"
2005-03-13,2004,"Ankaraspor","Besiktas","2-4",2,4,"T1",1,6,-2,"A"
2005-03-13,2004,"Diyarbakirspor","Gaziantepspor","3-0",3,0,"T1",1,3,3,"H"
2005-03-13,2004,"Fenerbahce","Genclerbirligi","3-2",3,2,"T1",1,5,1,"H"
2005-03-13,2004,"Rizespor","A. Sebatspor","2-1",2,1,"T1",1,3,1,"H"
2005-03-13,2004,"Samsunspor","Kayserispor","3-3",3,3,"T1",1,6,0,"D"
2005-03-18,2004,"Denizlispor","Fenerbahce","2-0",2,0,"T1",1,2,2,"H"
2005-03-19,2004,"Besiktas","Trabzonspor","1-0",1,0,"T1",1,1,1,"H"
2005-03-19,2004,"Gaziantepspor","Ankaragucu","2-0",2,0,"T1",1,2,2,"H"
2005-03-19,2004,"Kayserispor","Istanbulspor","0-0",0,0,"T1",1,0,0,"D"
2005-03-19,2004,"Malatyaspor","Rizespor","0-1",0,1,"T1",1,1,-1,"A"
2005-03-20,2004,"A. Sebatspor","Samsunspor","3-0",3,0,"T1",1,3,3,"H"
2005-03-20,2004,"Galatasaray","Ankaraspor","4-2",4,2,"T1",1,6,2,"H"
2005-03-20,2004,"Genclerbirligi","Konyaspor","2-1",2,1,"T1",1,3,1,"H"
2005-03-20,2004,"Sakaryaspor","Diyarbakirspor","3-2",3,2,"T1",1,5,1,"H"
2005-04-02,2004,"Ankaragucu","Sakaryaspor","2-7",2,7,"T1",1,9,-5,"A"
2005-04-02,2004,"Fenerbahce","Gaziantepspor","2-0",2,0,"T1",1,2,2,"H"
2005-04-02,2004,"Istanbulspor","A. Sebatspor","1-0",1,0,"T1",1,1,1,"H"
2005-04-02,2004,"Rizespor","Genclerbirligi","1-1",1,1,"T1",1,2,0,"D"
2005-04-03,2004,"Diyarbakirspor","Besiktas","0-0",0,0,"T1",1,0,0,"D"
2005-04-03,2004,"Kayserispor","Galatasaray","2-2",2,2,"T1",1,4,0,"D"
2005-04-03,2004,"Konyaspor","Denizlispor","0-0",0,0,"T1",1,0,0,"D"
2005-04-03,2004,"Samsunspor","Malatyaspor","0-1",0,1,"T1",1,1,-1,"A"
2005-04-03,2004,"Trabzonspor","Ankaraspor","2-2",2,2,"T1",1,4,0,"D"
2005-04-08,2004,"Besiktas","Ankaragucu","4-1",4,1,"T1",1,5,3,"H"
2005-04-09,2004,"A. Sebatspor","Kayserispor","0-0",0,0,"T1",1,0,0,"D"
2005-04-09,2004,"Ankaraspor","Diyarbakirspor","3-0",3,0,"T1",1,3,3,"H"
2005-04-09,2004,"Malatyaspor","Istanbulspor","2-0",2,0,"T1",1,2,2,"H"
2005-04-09,2004,"Sakaryaspor","Fenerbahce","0-1",0,1,"T1",1,1,-1,"A"
2005-04-10,2004,"Denizlispor","Rizespor","3-0",3,0,"T1",1,3,3,"H"
2005-04-10,2004,"Galatasaray","Trabzonspor","0-2",0,2,"T1",1,2,-2,"A"
2005-04-10,2004,"Gaziantepspor","Konyaspor","2-0",2,0,"T1",1,2,2,"H"
2005-04-10,2004,"Genclerbirligi","Samsunspor","0-0",0,0,"T1",1,0,0,"D"
2005-04-15,2004,"Diyarbakirspor","Trabzonspor","0-1",0,1,"T1",1,1,-1,"A"
2005-04-16,2004,"A. Sebatspor","Galatasaray","1-3",1,3,"T1",1,4,-2,"A"
2005-04-16,2004,"Kayserispor","Malatyaspor","1-1",1,1,"T1",1,2,0,"D"
2005-04-16,2004,"Konyaspor","Sakaryaspor","2-0",2,0,"T1",1,2,2,"H"
2005-04-16,2004,"Samsunspor","Denizlispor","4-0",4,0,"T1",1,4,4,"H"
2005-04-17,2004,"Ankaragucu","Ankaraspor","2-5",2,5,"T1",1,7,-3,"A"
2005-04-17,2004,"Fenerbahce","Besiktas","3-4",3,4,"T1",1,7,-1,"A"
2005-04-17,2004,"Istanbulspor","Genclerbirligi","1-3",1,3,"T1",1,4,-2,"A"
2005-04-17,2004,"Rizespor","Gaziantepspor","1-1",1,1,"T1",1,2,0,"D"
2005-04-23,2004,"Besiktas","Konyaspor","2-1",2,1,"T1",1,3,1,"H"
2005-04-23,2004,"Gaziantepspor","Samsunspor","1-3",1,3,"T1",1,4,-2,"A"
2005-04-23,2004,"Genclerbirligi","Kayserispor","0-0",0,0,"T1",1,0,0,"D"
2005-04-23,2004,"Malatyaspor","A. Sebatspor","2-2",2,2,"T1",1,4,0,"D"
2005-04-24,2004,"Ankaraspor","Fenerbahce","0-1",0,1,"T1",1,1,-1,"A"
2005-04-24,2004,"Denizlispor","Istanbulspor","2-2",2,2,"T1",1,4,0,"D"
2005-04-24,2004,"Galatasaray","Diyarbakirspor","1-0",1,0,"T1",1,1,1,"H"
2005-04-24,2004,"Sakaryaspor","Rizespor","3-1",3,1,"T1",1,4,2,"H"
2005-04-24,2004,"Trabzonspor","Ankaragucu","3-1",3,1,"T1",1,4,2,"H"
2005-04-29,2004,"Istanbulspor","Gaziantepspor","1-3",1,3,"T1",1,4,-2,"A"
2005-04-29,2004,"Rizespor","Besiktas","0-1",0,1,"T1",1,1,-1,"A"
2005-04-30,2004,"Ankaragucu","Diyarbakirspor","4-1",4,1,"T1",1,5,3,"H"
2005-04-30,2004,"Fenerbahce","Trabzonspor","2-1",2,1,"T1",1,3,1,"H"
2005-04-30,2004,"Kayserispor","Denizlispor","1-0",1,0,"T1",1,1,1,"H"
2005-04-30,2004,"Samsunspor","Sakaryaspor","1-1",1,1,"T1",1,2,0,"D"
2005-05-01,2004,"A. Sebatspor","Genclerbirligi","0-5",0,5,"T1",1,5,-5,"A"
2005-05-01,2004,"Konyaspor","Ankaraspor","2-3",2,3,"T1",1,5,-1,"A"
2005-05-01,2004,"Malatyaspor","Galatasaray","0-1",0,1,"T1",1,1,-1,"A"
2005-05-07,2004,"Ankaraspor","Rizespor","1-0",1,0,"T1",1,1,1,"H"
2005-05-07,2004,"Diyarbakirspor","Fenerbahce","0-2",0,2,"T1",1,2,-2,"A"
2005-05-07,2004,"Galatasaray","Ankaragucu","2-1",2,1,"T1",1,3,1,"H"
2005-05-07,2004,"Gaziantepspor","Kayserispor","1-2",1,2,"T1",1,3,-1,"A"
2005-05-07,2004,"Sakaryaspor","Istanbulspor","1-3",1,3,"T1",1,4,-2,"A"
2005-05-07,2004,"Trabzonspor","Konyaspor","4-2",4,2,"T1",1,6,2,"H"
2005-05-08,2004,"Besiktas","Samsunspor","2-0",2,0,"T1",1,2,2,"H"
2005-05-08,2004,"Denizlispor","A. Sebatspor","4-2",4,2,"T1",1,6,2,"H"
2005-05-08,2004,"Genclerbirligi","Malatyaspor","5-3",5,3,"T1",1,8,2,"H"
2005-05-14,2004,"A. Sebatspor","Gaziantepspor","2-0",2,0,"T1",1,2,2,"H"
2005-05-14,2004,"Malatyaspor","Denizlispor","2-2",2,2,"T1",1,4,0,"D"
2005-05-14,2004,"Samsunspor","Ankaraspor","0-0",0,0,"T1",1,0,0,"D"
2005-05-15,2004,"Ankaragucu","Fenerbahce","1-0",1,0,"T1",1,1,1,"H"
2005-05-15,2004,"Galatasaray","Genclerbirligi","1-2",1,2,"T1",1,3,-1,"A"
2005-05-15,2004,"Istanbulspor","Besiktas","1-1",1,1,"T1",1,2,0,"D"
2005-05-15,2004,"Kayserispor","Sakaryaspor","1-0",1,0,"T1",1,1,1,"H"
2005-05-15,2004,"Konyaspor","Diyarbakirspor","2-1",2,1,"T1",1,3,1,"H"
2005-05-15,2004,"Rizespor","Trabzonspor","1-2",1,2,"T1",1,3,-1,"A"
2005-05-21,2004,"Ankaragucu","Konyaspor","1-1",1,1,"T1",1,2,0,"D"
2005-05-21,2004,"Ankaraspor","Istanbulspor","3-2",3,2,"T1",1,5,1,"H"
2005-05-21,2004,"Besiktas","Kayserispor","3-2",3,2,"T1",1,5,1,"H"
2005-05-21,2004,"Diyarbakirspor","Rizespor","1-1",1,1,"T1",1,2,0,"D"
2005-05-21,2004,"Gaziantepspor","Malatyaspor","4-3",4,3,"T1",1,7,1,"H"
2005-05-21,2004,"Sakaryaspor","A. Sebatspor","4-2",4,2,"T1",1,6,2,"H"
2005-05-22,2004,"Denizlispor","Genclerbirligi","1-1",1,1,"T1",1,2,0,"D"
2005-05-22,2004,"Fenerbahce","Galatasaray","1-0",1,0,"T1",1,1,1,"H"
2005-05-22,2004,"Trabzonspor","Samsunspor","3-0",3,0,"T1",1,3,3,"H"
2005-05-29,2004,"A. Sebatspor","Besiktas","2-2",2,2,"T1",1,4,0,"D"
2005-05-29,2004,"Galatasaray","Denizlispor","4-0",4,0,"T1",1,4,4,"H"
2005-05-29,2004,"Genclerbirligi","Gaziantepspor","2-1",2,1,"T1",1,3,1,"H"
2005-05-29,2004,"Istanbulspor","Trabzonspor","0-5",0,5,"T1",1,5,-5,"A"
2005-05-29,2004,"Kayserispor","Ankaraspor","0-0",0,0,"T1",1,0,0,"D"
2005-05-29,2004,"Konyaspor","Fenerbahce","4-2",4,2,"T1",1,6,2,"H"
2005-05-29,2004,"Malatyaspor","Sakaryaspor","4-2",4,2,"T1",1,6,2,"H"
2005-05-29,2004,"Rizespor","Ankaragucu","1-2",1,2,"T1",1,3,-1,"A"
2005-05-29,2004,"Samsunspor","Diyarbakirspor","0-1",0,1,"T1",1,1,-1,"A"
2005-08-05,2005,"Genclerbirligi","Fenerbahce","0-0",0,0,"T1",1,0,0,"D"
2005-08-06,2005,"Diyarbakirspor","Rizespor","1-0",1,0,"T1",1,1,1,"H"
2005-08-06,2005,"Erciyesspor","Besiktas","1-1",1,1,"T1",1,2,0,"D"
2005-08-06,2005,"Sivasspor","Malatyaspor","1-1",1,1,"T1",1,2,0,"D"
2005-08-06,2005,"Trabzonspor","Kayserispor","2-1",2,1,"T1",1,3,1,"H"
2005-08-07,2005,"Denizlispor","Ankaraspor","1-1",1,1,"T1",1,2,0,"D"
2005-08-07,2005,"Galatasaray","Konyaspor","2-1",2,1,"T1",1,3,1,"H"
2005-08-07,2005,"Manisaspor","Ankaragucu","2-2",2,2,"T1",1,4,0,"D"
2005-08-07,2005,"Samsunspor","Gaziantepspor","2-3",2,3,"T1",1,5,-1,"A"
2005-08-12,2005,"Ankaragucu","Galatasaray","0-1",0,1,"T1",1,1,-1,"A"
2005-08-13,2005,"Fenerbahce","Diyarbakirspor","2-2",2,2,"T1",1,4,0,"D"
2005-08-13,2005,"Gaziantepspor","Sivasspor","0-0",0,0,"T1",1,0,0,"D"
2005-08-13,2005,"Malatyaspor","Manisaspor","0-5",0,5,"T1",1,5,-5,"A"
2005-08-13,2005,"Rizespor","Samsunspor","1-2",1,2,"T1",1,3,-1,"A"
2005-08-14,2005,"Ankaraspor","Genclerbirligi","0-0",0,0,"T1",1,0,0,"D"
2005-08-14,2005,"Besiktas","Denizlispor","2-0",2,0,"T1",1,2,2,"H"
2005-08-14,2005,"Kayserispor","Erciyesspor","1-2",1,2,"T1",1,3,-1,"A"
2005-08-14,2005,"Konyaspor","Trabzonspor","0-0",0,0,"T1",1,0,0,"D"
2005-08-20,2005,"Denizlispor","Kayserispor","1-3",1,3,"T1",1,4,-2,"A"
2005-08-20,2005,"Genclerbirligi","Besiktas","0-2",0,2,"T1",1,2,-2,"A"
2005-08-20,2005,"Samsunspor","Sivasspor","1-2",1,2,"T1",1,3,-1,"A"
2005-08-20,2005,"Trabzonspor","Ankaragucu","3-1",3,1,"T1",1,4,2,"H"
2005-08-21,2005,"Diyarbakirspor","Ankaraspor","1-2",1,2,"T1",1,3,-1,"A"
2005-08-21,2005,"Erciyesspor","Konyaspor","0-0",0,0,"T1",1,0,0,"D"
2005-08-21,2005,"Galatasaray","Malatyaspor","5-2",5,2,"T1",1,7,3,"H"
2005-08-21,2005,"Manisaspor","Gaziantepspor","1-2",1,2,"T1",1,3,-1,"A"
2005-08-21,2005,"Rizespor","Fenerbahce","1-2",1,2,"T1",1,3,-1,"A"
2005-08-26,2005,"Gaziantepspor","Galatasaray","2-2",2,2,"T1",1,4,0,"D"
2005-08-27,2005,"Ankaraspor","Rizespor","0-0",0,0,"T1",1,0,0,"D"
2005-08-27,2005,"Fenerbahce","Samsunspor","5-2",5,2,"T1",1,7,3,"H"
2005-08-27,2005,"Konyaspor","Denizlispor","1-0",1,0,"T1",1,1,1,"H"
2005-08-27,2005,"Sivasspor","Manisaspor","1-0",1,0,"T1",1,1,1,"H"
2005-08-28,2005,"Ankaragucu","Erciyesspor","1-2",1,2,"T1",1,3,-1,"A"
2005-08-28,2005,"Besiktas","Diyarbakirspor","1-1",1,1,"T1",1,2,0,"D"
2005-08-28,2005,"Kayserispor","Genclerbirligi","2-0",2,0,"T1",1,2,2,"H"
2005-08-28,2005,"Malatyaspor","Trabzonspor","1-1",1,1,"T1",1,2,0,"D"
2005-09-10,2005,"Diyarbakirspor","Kayserispor","0-2",0,2,"T1",1,2,-2,"A"
2005-09-10,2005,"Erciyesspor","Malatyaspor","1-1",1,1,"T1",1,2,0,"D"
2005-09-10,2005,"Fenerbahce","Ankaraspor","2-1",2,1,"T1",1,3,1,"H"
2005-09-10,2005,"Rizespor","Besiktas","1-0",1,0,"T1",1,1,1,"H"
2005-09-11,2005,"Denizlispor","Ankaragucu","0-0",0,0,"T1",1,0,0,"D"
2005-09-11,2005,"Galatasaray","Sivasspor","2-0",2,0,"T1",1,2,2,"H"
2005-09-11,2005,"Genclerbirligi","Konyaspor","1-1",1,1,"T1",1,2,0,"D"
2005-09-11,2005,"Samsunspor","Manisaspor","1-1",1,1,"T1",1,2,0,"D"
2005-09-11,2005,"Trabzonspor","Gaziantepspor","2-0",2,0,"T1",1,2,2,"H"
2005-09-16,2005,"Sivasspor","Trabzonspor","2-1",2,1,"T1",1,3,1,"H"
2005-09-17,2005,"Ankaragucu","Genclerbirligi","1-1",1,1,"T1",1,2,0,"D"
2005-09-17,2005,"Kayserispor","Rizespor","3-1",3,1,"T1",1,4,2,"H"
2005-09-17,2005,"Konyaspor","Diyarbakirspor","5-1",5,1,"T1",1,6,4,"H"
2005-09-17,2005,"Malatyaspor","Denizlispor","0-1",0,1,"T1",1,1,-1,"A"
2005-09-18,2005,"Ankaraspor","Samsunspor","3-3",3,3,"T1",1,6,0,"D"
2005-09-18,2005,"Besiktas","Fenerbahce","1-2",1,2,"T1",1,3,-1,"A"
2005-09-18,2005,"Gaziantepspor","Erciyesspor","1-2",1,2,"T1",1,3,-1,"A"
2005-09-18,2005,"Manisaspor","Galatasaray","1-4",1,4,"T1",1,5,-3,"A"
2005-09-23,2005,"Trabzonspor","Manisaspor","0-2",0,2,"T1",1,2,-2,"A"
2005-09-24,2005,"Denizlispor","Gaziantepspor","1-2",1,2,"T1",1,3,-1,"A"
2005-09-24,2005,"Fenerbahce","Kayserispor","3-0",3,0,"T1",1,3,3,"H"
2005-09-24,2005,"Genclerbirligi","Malatyaspor","2-0",2,0,"T1",1,2,2,"H"
2005-09-25,2005,"Ankaraspor","Besiktas","2-0",2,0,"T1",1,2,2,"H"
2005-09-25,2005,"Diyarbakirspor","Ankaragucu","0-3",0,3,"T1",1,3,-3,"A"
2005-09-25,2005,"Erciyesspor","Sivasspor","0-0",0,0,"T1",1,0,0,"D"
2005-09-25,2005,"Rizespor","Konyaspor","1-1",1,1,"T1",1,2,0,"D"
2005-09-25,2005,"Samsunspor","Galatasaray","1-2",1,2,"T1",1,3,-1,"A"
2005-09-30,2005,"Gaziantepspor","Genclerbirligi","1-1",1,1,"T1",1,2,0,"D"
2005-10-01,2005,"Konyaspor","Fenerbahce","2-4",2,4,"T1",1,6,-2,"A"
2005-10-01,2005,"Manisaspor","Erciyesspor","0-2",0,2,"T1",1,2,-2,"A"
2005-10-01,2005,"Sivasspor","Denizlispor","1-0",1,0,"T1",1,1,1,"H"
2005-10-02,2005,"Ankaragucu","Rizespor","1-0",1,0,"T1",1,1,1,"H"
2005-10-02,2005,"Besiktas","Samsunspor","3-2",3,2,"T1",1,5,1,"H"
2005-10-02,2005,"Galatasaray","Trabzonspor","4-1",4,1,"T1",1,5,3,"H"
2005-10-02,2005,"Kayserispor","Ankaraspor","2-1",2,1,"T1",1,3,1,"H"
2005-10-02,2005,"Malatyaspor","Diyarbakirspor","1-2",1,2,"T1",1,3,-1,"A"
2005-10-15,2005,"Ankaraspor","Konyaspor","0-0",0,0,"T1",1,0,0,"D"
2005-10-15,2005,"Diyarbakirspor","Gaziantepspor","1-2",1,2,"T1",1,3,-1,"A"
2005-10-15,2005,"Erciyesspor","Galatasaray","1-2",1,2,"T1",1,3,-1,"A"
2005-10-15,2005,"Fenerbahce","Ankaragucu","2-1",2,1,"T1",1,3,1,"H"
2005-10-16,2005,"Besiktas","Kayserispor","0-0",0,0,"T1",1,0,0,"D"
2005-10-16,2005,"Denizlispor","Manisaspor","1-1",1,1,"T1",1,2,0,"D"
2005-10-16,2005,"Genclerbirligi","Sivasspor","0-1",0,1,"T1",1,1,-1,"A"
2005-10-16,2005,"Rizespor","Malatyaspor","1-0",1,0,"T1",1,1,1,"H"
2005-10-16,2005,"Samsunspor","Trabzonspor","3-1",3,1,"T1",1,4,2,"H"
2005-10-21,2005,"Trabzonspor","Erciyesspor","0-0",0,0,"T1",1,0,0,"D"
2005-10-22,2005,"Ankaragucu","Ankaraspor","3-2",3,2,"T1",1,5,1,"H"
2005-10-22,2005,"Galatasaray","Denizlispor","1-1",1,1,"T1",1,2,0,"D"
2005-10-22,2005,"Kayserispor","Samsunspor","6-3",6,3,"T1",1,9,3,"H"
2005-10-23,2005,"Gaziantepspor","Rizespor","1-1",1,1,"T1",1,2,0,"D"
2005-10-23,2005,"Konyaspor","Besiktas","0-1",0,1,"T1",1,1,-1,"A"
2005-10-23,2005,"Malatyaspor","Fenerbahce","0-3",0,3,"T1",1,3,-3,"A"
2005-10-23,2005,"Manisaspor","Genclerbirligi","0-3",0,3,"T1",1,3,-3,"A"
2005-10-23,2005,"Sivasspor","Diyarbakirspor","4-1",4,1,"T1",1,5,3,"H"
2005-10-28,2005,"Denizlispor","Trabzonspor","0-1",0,1,"T1",1,1,-1,"A"
2005-10-29,2005,"Ankaraspor","Malatyaspor","1-2",1,2,"T1",1,3,-1,"A"
2005-10-29,2005,"Fenerbahce","Gaziantepspor","1-0",1,0,"T1",1,1,1,"H"
2005-10-30,2005,"Besiktas","Ankaragucu","4-2",4,2,"T1",1,6,2,"H"
2005-10-30,2005,"Diyarbakirspor","Manisaspor","0-2",0,2,"T1",1,2,-2,"A"
2005-10-30,2005,"Genclerbirligi","Galatasaray","2-1",2,1,"T1",1,3,1,"H"
2005-10-30,2005,"Kayserispor","Konyaspor","1-0",1,0,"T1",1,1,1,"H"
2005-10-30,2005,"Rizespor","Sivasspor","1-0",1,0,"T1",1,1,1,"H"
2005-10-30,2005,"Samsunspor","Erciyesspor","1-1",1,1,"T1",1,2,0,"D"
2005-11-04,2005,"Galatasaray","Diyarbakirspor","2-0",2,0,"T1",1,2,2,"H"
2005-11-05,2005,"Erciyesspor","Denizlispor","2-0",2,0,"T1",1,2,2,"H"
2005-11-05,2005,"Gaziantepspor","Ankaraspor","3-3",3,3,"T1",1,6,0,"D"
2005-11-05,2005,"Trabzonspor","Genclerbirligi","1-1",1,1,"T1",1,2,0,"D"
2005-11-06,2005,"Ankaragucu","Kayserispor","2-0",2,0,"T1",1,2,2,"H"
2005-11-06,2005,"Konyaspor","Samsunspor","4-2",4,2,"T1",1,6,2,"H"
2005-11-06,2005,"Malatyaspor","Besiktas","1-1",1,1,"T1",1,2,0,"D"
2005-11-06,2005,"Manisaspor","Rizespor","1-1",1,1,"T1",1,2,0,"D"
2005-11-06,2005,"Sivasspor","Fenerbahce","2-3",2,3,"T1",1,5,-1,"A"
2005-11-19,2005,"Diyarbakirspor","Trabzonspor","3-0",3,0,"T1",1,3,3,"H"
2005-11-19,2005,"Fenerbahce","Manisaspor","2-1",2,1,"T1",1,3,1,"H"
2005-11-19,2005,"Genclerbirligi","Erciyesspor","3-0",3,0,"T1",1,3,3,"H"
2005-11-19,2005,"Samsunspor","Denizlispor","1-2",1,2,"T1",1,3,-1,"A"
2005-11-20,2005,"Ankaraspor","Sivasspor","1-1",1,1,"T1",1,2,0,"D"
2005-11-20,2005,"Besiktas","Gaziantepspor","0-1",0,1,"T1",1,1,-1,"A"
2005-11-20,2005,"Kayserispor","Malatyaspor","2-0",2,0,"T1",1,2,2,"H"
2005-11-20,2005,"Konyaspor","Ankaragucu","2-0",2,0,"T1",1,2,2,"H"
2005-11-20,2005,"Rizespor","Galatasaray","0-3",0,3,"T1",1,3,-3,"A"
2005-11-25,2005,"Trabzonspor","Rizespor","3-1",3,1,"T1",1,4,2,"H"
2005-11-26,2005,"Malatyaspor","Konyaspor","1-0",1,0,"T1",1,1,1,"H"
2005-11-26,2005,"Manisaspor","Ankaraspor","1-0",1,0,"T1",1,1,1,"H"
2005-11-26,2005,"Sivasspor","Besiktas","1-3",1,3,"T1",1,4,-2,"A"
2005-11-27,2005,"Ankaragucu","Samsunspor","1-1",1,1,"T1",1,2,0,"D"
2005-11-27,2005,"Denizlispor","Genclerbirligi","0-2",0,2,"T1",1,2,-2,"A"
2005-11-27,2005,"Erciyesspor","Diyarbakirspor","0-2",0,2,"T1",1,2,-2,"A"
2005-11-27,2005,"Galatasaray","Fenerbahce","0-1",0,1,"T1",1,1,-1,"A"
2005-11-27,2005,"Gaziantepspor","Kayserispor","1-4",1,4,"T1",1,5,-3,"A"
2005-12-02,2005,"Fenerbahce","Trabzonspor","2-2",2,2,"T1",1,4,0,"D"
2005-12-03,2005,"Ankaraspor","Galatasaray","1-2",1,2,"T1",1,3,-1,"A"
2005-12-03,2005,"Konyaspor","Gaziantepspor","3-2",3,2,"T1",1,5,1,"H"
2005-12-03,2005,"Rizespor","Erciyesspor","2-2",2,2,"T1",1,4,0,"D"
2005-12-04,2005,"Besiktas","Manisaspor","3-1",3,1,"T1",1,4,2,"H"
2005-12-04,2005,"Diyarbakirspor","Denizlispor","1-0",1,0,"T1",1,1,1,"H"
2005-12-04,2005,"Genclerbirligi","Samsunspor","0-1",0,1,"T1",1,1,-1,"A"
2005-12-04,2005,"Kayserispor","Sivasspor","2-2",2,2,"T1",1,4,0,"D"
2005-12-05,2005,"Malatyaspor","Ankaragucu","0-0",0,0,"T1",1,0,0,"D"
2005-12-09,2005,"Manisaspor","Kayserispor","1-0",1,0,"T1",1,1,1,"H"
2005-12-10,2005,"Denizlispor","Rizespor","2-0",2,0,"T1",1,2,2,"H"
2005-12-10,2005,"Galatasaray","Besiktas","3-2",3,2,"T1",1,5,1,"H"
2005-12-10,2005,"Gaziantepspor","Ankaragucu","1-1",1,1,"T1",1,2,0,"D"
2005-12-11,2005,"Erciyesspor","Fenerbahce","0-3",0,3,"T1",1,3,-3,"A"
2005-12-11,2005,"Genclerbirligi","Diyarbakirspor","4-0",4,0,"T1",1,4,4,"H"
2005-12-11,2005,"Samsunspor","Malatyaspor","1-2",1,2,"T1",1,3,-1,"A"
2005-12-11,2005,"Sivasspor","Konyaspor","1-1",1,1,"T1",1,2,0,"D"
2005-12-11,2005,"Trabzonspor","Ankaraspor","2-3",2,3,"T1",1,5,-1,"A"
2005-12-16,2005,"Kayserispor","Galatasaray","1-3",1,3,"T1",1,4,-2,"A"
2005-12-17,2005,"Ankaragucu","Sivasspor","0-0",0,0,"T1",1,0,0,"D"
2005-12-17,2005,"Fenerbahce","Denizlispor","6-2",6,2,"T1",1,8,4,"H"
2005-12-17,2005,"Malatyaspor","Gaziantepspor","2-0",2,0,"T1",1,2,2,"H"
2005-12-18,2005,"Ankaraspor","Erciyesspor","1-1",1,1,"T1",1,2,0,"D"
2005-12-18,2005,"Besiktas","Trabzonspor","0-1",0,1,"T1",1,1,-1,"A"
2005-12-18,2005,"Diyarbakirspor","Samsunspor","0-0",0,0,"T1",1,0,0,"D"
2005-12-18,2005,"Konyaspor","Manisaspor","1-1",1,1,"T1",1,2,0,"D"
2005-12-18,2005,"Rizespor","Genclerbirligi","1-1",1,1,"T1",1,2,0,"D"
2006-01-20,2005,"Fenerbahce","Genclerbirligi","3-0",3,0,"T1",1,3,3,"H"
2006-01-21,2005,"Ankaragucu","Manisaspor","0-2",0,2,"T1",1,2,-2,"A"
2006-01-21,2005,"Besiktas","Erciyesspor","2-2",2,2,"T1",1,4,0,"D"
2006-01-21,2005,"Gaziantepspor","Samsunspor","0-1",0,1,"T1",1,1,-1,"A"
2006-01-22,2005,"Ankaraspor","Denizlispor","1-3",1,3,"T1",1,4,-2,"A"
2006-01-22,2005,"Kayserispor","Trabzonspor","4-2",4,2,"T1",1,6,2,"H"
2006-01-22,2005,"Konyaspor","Galatasaray","0-1",0,1,"T1",1,1,-1,"A"
2006-01-22,2005,"Malatyaspor","Sivasspor","0-0",0,0,"T1",1,0,0,"D"
2006-01-22,2005,"Rizespor","Diyarbakirspor","2-0",2,0,"T1",1,2,2,"H"
2006-01-27,2006,"Ankaragucu","Bursaspor","1-1",1,1,"T1",1,2,0,"D"
2006-01-27,2006,"Besiktas","Manisaspor","3-1",3,1,"T1",1,4,2,"H"
2006-01-27,2006,"Denizlispor","Gaziantepspor","0-2",0,2,"T1",1,2,-2,"A"
2006-01-27,2006,"Erciyesspor","Fenerbahce","1-1",1,1,"T1",1,2,0,"D"
2006-01-27,2006,"Galatasaray","Ankaraspor","2-0",2,0,"T1",1,2,2,"H"
2006-01-27,2006,"Genclerbirligi","Sivasspor","0-1",0,1,"T1",1,1,-1,"A"
2006-01-27,2006,"Rizespor","Antalyaspor","1-0",1,0,"T1",1,1,1,"H"
2006-01-27,2006,"Sakaryaspor","Konyaspor","1-1",1,1,"T1",1,2,0,"D"
2006-01-27,2006,"Trabzonspor","Kayserispor","0-0",0,0,"T1",1,0,0,"D"
2006-02-02,2006,"Fenerbahce","Genclerbirligi","2-1",2,1,"T1",1,3,1,"H"
2006-02-03,2006,"Antalyaspor","Sakaryaspor","1-0",1,0,"T1",1,1,1,"H"
2006-02-03,2006,"Konyaspor","Denizlispor","5-1",5,1,"T1",1,6,4,"H"
2006-02-03,2006,"Manisaspor","Trabzonspor","0-0",0,0,"T1",1,0,0,"D"
2006-02-03,2005,"Fenerbahce","Rizespor","1-1",1,1,"T1",1,2,0,"D"
2006-02-04,2006,"Ankaraspor","Ankaragucu","1-0",1,0,"T1",1,1,1,"H"
2006-02-04,2006,"Bursaspor","Erciyesspor","0-0",0,0,"T1",1,0,0,"D"
2006-02-04,2006,"Gaziantepspor","Besiktas","0-0",0,0,"T1",1,0,0,"D"
2006-02-04,2006,"Kayserispor","Galatasaray","0-0",0,0,"T1",1,0,0,"D"
2006-02-04,2006,"Sivasspor","Rizespor","1-0",1,0,"T1",1,1,1,"H"
2006-02-04,2005,"Ankaraspor","Diyarbakirspor","3-3",3,3,"T1",1,6,0,"D"
2006-02-04,2005,"Besiktas","Genclerbirligi","2-1",2,1,"T1",1,3,1,"H"
2006-02-04,2005,"Kayserispor","Denizlispor","2-2",2,2,"T1",1,4,0,"D"
2006-02-05,2005,"Ankaragucu","Trabzonspor","1-2",1,2,"T1",1,3,-1,"A"
2006-02-05,2005,"Gaziantepspor","Manisaspor","1-1",1,1,"T1",1,2,0,"D"
2006-02-05,2005,"Konyaspor","Erciyesspor","2-0",2,0,"T1",1,2,2,"H"
2006-02-05,2005,"Malatyaspor","Galatasaray","1-1",1,1,"T1",1,2,0,"D"
2006-02-05,2005,"Sivasspor","Samsunspor","0-3",0,3,"T1",1,3,-3,"A"
2006-02-10,2006,"Ankaragucu","Kayserispor","0-4",0,4,"T1",1,4,-4,"A"
2006-02-10,2006,"Besiktas","Denizlispor","2-0",2,0,"T1",1,2,2,"H"
2006-02-10,2006,"Rizespor","Fenerbahce","2-1",2,1,"T1",1,3,1,"H"
2006-02-10,2005,"Diyarbakirspor","Besiktas","1-3",1,3,"T1",1,4,-2,"A"
2006-02-11,2006,"Antalyaspor","Konyaspor","1-0",1,0,"T1",1,1,1,"H"
2006-02-11,2006,"Erciyesspor","Ankaraspor","1-0",1,0,"T1",1,1,1,"H"
2006-02-11,2006,"Galatasaray","Manisaspor","4-0",4,0,"T1",1,4,4,"H"
2006-02-11,2006,"Genclerbirligi","Bursaspor","1-0",1,0,"T1",1,1,1,"H"
2006-02-11,2006,"Sakaryaspor","Sivasspor","1-3",1,3,"T1",1,4,-2,"A"
2006-02-11,2006,"Trabzonspor","Gaziantepspor","2-0",2,0,"T1",1,2,2,"H"
2006-02-11,2005,"Erciyesspor","Ankaragucu","1-2",1,2,"T1",1,3,-1,"A"
2006-02-11,2005,"Manisaspor","Sivasspor","3-1",3,1,"T1",1,4,2,"H"
2006-02-11,2005,"Samsunspor","Fenerbahce","0-5",0,5,"T1",1,5,-5,"A"
2006-02-12,2005,"Denizlispor","Konyaspor","5-2",5,2,"T1",1,7,3,"H"
2006-02-12,2005,"Galatasaray","Gaziantepspor","6-0",6,0,"T1",1,6,6,"H"
2006-02-12,2005,"Genclerbirligi","Kayserispor","3-2",3,2,"T1",1,5,1,"H"
2006-02-12,2005,"Rizespor","Ankaraspor","1-1",1,1,"T1",1,2,0,"D"
2006-02-12,2005,"Trabzonspor","Malatyaspor","1-0",1,0,"T1",1,1,1,"H"
2006-02-16,2006,"Konyaspor","Besiktas","2-1",2,1,"T1",1,3,1,"H"
2006-02-17,2006,"Bursaspor","Rizespor","1-0",1,0,"T1",1,1,1,"H"
2006-02-17,2006,"Gaziantepspor","Galatasaray","1-0",1,0,"T1",1,1,1,"H"
2006-02-17,2005,"Besiktas","Rizespor","0-1",0,1,"T1",1,1,-1,"A"
2006-02-18,2006,"Ankaraspor","Genclerbirligi","1-2",1,2,"T1",1,3,-1,"A"
2006-02-18,2006,"Denizlispor","Trabzonspor","3-4",3,4,"T1",1,7,-1,"A"
2006-02-18,2006,"Fenerbahce","Sakaryaspor","1-0",1,0,"T1",1,1,1,"H"
2006-02-18,2006,"Kayserispor","Erciyesspor","1-0",1,0,"T1",1,1,1,"H"
2006-02-18,2006,"Manisaspor","Ankaragucu","0-1",0,1,"T1",1,1,-1,"A"
2006-02-18,2006,"Sivasspor","Antalyaspor","0-1",0,1,"T1",1,1,-1,"A"
2006-02-18,2005,"Ankaraspor","Fenerbahce","2-1",2,1,"T1",1,3,1,"H"
2006-02-19,2005,"Ankaragucu","Denizlispor","1-1",1,1,"T1",1,2,0,"D"
2006-02-19,2005,"Gaziantepspor","Trabzonspor","0-2",0,2,"T1",1,2,-2,"A"
2006-02-19,2005,"Kayserispor","Diyarbakirspor","3-0",3,0,"T1",1,3,3,"H"
2006-02-19,2005,"Konyaspor","Genclerbirligi","0-3",0,3,"T1",1,3,-3,"A"
2006-02-19,2005,"Malatyaspor","Erciyesspor","2-2",2,2,"T1",1,4,0,"D"
2006-02-19,2005,"Manisaspor","Samsunspor","3-0",3,0,"T1",1,3,3,"H"
2006-02-19,2005,"Sivasspor","Galatasaray","0-0",0,0,"T1",1,0,0,"D"
2006-02-23,2006,"Erciyesspor","Manisaspor","1-0",1,0,"T1",1,1,1,"H"
2006-02-23,2006,"Galatasaray","Denizlispor","1-1",1,1,"T1",1,2,0,"D"
2006-02-24,2006,"Ankaragucu","Gaziantepspor","2-1",2,1,"T1",1,3,1,"H"
2006-02-24,2006,"Trabzonspor","Besiktas","3-2",3,2,"T1",1,5,1,"H"
2006-02-25,2006,"Antalyaspor","Fenerbahce","1-0",1,0,"T1",1,1,1,"H"
2006-02-25,2006,"Genclerbirligi","Kayserispor","2-2",2,2,"T1",1,4,0,"D"
2006-02-25,2006,"Rizespor","Ankaraspor","1-1",1,1,"T1",1,2,0,"D"
2006-02-25,2006,"Sakaryaspor","Bursaspor","1-3",1,3,"T1",1,4,-2,"A"
2006-02-25,2006,"Sivasspor","Konyaspor","1-3",1,3,"T1",1,4,-2,"A"
2006-02-25,2005,"Erciyesspor","Gaziantepspor","1-0",1,0,"T1",1,1,1,"H"
2006-02-25,2005,"Galatasaray","Manisaspor","4-2",4,2,"T1",1,6,2,"H"
2006-02-26,2005,"Denizlispor","Malatyaspor","1-0",1,0,"T1",1,1,1,"H"
2006-02-26,2005,"Diyarbakirspor","Konyaspor","0-3",0,3,"T1",1,3,-3,"A"
2006-02-26,2005,"Fenerbahce","Besiktas","2-2",2,2,"T1",1,4,0,"D"
2006-02-26,2005,"Genclerbirligi","Ankaragucu","1-1",1,1,"T1",1,2,0,"D"
2006-02-26,2005,"Rizespor","Kayserispor","0-0",0,0,"T1",1,0,0,"D"
2006-02-26,2005,"Samsunspor","Ankaraspor","0-1",0,1,"T1",1,1,-1,"A"
2006-02-26,2005,"Trabzonspor","Sivasspor","0-0",0,0,"T1",1,0,0,"D"
2006-03-02,2006,"Bursaspor","Antalyaspor","0-0",0,0,"T1",1,0,0,"D"
2006-03-03,2006,"Besiktas","Galatasaray","2-1",2,1,"T1",1,3,1,"H"
2006-03-03,2006,"Denizlispor","Ankaragucu","1-0",1,0,"T1",1,1,1,"H"
2006-03-03,2006,"Kayserispor","Rizespor","1-0",1,0,"T1",1,1,1,"H"
2006-03-04,2006,"Ankaraspor","Sakaryaspor","1-0",1,0,"T1",1,1,1,"H"
2006-03-04,2006,"Fenerbahce","Sivasspor","2-2",2,2,"T1",1,4,0,"D"
2006-03-04,2006,"Gaziantepspor","Erciyesspor","0-1",0,1,"T1",1,1,-1,"A"
2006-03-04,2006,"Konyaspor","Trabzonspor","1-2",1,2,"T1",1,3,-1,"A"
2006-03-04,2006,"Manisaspor","Genclerbirligi","0-3",0,3,"T1",1,3,-3,"A"
2006-03-04,2005,"Galatasaray","Samsunspor","3-2",3,2,"T1",1,5,1,"H"
2006-03-04,2005,"Manisaspor","Trabzonspor","1-2",1,2,"T1",1,3,-1,"A"
2006-03-05,2005,"Ankaragucu","Diyarbakirspor","5-1",5,1,"T1",1,6,4,"H"
2006-03-05,2005,"Besiktas","Ankaraspor","3-0",3,0,"T1",1,3,3,"H"
2006-03-05,2005,"Gaziantepspor","Denizlispor","1-0",1,0,"T1",1,1,1,"H"
2006-03-05,2005,"Kayserispor","Fenerbahce","1-0",1,0,"T1",1,1,1,"H"
2006-03-05,2005,"Konyaspor","Rizespor","3-1",3,1,"T1",1,4,2,"H"
2006-03-05,2005,"Malatyaspor","Genclerbirligi","1-3",1,3,"T1",1,4,-2,"A"
2006-03-05,2005,"Sivasspor","Erciyesspor","3-0",3,0,"T1",1,3,3,"H"
2006-03-09,2006,"Sakaryaspor","Kayserispor","3-3",3,3,"T1",1,6,0,"D"
2006-03-10,2006,"Fenerbahce","Konyaspor","3-0",3,0,"T1",1,3,3,"H"
2006-03-10,2006,"Genclerbirligi","Gaziantepspor","0-0",0,0,"T1",1,0,0,"D"
2006-03-10,2006,"Sivasspor","Bursaspor","3-1",3,1,"T1",1,4,2,"H"
2006-03-10,2005,"Erciyesspor","Manisaspor","2-1",2,1,"T1",1,3,1,"H"
2006-03-11,2006,"Ankaragucu","Besiktas","0-1",0,1,"T1",1,1,-1,"A"
2006-03-11,2006,"Antalyaspor","Ankaraspor","1-1",1,1,"T1",1,2,0,"D"
2006-03-11,2006,"Erciyesspor","Denizlispor","2-0",2,0,"T1",1,2,2,"H"
2006-03-11,2006,"Galatasaray","Trabzonspor","2-1",2,1,"T1",1,3,1,"H"
2006-03-11,2006,"Rizespor","Manisaspor","3-1",3,1,"T1",1,4,2,"H"
2006-03-11,2005,"Fenerbahce","Konyaspor","5-0",5,0,"T1",1,5,5,"H"
2006-03-11,2005,"Genclerbirligi","Gaziantepspor","3-1",3,1,"T1",1,4,2,"H"
2006-03-11,2005,"Rizespor","Ankaragucu","1-0",1,0,"T1",1,1,1,"H"
2006-03-12,2005,"Ankaraspor","Kayserispor","1-3",1,3,"T1",1,4,-2,"A"
2006-03-12,2005,"Denizlispor","Sivasspor","4-0",4,0,"T1",1,4,4,"H"
2006-03-12,2005,"Diyarbakirspor","Malatyaspor","3-2",3,2,"T1",1,5,1,"H"
2006-03-12,2005,"Samsunspor","Besiktas","1-3",1,3,"T1",1,4,-2,"A"
2006-03-12,2005,"Trabzonspor","Galatasaray","1-1",1,1,"T1",1,2,0,"D"
2006-03-16,2006,"Konyaspor","Galatasaray","2-2",2,2,"T1",1,4,0,"D"
2006-03-17,2006,"Ankaraspor","Sivasspor","2-1",2,1,"T1",1,3,1,"H"
2006-03-17,2006,"Bursaspor","Fenerbahce","0-4",0,4,"T1",1,4,-4,"A"
2006-03-17,2006,"Denizlispor","Genclerbirligi","3-2",3,2,"T1",1,5,1,"H"
2006-03-17,2006,"Gaziantepspor","Rizespor","1-0",1,0,"T1",1,1,1,"H"
2006-03-17,2006,"Kayserispor","Antalyaspor","4-4",4,4,"T1",1,8,0,"D"
2006-03-17,2006,"Manisaspor","Sakaryaspor","0-3",0,3,"T1",1,3,-3,"A"
2006-03-17,2006,"Trabzonspor","Ankaragucu","0-1",0,1,"T1",1,1,-1,"A"
2006-03-17,2005,"Kayserispor","Besiktas","0-1",0,1,"T1",1,1,-1,"A"
2006-03-18,2006,"Besiktas","Erciyesspor","1-0",1,0,"T1",1,1,1,"H"
2006-03-18,2005,"Ankaragucu","Fenerbahce","1-4",1,4,"T1",1,5,-3,"A"
2006-03-18,2005,"Manisaspor","Denizlispor","4-2",4,2,"T1",1,6,2,"H"
2006-03-19,2005,"Galatasaray","Erciyesspor","4-2",4,2,"T1",1,6,2,"H"
2006-03-19,2005,"Gaziantepspor","Diyarbakirspor","2-0",2,0,"T1",1,2,2,"H"
2006-03-19,2005,"Konyaspor","Ankaraspor","0-0",0,0,"T1",1,0,0,"D"
2006-03-19,2005,"Malatyaspor","Rizespor","1-0",1,0,"T1",1,1,1,"H"
2006-03-19,2005,"Sivasspor","Genclerbirligi","2-1",2,1,"T1",1,3,1,"H"
2006-03-19,2005,"Trabzonspor","Samsunspor","2-1",2,1,"T1",1,3,1,"H"
2006-03-24,2005,"Besiktas","Konyaspor","0-1",0,1,"T1",1,1,-1,"A"
2006-03-25,2005,"Denizlispor","Galatasaray","1-2",1,2,"T1",1,3,-1,"A"
2006-03-25,2005,"Diyarbakirspor","Sivasspor","1-1",1,1,"T1",1,2,0,"D"
2006-03-25,2005,"Genclerbirligi","Manisaspor","2-1",2,1,"T1",1,3,1,"H"
2006-03-26,2005,"Ankaraspor","Ankaragucu","1-2",1,2,"T1",1,3,-1,"A"
2006-03-26,2005,"Erciyesspor","Trabzonspor","1-0",1,0,"T1",1,1,1,"H"
2006-03-26,2005,"Fenerbahce","Malatyaspor","2-0",2,0,"T1",1,2,2,"H"
2006-03-26,2005,"Rizespor","Gaziantepspor","0-0",0,0,"T1",1,0,0,"D"
2006-03-26,2005,"Samsunspor","Kayserispor","0-0",0,0,"T1",1,0,0,"D"
2006-03-29,2005,"Denizlispor","Besiktas","1-1",1,1,"T1",1,2,0,"D"
2006-03-29,2005,"Erciyesspor","Kayserispor","0-0",0,0,"T1",1,0,0,"D"
2006-03-29,2005,"Galatasaray","Ankaragucu","2-0",2,0,"T1",1,2,2,"H"
2006-03-29,2005,"Genclerbirligi","Ankaraspor","2-1",2,1,"T1",1,3,1,"H"
2006-03-29,2005,"Manisaspor","Malatyaspor","4-3",4,3,"T1",1,7,1,"H"
2006-03-29,2005,"Samsunspor","Rizespor","0-0",0,0,"T1",1,0,0,"D"
2006-03-29,2005,"Sivasspor","Gaziantepspor","0-0",0,0,"T1",1,0,0,"D"
2006-03-30,2005,"Diyarbakirspor","Fenerbahce","0-4",0,4,"T1",1,4,-4,"A"
2006-03-30,2005,"Trabzonspor","Konyaspor","1-2",1,2,"T1",1,3,-1,"A"
2006-04-01,2006,"Ankaragucu","Galatasaray","1-2",1,2,"T1",1,3,-1,"A"
2006-04-01,2006,"Antalyaspor","Manisaspor","1-0",1,0,"T1",1,1,1,"H"
2006-04-01,2006,"Bursaspor","Konyaspor","1-0",1,0,"T1",1,1,1,"H"
2006-04-01,2006,"Fenerbahce","Ankaraspor","2-1",2,1,"T1",1,3,1,"H"
2006-04-01,2006,"Rizespor","Denizlispor","2-2",2,2,"T1",1,4,0,"D"
2006-04-01,2006,"Sakaryaspor","Gaziantepspor","1-2",1,2,"T1",1,3,-1,"A"
2006-04-01,2006,"Sivasspor","Kayserispor","3-2",3,2,"T1",1,5,1,"H"
2006-04-01,2005,"Ankaragucu","Besiktas","2-3",2,3,"T1",1,5,-1,"A"
2006-04-01,2005,"Galatasaray","Genclerbirligi","3-0",3,0,"T1",1,3,3,"H"
2006-04-02,2006,"Erciyesspor","Trabzonspor","0-1",0,1,"T1",1,1,-1,"A"
2006-04-02,2006,"Genclerbirligi","Besiktas","0-2",0,2,"T1",1,2,-2,"A"
2006-04-02,2005,"Erciyesspor","Samsunspor","2-2",2,2,"T1",1,4,0,"D"
2006-04-02,2005,"Gaziantepspor","Fenerbahce","0-2",0,2,"T1",1,2,-2,"A"
2006-04-02,2005,"Konyaspor","Kayserispor","1-0",1,0,"T1",1,1,1,"H"
2006-04-02,2005,"Malatyaspor","Ankaraspor","0-2",0,2,"T1",1,2,-2,"A"
2006-04-02,2005,"Manisaspor","Diyarbakirspor","0-3",0,3,"T1",1,3,-3,"A"
2006-04-02,2005,"Sivasspor","Rizespor","1-2",1,2,"T1",1,3,-1,"A"
2006-04-02,2005,"Trabzonspor","Denizlispor","3-0",3,0,"T1",1,3,3,"H"
2006-04-06,2006,"Galatasaray","Erciyesspor","0-1",0,1,"T1",1,1,-1,"A"
2006-04-07,2006,"Kayserispor","Fenerbahce","2-2",2,2,"T1",1,4,0,"D"
2006-04-07,2006,"Trabzonspor","Genclerbirligi","4-3",4,3,"T1",1,7,1,"H"
2006-04-07,2005,"Diyarbakirspor","Galatasaray","1-3",1,3,"T1",1,4,-2,"A"
2006-04-08,2006,"Ankaraspor","Bursaspor","0-0",0,0,"T1",1,0,0,"D"
2006-04-08,2006,"Besiktas","Rizespor","1-0",1,0,"T1",1,1,1,"H"
2006-04-08,2006,"Denizlispor","Sakaryaspor","1-0",1,0,"T1",1,1,1,"H"
2006-04-08,2006,"Gaziantepspor","Antalyaspor","0-0",0,0,"T1",1,0,0,"D"
2006-04-08,2006,"Konyaspor","Ankaragucu","2-0",2,0,"T1",1,2,2,"H"
2006-04-08,2006,"Manisaspor","Sivasspor","1-0",1,0,"T1",1,1,1,"H"
2006-04-08,2005,"Ankaraspor","Gaziantepspor","3-0",3,0,"T1",1,3,3,"H"
2006-04-08,2005,"Besiktas","Malatyaspor","2-2",2,2,"T1",1,4,0,"D"
2006-04-09,2005,"Denizlispor","Erciyesspor","1-1",1,1,"T1",1,2,0,"D"
2006-04-09,2005,"Fenerbahce","Sivasspor","3-0",3,0,"T1",1,3,3,"H"
2006-04-09,2005,"Genclerbirligi","Trabzonspor","1-0",1,0,"T1",1,1,1,"H"
2006-04-09,2005,"Kayserispor","Ankaragucu","1-2",1,2,"T1",1,3,-1,"A"
2006-04-09,2005,"Rizespor","Manisaspor","4-1",4,1,"T1",1,5,3,"H"
2006-04-09,2005,"Samsunspor","Konyaspor","1-1",1,1,"T1",1,2,0,"D"
2006-04-13,2006,"Genclerbirligi","Galatasaray","1-3",1,3,"T1",1,4,-2,"A"
2006-04-14,2006,"Sakaryaspor","Besiktas","1-1",1,1,"T1",1,2,0,"D"
2006-04-15,2006,"Ankaraspor","Konyaspor","4-2",4,2,"T1",1,6,2,"H"
2006-04-15,2006,"Antalyaspor","Denizlispor","1-1",1,1,"T1",1,2,0,"D"
2006-04-15,2006,"Bursaspor","Kayserispor","0-3",0,3,"T1",1,3,-3,"A"
2006-04-15,2006,"Erciyesspor","Ankaragucu","0-1",0,1,"T1",1,1,-1,"A"
2006-04-15,2006,"Fenerbahce","Manisaspor","0-0",0,0,"T1",1,0,0,"D"
2006-04-15,2006,"Rizespor","Trabzonspor","3-2",3,2,"T1",1,5,1,"H"
2006-04-15,2006,"Sivasspor","Gaziantepspor","2-1",2,1,"T1",1,3,1,"H"
2006-04-15,2005,"Denizlispor","Samsunspor","1-2",1,2,"T1",1,3,-1,"A"
2006-04-15,2005,"Malatyaspor","Kayserispor","2-1",2,1,"T1",1,3,1,"H"
2006-04-15,2005,"Manisaspor","Fenerbahce","5-3",5,3,"T1",1,8,2,"H"
2006-04-16,2005,"Ankaragucu","Konyaspor","3-0",3,0,"T1",1,3,3,"H"
2006-04-16,2005,"Erciyesspor","Genclerbirligi","2-0",2,0,"T1",1,2,2,"H"
2006-04-16,2005,"Galatasaray","Rizespor","4-2",4,2,"T1",1,6,2,"H"
2006-04-16,2005,"Gaziantepspor","Besiktas","2-2",2,2,"T1",1,4,0,"D"
2006-04-16,2005,"Sivasspor","Ankaraspor","2-2",2,2,"T1",1,4,0,"D"
2006-04-16,2005,"Trabzonspor","Diyarbakirspor","3-0",3,0,"T1",1,3,3,"H"
2006-04-20,2006,"Gaziantepspor","Fenerbahce","0-2",0,2,"T1",1,2,-2,"A"
2006-04-21,2006,"Besiktas","Antalyaspor","1-0",1,0,"T1",1,1,1,"H"
2006-04-22,2006,"Ankaragucu","Genclerbirligi","0-0",0,0,"T1",1,0,0,"D"
2006-04-22,2006,"Denizlispor","Sivasspor","2-0",2,0,"T1",1,2,2,"H"
2006-04-22,2006,"Galatasaray","Rizespor","3-1",3,1,"T1",1,4,2,"H"
2006-04-22,2006,"Kayserispor","Ankaraspor","3-3",3,3,"T1",1,6,0,"D"
2006-04-22,2006,"Konyaspor","Erciyesspor","1-1",1,1,"T1",1,2,0,"D"
2006-04-22,2006,"Manisaspor","Bursaspor","4-1",4,1,"T1",1,5,3,"H"
2006-04-22,2006,"Trabzonspor","Sakaryaspor","5-2",5,2,"T1",1,7,3,"H"
2006-04-22,2005,"Ankaraspor","Manisaspor","3-1",3,1,"T1",1,4,2,"H"
2006-04-22,2005,"Fenerbahce","Galatasaray","4-0",4,0,"T1",1,4,4,"H"
2006-04-23,2005,"Besiktas","Sivasspor","0-1",0,1,"T1",1,1,-1,"A"
2006-04-23,2005,"Diyarbakirspor","Erciyesspor","2-1",2,1,"T1",1,3,1,"H"
2006-04-23,2005,"Genclerbirligi","Denizlispor","3-3",3,3,"T1",1,6,0,"D"
2006-04-23,2005,"Kayserispor","Gaziantepspor","0-1",0,1,"T1",1,1,-1,"A"
2006-04-23,2005,"Konyaspor","Malatyaspor","0-2",0,2,"T1",1,2,-2,"A"
2006-04-23,2005,"Rizespor","Trabzonspor","1-6",1,6,"T1",1,7,-5,"A"
2006-04-23,2005,"Samsunspor","Ankaragucu","2-1",2,1,"T1",1,3,1,"H"
2006-04-28,2006,"Ankaraspor","Manisaspor","1-1",1,1,"T1",1,2,0,"D"
2006-04-28,2006,"Antalyaspor","Trabzonspor","1-2",1,2,"T1",1,3,-1,"A"
2006-04-28,2006,"Bursaspor","Gaziantepspor","1-1",1,1,"T1",1,2,0,"D"
2006-04-28,2006,"Genclerbirligi","Erciyesspor","1-2",1,2,"T1",1,3,-1,"A"
2006-04-28,2006,"Kayserispor","Konyaspor","2-1",2,1,"T1",1,3,1,"H"
2006-04-28,2006,"Rizespor","Ankaragucu","3-1",3,1,"T1",1,4,2,"H"
2006-04-28,2006,"Sakaryaspor","Galatasaray","0-3",0,3,"T1",1,3,-3,"A"
2006-04-28,2005,"Manisaspor","Besiktas","0-1",0,1,"T1",1,1,-1,"A"
2006-04-29,2006,"Fenerbahce","Denizlispor","2-2",2,2,"T1",1,4,0,"D"
2006-04-29,2006,"Sivasspor","Besiktas","0-1",0,1,"T1",1,1,-1,"A"
2006-04-29,2005,"Ankaragucu","Malatyaspor","0-1",0,1,"T1",1,1,-1,"A"
2006-04-29,2005,"Denizlispor","Diyarbakirspor","1-0",1,0,"T1",1,1,1,"H"
2006-04-29,2005,"Erciyesspor","Rizespor","0-2",0,2,"T1",1,2,-2,"A"
2006-04-29,2005,"Galatasaray","Ankaraspor","4-0",4,0,"T1",1,4,4,"H"
2006-04-29,2005,"Gaziantepspor","Konyaspor","2-0",2,0,"T1",1,2,2,"H"
2006-04-29,2005,"Samsunspor","Genclerbirligi","2-0",2,0,"T1",1,2,2,"H"
2006-04-29,2005,"Trabzonspor","Fenerbahce","2-3",2,3,"T1",1,5,-1,"A"
2006-04-30,2005,"Sivasspor","Kayserispor","0-5",0,5,"T1",1,5,-5,"A"
2006-05-04,2006,"Trabzonspor","Sivasspor","2-0",2,0,"T1",1,2,2,"H"
2006-05-05,2006,"Ankaragucu","Sakaryaspor","1-0",1,0,"T1",1,1,1,"H"
2006-05-05,2006,"Besiktas","Fenerbahce","0-1",0,1,"T1",1,1,-1,"A"
2006-05-05,2006,"Denizlispor","Bursaspor","0-0",0,0,"T1",1,0,0,"D"
2006-05-05,2006,"Erciyesspor","Rizespor","1-1",1,1,"T1",1,2,0,"D"
2006-05-05,2006,"Gaziantepspor","Ankaraspor","0-2",0,2,"T1",1,2,-2,"A"
2006-05-05,2006,"Konyaspor","Genclerbirligi","2-1",2,1,"T1",1,3,1,"H"
2006-05-05,2006,"Manisaspor","Kayserispor","1-0",1,0,"T1",1,1,1,"H"
2006-05-06,2006,"Galatasaray","Antalyaspor","1-1",1,1,"T1",1,2,0,"D"
2006-05-06,2005,"Ankaraspor","Trabzonspor","0-2",0,2,"T1",1,2,-2,"A"
2006-05-06,2005,"Diyarbakirspor","Genclerbirligi","0-2",0,2,"T1",1,2,-2,"A"
2006-05-06,2005,"Kayserispor","Manisaspor","7-2",7,2,"T1",1,9,5,"H"
2006-05-06,2005,"Malatyaspor","Samsunspor","3-0",3,0,"T1",1,3,3,"H"
2006-05-06,2005,"Rizespor","Denizlispor","1-2",1,2,"T1",1,3,-1,"A"
2006-05-07,2005,"Ankaragucu","Gaziantepspor","2-1",2,1,"T1",1,3,1,"H"
2006-05-07,2005,"Besiktas","Galatasaray","1-2",1,2,"T1",1,3,-1,"A"
2006-05-07,2005,"Fenerbahce","Erciyesspor","4-2",4,2,"T1",1,6,2,"H"
2006-05-07,2005,"Konyaspor","Sivasspor","2-1",2,1,"T1",1,3,1,"H"
2006-05-13,2006,"Ankaraspor","Denizlispor","1-1",1,1,"T1",1,2,0,"D"
2006-05-13,2006,"Antalyaspor","Ankaragucu","0-1",0,1,"T1",1,1,-1,"A"
2006-05-13,2006,"Bursaspor","Besiktas","3-0",3,0,"T1",1,3,3,"H"
2006-05-13,2006,"Fenerbahce","Trabzonspor","2-2",2,2,"T1",1,4,0,"D"
2006-05-13,2006,"Genclerbirligi","Rizespor","2-1",2,1,"T1",1,3,1,"H"
2006-05-13,2006,"Kayserispor","Gaziantepspor","1-2",1,2,"T1",1,3,-1,"A"
2006-05-13,2006,"Konyaspor","Manisaspor","1-0",1,0,"T1",1,1,1,"H"
2006-05-13,2006,"Sakaryaspor","Erciyesspor","1-2",1,2,"T1",1,3,-1,"A"
2006-05-13,2006,"Sivasspor","Galatasaray","1-1",1,1,"T1",1,2,0,"D"
2006-05-13,2005,"Manisaspor","Konyaspor","0-0",0,0,"T1",1,0,0,"D"
2006-05-13,2005,"Sivasspor","Ankaragucu","3-1",3,1,"T1",1,4,2,"H"
2006-05-14,2005,"Denizlispor","Fenerbahce","1-1",1,1,"T1",1,2,0,"D"
2006-05-14,2005,"Erciyesspor","Ankaraspor","0-1",0,1,"T1",1,1,-1,"A"
2006-05-14,2005,"Galatasaray","Kayserispor","3-0",3,0,"T1",1,3,3,"H"
2006-05-14,2005,"Gaziantepspor","Malatyaspor","1-0",1,0,"T1",1,1,1,"H"
2006-05-14,2005,"Genclerbirligi","Rizespor","1-3",1,3,"T1",1,4,-2,"A"
2006-05-14,2005,"Samsunspor","Diyarbakirspor","1-0",1,0,"T1",1,1,1,"H"
2006-05-14,2005,"Trabzonspor","Besiktas","1-2",1,2,"T1",1,3,-1,"A"
2006-05-19,2006,"Besiktas","Ankaraspor","2-1",2,1,"T1",1,3,1,"H"
2006-05-19,2006,"Galatasaray","Fenerbahce","1-2",1,2,"T1",1,3,-1,"A"
2006-05-19,2006,"Genclerbirligi","Sakaryaspor","1-0",1,0,"T1",1,1,1,"H"
2006-05-20,2006,"Ankaragucu","Sivasspor","1-4",1,4,"T1",1,5,-3,"A"
2006-05-20,2006,"Denizlispor","Kayserispor","2-1",2,1,"T1",1,3,1,"H"
2006-05-20,2006,"Erciyesspor","Antalyaspor","0-0",0,0,"T1",1,0,0,"D"
2006-05-20,2006,"Gaziantepspor","Manisaspor","0-0",0,0,"T1",1,0,0,"D"
2006-05-20,2006,"Rizespor","Konyaspor","1-0",1,0,"T1",1,1,1,"H"
2006-05-20,2006,"Trabzonspor","Bursaspor","3-1",3,1,"T1",1,4,2,"H"
2006-05-25,2006,"Ankaraspor","Trabzonspor","2-1",2,1,"T1",1,3,1,"H"
2006-05-25,2006,"Bursaspor","Galatasaray","2-0",2,0,"T1",1,2,2,"H"
2006-05-25,2006,"Kayserispor","Besiktas","3-0",3,0,"T1",1,3,3,"H"
2006-05-26,2006,"Antalyaspor","Genclerbirligi","1-3",1,3,"T1",1,4,-2,"A"
2006-05-26,2006,"Fenerbahce","Ankaragucu","3-1",3,1,"T1",1,4,2,"H"
2006-05-26,2006,"Konyaspor","Gaziantepspor","0-2",0,2,"T1",1,2,-2,"A"
2006-05-26,2006,"Manisaspor","Denizlispor","0-0",0,0,"T1",1,0,0,"D"
2006-05-26,2006,"Sakaryaspor","Rizespor","1-1",1,1,"T1",1,2,0,"D"
2006-05-26,2006,"Sivasspor","Erciyesspor","2-1",2,1,"T1",1,3,1,"H"
2006-08-04,2006,"Ankaraspor","Galatasaray","1-1",1,1,"T1",1,2,0,"D"
2006-08-05,2006,"Fenerbahce","Erciyesspor","6-0",6,0,"T1",1,6,6,"H"
2006-08-05,2006,"Kayserispor","Trabzonspor","1-0",1,0,"T1",1,1,1,"H"
2006-08-06,2006,"Antalyaspor","Rizespor","0-0",0,0,"T1",1,0,0,"D"
2006-08-06,2006,"Bursaspor","Ankaragucu","0-0",0,0,"T1",1,0,0,"D"
2006-08-06,2006,"Gaziantepspor","Denizlispor","1-1",1,1,"T1",1,2,0,"D"
2006-08-06,2006,"Konyaspor","Sakaryaspor","1-1",1,1,"T1",1,2,0,"D"
2006-08-06,2006,"Manisaspor","Besiktas","1-0",1,0,"T1",1,1,1,"H"
2006-08-06,2006,"Sivasspor","Genclerbirligi","1-2",1,2,"T1",1,3,-1,"A"
2006-08-11,2006,"Besiktas","Gaziantepspor","2-1",2,1,"T1",1,3,1,"H"
2006-08-12,2006,"Genclerbirligi","Fenerbahce","0-2",0,2,"T1",1,2,-2,"A"
2006-08-13,2006,"Ankaragucu","Ankaraspor","1-1",1,1,"T1",1,2,0,"D"
2006-08-13,2006,"Denizlispor","Konyaspor","0-1",0,1,"T1",1,1,-1,"A"
2006-08-13,2006,"Erciyesspor","Bursaspor","2-1",2,1,"T1",1,3,1,"H"
2006-08-13,2006,"Galatasaray","Kayserispor","4-0",4,0,"T1",1,4,4,"H"
2006-08-13,2006,"Rizespor","Sivasspor","1-1",1,1,"T1",1,2,0,"D"
2006-08-13,2006,"Sakaryaspor","Antalyaspor","0-0",0,0,"T1",1,0,0,"D"
2006-08-13,2006,"Trabzonspor","Manisaspor","1-1",1,1,"T1",1,2,0,"D"
2006-08-19,2006,"Ankaraspor","Erciyesspor","2-2",2,2,"T1",1,4,0,"D"
2006-08-19,2006,"Fenerbahce","Rizespor","2-1",2,1,"T1",1,3,1,"H"
2006-08-19,2006,"Manisaspor","Galatasaray","2-2",2,2,"T1",1,4,0,"D"
2006-08-20,2006,"Bursaspor","Genclerbirligi","0-0",0,0,"T1",1,0,0,"D"
2006-08-20,2006,"Denizlispor","Besiktas","0-2",0,2,"T1",1,2,-2,"A"
2006-08-20,2006,"Gaziantepspor","Trabzonspor","2-1",2,1,"T1",1,3,1,"H"
2006-08-20,2006,"Kayserispor","Ankaragucu","2-1",2,1,"T1",1,3,1,"H"
2006-08-20,2006,"Konyaspor","Antalyaspor","0-0",0,0,"T1",1,0,0,"D"
2006-08-20,2006,"Sivasspor","Sakaryaspor","0-2",0,2,"T1",1,2,-2,"A"
2006-08-25,2006,"Besiktas","Konyaspor","3-1",3,1,"T1",1,4,2,"H"
2006-08-26,2006,"Galatasaray","Gaziantepspor","2-2",2,2,"T1",1,4,0,"D"
2006-08-26,2006,"Genclerbirligi","Ankaraspor","2-1",2,1,"T1",1,3,1,"H"
2006-08-27,2006,"Ankaragucu","Manisaspor","0-1",0,1,"T1",1,1,-1,"A"
2006-08-27,2006,"Antalyaspor","Sivasspor","1-2",1,2,"T1",1,3,-1,"A"
2006-08-27,2006,"Erciyesspor","Kayserispor","0-4",0,4,"T1",1,4,-4,"A"
2006-08-27,2006,"Rizespor","Bursaspor","1-2",1,2,"T1",1,3,-1,"A"
2006-08-27,2006,"Sakaryaspor","Fenerbahce","2-1",2,1,"T1",1,3,1,"H"
2006-08-27,2006,"Trabzonspor","Denizlispor","1-0",1,0,"T1",1,1,1,"H"
2006-09-09,2006,"Denizlispor","Galatasaray","1-1",1,1,"T1",1,2,0,"D"
2006-09-09,2006,"Fenerbahce","Antalyaspor","4-2",4,2,"T1",1,6,2,"H"
2006-09-09,2006,"Kayserispor","Genclerbirligi","0-0",0,0,"T1",1,0,0,"D"
2006-09-10,2006,"Ankaraspor","Rizespor","2-1",2,1,"T1",1,3,1,"H"
2006-09-10,2006,"Besiktas","Trabzonspor","2-3",2,3,"T1",1,5,-1,"A"
2006-09-10,2006,"Bursaspor","Sakaryaspor","3-1",3,1,"T1",1,4,2,"H"
2006-09-10,2006,"Gaziantepspor","Ankaragucu","2-2",2,2,"T1",1,4,0,"D"
2006-09-10,2006,"Konyaspor","Sivasspor","2-0",2,0,"T1",1,2,2,"H"
2006-09-10,2006,"Manisaspor","Erciyesspor","5-1",5,1,"T1",1,6,4,"H"
2006-09-15,2006,"Genclerbirligi","Manisaspor","0-5",0,5,"T1",1,5,-5,"A"
2006-09-16,2006,"Ankaragucu","Denizlispor","0-0",0,0,"T1",1,0,0,"D"
2006-09-16,2006,"Antalyaspor","Bursaspor","3-2",3,2,"T1",1,5,1,"H"
2006-09-16,2006,"Sakaryaspor","Ankaraspor","0-0",0,0,"T1",1,0,0,"D"
2006-09-17,2006,"Erciyesspor","Gaziantepspor","1-1",1,1,"T1",1,2,0,"D"
2006-09-17,2006,"Galatasaray","Besiktas","1-0",1,0,"T1",1,1,1,"H"
2006-09-17,2006,"Rizespor","Kayserispor","2-1",2,1,"T1",1,3,1,"H"
2006-09-17,2006,"Sivasspor","Fenerbahce","1-1",1,1,"T1",1,2,0,"D"
2006-09-17,2006,"Trabzonspor","Konyaspor","1-1",1,1,"T1",1,2,0,"D"
2006-09-22,2006,"Konyaspor","Fenerbahce","0-1",0,1,"T1",1,1,-1,"A"
2006-09-23,2006,"Trabzonspor","Galatasaray","3-1",3,1,"T1",1,4,2,"H"
2006-09-24,2006,"Ankaraspor","Antalyaspor","1-1",1,1,"T1",1,2,0,"D"
2006-09-24,2006,"Besiktas","Ankaragucu","2-1",2,1,"T1",1,3,1,"H"
2006-09-24,2006,"Bursaspor","Sivasspor","1-3",1,3,"T1",1,4,-2,"A"
2006-09-24,2006,"Denizlispor","Erciyesspor","2-1",2,1,"T1",1,3,1,"H"
2006-09-24,2006,"Gaziantepspor","Genclerbirligi","2-0",2,0,"T1",1,2,2,"H"
2006-09-24,2006,"Kayserispor","Sakaryaspor","2-0",2,0,"T1",1,2,2,"H"
2006-09-24,2006,"Manisaspor","Rizespor","2-0",2,0,"T1",1,2,2,"H"
2006-09-30,2006,"Galatasaray","Konyaspor","3-3",3,3,"T1",1,6,0,"D"
2006-09-30,2006,"Genclerbirligi","Denizlispor","3-1",3,1,"T1",1,4,2,"H"
2006-09-30,2006,"Rizespor","Gaziantepspor","2-0",2,0,"T1",1,2,2,"H"
2006-09-30,2006,"Sivasspor","Ankaraspor","0-2",0,2,"T1",1,2,-2,"A"
2006-10-01,2006,"Antalyaspor","Kayserispor","1-0",1,0,"T1",1,1,1,"H"
2006-10-01,2006,"Erciyesspor","Besiktas","1-1",1,1,"T1",1,2,0,"D"
2006-10-01,2006,"Fenerbahce","Bursaspor","0-1",0,1,"T1",1,1,-1,"A"
2006-10-01,2006,"Sakaryaspor","Manisaspor","0-1",0,1,"T1",1,1,-1,"A"
2006-10-02,2006,"Ankaragucu","Trabzonspor","2-2",2,2,"T1",1,4,0,"D"
2006-10-14,2006,"Galatasaray","Ankaragucu","1-1",1,1,"T1",1,2,0,"D"
2006-10-14,2006,"Gaziantepspor","Sakaryaspor","1-0",1,0,"T1",1,1,1,"H"
2006-10-14,2006,"Konyaspor","Bursaspor","1-0",1,0,"T1",1,1,1,"H"
2006-10-14,2006,"Trabzonspor","Erciyesspor","3-1",3,1,"T1",1,4,2,"H"
2006-10-15,2006,"Ankaraspor","Fenerbahce","2-2",2,2,"T1",1,4,0,"D"
2006-10-15,2006,"Besiktas","Genclerbirligi","1-0",1,0,"T1",1,1,1,"H"
2006-10-15,2006,"Denizlispor","Rizespor","2-0",2,0,"T1",1,2,2,"H"
2006-10-15,2006,"Kayserispor","Sivasspor","1-1",1,1,"T1",1,2,0,"D"
2006-10-15,2006,"Manisaspor","Antalyaspor","3-2",3,2,"T1",1,5,1,"H"
2006-10-20,2006,"Genclerbirligi","Trabzonspor","3-0",3,0,"T1",1,3,3,"H"
2006-10-20,2006,"Sivasspor","Manisaspor","3-2",3,2,"T1",1,5,1,"H"
2006-10-21,2006,"Bursaspor","Ankaraspor","0-0",0,0,"T1",1,0,0,"D"
2006-10-21,2006,"Erciyesspor","Galatasaray","1-2",1,2,"T1",1,3,-1,"A"
2006-10-21,2006,"Sakaryaspor","Denizlispor","1-2",1,2,"T1",1,3,-1,"A"
2006-10-22,2006,"Ankaragucu","Konyaspor","2-0",2,0,"T1",1,2,2,"H"
2006-10-22,2006,"Antalyaspor","Gaziantepspor","0-0",0,0,"T1",1,0,0,"D"
2006-10-22,2006,"Fenerbahce","Kayserispor","4-1",4,1,"T1",1,5,3,"H"
2006-10-22,2006,"Rizespor","Besiktas","0-1",0,1,"T1",1,1,-1,"A"
2006-10-28,2006,"Galatasaray","Genclerbirligi","1-0",1,0,"T1",1,1,1,"H"
2006-10-29,2006,"Ankaragucu","Erciyesspor","4-1",4,1,"T1",1,5,3,"H"
2006-10-29,2006,"Besiktas","Sakaryaspor","0-0",0,0,"T1",1,0,0,"D"
2006-10-29,2006,"Denizlispor","Antalyaspor","1-1",1,1,"T1",1,2,0,"D"
2006-10-29,2006,"Gaziantepspor","Sivasspor","1-0",1,0,"T1",1,1,1,"H"
2006-10-29,2006,"Kayserispor","Bursaspor","2-0",2,0,"T1",1,2,2,"H"
2006-10-29,2006,"Konyaspor","Ankaraspor","2-2",2,2,"T1",1,4,0,"D"
2006-10-29,2006,"Manisaspor","Fenerbahce","2-3",2,3,"T1",1,5,-1,"A"
2006-10-30,2006,"Trabzonspor","Rizespor","0-1",0,1,"T1",1,1,-1,"A"
2006-11-03,2006,"Fenerbahce","Gaziantepspor","4-1",4,1,"T1",1,5,3,"H"
2006-11-04,2006,"Ankaraspor","Kayserispor","1-1",1,1,"T1",1,2,0,"D"
2006-11-04,2006,"Erciyesspor","Konyaspor","1-2",1,2,"T1",1,3,-1,"A"
2006-11-04,2006,"Sakaryaspor","Trabzonspor","1-0",1,0,"T1",1,1,1,"H"
2006-11-04,2006,"Sivasspor","Denizlispor","0-2",0,2,"T1",1,2,-2,"A"
2006-11-05,2006,"Antalyaspor","Besiktas","4-4",4,4,"T1",1,8,0,"D"
2006-11-05,2006,"Bursaspor","Manisaspor","4-0",4,0,"T1",1,4,4,"H"
2006-11-05,2006,"Genclerbirligi","Ankaragucu","1-2",1,2,"T1",1,3,-1,"A"
2006-11-05,2006,"Rizespor","Galatasaray","2-1",2,1,"T1",1,3,1,"H"
2006-11-10,2006,"Denizlispor","Fenerbahce","0-0",0,0,"T1",1,0,0,"D"
2006-11-11,2006,"Besiktas","Sivasspor","0-1",0,1,"T1",1,1,-1,"A"
2006-11-12,2006,"Ankaragucu","Rizespor","2-0",2,0,"T1",1,2,2,"H"
2006-11-12,2006,"Erciyesspor","Genclerbirligi","0-2",0,2,"T1",1,2,-2,"A"
2006-11-12,2006,"Galatasaray","Sakaryaspor","4-0",4,0,"T1",1,4,4,"H"
2006-11-12,2006,"Gaziantepspor","Bursaspor","1-2",1,2,"T1",1,3,-1,"A"
2006-11-12,2006,"Konyaspor","Kayserispor","1-1",1,1,"T1",1,2,0,"D"
2006-11-12,2006,"Manisaspor","Ankaraspor","1-3",1,3,"T1",1,4,-2,"A"
2006-11-12,2006,"Trabzonspor","Antalyaspor","0-0",0,0,"T1",1,0,0,"D"
2006-11-18,2006,"Antalyaspor","Galatasaray","0-1",0,1,"T1",1,1,-1,"A"
2006-11-18,2006,"Genclerbirligi","Konyaspor","4-1",4,1,"T1",1,5,3,"H"
2006-11-18,2006,"Kayserispor","Manisaspor","2-2",2,2,"T1",1,4,0,"D"
2006-11-18,2006,"Sakaryaspor","Ankaragucu","0-0",0,0,"T1",1,0,0,"D"
2006-11-19,2006,"Ankaraspor","Gaziantepspor","2-0",2,0,"T1",1,2,2,"H"
2006-11-19,2006,"Bursaspor","Denizlispor","1-0",1,0,"T1",1,1,1,"H"
2006-11-19,2006,"Fenerbahce","Besiktas","0-0",0,0,"T1",1,0,0,"D"
2006-11-19,2006,"Rizespor","Erciyesspor","0-0",0,0,"T1",1,0,0,"D"
2006-11-19,2006,"Sivasspor","Trabzonspor","1-0",1,0,"T1",1,1,1,"H"
2006-11-24,2006,"Besiktas","Bursaspor","3-1",3,1,"T1",1,4,2,"H"
2006-11-25,2006,"Denizlispor","Ankaraspor","1-1",1,1,"T1",1,2,0,"D"
2006-11-25,2006,"Galatasaray","Sivasspor","3-1",3,1,"T1",1,4,2,"H"
2006-11-25,2006,"Gaziantepspor","Kayserispor","1-2",1,2,"T1",1,3,-1,"A"
2006-11-25,2006,"Manisaspor","Konyaspor","0-1",0,1,"T1",1,1,-1,"A"
2006-11-26,2006,"Ankaragucu","Antalyaspor","1-0",1,0,"T1",1,1,1,"H"
2006-11-26,2006,"Erciyesspor","Sakaryaspor","2-0",2,0,"T1",1,2,2,"H"
2006-11-26,2006,"Rizespor","Genclerbirligi","0-1",0,1,"T1",1,1,-1,"A"
2006-11-26,2006,"Trabzonspor","Fenerbahce","1-2",1,2,"T1",1,3,-1,"A"
2006-12-01,2006,"Bursaspor","Trabzonspor","2-1",2,1,"T1",1,3,1,"H"
2006-12-02,2006,"Ankaraspor","Besiktas","0-0",0,0,"T1",1,0,0,"D"
2006-12-02,2006,"Kayserispor","Denizlispor","1-0",1,0,"T1",1,1,1,"H"
2006-12-02,2006,"Konyaspor","Rizespor","2-0",2,0,"T1",1,2,2,"H"
2006-12-02,2006,"Sivasspor","Ankaragucu","2-1",2,1,"T1",1,3,1,"H"
2006-12-03,2006,"Antalyaspor","Erciyesspor","3-1",3,1,"T1",1,4,2,"H"
2006-12-03,2006,"Fenerbahce","Galatasaray","2-1",2,1,"T1",1,3,1,"H"
2006-12-03,2006,"Manisaspor","Gaziantepspor","4-1",4,1,"T1",1,5,3,"H"
2006-12-03,2006,"Sakaryaspor","Genclerbirligi","1-1",1,1,"T1",1,2,0,"D"
2006-12-08,2006,"Ankaragucu","Fenerbahce","0-1",0,1,"T1",1,1,-1,"A"
2006-12-09,2006,"Besiktas","Kayserispor","2-1",2,1,"T1",1,3,1,"H"
2006-12-09,2006,"Erciyesspor","Sivasspor","0-0",0,0,"T1",1,0,0,"D"
2006-12-09,2006,"Rizespor","Sakaryaspor","3-1",3,1,"T1",1,4,2,"H"
2006-12-10,2006,"Denizlispor","Manisaspor","0-0",0,0,"T1",1,0,0,"D"
2006-12-10,2006,"Galatasaray","Bursaspor","3-1",3,1,"T1",1,4,2,"H"
2006-12-10,2006,"Gaziantepspor","Konyaspor","1-0",1,0,"T1",1,1,1,"H"
2006-12-10,2006,"Genclerbirligi","Antalyaspor","1-0",1,0,"T1",1,1,1,"H"
2006-12-10,2006,"Trabzonspor","Ankaraspor","3-0",3,0,"T1",1,3,3,"H"
2007-08-10,2007,"Buyuksehyr","Fenerbahce","2-0",2,0,"T1",1,2,2,"H"
2007-08-11,2007,"Ankaraspor","Ankaragucu","1-2",1,2,"T1",1,3,-1,"A"
2007-08-11,2007,"Besiktas","Konyaspor","1-0",1,0,"T1",1,1,1,"H"
2007-08-12,2007,"Denizlispor","Bursaspor","0-0",0,0,"T1",1,0,0,"D"
2007-08-12,2007,"Galatasaray","Rizespor","4-0",4,0,"T1",1,4,4,"H"
2007-08-12,2007,"Gaziantepspor","Kasimpasa","2-0",2,0,"T1",1,2,2,"H"
2007-08-12,2007,"Genclerbirligi","Oftasspor","1-2",1,2,"T1",1,3,-1,"A"
2007-08-12,2007,"Kayserispor","Manisaspor","3-1",3,1,"T1",1,4,2,"H"
2007-08-12,2007,"Trabzonspor","Sivasspor","0-3",0,3,"T1",1,3,-3,"A"
2007-08-17,2007,"Oftasspor","Trabzonspor","0-2",0,2,"T1",1,2,-2,"A"
2007-08-18,2007,"Fenerbahce","Gaziantepspor","2-1",2,1,"T1",1,3,1,"H"
2007-08-19,2007,"Ankaragucu","Denizlispor","3-2",3,2,"T1",1,5,1,"H"
2007-08-19,2007,"Bursaspor","Galatasaray","0-1",0,1,"T1",1,1,-1,"A"
2007-08-19,2007,"Kasimpasa","Besiktas","1-2",1,2,"T1",1,3,-1,"A"
2007-08-19,2007,"Konyaspor","Kayserispor","1-1",1,1,"T1",1,2,0,"D"
2007-08-19,2007,"Manisaspor","Ankaraspor","2-1",2,1,"T1",1,3,1,"H"
2007-08-19,2007,"Rizespor","Genclerbirligi","0-2",0,2,"T1",1,2,-2,"A"
2007-08-19,2007,"Sivasspor","Buyuksehyr","2-1",2,1,"T1",1,3,1,"H"
2007-08-25,2007,"Fenerbahce","Sivasspor","1-0",1,0,"T1",1,1,1,"H"
2007-08-25,2007,"Gaziantepspor","Besiktas","0-1",0,1,"T1",1,1,-1,"A"
2007-08-25,2007,"Genclerbirligi","Bursaspor","1-3",1,3,"T1",1,4,-2,"A"
2007-08-26,2007,"Ankaraspor","Konyaspor","1-1",1,1,"T1",1,2,0,"D"
2007-08-26,2007,"Buyuksehyr","Oftasspor","1-0",1,0,"T1",1,1,1,"H"
2007-08-26,2007,"Denizlispor","Manisaspor","3-2",3,2,"T1",1,5,1,"H"
2007-08-26,2007,"Galatasaray","Ankaragucu","1-0",1,0,"T1",1,1,1,"H"
2007-08-26,2007,"Kayserispor","Kasimpasa","2-0",2,0,"T1",1,2,2,"H"
2007-08-26,2007,"Trabzonspor","Rizespor","5-1",5,1,"T1",1,6,4,"H"
2007-08-31,2007,"Bursaspor","Trabzonspor","1-1",1,1,"T1",1,2,0,"D"
2007-09-01,2007,"Ankaragucu","Genclerbirligi","2-2",2,2,"T1",1,4,0,"D"
2007-09-01,2007,"Besiktas","Kayserispor","0-0",0,0,"T1",1,0,0,"D"
2007-09-01,2007,"Konyaspor","Denizlispor","2-2",2,2,"T1",1,4,0,"D"
2007-09-01,2007,"Rizespor","Buyuksehyr","3-1",3,1,"T1",1,4,2,"H"
2007-09-02,2007,"Kasimpasa","Ankaraspor","3-1",3,1,"T1",1,4,2,"H"
2007-09-02,2007,"Manisaspor","Galatasaray","2-2",2,2,"T1",1,4,0,"D"
2007-09-02,2007,"Oftasspor","Fenerbahce","1-1",1,1,"T1",1,2,0,"D"
2007-09-02,2007,"Sivasspor","Gaziantepspor","2-0",2,0,"T1",1,2,2,"H"
2007-09-15,2007,"Ankaraspor","Besiktas","0-0",0,0,"T1",1,0,0,"D"
2007-09-15,2007,"Denizlispor","Kasimpasa","0-1",0,1,"T1",1,1,-1,"A"
2007-09-15,2007,"Fenerbahce","Rizespor","1-1",1,1,"T1",1,2,0,"D"
2007-09-15,2007,"Sivasspor","Oftasspor","1-0",1,0,"T1",1,1,1,"H"
2007-09-16,2007,"Buyuksehyr","Bursaspor","1-0",1,0,"T1",1,1,1,"H"
2007-09-16,2007,"Galatasaray","Konyaspor","6-0",6,0,"T1",1,6,6,"H"
2007-09-16,2007,"Gaziantepspor","Kayserispor","4-3",4,3,"T1",1,7,1,"H"
2007-09-16,2007,"Genclerbirligi","Manisaspor","0-2",0,2,"T1",1,2,-2,"A"
2007-09-16,2007,"Trabzonspor","Ankaragucu","0-0",0,0,"T1",1,0,0,"D"
2007-09-21,2007,"Ankaragucu","Buyuksehyr","1-0",1,0,"T1",1,1,1,"H"
2007-09-21,2007,"Manisaspor","Trabzonspor","1-1",1,1,"T1",1,2,0,"D"
2007-09-22,2007,"Besiktas","Denizlispor","3-2",3,2,"T1",1,5,1,"H"
2007-09-22,2007,"Kayserispor","Ankaraspor","3-1",3,1,"T1",1,4,2,"H"
2007-09-22,2007,"Konyaspor","Genclerbirligi","1-1",1,1,"T1",1,2,0,"D"
2007-09-23,2007,"Bursaspor","Fenerbahce","1-1",1,1,"T1",1,2,0,"D"
2007-09-23,2007,"Kasimpasa","Galatasaray","0-1",0,1,"T1",1,1,-1,"A"
2007-09-23,2007,"Oftasspor","Gaziantepspor","1-2",1,2,"T1",1,3,-1,"A"
2007-09-23,2007,"Rizespor","Sivasspor","0-2",0,2,"T1",1,2,-2,"A"
2007-09-28,2007,"Fenerbahce","Ankaragucu","2-0",2,0,"T1",1,2,2,"H"
2007-09-29,2007,"Galatasaray","Besiktas","2-1",2,1,"T1",1,3,1,"H"
2007-09-29,2007,"Oftasspor","Rizespor","2-0",2,0,"T1",1,2,2,"H"
2007-09-30,2007,"Buyuksehyr","Manisaspor","4-1",4,1,"T1",1,5,3,"H"
2007-09-30,2007,"Denizlispor","Kayserispor","2-0",2,0,"T1",1,2,2,"H"
2007-09-30,2007,"Gaziantepspor","Ankaraspor","1-0",1,0,"T1",1,1,1,"H"
2007-09-30,2007,"Genclerbirligi","Kasimpasa","3-1",3,1,"T1",1,4,2,"H"
2007-09-30,2007,"Sivasspor","Bursaspor","3-2",3,2,"T1",1,5,1,"H"
2007-09-30,2007,"Trabzonspor","Konyaspor","1-0",1,0,"T1",1,1,1,"H"
2007-10-05,2007,"Kasimpasa","Trabzonspor","0-0",0,0,"T1",1,0,0,"D"
2007-10-06,2007,"Ankaraspor","Denizlispor","0-0",0,0,"T1",1,0,0,"D"
2007-10-06,2007,"Bursaspor","Oftasspor","1-1",1,1,"T1",1,2,0,"D"
2007-10-06,2007,"Manisaspor","Fenerbahce","1-1",1,1,"T1",1,2,0,"D"
2007-10-07,2007,"Ankaragucu","Sivasspor","2-2",2,2,"T1",1,4,0,"D"
2007-10-07,2007,"Besiktas","Genclerbirligi","1-0",1,0,"T1",1,1,1,"H"
2007-10-07,2007,"Kayserispor","Galatasaray","1-1",1,1,"T1",1,2,0,"D"
2007-10-07,2007,"Konyaspor","Buyuksehyr","3-2",3,2,"T1",1,5,1,"H"
2007-10-07,2007,"Rizespor","Gaziantepspor","2-1",2,1,"T1",1,3,1,"H"
2007-10-20,2007,"Buyuksehyr","Kasimpasa","2-0",2,0,"T1",1,2,2,"H"
2007-10-20,2007,"Fenerbahce","Konyaspor","4-1",4,1,"T1",1,5,3,"H"
2007-10-20,2007,"Gaziantepspor","Denizlispor","1-2",1,2,"T1",1,3,-1,"A"
2007-10-20,2007,"Genclerbirligi","Kayserispor","1-1",1,1,"T1",1,2,0,"D"
2007-10-20,2007,"Rizespor","Bursaspor","2-0",2,0,"T1",1,2,2,"H"
2007-10-20,2007,"Trabzonspor","Besiktas","2-3",2,3,"T1",1,5,-1,"A"
2007-10-21,2007,"Galatasaray","Ankaraspor","0-0",0,0,"T1",1,0,0,"D"
2007-10-22,2007,"Oftasspor","Ankaragucu","2-1",2,1,"T1",1,3,1,"H"
2007-10-22,2007,"Sivasspor","Manisaspor","1-0",1,0,"T1",1,1,1,"H"
2007-10-26,2007,"Kayserispor","Trabzonspor","1-0",1,0,"T1",1,1,1,"H"
2007-10-27,2007,"Ankaraspor","Genclerbirligi","2-0",2,0,"T1",1,2,2,"H"
2007-10-27,2007,"Bursaspor","Gaziantepspor","1-1",1,1,"T1",1,2,0,"D"
2007-10-27,2007,"Kasimpasa","Fenerbahce","1-2",1,2,"T1",1,3,-1,"A"
2007-10-27,2007,"Manisaspor","Oftasspor","0-2",0,2,"T1",1,2,-2,"A"
2007-10-28,2007,"Ankaragucu","Rizespor","1-0",1,0,"T1",1,1,1,"H"
2007-10-28,2007,"Besiktas","Buyuksehyr","0-0",0,0,"T1",1,0,0,"D"
2007-10-28,2007,"Denizlispor","Galatasaray","1-2",1,2,"T1",1,3,-1,"A"
2007-10-28,2007,"Konyaspor","Sivasspor","2-1",2,1,"T1",1,3,1,"H"
2007-11-02,2007,"Trabzonspor","Ankaraspor","2-1",2,1,"T1",1,3,1,"H"
2007-11-03,2007,"Fenerbahce","Besiktas","2-1",2,1,"T1",1,3,1,"H"
2007-11-03,2007,"Oftasspor","Konyaspor","0-1",0,1,"T1",1,1,-1,"A"
2007-11-04,2007,"Bursaspor","Ankaragucu","2-1",2,1,"T1",1,3,1,"H"
2007-11-04,2007,"Buyuksehyr","Kayserispor","1-1",1,1,"T1",1,2,0,"D"
2007-11-04,2007,"Gaziantepspor","Galatasaray","1-1",1,1,"T1",1,2,0,"D"
2007-11-04,2007,"Genclerbirligi","Denizlispor","1-2",1,2,"T1",1,3,-1,"A"
2007-11-04,2007,"Rizespor","Manisaspor","1-4",1,4,"T1",1,5,-3,"A"
2007-11-04,2007,"Sivasspor","Kasimpasa","4-0",4,0,"T1",1,4,4,"H"
2007-11-09,2007,"Denizlispor","Trabzonspor","2-0",2,0,"T1",1,2,2,"H"
2007-11-10,2007,"Ankaragucu","Gaziantepspor","1-0",1,0,"T1",1,1,1,"H"
2007-11-10,2007,"Ankaraspor","Buyuksehyr","1-1",1,1,"T1",1,2,0,"D"
2007-11-10,2007,"Besiktas","Sivasspor","1-2",1,2,"T1",1,3,-1,"A"
2007-11-10,2007,"Kasimpasa","Oftasspor","1-3",1,3,"T1",1,4,-2,"A"
2007-11-10,2007,"Konyaspor","Rizespor","2-1",2,1,"T1",1,3,1,"H"
2007-11-10,2007,"Manisaspor","Bursaspor","1-1",1,1,"T1",1,2,0,"D"
2007-11-11,2007,"Galatasaray","Genclerbirligi","3-2",3,2,"T1",1,5,1,"H"
2007-11-11,2007,"Kayserispor","Fenerbahce","2-1",2,1,"T1",1,3,1,"H"
2007-11-24,2007,"Buyuksehyr","Denizlispor","0-2",0,2,"T1",1,2,-2,"A"
2007-11-24,2007,"Fenerbahce","Ankaraspor","4-2",4,2,"T1",1,6,2,"H"
2007-11-24,2007,"Oftasspor","Besiktas","0-1",0,1,"T1",1,1,-1,"A"
2007-11-25,2007,"Ankaragucu","Manisaspor","1-0",1,0,"T1",1,1,1,"H"
2007-11-25,2007,"Bursaspor","Konyaspor","1-0",1,0,"T1",1,1,1,"H"
2007-11-25,2007,"Gaziantepspor","Genclerbirligi","2-2",2,2,"T1",1,4,0,"D"
2007-11-25,2007,"Rizespor","Kasimpasa","2-0",2,0,"T1",1,2,2,"H"
2007-11-25,2007,"Sivasspor","Kayserispor","1-0",1,0,"T1",1,1,1,"H"
2007-11-25,2007,"Trabzonspor","Galatasaray","0-1",0,1,"T1",1,1,-1,"A"
2007-11-30,2007,"Genclerbirligi","Trabzonspor","2-1",2,1,"T1",1,3,1,"H"
2007-12-01,2007,"Denizlispor","Fenerbahce","0-1",0,1,"T1",1,1,-1,"A"
2007-12-01,2007,"Kasimpasa","Bursaspor","0-2",0,2,"T1",1,2,-2,"A"
2007-12-01,2007,"Konyaspor","Ankaragucu","1-0",1,0,"T1",1,1,1,"H"
2007-12-02,2007,"Ankaraspor","Sivasspor","2-0",2,0,"T1",1,2,2,"H"
2007-12-02,2007,"Besiktas","Rizespor","1-1",1,1,"T1",1,2,0,"D"
2007-12-02,2007,"Galatasaray","Buyuksehyr","2-2",2,2,"T1",1,4,0,"D"
2007-12-02,2007,"Kayserispor","Oftasspor","1-1",1,1,"T1",1,2,0,"D"
2007-12-02,2007,"Manisaspor","Gaziantepspor","1-0",1,0,"T1",1,1,1,"H"
2007-12-07,2007,"Bursaspor","Besiktas","0-1",0,1,"T1",1,1,-1,"A"
2007-12-08,2007,"Ankaragucu","Kasimpasa","2-2",2,2,"T1",1,4,0,"D"
2007-12-08,2007,"Fenerbahce","Galatasaray","2-0",2,0,"T1",1,2,2,"H"
2007-12-08,2007,"Rizespor","Kayserispor","0-0",0,0,"T1",1,0,0,"D"
2007-12-09,2007,"Buyuksehyr","Genclerbirligi","0-0",0,0,"T1",1,0,0,"D"
2007-12-09,2007,"Konyaspor","Manisaspor","4-2",4,2,"T1",1,6,2,"H"
2007-12-09,2007,"Oftasspor","Ankaraspor","0-0",0,0,"T1",1,0,0,"D"
2007-12-09,2007,"Sivasspor","Denizlispor","2-0",2,0,"T1",1,2,2,"H"
2007-12-09,2007,"Trabzonspor","Gaziantepspor","3-2",3,2,"T1",1,5,1,"H"
2007-12-14,2007,"Galatasaray","Sivasspor","2-0",2,0,"T1",1,2,2,"H"
2007-12-15,2007,"Ankaraspor","Rizespor","1-2",1,2,"T1",1,3,-1,"A"
2007-12-15,2007,"Gaziantepspor","Konyaspor","2-1",2,1,"T1",1,3,1,"H"
2007-12-15,2007,"Trabzonspor","Buyuksehyr","2-1",2,1,"T1",1,3,1,"H"
2007-12-16,2007,"Besiktas","Ankaragucu","3-1",3,1,"T1",1,4,2,"H"
2007-12-16,2007,"Denizlispor","Oftasspor","2-1",2,1,"T1",1,3,1,"H"
2007-12-16,2007,"Genclerbirligi","Fenerbahce","1-2",1,2,"T1",1,3,-1,"A"
2007-12-16,2007,"Kasimpasa","Manisaspor","2-2",2,2,"T1",1,4,0,"D"
2007-12-16,2007,"Kayserispor","Bursaspor","4-1",4,1,"T1",1,5,3,"H"
2007-12-21,2007,"Manisaspor","Besiktas","1-2",1,2,"T1",1,3,-1,"A"
2007-12-22,2007,"Ankaragucu","Kayserispor","1-1",1,1,"T1",1,2,0,"D"
2007-12-22,2007,"Fenerbahce","Trabzonspor","3-2",3,2,"T1",1,5,1,"H"
2007-12-22,2007,"Konyaspor","Kasimpasa","2-1",2,1,"T1",1,3,1,"H"
2007-12-23,2007,"Bursaspor","Ankaraspor","0-0",0,0,"T1",1,0,0,"D"
2007-12-23,2007,"Buyuksehyr","Gaziantepspor","1-2",1,2,"T1",1,3,-1,"A"
2007-12-23,2007,"Oftasspor","Galatasaray","0-0",0,0,"T1",1,0,0,"D"
2007-12-23,2007,"Rizespor","Denizlispor","2-0",2,0,"T1",1,2,2,"H"
2007-12-23,2007,"Sivasspor","Genclerbirligi","2-0",2,0,"T1",1,2,2,"H"
2008-01-12,2007,"Kasimpasa","Gaziantepspor","0-1",0,1,"T1",1,1,-1,"A"
2008-01-12,2007,"Konyaspor","Besiktas","1-2",1,2,"T1",1,3,-1,"A"
2008-01-12,2007,"Oftasspor","Genclerbirligi","1-1",1,1,"T1",1,2,0,"D"
2008-01-12,2007,"Rizespor","Galatasaray","2-5",2,5,"T1",1,7,-3,"A"
2008-01-13,2007,"Ankaragucu","Ankaraspor","1-1",1,1,"T1",1,2,0,"D"
2008-01-13,2007,"Bursaspor","Denizlispor","1-1",1,1,"T1",1,2,0,"D"
2008-01-13,2007,"Fenerbahce","Buyuksehyr","2-2",2,2,"T1",1,4,0,"D"
2008-01-13,2007,"Manisaspor","Kayserispor","0-1",0,1,"T1",1,1,-1,"A"
2008-01-13,2007,"Sivasspor","Trabzonspor","2-0",2,0,"T1",1,2,2,"H"
2008-01-19,2007,"Besiktas","Kasimpasa","4-2",4,2,"T1",1,6,2,"H"
2008-01-19,2007,"Buyuksehyr","Sivasspor","0-2",0,2,"T1",1,2,-2,"A"
2008-01-19,2007,"Trabzonspor","Oftasspor","1-2",1,2,"T1",1,3,-1,"A"
2008-01-20,2007,"Ankaraspor","Manisaspor","1-0",1,0,"T1",1,1,1,"H"
2008-01-20,2007,"Denizlispor","Ankaragucu","1-1",1,1,"T1",1,2,0,"D"
2008-01-20,2007,"Galatasaray","Bursaspor","1-0",1,0,"T1",1,1,1,"H"
2008-01-20,2007,"Gaziantepspor","Fenerbahce","0-5",0,5,"T1",1,5,-5,"A"
2008-01-20,2007,"Genclerbirligi","Rizespor","4-1",4,1,"T1",1,5,3,"H"
2008-01-20,2007,"Kayserispor","Konyaspor","3-0",3,0,"T1",1,3,3,"H"
2008-01-26,2007,"Besiktas","Gaziantepspor","3-1",3,1,"T1",1,4,2,"H"
2008-01-26,2007,"Oftasspor","Buyuksehyr","3-2",3,2,"T1",1,5,1,"H"
2008-01-27,2007,"Ankaragucu","Galatasaray","0-4",0,4,"T1",1,4,-4,"A"
2008-01-27,2007,"Kasimpasa","Kayserispor","0-2",0,2,"T1",1,2,-2,"A"
2008-01-27,2007,"Konyaspor","Ankaraspor","1-3",1,3,"T1",1,4,-2,"A"
2008-01-27,2007,"Manisaspor","Denizlispor","3-2",3,2,"T1",1,5,1,"H"
2008-01-27,2007,"Sivasspor","Fenerbahce","1-4",1,4,"T1",1,5,-3,"A"
2008-01-28,2007,"Bursaspor","Genclerbirligi","2-1",2,1,"T1",1,3,1,"H"
2008-01-28,2007,"Rizespor","Trabzonspor","0-4",0,4,"T1",1,4,-4,"A"
2008-02-09,2007,"Ankaraspor","Kasimpasa","2-0",2,0,"T1",1,2,2,"H"
2008-02-09,2007,"Buyuksehyr","Rizespor","2-1",2,1,"T1",1,3,1,"H"
2008-02-09,2007,"Galatasaray","Manisaspor","6-3",6,3,"T1",1,9,3,"H"
2008-02-09,2007,"Kayserispor","Besiktas","2-0",2,0,"T1",1,2,2,"H"
2008-02-10,2007,"Denizlispor","Konyaspor","2-1",2,1,"T1",1,3,1,"H"
2008-02-10,2007,"Fenerbahce","Oftasspor","3-1",3,1,"T1",1,4,2,"H"
2008-02-10,2007,"Gaziantepspor","Sivasspor","0-0",0,0,"T1",1,0,0,"D"
2008-02-10,2007,"Genclerbirligi","Ankaragucu","1-0",1,0,"T1",1,1,1,"H"
2008-02-10,2007,"Trabzonspor","Bursaspor","2-1",2,1,"T1",1,3,1,"H"
2008-02-15,2007,"Rizespor","Fenerbahce","2-4",2,4,"T1",1,6,-2,"A"
2008-02-16,2007,"Besiktas","Ankaraspor","3-2",3,2,"T1",1,5,1,"H"
2008-02-16,2007,"Bursaspor","Buyuksehyr","2-2",2,2,"T1",1,4,0,"D"
2008-02-16,2007,"Oftasspor","Sivasspor","0-1",0,1,"T1",1,1,-1,"A"
2008-02-17,2007,"Ankaragucu","Trabzonspor","0-2",0,2,"T1",1,2,-2,"A"
2008-02-17,2007,"Kasimpasa","Denizlispor","1-0",1,0,"T1",1,1,1,"H"
2008-02-17,2007,"Kayserispor","Gaziantepspor","3-1",3,1,"T1",1,4,2,"H"
2008-02-17,2007,"Manisaspor","Genclerbirligi","1-2",1,2,"T1",1,3,-1,"A"
2008-02-17,2007,"Konyaspor","Galatasaray","0-1",0,1,"T1",1,1,-1,"A"
2008-02-22,2007,"Denizlispor","Besiktas","1-2",1,2,"T1",1,3,-1,"A"
2008-02-23,2007,"Fenerbahce","Bursaspor","0-2",0,2,"T1",1,2,-2,"A"
2008-02-23,2007,"Gaziantepspor","Oftasspor","1-1",1,1,"T1",1,2,0,"D"
2008-02-23,2007,"Genclerbirligi","Konyaspor","6-1",6,1,"T1",1,7,5,"H"
2008-02-24,2007,"Ankaraspor","Kayserispor","0-3",0,3,"T1",1,3,-3,"A"
2008-02-24,2007,"Buyuksehyr","Ankaragucu","1-2",1,2,"T1",1,3,-1,"A"
2008-02-24,2007,"Galatasaray","Kasimpasa","0-1",0,1,"T1",1,1,-1,"A"
2008-02-24,2007,"Sivasspor","Rizespor","0-0",0,0,"T1",1,0,0,"D"
2008-02-24,2007,"Trabzonspor","Manisaspor","2-2",2,2,"T1",1,4,0,"D"
2008-02-29,2007,"Konyaspor","Trabzonspor","1-0",1,0,"T1",1,1,1,"H"
2008-03-01,2007,"Ankaragucu","Fenerbahce","0-0",0,0,"T1",1,0,0,"D"
2008-03-01,2007,"Kasimpasa","Genclerbirligi","0-0",0,0,"T1",1,0,0,"D"
2008-03-01,2007,"Manisaspor","Buyuksehyr","1-1",1,1,"T1",1,2,0,"D"
2008-03-02,2007,"Ankaraspor","Gaziantepspor","1-1",1,1,"T1",1,2,0,"D"
2008-03-02,2007,"Besiktas","Galatasaray","1-0",1,0,"T1",1,1,1,"H"
2008-03-02,2007,"Bursaspor","Sivasspor","0-1",0,1,"T1",1,1,-1,"A"
2008-03-02,2007,"Kayserispor","Denizlispor","1-1",1,1,"T1",1,2,0,"D"
2008-03-02,2007,"Rizespor","Oftasspor","0-0",0,0,"T1",1,0,0,"D"
2008-03-07,2007,"Genclerbirligi","Besiktas","1-2",1,2,"T1",1,3,-1,"A"
2008-03-08,2007,"Buyuksehyr","Konyaspor","5-0",5,0,"T1",1,5,5,"H"
2008-03-08,2007,"Denizlispor","Ankaraspor","1-0",1,0,"T1",1,1,1,"H"
2008-03-08,2007,"Galatasaray","Kayserispor","2-0",2,0,"T1",1,2,2,"H"
2008-03-09,2007,"Fenerbahce","Manisaspor","4-1",4,1,"T1",1,5,3,"H"
2008-03-09,2007,"Gaziantepspor","Rizespor","1-1",1,1,"T1",1,2,0,"D"
2008-03-09,2007,"Oftasspor","Bursaspor","2-2",2,2,"T1",1,4,0,"D"
2008-03-09,2007,"Sivasspor","Ankaragucu","3-2",3,2,"T1",1,5,1,"H"
2008-03-09,2007,"Trabzonspor","Kasimpasa","2-1",2,1,"T1",1,3,1,"H"
2008-03-14,2007,"Manisaspor","Sivasspor","1-1",1,1,"T1",1,2,0,"D"
2008-03-15,2007,"Ankaraspor","Galatasaray","0-1",0,1,"T1",1,1,-1,"A"
2008-03-15,2007,"Bursaspor","Rizespor","2-1",2,1,"T1",1,3,1,"H"
2008-03-15,2007,"Kayserispor","Genclerbirligi","3-0",3,0,"T1",1,3,3,"H"
2008-03-16,2007,"Ankaragucu","Oftasspor","2-0",2,0,"T1",1,2,2,"H"
2008-03-16,2007,"Besiktas","Trabzonspor","3-0",3,0,"T1",1,3,3,"H"
2008-03-16,2007,"Denizlispor","Gaziantepspor","2-1",2,1,"T1",1,3,1,"H"
2008-03-16,2007,"Kasimpasa","Buyuksehyr","1-0",1,0,"T1",1,1,1,"H"
2008-03-16,2007,"Konyaspor","Fenerbahce","1-4",1,4,"T1",1,5,-3,"A"
2008-03-21,2007,"Fenerbahce","Kasimpasa","3-0",3,0,"T1",1,3,3,"H"
2008-03-22,2007,"Buyuksehyr","Besiktas","2-1",2,1,"T1",1,3,1,"H"
2008-03-22,2007,"Gaziantepspor","Bursaspor","1-0",1,0,"T1",1,1,1,"H"
2008-03-22,2007,"Oftasspor","Manisaspor","1-0",1,0,"T1",1,1,1,"H"
2008-03-23,2007,"Galatasaray","Denizlispor","2-1",2,1,"T1",1,3,1,"H"
2008-03-23,2007,"Genclerbirligi","Ankaraspor","1-3",1,3,"T1",1,4,-2,"A"
2008-03-23,2007,"Rizespor","Ankaragucu","0-0",0,0,"T1",1,0,0,"D"
2008-03-23,2007,"Sivasspor","Konyaspor","3-0",3,0,"T1",1,3,3,"H"
2008-03-23,2007,"Trabzonspor","Kayserispor","2-1",2,1,"T1",1,3,1,"H"
2008-03-29,2007,"Ankaraspor","Trabzonspor","1-0",1,0,"T1",1,1,1,"H"
2008-03-29,2007,"Besiktas","Fenerbahce","1-2",1,2,"T1",1,3,-1,"A"
2008-03-29,2007,"Denizlispor","Genclerbirligi","3-2",3,2,"T1",1,5,1,"H"
2008-03-30,2007,"Ankaragucu","Bursaspor","2-0",2,0,"T1",1,2,2,"H"
2008-03-30,2007,"Galatasaray","Gaziantepspor","0-0",0,0,"T1",1,0,0,"D"
2008-03-30,2007,"Kasimpasa","Sivasspor","0-4",0,4,"T1",1,4,-4,"A"
2008-03-30,2007,"Kayserispor","Buyuksehyr","1-2",1,2,"T1",1,3,-1,"A"
2008-03-30,2007,"Konyaspor","Oftasspor","0-1",0,1,"T1",1,1,-1,"A"
2008-03-30,2007,"Manisaspor","Rizespor","2-1",2,1,"T1",1,3,1,"H"
2008-04-04,2007,"Trabzonspor","Denizlispor","2-0",2,0,"T1",1,2,2,"H"
2008-04-05,2007,"Fenerbahce","Kayserispor","2-1",2,1,"T1",1,3,1,"H"
2008-04-05,2007,"Oftasspor","Kasimpasa","0-1",0,1,"T1",1,1,-1,"A"
2008-04-06,2007,"Bursaspor","Manisaspor","1-0",1,0,"T1",1,1,1,"H"
2008-04-06,2007,"Buyuksehyr","Ankaraspor","0-1",0,1,"T1",1,1,-1,"A"
2008-04-06,2007,"Gaziantepspor","Ankaragucu","2-1",2,1,"T1",1,3,1,"H"
2008-04-06,2007,"Genclerbirligi","Galatasaray","0-1",0,1,"T1",1,1,-1,"A"
2008-04-06,2007,"Rizespor","Konyaspor","2-2",2,2,"T1",1,4,0,"D"
2008-04-06,2007,"Sivasspor","Besiktas","1-2",1,2,"T1",1,3,-1,"A"
2008-04-11,2007,"Besiktas","Oftasspor","0-1",0,1,"T1",1,1,-1,"A"
2008-04-12,2007,"Denizlispor","Buyuksehyr","2-3",2,3,"T1",1,5,-1,"A"
2008-04-12,2007,"Galatasaray","Trabzonspor","1-0",1,0,"T1",1,1,1,"H"
2008-04-12,2007,"Genclerbirligi","Gaziantepspor","2-0",2,0,"T1",1,2,2,"H"
2008-04-13,2007,"Ankaraspor","Fenerbahce","2-2",2,2,"T1",1,4,0,"D"
2008-04-13,2007,"Kasimpasa","Rizespor","0-1",0,1,"T1",1,1,-1,"A"
2008-04-13,2007,"Kayserispor","Sivasspor","0-1",0,1,"T1",1,1,-1,"A"
2008-04-13,2007,"Konyaspor","Bursaspor","2-0",2,0,"T1",1,2,2,"H"
2008-04-13,2007,"Manisaspor","Ankaragucu","1-2",1,2,"T1",1,3,-1,"A"
2008-04-19,2007,"Ankaragucu","Konyaspor","0-3",0,3,"T1",1,3,-3,"A"
2008-04-19,2007,"Bursaspor","Kasimpasa","1-0",1,0,"T1",1,1,1,"H"
2008-04-19,2007,"Fenerbahce","Denizlispor","4-1",4,1,"T1",1,5,3,"H"
2008-04-19,2007,"Gaziantepspor","Manisaspor","1-0",1,0,"T1",1,1,1,"H"
2008-04-19,2007,"Sivasspor","Ankaraspor","2-1",2,1,"T1",1,3,1,"H"
2008-04-19,2007,"Trabzonspor","Genclerbirligi","0-0",0,0,"T1",1,0,0,"D"
2008-04-20,2007,"Buyuksehyr","Galatasaray","0-3",0,3,"T1",1,3,-3,"A"
2008-04-20,2007,"Oftasspor","Kayserispor","1-1",1,1,"T1",1,2,0,"D"
2008-04-20,2007,"Rizespor","Besiktas","1-2",1,2,"T1",1,3,-1,"A"
2008-04-26,2007,"Ankaraspor","Oftasspor","1-0",1,0,"T1",1,1,1,"H"
2008-04-26,2007,"Besiktas","Bursaspor","3-0",3,0,"T1",1,3,3,"H"
2008-04-26,2007,"Denizlispor","Sivasspor","1-2",1,2,"T1",1,3,-1,"A"
2008-04-26,2007,"Gaziantepspor","Trabzonspor","1-1",1,1,"T1",1,2,0,"D"
2008-04-26,2007,"Genclerbirligi","Buyuksehyr","2-1",2,1,"T1",1,3,1,"H"
2008-04-26,2007,"Kasimpasa","Ankaragucu","2-2",2,2,"T1",1,4,0,"D"
2008-04-26,2007,"Kayserispor","Rizespor","3-0",3,0,"T1",1,3,3,"H"
2008-04-26,2007,"Manisaspor","Konyaspor","2-0",2,0,"T1",1,2,2,"H"
2008-04-27,2007,"Galatasaray","Fenerbahce","1-0",1,0,"T1",1,1,1,"H"
2008-05-03,2007,"Buyuksehyr","Trabzonspor","1-2",1,2,"T1",1,3,-1,"A"
2008-05-03,2007,"Oftasspor","Denizlispor","0-2",0,2,"T1",1,2,-2,"A"
2008-05-03,2007,"Rizespor","Ankaraspor","0-1",0,1,"T1",1,1,-1,"A"
2008-05-04,2007,"Ankaragucu","Besiktas","0-2",0,2,"T1",1,2,-2,"A"
2008-05-04,2007,"Bursaspor","Kayserispor","0-1",0,1,"T1",1,1,-1,"A"
2008-05-04,2007,"Fenerbahce","Genclerbirligi","3-2",3,2,"T1",1,5,1,"H"
2008-05-04,2007,"Konyaspor","Gaziantepspor","1-1",1,1,"T1",1,2,0,"D"
2008-05-04,2007,"Manisaspor","Kasimpasa","1-2",1,2,"T1",1,3,-1,"A"
2008-05-04,2007,"Sivasspor","Galatasaray","3-5",3,5,"T1",1,8,-2,"A"
2008-05-10,2007,"Ankaraspor","Bursaspor","1-1",1,1,"T1",1,2,0,"D"
2008-05-10,2007,"Besiktas","Manisaspor","5-1",5,1,"T1",1,6,4,"H"
2008-05-10,2007,"Denizlispor","Rizespor","5-1",5,1,"T1",1,6,4,"H"
2008-05-10,2007,"Galatasaray","Oftasspor","2-0",2,0,"T1",1,2,2,"H"
2008-05-10,2007,"Gaziantepspor","Buyuksehyr","1-0",1,0,"T1",1,1,1,"H"
2008-05-10,2007,"Genclerbirligi","Sivasspor","0-2",0,2,"T1",1,2,-2,"A"
2008-05-10,2007,"Kasimpasa","Konyaspor","2-1",2,1,"T1",1,3,1,"H"
2008-05-10,2007,"Kayserispor","Ankaragucu","0-2",0,2,"T1",1,2,-2,"A"
2008-05-10,2007,"Trabzonspor","Fenerbahce","2-0",2,0,"T1",1,2,2,"H"
2008-08-23,2008,"Buyuksehyr","Eskisehirspor","0-0",0,0,"T1",1,0,0,"D"
2008-08-23,2008,"Galatasaray","Denizlispor","4-1",4,1,"T1",1,5,3,"H"
2008-08-23,2008,"Gaziantepspor","Fenerbahce","1-0",1,0,"T1",1,1,1,"H"
2008-08-23,2008,"Hacettepespor","Bursaspor","1-2",1,2,"T1",1,3,-1,"A"
2008-08-23,2008,"Sivasspor","Kayserispor","0-0",0,0,"T1",1,0,0,"D"
2008-08-24,2008,"Antalyaspor","Besiktas","2-3",2,3,"T1",1,5,-1,"A"
2008-08-24,2008,"Genclerbirligi","Kocaelispor","1-1",1,1,"T1",1,2,0,"D"
2008-08-24,2008,"Konyaspor","Ankaragucu","3-2",3,2,"T1",1,5,1,"H"
2008-08-24,2008,"Trabzonspor","Ankaraspor","2-0",2,0,"T1",1,2,2,"H"
2008-08-29,2008,"Ankaragucu","Trabzonspor","1-2",1,2,"T1",1,3,-1,"A"
2008-08-30,2008,"Ankaraspor","Gaziantepspor","0-2",0,2,"T1",1,2,-2,"A"
2008-08-30,2008,"Fenerbahce","Buyuksehyr","2-0",2,0,"T1",1,2,2,"H"
2008-08-30,2008,"Kocaelispor","Sivasspor","0-2",0,2,"T1",1,2,-2,"A"
2008-08-31,2008,"Bursaspor","Genclerbirligi","2-0",2,0,"T1",1,2,2,"H"
2008-08-31,2008,"Denizlispor","Antalyaspor","3-2",3,2,"T1",1,5,1,"H"
2008-08-31,2008,"Eskisehirspor","Hacettepespor","0-0",0,0,"T1",1,0,0,"D"
2008-08-31,2008,"Kayserispor","Galatasaray","0-0",0,0,"T1",1,0,0,"D"
2008-09-01,2008,"Besiktas","Konyaspor","2-0",2,0,"T1",1,2,2,"H"
2008-09-13,2008,"Galatasaray","Antalyaspor","1-1",1,1,"T1",1,2,0,"D"
2008-09-13,2008,"Hacettepespor","Fenerbahce","2-1",2,1,"T1",1,3,1,"H"
2008-09-13,2008,"Kayserispor","Kocaelispor","1-0",1,0,"T1",1,1,1,"H"
2008-09-13,2008,"Konyaspor","Denizlispor","1-1",1,1,"T1",1,2,0,"D"
2008-09-14,2008,"Buyuksehyr","Ankaraspor","1-2",1,2,"T1",1,3,-1,"A"
2008-09-14,2008,"Gaziantepspor","Ankaragucu","2-2",2,2,"T1",1,4,0,"D"
2008-09-14,2008,"Genclerbirligi","Eskisehirspor","3-1",3,1,"T1",1,4,2,"H"
2008-09-14,2008,"Sivasspor","Bursaspor","3-1",3,1,"T1",1,4,2,"H"
2008-09-14,2008,"Trabzonspor","Besiktas","0-0",0,0,"T1",1,0,0,"D"
2008-09-19,2008,"Denizlispor","Trabzonspor","0-1",0,1,"T1",1,1,-1,"A"
2008-09-20,2008,"Ankaragucu","Buyuksehyr","0-0",0,0,"T1",1,0,0,"D"
2008-09-20,2008,"Eskisehirspor","Sivasspor","2-2",2,2,"T1",1,4,0,"D"
2008-09-20,2008,"Fenerbahce","Genclerbirligi","3-0",3,0,"T1",1,3,3,"H"
2008-09-21,2008,"Ankaraspor","Hacettepespor","4-0",4,0,"T1",1,4,4,"H"
2008-09-21,2008,"Antalyaspor","Konyaspor","0-1",0,1,"T1",1,1,-1,"A"
2008-09-21,2008,"Besiktas","Gaziantepspor","3-0",3,0,"T1",1,3,3,"H"
2008-09-21,2008,"Bursaspor","Kayserispor","1-0",1,0,"T1",1,1,1,"H"
2008-09-21,2008,"Kocaelispor","Galatasaray","1-4",1,4,"T1",1,5,-3,"A"
2008-09-26,2008,"Sivasspor","Fenerbahce","2-1",2,1,"T1",1,3,1,"H"
2008-09-27,2008,"Buyuksehyr","Besiktas","1-1",1,1,"T1",1,2,0,"D"
2008-09-27,2008,"Genclerbirligi","Ankaraspor","1-1",1,1,"T1",1,2,0,"D"
2008-09-27,2008,"Kocaelispor","Bursaspor","2-3",2,3,"T1",1,5,-1,"A"
2008-09-27,2008,"Trabzonspor","Antalyaspor","3-2",3,2,"T1",1,5,1,"H"
2008-09-28,2008,"Galatasaray","Konyaspor","4-1",4,1,"T1",1,5,3,"H"
2008-09-28,2008,"Gaziantepspor","Denizlispor","2-1",2,1,"T1",1,3,1,"H"
2008-09-28,2008,"Hacettepespor","Ankaragucu","0-1",0,1,"T1",1,1,-1,"A"
2008-09-28,2008,"Kayserispor","Eskisehirspor","1-0",1,0,"T1",1,1,1,"H"
2008-10-04,2008,"Ankaraspor","Sivasspor","2-0",2,0,"T1",1,2,2,"H"
2008-10-04,2008,"Antalyaspor","Gaziantepspor","1-4",1,4,"T1",1,5,-3,"A"
2008-10-04,2008,"Konyaspor","Trabzonspor","2-3",2,3,"T1",1,5,-1,"A"
2008-10-05,2008,"Ankaragucu","Genclerbirligi","0-2",0,2,"T1",1,2,-2,"A"
2008-10-05,2008,"Bursaspor","Galatasaray","2-1",2,1,"T1",1,3,1,"H"
2008-10-05,2008,"Denizlispor","Buyuksehyr","2-1",2,1,"T1",1,3,1,"H"
2008-10-05,2008,"Eskisehirspor","Kocaelispor","2-1",2,1,"T1",1,3,1,"H"
2008-10-05,2008,"Fenerbahce","Kayserispor","1-4",1,4,"T1",1,5,-3,"A"
2008-10-06,2008,"Besiktas","Hacettepespor","2-1",2,1,"T1",1,3,1,"H"
2008-10-18,2008,"Bursaspor","Eskisehirspor","1-2",1,2,"T1",1,3,-1,"A"
2008-10-18,2008,"Buyuksehyr","Antalyaspor","2-1",2,1,"T1",1,3,1,"H"
2008-10-18,2008,"Hacettepespor","Denizlispor","1-0",1,0,"T1",1,1,1,"H"
2008-10-18,2008,"Kocaelispor","Fenerbahce","2-3",2,3,"T1",1,5,-1,"A"
2008-10-19,2008,"Galatasaray","Trabzonspor","3-0",3,0,"T1",1,3,3,"H"
2008-10-19,2008,"Gaziantepspor","Konyaspor","0-1",0,1,"T1",1,1,-1,"A"
2008-10-19,2008,"Genclerbirligi","Besiktas","1-3",1,3,"T1",1,4,-2,"A"
2008-10-19,2008,"Kayserispor","Ankaraspor","1-2",1,2,"T1",1,3,-1,"A"
2008-10-19,2008,"Sivasspor","Ankaragucu","3-0",3,0,"T1",1,3,3,"H"
2008-10-24,2008,"Besiktas","Sivasspor","1-1",1,1,"T1",1,2,0,"D"
2008-10-25,2008,"Ankaraspor","Kocaelispor","4-0",4,0,"T1",1,4,4,"H"
2008-10-25,2008,"Denizlispor","Genclerbirligi","2-2",2,2,"T1",1,4,0,"D"
2008-10-25,2008,"Fenerbahce","Bursaspor","5-2",5,2,"T1",1,7,3,"H"
2008-10-26,2008,"Ankaragucu","Kayserispor","1-3",1,3,"T1",1,4,-2,"A"
2008-10-26,2008,"Antalyaspor","Hacettepespor","1-1",1,1,"T1",1,2,0,"D"
2008-10-26,2008,"Eskisehirspor","Galatasaray","4-2",4,2,"T1",1,6,2,"H"
2008-10-26,2008,"Konyaspor","Buyuksehyr","1-2",1,2,"T1",1,3,-1,"A"
2008-10-26,2008,"Trabzonspor","Gaziantepspor","1-1",1,1,"T1",1,2,0,"D"
2008-11-01,2008,"Buyuksehyr","Trabzonspor","0-4",0,4,"T1",1,4,-4,"A"
2008-11-01,2008,"Eskisehirspor","Fenerbahce","2-2",2,2,"T1",1,4,0,"D"
2008-11-01,2008,"Hacettepespor","Konyaspor","1-2",1,2,"T1",1,3,-1,"A"
2008-11-02,2008,"Bursaspor","Ankaraspor","0-1",0,1,"T1",1,1,-1,"A"
2008-11-02,2008,"Galatasaray","Gaziantepspor","3-1",3,1,"T1",1,4,2,"H"
2008-11-02,2008,"Genclerbirligi","Antalyaspor","1-2",1,2,"T1",1,3,-1,"A"
2008-11-02,2008,"Kayserispor","Besiktas","1-0",1,0,"T1",1,1,1,"H"
2008-11-02,2008,"Kocaelispor","Ankaragucu","1-1",1,1,"T1",1,2,0,"D"
2008-11-02,2008,"Sivasspor","Denizlispor","3-1",3,1,"T1",1,4,2,"H"
2008-11-07,2008,"Besiktas","Kocaelispor","5-2",5,2,"T1",1,7,3,"H"
2008-11-08,2008,"Ankaragucu","Bursaspor","1-1",1,1,"T1",1,2,0,"D"
2008-11-08,2008,"Trabzonspor","Hacettepespor","1-0",1,0,"T1",1,1,1,"H"
2008-11-09,2008,"Ankaraspor","Eskisehirspor","2-0",2,0,"T1",1,2,2,"H"
2008-11-09,2008,"Antalyaspor","Sivasspor","2-1",2,1,"T1",1,3,1,"H"
2008-11-09,2008,"Denizlispor","Kayserispor","1-0",1,0,"T1",1,1,1,"H"
2008-11-09,2008,"Fenerbahce","Galatasaray","4-1",4,1,"T1",1,5,3,"H"
2008-11-09,2008,"Gaziantepspor","Buyuksehyr","1-4",1,4,"T1",1,5,-3,"A"
2008-11-09,2008,"Konyaspor","Genclerbirligi","2-2",2,2,"T1",1,4,0,"D"
2008-11-14,2008,"Genclerbirligi","Trabzonspor","0-1",0,1,"T1",1,1,-1,"A"
2008-11-15,2008,"Fenerbahce","Ankaraspor","2-0",2,0,"T1",1,2,2,"H"
2008-11-15,2008,"Kocaelispor","Denizlispor","3-2",3,2,"T1",1,5,1,"H"
2008-11-16,2008,"Bursaspor","Besiktas","0-0",0,0,"T1",1,0,0,"D"
2008-11-16,2008,"Eskisehirspor","Ankaragucu","1-3",1,3,"T1",1,4,-2,"A"
2008-11-16,2008,"Galatasaray","Buyuksehyr","2-0",2,0,"T1",1,2,2,"H"
2008-11-16,2008,"Hacettepespor","Gaziantepspor","0-0",0,0,"T1",1,0,0,"D"
2008-11-16,2008,"Kayserispor","Antalyaspor","0-0",0,0,"T1",1,0,0,"D"
2008-11-16,2008,"Sivasspor","Konyaspor","1-0",1,0,"T1",1,1,1,"H"
2008-11-22,2008,"Ankaragucu","Fenerbahce","0-0",0,0,"T1",1,0,0,"D"
2008-11-22,2008,"Ankaraspor","Galatasaray","0-0",0,0,"T1",1,0,0,"D"
2008-11-22,2008,"Antalyaspor","Kocaelispor","0-0",0,0,"T1",1,0,0,"D"
2008-11-22,2008,"Gaziantepspor","Genclerbirligi","2-0",2,0,"T1",1,2,2,"H"
2008-11-23,2008,"Besiktas","Eskisehirspor","2-0",2,0,"T1",1,2,2,"H"
2008-11-23,2008,"Buyuksehyr","Hacettepespor","1-0",1,0,"T1",1,1,1,"H"
2008-11-23,2008,"Denizlispor","Bursaspor","4-3",4,3,"T1",1,7,1,"H"
2008-11-23,2008,"Konyaspor","Kayserispor","0-0",0,0,"T1",1,0,0,"D"
2008-11-23,2008,"Trabzonspor","Sivasspor","0-0",0,0,"T1",1,0,0,"D"
2008-11-28,2008,"Kayserispor","Trabzonspor","1-1",1,1,"T1",1,2,0,"D"
2008-11-29,2008,"Ankaraspor","Ankaragucu","0-1",0,1,"T1",1,1,-1,"A"
2008-11-29,2008,"Eskisehirspor","Denizlispor","4-3",4,3,"T1",1,7,1,"H"
2008-11-29,2008,"Fenerbahce","Besiktas","2-1",2,1,"T1",1,3,1,"H"
2008-11-29,2008,"Sivasspor","Gaziantepspor","3-0",3,0,"T1",1,3,3,"H"
2008-11-30,2008,"Bursaspor","Antalyaspor","1-1",1,1,"T1",1,2,0,"D"
2008-11-30,2008,"Galatasaray","Hacettepespor","3-1",3,1,"T1",1,4,2,"H"
2008-11-30,2008,"Genclerbirligi","Buyuksehyr","0-0",0,0,"T1",1,0,0,"D"
2008-11-30,2008,"Kocaelispor","Konyaspor","3-0",3,0,"T1",1,3,3,"H"
2008-12-05,2008,"Denizlispor","Fenerbahce","0-1",0,1,"T1",1,1,-1,"A"
2008-12-06,2008,"Antalyaspor","Eskisehirspor","0-0",0,0,"T1",1,0,0,"D"
2008-12-06,2008,"Besiktas","Ankaraspor","1-3",1,3,"T1",1,4,-2,"A"
2008-12-06,2008,"Gaziantepspor","Kayserispor","0-0",0,0,"T1",1,0,0,"D"
2008-12-06,2008,"Hacettepespor","Genclerbirligi","0-3",0,3,"T1",1,3,-3,"A"
2008-12-07,2008,"Ankaragucu","Galatasaray","0-3",0,3,"T1",1,3,-3,"A"
2008-12-07,2008,"Buyuksehyr","Sivasspor","0-3",0,3,"T1",1,3,-3,"A"
2008-12-07,2008,"Konyaspor","Bursaspor","0-0",0,0,"T1",1,0,0,"D"
2008-12-07,2008,"Trabzonspor","Kocaelispor","2-1",2,1,"T1",1,3,1,"H"
2008-12-12,2008,"Genclerbirligi","Galatasaray","1-3",1,3,"T1",1,4,-2,"A"
2008-12-13,2008,"Besiktas","Ankaragucu","1-0",1,0,"T1",1,1,1,"H"
2008-12-13,2008,"Bursaspor","Trabzonspor","2-1",2,1,"T1",1,3,1,"H"
2008-12-13,2008,"Kayserispor","Buyuksehyr","2-0",2,0,"T1",1,2,2,"H"
2008-12-13,2008,"Sivasspor","Hacettepespor","2-1",2,1,"T1",1,3,1,"H"
2008-12-14,2008,"Ankaraspor","Denizlispor","2-0",2,0,"T1",1,2,2,"H"
2008-12-14,2008,"Eskisehirspor","Konyaspor","0-0",0,0,"T1",1,0,0,"D"
2008-12-14,2008,"Fenerbahce","Antalyaspor","2-0",2,0,"T1",1,2,2,"H"
2008-12-14,2008,"Kocaelispor","Gaziantepspor","2-5",2,5,"T1",1,7,-3,"A"
2008-12-19,2008,"Konyaspor","Fenerbahce","1-2",1,2,"T1",1,3,-1,"A"
2008-12-20,2008,"Buyuksehyr","Kocaelispor","5-0",5,0,"T1",1,5,5,"H"
2008-12-20,2008,"Hacettepespor","Kayserispor","0-3",0,3,"T1",1,3,-3,"A"
2008-12-20,2008,"Trabzonspor","Eskisehirspor","2-1",2,1,"T1",1,3,1,"H"
2008-12-21,2008,"Antalyaspor","Ankaraspor","1-1",1,1,"T1",1,2,0,"D"
2008-12-21,2008,"Denizlispor","Ankaragucu","1-1",1,1,"T1",1,2,0,"D"
2008-12-21,2008,"Galatasaray","Besiktas","4-2",4,2,"T1",1,6,2,"H"
2008-12-21,2008,"Gaziantepspor","Bursaspor","2-0",2,0,"T1",1,2,2,"H"
2008-12-21,2008,"Genclerbirligi","Sivasspor","1-2",1,2,"T1",1,3,-1,"A"
2009-01-23,2008,"Ankaraspor","Konyaspor","3-0",3,0,"T1",1,3,3,"H"
2009-01-24,2008,"Ankaragucu","Antalyaspor","0-1",0,1,"T1",1,1,-1,"A"
2009-01-24,2008,"Besiktas","Denizlispor","1-0",1,0,"T1",1,1,1,"H"
2009-01-24,2008,"Eskisehirspor","Gaziantepspor","1-1",1,1,"T1",1,2,0,"D"
2009-01-24,2008,"Kayserispor","Genclerbirligi","1-3",1,3,"T1",1,4,-2,"A"
2009-01-24,2008,"Sivasspor","Galatasaray","2-0",2,0,"T1",1,2,2,"H"
2009-01-25,2008,"Bursaspor","Buyuksehyr","2-0",2,0,"T1",1,2,2,"H"
2009-01-25,2008,"Fenerbahce","Trabzonspor","0-0",0,0,"T1",1,0,0,"D"
2009-01-25,2008,"Kocaelispor","Hacettepespor","4-0",4,0,"T1",1,4,4,"H"
2009-01-31,2008,"Ankaraspor","Trabzonspor","0-2",0,2,"T1",1,2,-2,"A"
2009-01-31,2008,"Denizlispor","Galatasaray","0-2",0,2,"T1",1,2,-2,"A"
2009-01-31,2008,"Kayserispor","Sivasspor","0-0",0,0,"T1",1,0,0,"D"
2009-01-31,2008,"Kocaelispor","Genclerbirligi","0-2",0,2,"T1",1,2,-2,"A"
2009-02-01,2008,"Ankaragucu","Konyaspor","1-3",1,3,"T1",1,4,-2,"A"
2009-02-01,2008,"Besiktas","Antalyaspor","1-0",1,0,"T1",1,1,1,"H"
2009-02-01,2008,"Bursaspor","Hacettepespor","0-0",0,0,"T1",1,0,0,"D"
2009-02-01,2008,"Eskisehirspor","Buyuksehyr","6-1",6,1,"T1",1,7,5,"H"
2009-02-01,2008,"Fenerbahce","Gaziantepspor","1-1",1,1,"T1",1,2,0,"D"
2009-02-06,2008,"Trabzonspor","Ankaragucu","2-1",2,1,"T1",1,3,1,"H"
2009-02-07,2008,"Galatasaray","Kayserispor","1-1",1,1,"T1",1,2,0,"D"
2009-02-07,2008,"Hacettepespor","Eskisehirspor","2-2",2,2,"T1",1,4,0,"D"
2009-02-07,2008,"Sivasspor","Kocaelispor","2-0",2,0,"T1",1,2,2,"H"
2009-02-08,2008,"Antalyaspor","Denizlispor","2-1",2,1,"T1",1,3,1,"H"
2009-02-08,2008,"Buyuksehyr","Fenerbahce","2-0",2,0,"T1",1,2,2,"H"
2009-02-08,2008,"Gaziantepspor","Ankaraspor","2-0",2,0,"T1",1,2,2,"H"
2009-02-08,2008,"Genclerbirligi","Bursaspor","1-2",1,2,"T1",1,3,-1,"A"
2009-02-08,2008,"Konyaspor","Besiktas","0-0",0,0,"T1",1,0,0,"D"
2009-02-14,2008,"Ankaragucu","Gaziantepspor","3-1",3,1,"T1",1,4,2,"H"
2009-02-14,2008,"Antalyaspor","Galatasaray","1-0",1,0,"T1",1,1,1,"H"
2009-02-14,2008,"Eskisehirspor","Genclerbirligi","0-0",0,0,"T1",1,0,0,"D"
2009-02-14,2008,"Fenerbahce","Hacettepespor","7-0",7,0,"T1",1,7,7,"H"
2009-02-15,2008,"Ankaraspor","Buyuksehyr","1-2",1,2,"T1",1,3,-1,"A"
2009-02-15,2008,"Besiktas","Trabzonspor","1-1",1,1,"T1",1,2,0,"D"
2009-02-15,2008,"Bursaspor","Sivasspor","1-1",1,1,"T1",1,2,0,"D"
2009-02-15,2008,"Denizlispor","Konyaspor","2-1",2,1,"T1",1,3,1,"H"
2009-02-15,2008,"Kocaelispor","Kayserispor","1-2",1,2,"T1",1,3,-1,"A"
2009-02-20,2008,"Gaziantepspor","Besiktas","0-3",0,3,"T1",1,3,-3,"A"
2009-02-21,2008,"Buyuksehyr","Ankaragucu","1-2",1,2,"T1",1,3,-1,"A"
2009-02-21,2008,"Genclerbirligi","Fenerbahce","1-0",1,0,"T1",1,1,1,"H"
2009-02-21,2008,"Kayserispor","Bursaspor","0-0",0,0,"T1",1,0,0,"D"
2009-02-21,2008,"Konyaspor","Antalyaspor","2-0",2,0,"T1",1,2,2,"H"
2009-02-21,2008,"Trabzonspor","Denizlispor","0-2",0,2,"T1",1,2,-2,"A"
2009-02-22,2008,"Galatasaray","Kocaelispor","2-5",2,5,"T1",1,7,-3,"A"
2009-02-22,2008,"Hacettepespor","Ankaraspor","3-1",3,1,"T1",1,4,2,"H"
2009-02-22,2008,"Sivasspor","Eskisehirspor","1-0",1,0,"T1",1,1,1,"H"
2009-02-27,2008,"Besiktas","Buyuksehyr","2-1",2,1,"T1",1,3,1,"H"
2009-02-28,2008,"Ankaraspor","Genclerbirligi","0-0",0,0,"T1",1,0,0,"D"
2009-02-28,2008,"Denizlispor","Gaziantepspor","2-0",2,0,"T1",1,2,2,"H"
2009-02-28,2008,"Eskisehirspor","Kayserispor","1-0",1,0,"T1",1,1,1,"H"
2009-02-28,2008,"Fenerbahce","Sivasspor","4-2",4,2,"T1",1,6,2,"H"
2009-03-01,2008,"Ankaragucu","Hacettepespor","1-0",1,0,"T1",1,1,1,"H"
2009-03-01,2008,"Antalyaspor","Trabzonspor","0-1",0,1,"T1",1,1,-1,"A"
2009-03-01,2008,"Bursaspor","Kocaelispor","1-1",1,1,"T1",1,2,0,"D"
2009-03-01,2008,"Konyaspor","Galatasaray","0-1",0,1,"T1",1,1,-1,"A"
2009-03-06,2008,"Galatasaray","Bursaspor","2-1",2,1,"T1",1,3,1,"H"
2009-03-07,2008,"Buyuksehyr","Denizlispor","0-2",0,2,"T1",1,2,-2,"A"
2009-03-07,2008,"Gaziantepspor","Antalyaspor","1-1",1,1,"T1",1,2,0,"D"
2009-03-07,2008,"Hacettepespor","Besiktas","2-3",2,3,"T1",1,5,-1,"A"
2009-03-07,2008,"Trabzonspor","Konyaspor","0-1",0,1,"T1",1,1,-1,"A"
2009-03-08,2008,"Genclerbirligi","Ankaragucu","2-0",2,0,"T1",1,2,2,"H"
2009-03-08,2008,"Kayserispor","Fenerbahce","0-2",0,2,"T1",1,2,-2,"A"
2009-03-08,2008,"Kocaelispor","Eskisehirspor","1-0",1,0,"T1",1,1,1,"H"
2009-03-08,2008,"Sivasspor","Ankaraspor","1-1",1,1,"T1",1,2,0,"D"
2009-03-13,2008,"Fenerbahce","Kocaelispor","1-1",1,1,"T1",1,2,0,"D"
2009-03-14,2008,"Ankaragucu","Sivasspor","0-2",0,2,"T1",1,2,-2,"A"
2009-03-14,2008,"Antalyaspor","Buyuksehyr","1-0",1,0,"T1",1,1,1,"H"
2009-03-14,2008,"Besiktas","Genclerbirligi","3-0",3,0,"T1",1,3,3,"H"
2009-03-14,2008,"Konyaspor","Gaziantepspor","2-3",2,3,"T1",1,5,-1,"A"
2009-03-15,2008,"Ankaraspor","Kayserispor","2-2",2,2,"T1",1,4,0,"D"
2009-03-15,2008,"Denizlispor","Hacettepespor","0-0",0,0,"T1",1,0,0,"D"
2009-03-15,2008,"Eskisehirspor","Bursaspor","1-2",1,2,"T1",1,3,-1,"A"
2009-03-15,2008,"Trabzonspor","Galatasaray","2-2",2,2,"T1",1,4,0,"D"
2009-03-20,2008,"Bursaspor","Fenerbahce","2-1",2,1,"T1",1,3,1,"H"
2009-03-21,2008,"Buyuksehyr","Konyaspor","2-0",2,0,"T1",1,2,2,"H"
2009-03-21,2008,"Gaziantepspor","Trabzonspor","3-2",3,2,"T1",1,5,1,"H"
2009-03-21,2008,"Hacettepespor","Antalyaspor","1-2",1,2,"T1",1,3,-1,"A"
2009-03-21,2008,"Kayserispor","Ankaragucu","2-0",2,0,"T1",1,2,2,"H"
2009-03-21,2008,"Kocaelispor","Ankaraspor","3-1",3,1,"T1",1,4,2,"H"
2009-03-21,2008,"Sivasspor","Besiktas","1-1",1,1,"T1",1,2,0,"D"
2009-03-22,2008,"Galatasaray","Eskisehirspor","0-1",0,1,"T1",1,1,-1,"A"
2009-03-22,2008,"Genclerbirligi","Denizlispor","0-0",0,0,"T1",1,0,0,"D"
2009-04-04,2008,"Ankaraspor","Bursaspor","0-2",0,2,"T1",1,2,-2,"A"
2009-04-04,2008,"Besiktas","Kayserispor","1-0",1,0,"T1",1,1,1,"H"
2009-04-04,2008,"Denizlispor","Sivasspor","0-2",0,2,"T1",1,2,-2,"A"
2009-04-04,2008,"Konyaspor","Hacettepespor","2-0",2,0,"T1",1,2,2,"H"
2009-04-05,2008,"Ankaragucu","Kocaelispor","4-0",4,0,"T1",1,4,4,"H"
2009-04-05,2008,"Antalyaspor","Genclerbirligi","4-2",4,2,"T1",1,6,2,"H"
2009-04-05,2008,"Fenerbahce","Eskisehirspor","2-1",2,1,"T1",1,3,1,"H"
2009-04-05,2008,"Trabzonspor","Buyuksehyr","0-0",0,0,"T1",1,0,0,"D"
2009-04-06,2008,"Gaziantepspor","Galatasaray","0-1",0,1,"T1",1,1,-1,"A"
2009-04-10,2008,"Kocaelispor","Besiktas","1-3",1,3,"T1",1,4,-2,"A"
2009-04-11,2008,"Bursaspor","Ankaragucu","2-0",2,0,"T1",1,2,2,"H"
2009-04-11,2008,"Buyuksehyr","Gaziantepspor","1-1",1,1,"T1",1,2,0,"D"
2009-04-11,2008,"Hacettepespor","Trabzonspor","1-4",1,4,"T1",1,5,-3,"A"
2009-04-11,2008,"Sivasspor","Antalyaspor","1-0",1,0,"T1",1,1,1,"H"
2009-04-12,2008,"Eskisehirspor","Ankaraspor","2-0",2,0,"T1",1,2,2,"H"
2009-04-12,2008,"Galatasaray","Fenerbahce","0-0",0,0,"T1",1,0,0,"D"
2009-04-12,2008,"Genclerbirligi","Konyaspor","1-0",1,0,"T1",1,1,1,"H"
2009-04-12,2008,"Kayserispor","Denizlispor","2-0",2,0,"T1",1,2,2,"H"
2009-04-17,2008,"Trabzonspor","Genclerbirligi","2-0",2,0,"T1",1,2,2,"H"
2009-04-18,2008,"Ankaraspor","Fenerbahce","1-0",1,0,"T1",1,1,1,"H"
2009-04-18,2008,"Konyaspor","Sivasspor","0-0",0,0,"T1",1,0,0,"D"
2009-04-19,2008,"Ankaragucu","Eskisehirspor","3-2",3,2,"T1",1,5,1,"H"
2009-04-19,2008,"Antalyaspor","Kayserispor","2-1",2,1,"T1",1,3,1,"H"
2009-04-19,2008,"Besiktas","Bursaspor","0-0",0,0,"T1",1,0,0,"D"
2009-04-19,2008,"Buyuksehyr","Galatasaray","0-1",0,1,"T1",1,1,-1,"A"
2009-04-19,2008,"Denizlispor","Kocaelispor","2-1",2,1,"T1",1,3,1,"H"
2009-04-19,2008,"Gaziantepspor","Hacettepespor","0-0",0,0,"T1",1,0,0,"D"
2009-04-25,2008,"Fenerbahce","Ankaragucu","1-2",1,2,"T1",1,3,-1,"A"
2009-04-25,2008,"Hacettepespor","Buyuksehyr","2-1",2,1,"T1",1,3,1,"H"
2009-04-25,2008,"Sivasspor","Trabzonspor","3-0",3,0,"T1",1,3,3,"H"
2009-04-26,2008,"Bursaspor","Denizlispor","2-0",2,0,"T1",1,2,2,"H"
2009-04-26,2008,"Eskisehirspor","Besiktas","0-2",0,2,"T1",1,2,-2,"A"
2009-04-26,2008,"Galatasaray","Ankaraspor","1-1",1,1,"T1",1,2,0,"D"
2009-04-26,2008,"Genclerbirligi","Gaziantepspor","1-0",1,0,"T1",1,1,1,"H"
2009-04-26,2008,"Kayserispor","Konyaspor","1-1",1,1,"T1",1,2,0,"D"
2009-04-26,2008,"Kocaelispor","Antalyaspor","1-0",1,0,"T1",1,1,1,"H"
2009-05-01,2008,"Hacettepespor","Galatasaray","2-0",2,0,"T1",1,2,2,"H"
2009-05-02,2008,"Trabzonspor","Kayserispor","4-1",4,1,"T1",1,5,3,"H"
2009-05-03,2008,"Ankaragucu","Ankaraspor","1-0",1,0,"T1",1,1,1,"H"
2009-05-03,2008,"Antalyaspor","Bursaspor","2-3",2,3,"T1",1,5,-1,"A"
2009-05-03,2008,"Besiktas","Fenerbahce","1-2",1,2,"T1",1,3,-1,"A"
2009-05-03,2008,"Buyuksehyr","Genclerbirligi","3-1",3,1,"T1",1,4,2,"H"
2009-05-03,2008,"Denizlispor","Eskisehirspor","3-2",3,2,"T1",1,5,1,"H"
2009-05-03,2008,"Gaziantepspor","Sivasspor","2-1",2,1,"T1",1,3,1,"H"
2009-05-03,2008,"Konyaspor","Kocaelispor","2-0",2,0,"T1",1,2,2,"H"
2009-05-09,2008,"Ankaraspor","Besiktas","1-4",1,4,"T1",1,5,-3,"A"
2009-05-09,2008,"Bursaspor","Konyaspor","3-0",3,0,"T1",1,3,3,"H"
2009-05-09,2008,"Eskisehirspor","Antalyaspor","2-0",2,0,"T1",1,2,2,"H"
2009-05-09,2008,"Fenerbahce","Denizlispor","1-0",1,0,"T1",1,1,1,"H"
2009-05-09,2008,"Galatasaray","Ankaragucu","1-0",1,0,"T1",1,1,1,"H"
2009-05-09,2008,"Genclerbirligi","Hacettepespor","3-1",3,1,"T1",1,4,2,"H"
2009-05-09,2008,"Kocaelispor","Trabzonspor","1-3",1,3,"T1",1,4,-2,"A"
2009-05-09,2008,"Sivasspor","Buyuksehyr","1-2",1,2,"T1",1,3,-1,"A"
2009-05-10,2008,"Kayserispor","Gaziantepspor","3-0",3,0,"T1",1,3,3,"H"
2009-05-16,2008,"Hacettepespor","Sivasspor","1-2",1,2,"T1",1,3,-1,"A"
2009-05-17,2008,"Ankaragucu","Besiktas","1-3",1,3,"T1",1,4,-2,"A"
2009-05-17,2008,"Antalyaspor","Fenerbahce","1-1",1,1,"T1",1,2,0,"D"
2009-05-17,2008,"Buyuksehyr","Kayserispor","1-0",1,0,"T1",1,1,1,"H"
2009-05-17,2008,"Denizlispor","Ankaraspor","2-0",2,0,"T1",1,2,2,"H"
2009-05-17,2008,"Galatasaray","Genclerbirligi","2-1",2,1,"T1",1,3,1,"H"
2009-05-17,2008,"Gaziantepspor","Kocaelispor","5-2",5,2,"T1",1,7,3,"H"
2009-05-17,2008,"Konyaspor","Eskisehirspor","1-2",1,2,"T1",1,3,-1,"A"
2009-05-17,2008,"Trabzonspor","Bursaspor","1-0",1,0,"T1",1,1,1,"H"
2009-05-23,2008,"Kayserispor","Hacettepespor","1-0",1,0,"T1",1,1,1,"H"
2009-05-24,2008,"Ankaragucu","Denizlispor","3-0",3,0,"T1",1,3,3,"H"
2009-05-24,2008,"Ankaraspor","Antalyaspor","0-0",0,0,"T1",1,0,0,"D"
2009-05-24,2008,"Besiktas","Galatasaray","2-1",2,1,"T1",1,3,1,"H"
2009-05-24,2008,"Bursaspor","Gaziantepspor","2-2",2,2,"T1",1,4,0,"D"
2009-05-24,2008,"Eskisehirspor","Trabzonspor","2-5",2,5,"T1",1,7,-3,"A"
2009-05-24,2008,"Fenerbahce","Konyaspor","4-2",4,2,"T1",1,6,2,"H"
2009-05-24,2008,"Kocaelispor","Buyuksehyr","2-3",2,3,"T1",1,5,-1,"A"
2009-05-24,2008,"Sivasspor","Genclerbirligi","3-2",3,2,"T1",1,5,1,"H"
2009-05-29,2008,"Gaziantepspor","Eskisehirspor","1-1",1,1,"T1",1,2,0,"D"
2009-05-29,2008,"Hacettepespor","Kocaelispor","0-4",0,4,"T1",1,4,-4,"A"
2009-05-30,2008,"Antalyaspor","Ankaragucu","1-0",1,0,"T1",1,1,1,"H"
2009-05-30,2008,"Buyuksehyr","Bursaspor","0-1",0,1,"T1",1,1,-1,"A"
2009-05-30,2008,"Denizlispor","Besiktas","1-2",1,2,"T1",1,3,-1,"A"
2009-05-30,2008,"Galatasaray","Sivasspor","2-1",2,1,"T1",1,3,1,"H"
2009-05-30,2008,"Genclerbirligi","Kayserispor","0-4",0,4,"T1",1,4,-4,"A"
2009-05-30,2008,"Konyaspor","Ankaraspor","3-0",3,0,"T1",1,3,3,"H"
2009-05-30,2008,"Trabzonspor","Fenerbahce","1-2",1,2,"T1",1,3,-1,"A"
2009-08-07,2009,"Buyuksehyr","Besiktas","1-1",1,1,"T1",1,2,0,"D"
2009-08-08,2009,"Diyarbakirspor","Ankaragucu","2-2",2,2,"T1",1,4,0,"D"
2009-08-08,2009,"Sivasspor","Trabzonspor","1-2",1,2,"T1",1,3,-1,"A"
2009-08-09,2009,"Bursaspor","Kasimpasa","2-1",2,1,"T1",1,3,1,"H"
2009-08-09,2009,"Denizlispor","Fenerbahce","0-2",0,2,"T1",1,2,-2,"A"
2009-08-09,2009,"Gaziantepspor","Galatasaray","2-3",2,3,"T1",1,5,-1,"A"
2009-08-09,2009,"Genclerbirligi","Kayserispor","0-0",0,0,"T1",1,0,0,"D"
2009-08-09,2009,"Manisaspor","Eskisehirspor","0-0",0,0,"T1",1,0,0,"D"
2009-08-15,2009,"Ankaragucu","Manisaspor","1-1",1,1,"T1",1,2,0,"D"
2009-08-15,2009,"Galatasaray","Denizlispor","4-1",4,1,"T1",1,5,3,"H"
2009-08-15,2009,"Trabzonspor","Diyarbakirspor","1-2",1,2,"T1",1,3,-1,"A"
2009-08-16,2009,"Eskisehirspor","Bursaspor","3-2",3,2,"T1",1,5,1,"H"
2009-08-16,2009,"Fenerbahce","Sivasspor","3-0",3,0,"T1",1,3,3,"H"
2009-08-16,2009,"Kasimpasa","Buyuksehyr","1-3",1,3,"T1",1,4,-2,"A"
2009-08-16,2009,"Kayserispor","Gaziantepspor","1-1",1,1,"T1",1,2,0,"D"
2009-08-17,2009,"Besiktas","Antalyaspor","2-0",2,0,"T1",1,2,2,"H"
2009-08-22,2009,"Bursaspor","Ankaragucu","1-0",1,0,"T1",1,1,1,"H"
2009-08-22,2009,"Buyuksehyr","Eskisehirspor","0-0",0,0,"T1",1,0,0,"D"
2009-08-22,2009,"Genclerbirligi","Besiktas","0-0",0,0,"T1",1,0,0,"D"
2009-08-23,2009,"Antalyaspor","Kasimpasa","2-0",2,0,"T1",1,2,2,"H"
2009-08-23,2009,"Galatasaray","Kayserispor","4-1",4,1,"T1",1,5,3,"H"
2009-08-23,2009,"Manisaspor","Trabzonspor","1-0",1,0,"T1",1,1,1,"H"
2009-08-24,2009,"Diyarbakirspor","Fenerbahce","1-3",1,3,"T1",1,4,-2,"A"
2009-08-28,2009,"Besiktas","Gaziantepspor","0-0",0,0,"T1",1,0,0,"D"
2009-08-29,2009,"Ankaragucu","Buyuksehyr","2-2",2,2,"T1",1,4,0,"D"
2009-08-29,2009,"Eskisehirspor","Antalyaspor","2-1",2,1,"T1",1,3,1,"H"
2009-08-29,2009,"Kayserispor","Denizlispor","3-0",3,0,"T1",1,3,3,"H"
2009-08-30,2009,"Fenerbahce","Manisaspor","2-1",2,1,"T1",1,3,1,"H"
2009-08-30,2009,"Kasimpasa","Genclerbirligi","0-4",0,4,"T1",1,4,-4,"A"
2009-08-30,2009,"Sivasspor","Diyarbakirspor","0-2",0,2,"T1",1,2,-2,"A"
2009-08-30,2009,"Trabzonspor","Bursaspor","1-1",1,1,"T1",1,2,0,"D"
2009-09-12,2009,"Denizlispor","Diyarbakirspor","0-0",0,0,"T1",1,0,0,"D"
2009-09-12,2009,"Galatasaray","Besiktas","3-0",3,0,"T1",1,3,3,"H"
2009-09-12,2009,"Manisaspor","Sivasspor","3-1",3,1,"T1",1,4,2,"H"
2009-09-13,2009,"Antalyaspor","Ankaragucu","1-0",1,0,"T1",1,1,1,"H"
2009-09-13,2009,"Bursaspor","Fenerbahce","0-1",0,1,"T1",1,1,-1,"A"
2009-09-13,2009,"Buyuksehyr","Trabzonspor","1-6",1,6,"T1",1,7,-5,"A"
2009-09-13,2009,"Gaziantepspor","Kasimpasa","1-0",1,0,"T1",1,1,1,"H"
2009-09-13,2009,"Genclerbirligi","Eskisehirspor","2-2",2,2,"T1",1,4,0,"D"
2009-09-16,2009,"Denizlispor","Sivasspor","1-1",1,1,"T1",1,2,0,"D"
2009-09-18,2009,"Trabzonspor","Antalyaspor","3-1",3,1,"T1",1,4,2,"H"
2009-09-19,2009,"Ankaragucu","Genclerbirligi","1-2",1,2,"T1",1,3,-1,"A"
2009-09-19,2009,"Besiktas","Kayserispor","0-1",0,1,"T1",1,1,-1,"A"
2009-09-19,2009,"Diyarbakirspor","Manisaspor","0-0",0,0,"T1",1,0,0,"D"
2009-09-19,2009,"Eskisehirspor","Gaziantepspor","3-2",3,2,"T1",1,5,1,"H"
2009-09-19,2009,"Sivasspor","Bursaspor","1-3",1,3,"T1",1,4,-2,"A"
2009-09-20,2009,"Fenerbahce","Buyuksehyr","1-0",1,0,"T1",1,1,1,"H"
2009-09-21,2009,"Kasimpasa","Galatasaray","1-3",1,3,"T1",1,4,-2,"A"
2009-09-25,2009,"Genclerbirligi","Trabzonspor","2-2",2,2,"T1",1,4,0,"D"
2009-09-26,2009,"Antalyaspor","Fenerbahce","1-2",1,2,"T1",1,3,-1,"A"
2009-09-26,2009,"Bursaspor","Diyarbakirspor","4-0",4,0,"T1",1,4,4,"H"
2009-09-26,2009,"Buyuksehyr","Sivasspor","1-0",1,0,"T1",1,1,1,"H"
2009-09-26,2009,"Gaziantepspor","Ankaragucu","1-3",1,3,"T1",1,4,-2,"A"
2009-09-27,2009,"Denizlispor","Manisaspor","1-1",1,1,"T1",1,2,0,"D"
2009-09-27,2009,"Galatasaray","Eskisehirspor","1-1",1,1,"T1",1,2,0,"D"
2009-09-27,2009,"Kayserispor","Kasimpasa","0-0",0,0,"T1",1,0,0,"D"
2009-10-02,2009,"Trabzonspor","Gaziantepspor","0-0",0,0,"T1",1,0,0,"D"
2009-10-03,2009,"Besiktas","Denizlispor","1-0",1,0,"T1",1,1,1,"H"
2009-10-03,2009,"Diyarbakirspor","Buyuksehyr","1-3",1,3,"T1",1,4,-2,"A"
2009-10-03,2009,"Manisaspor","Bursaspor","0-2",0,2,"T1",1,2,-2,"A"
2009-10-04,2009,"Ankaragucu","Galatasaray","3-0",3,0,"T1",1,3,3,"H"
2009-10-04,2009,"Eskisehirspor","Kayserispor","0-1",0,1,"T1",1,1,-1,"A"
2009-10-04,2009,"Fenerbahce","Genclerbirligi","3-0",3,0,"T1",1,3,3,"H"
2009-10-04,2009,"Sivasspor","Antalyaspor","2-0",2,0,"T1",1,2,2,"H"
2009-10-17,2009,"Besiktas","Kasimpasa","2-1",2,1,"T1",1,3,1,"H"
2009-10-17,2009,"Denizlispor","Bursaspor","2-3",2,3,"T1",1,5,-1,"A"
2009-10-18,2009,"Antalyaspor","Diyarbakirspor","4-1",4,1,"T1",1,5,3,"H"
2009-10-18,2009,"Buyuksehyr","Manisaspor","1-0",1,0,"T1",1,1,1,"H"
2009-10-18,2009,"Galatasaray","Trabzonspor","4-3",4,3,"T1",1,7,1,"H"
2009-10-18,2009,"Gaziantepspor","Fenerbahce","2-1",2,1,"T1",1,3,1,"H"
2009-10-18,2009,"Genclerbirligi","Sivasspor","2-0",2,0,"T1",1,2,2,"H"
2009-10-18,2009,"Kayserispor","Ankaragucu","3-0",3,0,"T1",1,3,3,"H"
2009-10-23,2009,"Trabzonspor","Kayserispor","2-1",2,1,"T1",1,3,1,"H"
2009-10-24,2009,"Bursaspor","Buyuksehyr","6-0",6,0,"T1",1,6,6,"H"
2009-10-24,2009,"Eskisehirspor","Besiktas","0-1",0,1,"T1",1,1,-1,"A"
2009-10-25,2009,"Diyarbakirspor","Genclerbirligi","1-0",1,0,"T1",1,1,1,"H"
2009-10-25,2009,"Fenerbahce","Galatasaray","3-1",3,1,"T1",1,4,2,"H"
2009-10-25,2009,"Kasimpasa","Denizlispor","3-1",3,1,"T1",1,4,2,"H"
2009-10-25,2009,"Manisaspor","Antalyaspor","1-2",1,2,"T1",1,3,-1,"A"
2009-10-25,2009,"Sivasspor","Gaziantepspor","3-0",3,0,"T1",1,3,3,"H"
2009-10-31,2009,"Antalyaspor","Bursaspor","1-1",1,1,"T1",1,2,0,"D"
2009-10-31,2009,"Besiktas","Ankaragucu","1-0",1,0,"T1",1,1,1,"H"
2009-11-01,2009,"Denizlispor","Buyuksehyr","0-1",0,1,"T1",1,1,-1,"A"
2009-11-01,2009,"Galatasaray","Sivasspor","2-0",2,0,"T1",1,2,2,"H"
2009-11-01,2009,"Gaziantepspor","Diyarbakirspor","2-1",2,1,"T1",1,3,1,"H"
2009-11-01,2009,"Genclerbirligi","Manisaspor","0-2",0,2,"T1",1,2,-2,"A"
2009-11-01,2009,"Kasimpasa","Eskisehirspor","1-1",1,1,"T1",1,2,0,"D"
2009-11-01,2009,"Kayserispor","Fenerbahce","1-1",1,1,"T1",1,2,0,"D"
2009-11-06,2009,"Bursaspor","Genclerbirligi","1-2",1,2,"T1",1,3,-1,"A"
2009-11-07,2009,"Buyuksehyr","Antalyaspor","1-0",1,0,"T1",1,1,1,"H"
2009-11-07,2009,"Trabzonspor","Besiktas","0-2",0,2,"T1",1,2,-2,"A"
2009-11-08,2009,"Ankaragucu","Kasimpasa","2-2",2,2,"T1",1,4,0,"D"
2009-11-08,2009,"Diyarbakirspor","Galatasaray","1-2",1,2,"T1",1,3,-1,"A"
2009-11-08,2009,"Eskisehirspor","Denizlispor","2-0",2,0,"T1",1,2,2,"H"
2009-11-08,2009,"Manisaspor","Gaziantepspor","0-3",0,3,"T1",1,3,-3,"A"
2009-11-08,2009,"Sivasspor","Kayserispor","2-4",2,4,"T1",1,6,-2,"A"
2009-11-21,2009,"Besiktas","Fenerbahce","3-0",3,0,"T1",1,3,3,"H"
2009-11-21,2009,"Gaziantepspor","Bursaspor","0-1",0,1,"T1",1,1,-1,"A"
2009-11-22,2009,"Denizlispor","Antalyaspor","1-1",1,1,"T1",1,2,0,"D"
2009-11-22,2009,"Eskisehirspor","Ankaragucu","0-0",0,0,"T1",1,0,0,"D"
2009-11-22,2009,"Galatasaray","Manisaspor","1-1",1,1,"T1",1,2,0,"D"
2009-11-22,2009,"Genclerbirligi","Buyuksehyr","3-1",3,1,"T1",1,4,2,"H"
2009-11-22,2009,"Kasimpasa","Trabzonspor","3-1",3,1,"T1",1,4,2,"H"
2009-11-22,2009,"Kayserispor","Diyarbakirspor","2-0",2,0,"T1",1,2,2,"H"
2009-11-27,2009,"Bursaspor","Galatasaray","1-0",1,0,"T1",1,1,1,"H"
2009-11-28,2009,"Fenerbahce","Kasimpasa","1-3",1,3,"T1",1,4,-2,"A"
2009-11-29,2009,"Ankaragucu","Denizlispor","1-0",1,0,"T1",1,1,1,"H"
2009-11-29,2009,"Antalyaspor","Genclerbirligi","2-0",2,0,"T1",1,2,2,"H"
2009-11-29,2009,"Buyuksehyr","Gaziantepspor","1-1",1,1,"T1",1,2,0,"D"
2009-11-29,2009,"Manisaspor","Kayserispor","0-1",0,1,"T1",1,1,-1,"A"
2009-11-29,2009,"Sivasspor","Besiktas","0-1",0,1,"T1",1,1,-1,"A"
2009-11-29,2009,"Trabzonspor","Eskisehirspor","2-1",2,1,"T1",1,3,1,"H"
2009-12-04,2009,"Besiktas","Diyarbakirspor","0-0",0,0,"T1",1,0,0,"D"
2009-12-05,2009,"Eskisehirspor","Fenerbahce","2-1",2,1,"T1",1,3,1,"H"
2009-12-05,2009,"Kasimpasa","Sivasspor","2-2",2,2,"T1",1,4,0,"D"
2009-12-06,2009,"Galatasaray","Buyuksehyr","1-1",1,1,"T1",1,2,0,"D"
2009-12-06,2009,"Gaziantepspor","Antalyaspor","1-1",1,1,"T1",1,2,0,"D"
2009-12-06,2009,"Genclerbirligi","Denizlispor","2-0",2,0,"T1",1,2,2,"H"
2009-12-06,2009,"Kayserispor","Bursaspor","3-0",3,0,"T1",1,3,3,"H"
2009-12-06,2009,"Trabzonspor","Ankaragucu","3-0",3,0,"T1",1,3,3,"H"
2009-12-11,2009,"Antalyaspor","Galatasaray","2-3",2,3,"T1",1,5,-1,"A"
2009-12-12,2009,"Fenerbahce","Ankaragucu","3-2",3,2,"T1",1,5,1,"H"
2009-12-13,2009,"Buyuksehyr","Kayserispor","1-2",1,2,"T1",1,3,-1,"A"
2009-12-13,2009,"Denizlispor","Trabzonspor","0-1",0,1,"T1",1,1,-1,"A"
2009-12-13,2009,"Diyarbakirspor","Kasimpasa","2-2",2,2,"T1",1,4,0,"D"
2009-12-13,2009,"Genclerbirligi","Gaziantepspor","1-1",1,1,"T1",1,2,0,"D"
2009-12-13,2009,"Manisaspor","Besiktas","1-1",1,1,"T1",1,2,0,"D"
2009-12-13,2009,"Sivasspor","Eskisehirspor","2-1",2,1,"T1",1,3,1,"H"
2009-12-18,2009,"Besiktas","Bursaspor","2-3",2,3,"T1",1,5,-1,"A"
2009-12-19,2009,"Ankaragucu","Sivasspor","2-3",2,3,"T1",1,5,-1,"A"
2009-12-19,2009,"Eskisehirspor","Diyarbakirspor","0-0",0,0,"T1",1,0,0,"D"
2009-12-19,2009,"Galatasaray","Genclerbirligi","1-0",1,0,"T1",1,1,1,"H"
2009-12-19,2009,"Gaziantepspor","Denizlispor","2-1",2,1,"T1",1,3,1,"H"
2009-12-19,2009,"Kasimpasa","Manisaspor","3-1",3,1,"T1",1,4,2,"H"
2009-12-19,2009,"Kayserispor","Antalyaspor","1-2",1,2,"T1",1,3,-1,"A"
2009-12-20,2009,"Trabzonspor","Fenerbahce","0-1",0,1,"T1",1,1,-1,"A"
2010-01-22,2009,"Fenerbahce","Denizlispor","3-1",3,1,"T1",1,4,2,"H"
2010-01-23,2009,"Eskisehirspor","Manisaspor","1-0",1,0,"T1",1,1,1,"H"
2010-01-24,2009,"Ankaragucu","Diyarbakirspor","0-0",0,0,"T1",1,0,0,"D"
2010-01-24,2009,"Galatasaray","Gaziantepspor","1-0",1,0,"T1",1,1,1,"H"
2010-01-24,2009,"Kayserispor","Genclerbirligi","1-1",1,1,"T1",1,2,0,"D"
2010-01-24,2009,"Trabzonspor","Sivasspor","3-1",3,1,"T1",1,4,2,"H"
2010-01-29,2009,"Antalyaspor","Besiktas","0-1",0,1,"T1",1,1,-1,"A"
2010-01-30,2009,"Buyuksehyr","Kasimpasa","4-2",4,2,"T1",1,6,2,"H"
2010-01-30,2009,"Diyarbakirspor","Trabzonspor","1-2",1,2,"T1",1,3,-1,"A"
2010-01-31,2009,"Bursaspor","Eskisehirspor","3-1",3,1,"T1",1,4,2,"H"
2010-01-31,2009,"Denizlispor","Galatasaray","1-2",1,2,"T1",1,3,-1,"A"
2010-01-31,2009,"Gaziantepspor","Kayserispor","0-1",0,1,"T1",1,1,-1,"A"
2010-01-31,2009,"Manisaspor","Ankaragucu","0-0",0,0,"T1",1,0,0,"D"
2010-01-31,2009,"Sivasspor","Fenerbahce","1-5",1,5,"T1",1,6,-4,"A"
2010-02-05,2009,"Besiktas","Genclerbirligi","4-1",4,1,"T1",1,5,3,"H"
2010-02-06,2009,"Eskisehirspor","Buyuksehyr","2-1",2,1,"T1",1,3,1,"H"
2010-02-06,2009,"Kayserispor","Galatasaray","0-0",0,0,"T1",1,0,0,"D"
2010-02-07,2009,"Ankaragucu","Bursaspor","0-0",0,0,"T1",1,0,0,"D"
2010-02-07,2009,"Fenerbahce","Diyarbakirspor","1-1",1,1,"T1",1,2,0,"D"
2010-02-07,2009,"Kasimpasa","Antalyaspor","2-2",2,2,"T1",1,4,0,"D"
2010-02-07,2009,"Sivasspor","Denizlispor","2-0",2,0,"T1",1,2,2,"H"
2010-02-07,2009,"Trabzonspor","Manisaspor","3-0",3,0,"T1",1,3,3,"H"
2010-02-13,2009,"Diyarbakirspor","Sivasspor","1-1",1,1,"T1",1,2,0,"D"
2010-02-13,2009,"Gaziantepspor","Besiktas","2-0",2,0,"T1",1,2,2,"H"
2010-02-14,2009,"Antalyaspor","Eskisehirspor","1-2",1,2,"T1",1,3,-1,"A"
2010-02-14,2009,"Buyuksehyr","Ankaragucu","1-1",1,1,"T1",1,2,0,"D"
2010-02-14,2009,"Denizlispor","Kayserispor","1-0",1,0,"T1",1,1,1,"H"
2010-02-14,2009,"Genclerbirligi","Kasimpasa","0-2",0,2,"T1",1,2,-2,"A"
2010-02-14,2009,"Manisaspor","Fenerbahce","2-2",2,2,"T1",1,4,0,"D"
2010-02-15,2009,"Bursaspor","Trabzonspor","1-1",1,1,"T1",1,2,0,"D"
2010-02-20,2009,"Eskisehirspor","Genclerbirligi","0-0",0,0,"T1",1,0,0,"D"
2010-02-20,2009,"Sivasspor","Manisaspor","1-0",1,0,"T1",1,1,1,"H"
2010-02-20,2009,"Trabzonspor","Buyuksehyr","0-0",0,0,"T1",1,0,0,"D"
2010-02-21,2009,"Ankaragucu","Antalyaspor","2-2",2,2,"T1",1,4,0,"D"
2010-02-21,2009,"Besiktas","Galatasaray","1-1",1,1,"T1",1,2,0,"D"
2010-02-21,2009,"Diyarbakirspor","Denizlispor","0-2",0,2,"T1",1,2,-2,"A"
2010-02-21,2009,"Kasimpasa","Gaziantepspor","3-0",3,0,"T1",1,3,3,"H"
2010-02-22,2009,"Fenerbahce","Bursaspor","2-3",2,3,"T1",1,5,-1,"A"
2010-02-26,2009,"Antalyaspor","Trabzonspor","1-1",1,1,"T1",1,2,0,"D"
2010-02-27,2009,"Bursaspor","Sivasspor","3-0",3,0,"T1",1,3,3,"H"
2010-02-27,2009,"Kayserispor","Besiktas","1-2",1,2,"T1",1,3,-1,"A"
2010-02-28,2009,"Buyuksehyr","Fenerbahce","2-1",2,1,"T1",1,3,1,"H"
2010-02-28,2009,"Galatasaray","Kasimpasa","4-1",4,1,"T1",1,5,3,"H"
2010-02-28,2009,"Gaziantepspor","Eskisehirspor","1-1",1,1,"T1",1,2,0,"D"
2010-02-28,2009,"Genclerbirligi","Ankaragucu","0-1",0,1,"T1",1,1,-1,"A"
2010-02-28,2009,"Manisaspor","Diyarbakirspor","2-1",2,1,"T1",1,3,1,"H"
2010-03-06,2009,"Diyarbakirspor","Bursaspor","0-3",0,3,"T1",1,3,-3,"A"
2010-03-06,2009,"Kasimpasa","Kayserispor","2-2",2,2,"T1",1,4,0,"D"
2010-03-06,2009,"Sivasspor","Buyuksehyr","0-1",0,1,"T1",1,1,-1,"A"
2010-03-06,2009,"Trabzonspor","Genclerbirligi","3-1",3,1,"T1",1,4,2,"H"
2010-03-07,2009,"Ankaragucu","Gaziantepspor","0-0",0,0,"T1",1,0,0,"D"
2010-03-07,2009,"Fenerbahce","Antalyaspor","1-0",1,0,"T1",1,1,1,"H"
2010-03-07,2009,"Manisaspor","Denizlispor","0-0",0,0,"T1",1,0,0,"D"
2010-03-08,2009,"Eskisehirspor","Galatasaray","2-1",2,1,"T1",1,3,1,"H"
2010-03-10,2009,"Besiktas","Buyuksehyr","2-0",2,0,"T1",1,2,2,"H"
2010-03-10,2009,"Kasimpasa","Bursaspor","0-2",0,2,"T1",1,2,-2,"A"
2010-03-12,2009,"Gaziantepspor","Trabzonspor","1-1",1,1,"T1",1,2,0,"D"
2010-03-13,2009,"Genclerbirligi","Fenerbahce","0-0",0,0,"T1",1,0,0,"D"
2010-03-14,2009,"Antalyaspor","Sivasspor","3-0",3,0,"T1",1,3,3,"H"
2010-03-14,2009,"Bursaspor","Manisaspor","2-0",2,0,"T1",1,2,2,"H"
2010-03-14,2009,"Buyuksehyr","Diyarbakirspor","1-0",1,0,"T1",1,1,1,"H"
2010-03-14,2009,"Galatasaray","Ankaragucu","3-0",3,0,"T1",1,3,3,"H"
2010-03-14,2009,"Kayserispor","Eskisehirspor","1-2",1,2,"T1",1,3,-1,"A"
2010-03-15,2009,"Denizlispor","Besiktas","0-1",0,1,"T1",1,1,-1,"A"
2010-03-19,2009,"Kasimpasa","Besiktas","2-2",2,2,"T1",1,4,0,"D"
2010-03-20,2009,"Diyarbakirspor","Antalyaspor","1-0",1,0,"T1",1,1,1,"H"
2010-03-20,2009,"Fenerbahce","Gaziantepspor","1-0",1,0,"T1",1,1,1,"H"
2010-03-20,2009,"Manisaspor","Buyuksehyr","1-0",1,0,"T1",1,1,1,"H"
2010-03-21,2009,"Ankaragucu","Kayserispor","3-0",3,0,"T1",1,3,3,"H"
2010-03-21,2009,"Sivasspor","Genclerbirligi","0-2",0,2,"T1",1,2,-2,"A"
2010-03-21,2009,"Trabzonspor","Galatasaray","1-0",1,0,"T1",1,1,1,"H"
2010-03-22,2009,"Bursaspor","Denizlispor","2-1",2,1,"T1",1,3,1,"H"
2010-03-26,2009,"Buyuksehyr","Bursaspor","2-1",2,1,"T1",1,3,1,"H"
2010-03-27,2009,"Besiktas","Eskisehirspor","3-2",3,2,"T1",1,5,1,"H"
2010-03-27,2009,"Genclerbirligi","Diyarbakirspor","1-0",1,0,"T1",1,1,1,"H"
2010-03-28,2009,"Antalyaspor","Manisaspor","0-0",0,0,"T1",1,0,0,"D"
2010-03-28,2009,"Denizlispor","Kasimpasa","3-3",3,3,"T1",1,6,0,"D"
2010-03-28,2009,"Galatasaray","Fenerbahce","0-1",0,1,"T1",1,1,-1,"A"
2010-03-28,2009,"Gaziantepspor","Sivasspor","2-2",2,2,"T1",1,4,0,"D"
2010-03-29,2009,"Kayserispor","Trabzonspor","1-0",1,0,"T1",1,1,1,"H"
2010-04-02,2009,"Ankaragucu","Besiktas","0-0",0,0,"T1",1,0,0,"D"
2010-04-03,2009,"Bursaspor","Antalyaspor","2-1",2,1,"T1",1,3,1,"H"
2010-04-03,2009,"Buyuksehyr","Denizlispor","3-1",3,1,"T1",1,4,2,"H"
2010-04-04,2009,"Diyarbakirspor","Gaziantepspor","1-3",1,3,"T1",1,4,-2,"A"
2010-04-04,2009,"Eskisehirspor","Kasimpasa","2-0",2,0,"T1",1,2,2,"H"
2010-04-04,2009,"Fenerbahce","Kayserispor","2-0",2,0,"T1",1,2,2,"H"
2010-04-04,2009,"Manisaspor","Genclerbirligi","0-0",0,0,"T1",1,0,0,"D"
2010-04-05,2009,"Sivasspor","Galatasaray","1-1",1,1,"T1",1,2,0,"D"
2010-04-09,2009,"Gaziantepspor","Manisaspor","0-0",0,0,"T1",1,0,0,"D"
2010-04-10,2009,"Antalyaspor","Buyuksehyr","1-3",1,3,"T1",1,4,-2,"A"
2010-04-10,2009,"Besiktas","Trabzonspor","0-0",0,0,"T1",1,0,0,"D"
2010-04-11,2009,"Denizlispor","Eskisehirspor","1-0",1,0,"T1",1,1,1,"H"
2010-04-11,2009,"Galatasaray","Diyarbakirspor","4-1",4,1,"T1",1,5,3,"H"
2010-04-11,2009,"Genclerbirligi","Bursaspor","0-0",0,0,"T1",1,0,0,"D"
2010-04-11,2009,"Kasimpasa","Ankaragucu","2-0",2,0,"T1",1,2,2,"H"
2010-04-12,2009,"Kayserispor","Sivasspor","2-2",2,2,"T1",1,4,0,"D"
2010-04-16,2009,"Bursaspor","Gaziantepspor","2-0",2,0,"T1",1,2,2,"H"
2010-04-17,2009,"Buyuksehyr","Genclerbirligi","1-3",1,3,"T1",1,4,-2,"A"
2010-04-17,2009,"Manisaspor","Galatasaray","1-2",1,2,"T1",1,3,-1,"A"
2010-04-18,2009,"Ankaragucu","Eskisehirspor","3-1",3,1,"T1",1,4,2,"H"
2010-04-18,2009,"Antalyaspor","Denizlispor","2-1",2,1,"T1",1,3,1,"H"
2010-04-18,2009,"Diyarbakirspor","Kayserispor","0-3",0,3,"T1",1,3,-3,"A"
2010-04-18,2009,"Fenerbahce","Besiktas","1-0",1,0,"T1",1,1,1,"H"
2010-04-19,2009,"Trabzonspor","Kasimpasa","2-0",2,0,"T1",1,2,2,"H"
2010-04-24,2009,"Besiktas","Sivasspor","2-2",2,2,"T1",1,4,0,"D"
2010-04-24,2009,"Denizlispor","Ankaragucu","0-0",0,0,"T1",1,0,0,"D"
2010-04-24,2009,"Genclerbirligi","Antalyaspor","0-2",0,2,"T1",1,2,-2,"A"
2010-04-24,2009,"Kayserispor","Manisaspor","1-2",1,2,"T1",1,3,-1,"A"
2010-04-25,2009,"Galatasaray","Bursaspor","0-0",0,0,"T1",1,0,0,"D"
2010-04-25,2009,"Gaziantepspor","Buyuksehyr","2-3",2,3,"T1",1,5,-1,"A"
2010-04-25,2009,"Kasimpasa","Fenerbahce","0-1",0,1,"T1",1,1,-1,"A"
2010-04-26,2009,"Eskisehirspor","Trabzonspor","1-0",1,0,"T1",1,1,1,"H"
2010-05-01,2009,"Ankaragucu","Trabzonspor","1-0",1,0,"T1",1,1,1,"H"
2010-05-01,2009,"Bursaspor","Kayserispor","2-0",2,0,"T1",1,2,2,"H"
2010-05-01,2009,"Buyuksehyr","Galatasaray","0-1",0,1,"T1",1,1,-1,"A"
2010-05-01,2009,"Fenerbahce","Eskisehirspor","2-0",2,0,"T1",1,2,2,"H"
2010-05-02,2009,"Antalyaspor","Gaziantepspor","1-0",1,0,"T1",1,1,1,"H"
2010-05-02,2009,"Denizlispor","Genclerbirligi","2-0",2,0,"T1",1,2,2,"H"
2010-05-02,2009,"Diyarbakirspor","Besiktas","1-3",1,3,"T1",1,4,-2,"A"
2010-05-02,2009,"Sivasspor","Kasimpasa","1-1",1,1,"T1",1,2,0,"D"
2010-05-07,2009,"Besiktas","Manisaspor","2-0",2,0,"T1",1,2,2,"H"
2010-05-08,2009,"Galatasaray","Antalyaspor","1-2",1,2,"T1",1,3,-1,"A"
2010-05-08,2009,"Gaziantepspor","Genclerbirligi","1-1",1,1,"T1",1,2,0,"D"
2010-05-09,2009,"Ankaragucu","Fenerbahce","0-3",0,3,"T1",1,3,-3,"A"
2010-05-09,2009,"Eskisehirspor","Sivasspor","1-1",1,1,"T1",1,2,0,"D"
2010-05-09,2009,"Kasimpasa","Diyarbakirspor","1-0",1,0,"T1",1,1,1,"H"
2010-05-09,2009,"Kayserispor","Buyuksehyr","1-1",1,1,"T1",1,2,0,"D"
2010-05-10,2009,"Trabzonspor","Denizlispor","2-1",2,1,"T1",1,3,1,"H"
2010-05-15,2009,"Antalyaspor","Kayserispor","4-0",4,0,"T1",1,4,4,"H"
2010-05-15,2009,"Denizlispor","Gaziantepspor","1-1",1,1,"T1",1,2,0,"D"
2010-05-15,2009,"Diyarbakirspor","Eskisehirspor","0-2",0,2,"T1",1,2,-2,"A"
2010-05-15,2009,"Sivasspor","Ankaragucu","3-3",3,3,"T1",1,6,0,"D"
2010-05-16,2009,"Bursaspor","Besiktas","2-1",2,1,"T1",1,3,1,"H"
2010-05-16,2009,"Fenerbahce","Trabzonspor","1-1",1,1,"T1",1,2,0,"D"
2010-05-16,2009,"Genclerbirligi","Galatasaray","2-1",2,1,"T1",1,3,1,"H"
2010-05-16,2009,"Manisaspor","Kasimpasa","0-0",0,0,"T1",1,0,0,"D"
2010-08-14,2010,"Bucaspor","Besiktas","0-1",0,1,"T1",1,1,-1,"A"
2010-08-14,2010,"Eskisehirspor","Genclerbirligi","0-0",0,0,"T1",1,0,0,"D"
2010-08-14,2010,"Gaziantepspor","Kasimpasa","0-0",0,0,"T1",1,0,0,"D"
2010-08-14,2010,"Sivasspor","Galatasaray","2-1",2,1,"T1",1,3,1,"H"
2010-08-15,2010,"Ankaragucu","Trabzonspor","0-2",0,2,"T1",1,2,-2,"A"
2010-08-15,2010,"Fenerbahce","Antalyaspor","4-0",4,0,"T1",1,4,4,"H"
2010-08-15,2010,"Karabukspor","Manisaspor","2-1",2,1,"T1",1,3,1,"H"
2010-08-16,2010,"Bursaspor","Konyaspor","1-0",1,0,"T1",1,1,1,"H"
2010-08-16,2010,"Buyuksehyr","Kayserispor","0-2",0,2,"T1",1,2,-2,"A"
2010-08-20,2010,"Kayserispor","Karabukspor","1-0",1,0,"T1",1,1,1,"H"
2010-08-20,2010,"Konyaspor","Eskisehirspor","2-1",2,1,"T1",1,3,1,"H"
2010-08-21,2010,"Antalyaspor","Sivasspor","1-1",1,1,"T1",1,2,0,"D"
2010-08-21,2010,"Besiktas","Buyuksehyr","0-2",0,2,"T1",1,2,-2,"A"
2010-08-22,2010,"Galatasaray","Bursaspor","0-2",0,2,"T1",1,2,-2,"A"
2010-08-22,2010,"Genclerbirligi","Gaziantepspor","0-0",0,0,"T1",1,0,0,"D"
2010-08-22,2010,"Manisaspor","Ankaragucu","0-3",0,3,"T1",1,3,-3,"A"
2010-08-23,2010,"Kasimpasa","Bucaspor","0-0",0,0,"T1",1,0,0,"D"
2010-08-23,2010,"Trabzonspor","Fenerbahce","3-2",3,2,"T1",1,5,1,"H"
2010-08-27,2010,"Ankaragucu","Kayserispor","1-1",1,1,"T1",1,2,0,"D"
2010-08-27,2010,"Gaziantepspor","Konyaspor","2-2",2,2,"T1",1,4,0,"D"
2010-08-28,2010,"Bucaspor","Genclerbirligi","3-1",3,1,"T1",1,4,2,"H"
2010-08-28,2010,"Buyuksehyr","Kasimpasa","3-1",3,1,"T1",1,4,2,"H"
2010-08-28,2010,"Sivasspor","Bursaspor","0-2",0,2,"T1",1,2,-2,"A"
2010-08-29,2010,"Eskisehirspor","Galatasaray","1-3",1,3,"T1",1,4,-2,"A"
2010-08-29,2010,"Fenerbahce","Manisaspor","4-2",4,2,"T1",1,6,2,"H"
2010-08-29,2010,"Karabukspor","Besiktas","1-4",1,4,"T1",1,5,-3,"A"
2010-08-30,2010,"Antalyaspor","Trabzonspor","0-0",0,0,"T1",1,0,0,"D"
2010-09-10,2010,"Bursaspor","Eskisehirspor","2-1",2,1,"T1",1,3,1,"H"
2010-09-11,2010,"Besiktas","Ankaragucu","4-0",4,0,"T1",1,4,4,"H"
2010-09-11,2010,"Kayserispor","Fenerbahce","2-0",2,0,"T1",1,2,2,"H"
2010-09-11,2010,"Konyaspor","Bucaspor","1-1",1,1,"T1",1,2,0,"D"
2010-09-11,2010,"Manisaspor","Antalyaspor","1-2",1,2,"T1",1,3,-1,"A"
2010-09-13,2010,"Galatasaray","Gaziantepspor","1-0",1,0,"T1",1,1,1,"H"
2010-09-13,2010,"Genclerbirligi","Buyuksehyr","2-1",2,1,"T1",1,3,1,"H"
2010-09-13,2010,"Kasimpasa","Karabukspor","1-2",1,2,"T1",1,3,-1,"A"
2010-09-13,2010,"Trabzonspor","Sivasspor","6-1",6,1,"T1",1,7,5,"H"
2010-09-17,2010,"Trabzonspor","Manisaspor","1-3",1,3,"T1",1,4,-2,"A"
2010-09-18,2010,"Ankaragucu","Kasimpasa","3-0",3,0,"T1",1,3,3,"H"
2010-09-18,2010,"Antalyaspor","Kayserispor","2-1",2,1,"T1",1,3,1,"H"
2010-09-18,2010,"Bucaspor","Galatasaray","0-1",0,1,"T1",1,1,-1,"A"
2010-09-18,2010,"Sivasspor","Eskisehirspor","1-1",1,1,"T1",1,2,0,"D"
2010-09-19,2010,"Buyuksehyr","Konyaspor","1-0",1,0,"T1",1,1,1,"H"
2010-09-19,2010,"Fenerbahce","Besiktas","1-1",1,1,"T1",1,2,0,"D"
2010-09-19,2010,"Karabukspor","Genclerbirligi","3-0",3,0,"T1",1,3,3,"H"
2010-09-20,2010,"Gaziantepspor","Bursaspor","0-3",0,3,"T1",1,3,-3,"A"
2010-09-24,2010,"Bursaspor","Bucaspor","1-0",1,0,"T1",1,1,1,"H"
2010-09-25,2010,"Besiktas","Antalyaspor","2-1",2,1,"T1",1,3,1,"H"
2010-09-25,2010,"Eskisehirspor","Gaziantepspor","0-1",0,1,"T1",1,1,-1,"A"
2010-09-25,2010,"Genclerbirligi","Ankaragucu","1-0",1,0,"T1",1,1,1,"H"
2010-09-26,2010,"Galatasaray","Buyuksehyr","3-1",3,1,"T1",1,4,2,"H"
2010-09-26,2010,"Kayserispor","Trabzonspor","0-0",0,0,"T1",1,0,0,"D"
2010-09-26,2010,"Konyaspor","Karabukspor","2-2",2,2,"T1",1,4,0,"D"
2010-09-26,2010,"Manisaspor","Sivasspor","3-0",3,0,"T1",1,3,3,"H"
2010-09-27,2010,"Kasimpasa","Fenerbahce","2-6",2,6,"T1",1,8,-4,"A"
2010-10-01,2010,"Bucaspor","Eskisehirspor","0-0",0,0,"T1",1,0,0,"D"
2010-10-01,2010,"Karabukspor","Galatasaray","2-1",2,1,"T1",1,3,1,"H"
2010-10-02,2010,"Ankaragucu","Konyaspor","4-1",4,1,"T1",1,5,3,"H"
2010-10-02,2010,"Fenerbahce","Genclerbirligi","3-0",3,0,"T1",1,3,3,"H"
2010-10-02,2010,"Manisaspor","Kayserispor","0-2",0,2,"T1",1,2,-2,"A"
2010-10-03,2010,"Antalyaspor","Kasimpasa","3-1",3,1,"T1",1,4,2,"H"
2010-10-03,2010,"Buyuksehyr","Bursaspor","0-0",0,0,"T1",1,0,0,"D"
2010-10-03,2010,"Sivasspor","Gaziantepspor","1-1",1,1,"T1",1,2,0,"D"
2010-10-03,2010,"Trabzonspor","Besiktas","1-0",1,0,"T1",1,1,1,"H"
2010-10-15,2010,"Bursaspor","Karabukspor","2-2",2,2,"T1",1,4,0,"D"
2010-10-16,2010,"Besiktas","Manisaspor","2-3",2,3,"T1",1,5,-1,"A"
2010-10-16,2010,"Eskisehirspor","Buyuksehyr","1-0",1,0,"T1",1,1,1,"H"
2010-10-16,2010,"Gaziantepspor","Bucaspor","2-0",2,0,"T1",1,2,2,"H"
2010-10-17,2010,"Galatasaray","Ankaragucu","2-4",2,4,"T1",1,6,-2,"A"
2010-10-17,2010,"Genclerbirligi","Antalyaspor","2-3",2,3,"T1",1,5,-1,"A"
2010-10-17,2010,"Kasimpasa","Trabzonspor","0-7",0,7,"T1",1,7,-7,"A"
2010-10-17,2010,"Kayserispor","Sivasspor","4-1",4,1,"T1",1,5,3,"H"
2010-10-18,2010,"Konyaspor","Fenerbahce","1-4",1,4,"T1",1,5,-3,"A"
2010-10-22,2010,"Karabukspor","Eskisehirspor","1-2",1,2,"T1",1,3,-1,"A"
2010-10-22,2010,"Sivasspor","Bucaspor","1-1",1,1,"T1",1,2,0,"D"
2010-10-23,2010,"Antalyaspor","Konyaspor","1-0",1,0,"T1",1,1,1,"H"
2010-10-23,2010,"Buyuksehyr","Gaziantepspor","1-0",1,0,"T1",1,1,1,"H"
2010-10-23,2010,"Trabzonspor","Genclerbirligi","3-1",3,1,"T1",1,4,2,"H"
2010-10-24,2010,"Ankaragucu","Bursaspor","1-5",1,5,"T1",1,6,-4,"A"
2010-10-24,2010,"Fenerbahce","Galatasaray","0-0",0,0,"T1",1,0,0,"D"
2010-10-24,2010,"Manisaspor","Kasimpasa","2-1",2,1,"T1",1,3,1,"H"
2010-10-25,2010,"Kayserispor","Besiktas","1-0",1,0,"T1",1,1,1,"H"
2010-10-29,2010,"Bursaspor","Fenerbahce","1-1",1,1,"T1",1,2,0,"D"
2010-10-30,2010,"Eskisehirspor","Ankaragucu","0-0",0,0,"T1",1,0,0,"D"
2010-10-30,2010,"Galatasaray","Antalyaspor","2-1",2,1,"T1",1,3,1,"H"
2010-10-30,2010,"Gaziantepspor","Karabukspor","0-0",0,0,"T1",1,0,0,"D"
2010-10-31,2010,"Besiktas","Sivasspor","2-1",2,1,"T1",1,3,1,"H"
2010-10-31,2010,"Bucaspor","Buyuksehyr","0-2",0,2,"T1",1,2,-2,"A"
2010-10-31,2010,"Genclerbirligi","Manisaspor","2-0",2,0,"T1",1,2,2,"H"
2010-10-31,2010,"Kasimpasa","Kayserispor","1-2",1,2,"T1",1,3,-1,"A"
2010-11-01,2010,"Konyaspor","Trabzonspor","1-2",1,2,"T1",1,3,-1,"A"
2010-11-05,2010,"Kayserispor","Genclerbirligi","1-1",1,1,"T1",1,2,0,"D"
2010-11-06,2010,"Ankaragucu","Gaziantepspor","0-2",0,2,"T1",1,2,-2,"A"
2010-11-06,2010,"Antalyaspor","Bursaspor","2-2",2,2,"T1",1,4,0,"D"
2010-11-06,2010,"Fenerbahce","Eskisehirspor","4-2",4,2,"T1",1,6,2,"H"
2010-11-06,2010,"Karabukspor","Bucaspor","3-0",3,0,"T1",1,3,3,"H"
2010-11-07,2010,"Manisaspor","Konyaspor","0-1",0,1,"T1",1,1,-1,"A"
2010-11-07,2010,"Sivasspor","Buyuksehyr","0-4",0,4,"T1",1,4,-4,"A"
2010-11-07,2010,"Trabzonspor","Galatasaray","2-0",2,0,"T1",1,2,2,"H"
2010-11-08,2010,"Besiktas","Kasimpasa","1-1",1,1,"T1",1,2,0,"D"
2010-11-12,2010,"Konyaspor","Kayserispor","0-1",0,1,"T1",1,1,-1,"A"
2010-11-13,2010,"Bucaspor","Ankaragucu","0-0",0,0,"T1",1,0,0,"D"
2010-11-13,2010,"Bursaspor","Trabzonspor","0-2",0,2,"T1",1,2,-2,"A"
2010-11-13,2010,"Eskisehirspor","Antalyaspor","0-0",0,0,"T1",1,0,0,"D"
2010-11-13,2010,"Gaziantepspor","Fenerbahce","2-1",2,1,"T1",1,3,1,"H"
2010-11-14,2010,"Buyuksehyr","Karabukspor","2-1",2,1,"T1",1,3,1,"H"
2010-11-14,2010,"Galatasaray","Manisaspor","0-2",0,2,"T1",1,2,-2,"A"
2010-11-14,2010,"Genclerbirligi","Besiktas","0-2",0,2,"T1",1,2,-2,"A"
2010-11-14,2010,"Kasimpasa","Sivasspor","2-0",2,0,"T1",1,2,2,"H"
2010-11-20,2010,"Besiktas","Konyaspor","2-2",2,2,"T1",1,4,0,"D"
2010-11-20,2010,"Kasimpasa","Genclerbirligi","1-1",1,1,"T1",1,2,0,"D"
2010-11-20,2010,"Manisaspor","Bursaspor","0-2",0,2,"T1",1,2,-2,"A"
2010-11-20,2010,"Sivasspor","Karabukspor","5-1",5,1,"T1",1,6,4,"H"
2010-11-21,2010,"Ankaragucu","Buyuksehyr","2-2",2,2,"T1",1,4,0,"D"
2010-11-21,2010,"Antalyaspor","Gaziantepspor","0-1",0,1,"T1",1,1,-1,"A"
2010-11-21,2010,"Kayserispor","Galatasaray","0-0",0,0,"T1",1,0,0,"D"
2010-11-21,2010,"Trabzonspor","Eskisehirspor","0-0",0,0,"T1",1,0,0,"D"
2010-11-22,2010,"Fenerbahce","Bucaspor","5-2",5,2,"T1",1,7,3,"H"
2010-11-26,2010,"Eskisehirspor","Manisaspor","2-1",2,1,"T1",1,3,1,"H"
2010-11-27,2010,"Buyuksehyr","Fenerbahce","0-1",0,1,"T1",1,1,-1,"A"
2010-11-27,2010,"Gaziantepspor","Trabzonspor","1-3",1,3,"T1",1,4,-2,"A"
2010-11-27,2010,"Genclerbirligi","Sivasspor","1-1",1,1,"T1",1,2,0,"D"
2010-11-27,2010,"Konyaspor","Kasimpasa","2-2",2,2,"T1",1,4,0,"D"
2010-11-28,2010,"Bucaspor","Antalyaspor","1-0",1,0,"T1",1,1,1,"H"
2010-11-28,2010,"Galatasaray","Besiktas","1-2",1,2,"T1",1,3,-1,"A"
2010-11-28,2010,"Karabukspor","Ankaragucu","5-1",5,1,"T1",1,6,4,"H"
2010-11-29,2010,"Bursaspor","Kayserispor","2-0",2,0,"T1",1,2,2,"H"
2010-12-03,2010,"Trabzonspor","Bucaspor","2-0",2,0,"T1",1,2,2,"H"
2010-12-04,2010,"Ankaragucu","Sivasspor","1-1",1,1,"T1",1,2,0,"D"
2010-12-04,2010,"Kasimpasa","Galatasaray","0-3",0,3,"T1",1,3,-3,"A"
2010-12-04,2010,"Manisaspor","Gaziantepspor","2-0",2,0,"T1",1,2,2,"H"
2010-12-05,2010,"Antalyaspor","Buyuksehyr","1-0",1,0,"T1",1,1,1,"H"
2010-12-05,2010,"Besiktas","Bursaspor","1-0",1,0,"T1",1,1,1,"H"
2010-12-05,2010,"Fenerbahce","Karabukspor","2-1",2,1,"T1",1,3,1,"H"
2010-12-05,2010,"Konyaspor","Genclerbirligi","2-1",2,1,"T1",1,3,1,"H"
2010-12-06,2010,"Kayserispor","Eskisehirspor","2-2",2,2,"T1",1,4,0,"D"
2010-12-10,2010,"Eskisehirspor","Besiktas","2-0",2,0,"T1",1,2,2,"H"
2010-12-11,2010,"Bucaspor","Manisaspor","1-1",1,1,"T1",1,2,0,"D"
2010-12-11,2010,"Galatasaray","Genclerbirligi","0-2",0,2,"T1",1,2,-2,"A"
2010-12-11,2010,"Karabukspor","Antalyaspor","2-0",2,0,"T1",1,2,2,"H"
2010-12-12,2010,"Ankaragucu","Fenerbahce","2-1",2,1,"T1",1,3,1,"H"
2010-12-12,2010,"Buyuksehyr","Trabzonspor","1-3",1,3,"T1",1,4,-2,"A"
2010-12-12,2010,"Gaziantepspor","Kayserispor","2-0",2,0,"T1",1,2,2,"H"
2010-12-12,2010,"Sivasspor","Konyaspor","1-0",1,0,"T1",1,1,1,"H"
2010-12-13,2010,"Bursaspor","Kasimpasa","2-1",2,1,"T1",1,3,1,"H"
2010-12-17,2010,"Trabzonspor","Karabukspor","3-0",3,0,"T1",1,3,3,"H"
2010-12-18,2010,"Antalyaspor","Ankaragucu","2-2",2,2,"T1",1,4,0,"D"
2010-12-18,2010,"Fenerbahce","Sivasspor","1-0",1,0,"T1",1,1,1,"H"
2010-12-18,2010,"Genclerbirligi","Bursaspor","1-5",1,5,"T1",1,6,-4,"A"
2010-12-18,2010,"Kayserispor","Bucaspor","2-0",2,0,"T1",1,2,2,"H"
2010-12-19,2010,"Besiktas","Gaziantepspor","1-1",1,1,"T1",1,2,0,"D"
2010-12-19,2010,"Kasimpasa","Eskisehirspor","0-2",0,2,"T1",1,2,-2,"A"
2010-12-19,2010,"Konyaspor","Galatasaray","0-1",0,1,"T1",1,1,-1,"A"
2010-12-19,2010,"Manisaspor","Buyuksehyr","1-0",1,0,"T1",1,1,1,"H"
2011-01-21,2010,"Besiktas","Bucaspor","5-1",5,1,"T1",1,6,4,"H"
2011-01-22,2010,"Antalyaspor","Fenerbahce","0-1",0,1,"T1",1,1,-1,"A"
2011-01-22,2010,"Genclerbirligi","Eskisehirspor","0-1",0,1,"T1",1,1,-1,"A"
2011-01-22,2010,"Manisaspor","Karabukspor","4-2",4,2,"T1",1,6,2,"H"
2011-01-22,2010,"Trabzonspor","Ankaragucu","1-1",1,1,"T1",1,2,0,"D"
2011-01-23,2010,"Galatasaray","Sivasspor","1-0",1,0,"T1",1,1,1,"H"
2011-01-23,2010,"Kasimpasa","Gaziantepspor","0-1",0,1,"T1",1,1,-1,"A"
2011-01-23,2010,"Konyaspor","Bursaspor","0-0",0,0,"T1",1,0,0,"D"
2011-01-24,2010,"Kayserispor","Buyuksehyr","3-2",3,2,"T1",1,5,1,"H"
2011-01-29,2010,"Bucaspor","Kasimpasa","4-0",4,0,"T1",1,4,4,"H"
2011-01-29,2010,"Bursaspor","Galatasaray","2-0",2,0,"T1",1,2,2,"H"
2011-01-29,2010,"Karabukspor","Kayserispor","0-0",0,0,"T1",1,0,0,"D"
2011-01-29,2010,"Sivasspor","Antalyaspor","1-1",1,1,"T1",1,2,0,"D"
2011-01-30,2010,"Ankaragucu","Manisaspor","1-3",1,3,"T1",1,4,-2,"A"
2011-01-30,2010,"Buyuksehyr","Besiktas","2-1",2,1,"T1",1,3,1,"H"
2011-01-30,2010,"Fenerbahce","Trabzonspor","2-0",2,0,"T1",1,2,2,"H"
2011-01-30,2010,"Gaziantepspor","Genclerbirligi","1-1",1,1,"T1",1,2,0,"D"
2011-01-31,2010,"Eskisehirspor","Konyaspor","1-0",1,0,"T1",1,1,1,"H"
2011-02-04,2010,"Bursaspor","Sivasspor","2-1",2,1,"T1",1,3,1,"H"
2011-02-05,2010,"Besiktas","Karabukspor","1-1",1,1,"T1",1,2,0,"D"
2011-02-05,2010,"Kasimpasa","Buyuksehyr","1-3",1,3,"T1",1,4,-2,"A"
2011-02-05,2010,"Kayserispor","Ankaragucu","2-1",2,1,"T1",1,3,1,"H"
2011-02-05,2010,"Manisaspor","Fenerbahce","1-3",1,3,"T1",1,4,-2,"A"
2011-02-06,2010,"Galatasaray","Eskisehirspor","4-2",4,2,"T1",1,6,2,"H"
2011-02-06,2010,"Genclerbirligi","Bucaspor","1-0",1,0,"T1",1,1,1,"H"
2011-02-06,2010,"Konyaspor","Gaziantepspor","0-2",0,2,"T1",1,2,-2,"A"
2011-02-06,2010,"Trabzonspor","Antalyaspor","0-0",0,0,"T1",1,0,0,"D"
2011-02-12,2010,"Bucaspor","Konyaspor","3-2",3,2,"T1",1,5,1,"H"
2011-02-12,2010,"Buyuksehyr","Genclerbirligi","0-1",0,1,"T1",1,1,-1,"A"
2011-02-12,2010,"Gaziantepspor","Galatasaray","1-0",1,0,"T1",1,1,1,"H"
2011-02-12,2010,"Sivasspor","Trabzonspor","2-3",2,3,"T1",1,5,-1,"A"
2011-02-13,2010,"Ankaragucu","Besiktas","1-0",1,0,"T1",1,1,1,"H"
2011-02-13,2010,"Antalyaspor","Manisaspor","1-4",1,4,"T1",1,5,-3,"A"
2011-02-13,2010,"Eskisehirspor","Bursaspor","1-1",1,1,"T1",1,2,0,"D"
2011-02-13,2010,"Karabukspor","Kasimpasa","1-3",1,3,"T1",1,4,-2,"A"
2011-02-14,2010,"Fenerbahce","Kayserispor","2-0",2,0,"T1",1,2,2,"H"
2011-02-18,2010,"Eskisehirspor","Sivasspor","2-1",2,1,"T1",1,3,1,"H"
2011-02-19,2010,"Bursaspor","Gaziantepspor","1-4",1,4,"T1",1,5,-3,"A"
2011-02-19,2010,"Galatasaray","Bucaspor","1-0",1,0,"T1",1,1,1,"H"
2011-02-19,2010,"Genclerbirligi","Karabukspor","2-3",2,3,"T1",1,5,-1,"A"
2011-02-19,2010,"Kasimpasa","Ankaragucu","2-1",2,1,"T1",1,3,1,"H"
2011-02-20,2010,"Besiktas","Fenerbahce","2-4",2,4,"T1",1,6,-2,"A"
2011-02-20,2010,"Kayserispor","Antalyaspor","2-0",2,0,"T1",1,2,2,"H"
2011-02-20,2010,"Konyaspor","Buyuksehyr","0-0",0,0,"T1",1,0,0,"D"
2011-02-21,2010,"Manisaspor","Trabzonspor","1-2",1,2,"T1",1,3,-1,"A"
2011-02-25,2010,"Bucaspor","Bursaspor","0-2",0,2,"T1",1,2,-2,"A"
2011-02-26,2010,"Ankaragucu","Genclerbirligi","2-4",2,4,"T1",1,6,-2,"A"
2011-02-26,2010,"Buyuksehyr","Galatasaray","3-1",3,1,"T1",1,4,2,"H"
2011-02-26,2010,"Fenerbahce","Kasimpasa","2-0",2,0,"T1",1,2,2,"H"
2011-02-26,2010,"Gaziantepspor","Eskisehirspor","2-1",2,1,"T1",1,3,1,"H"
2011-02-27,2010,"Karabukspor","Konyaspor","2-1",2,1,"T1",1,3,1,"H"
2011-02-27,2010,"Sivasspor","Manisaspor","4-2",4,2,"T1",1,6,2,"H"
2011-02-27,2010,"Trabzonspor","Kayserispor","3-3",3,3,"T1",1,6,0,"D"
2011-02-28,2010,"Antalyaspor","Besiktas","0-2",0,2,"T1",1,2,-2,"A"
2011-03-04,2010,"Kayserispor","Manisaspor","1-2",1,2,"T1",1,3,-1,"A"
2011-03-05,2010,"Galatasaray","Karabukspor","0-0",0,0,"T1",1,0,0,"D"
2011-03-05,2010,"Gaziantepspor","Sivasspor","3-1",3,1,"T1",1,4,2,"H"
2011-03-05,2010,"Konyaspor","Ankaragucu","0-2",0,2,"T1",1,2,-2,"A"
2011-03-06,2010,"Besiktas","Trabzonspor","1-2",1,2,"T1",1,3,-1,"A"
2011-03-06,2010,"Bursaspor","Buyuksehyr","1-1",1,1,"T1",1,2,0,"D"
2011-03-06,2010,"Eskisehirspor","Bucaspor","1-0",1,0,"T1",1,1,1,"H"
2011-03-06,2010,"Kasimpasa","Antalyaspor","2-3",2,3,"T1",1,5,-1,"A"
2011-03-07,2010,"Genclerbirligi","Fenerbahce","2-4",2,4,"T1",1,6,-2,"A"
2011-03-11,2010,"Manisaspor","Besiktas","0-0",0,0,"T1",1,0,0,"D"
2011-03-12,2010,"Buyuksehyr","Eskisehirspor","0-2",0,2,"T1",1,2,-2,"A"
2011-03-12,2010,"Karabukspor","Bursaspor","1-1",1,1,"T1",1,2,0,"D"
2011-03-12,2010,"Trabzonspor","Kasimpasa","1-0",1,0,"T1",1,1,1,"H"
2011-03-13,2010,"Ankaragucu","Galatasaray","3-2",3,2,"T1",1,5,1,"H"
2011-03-13,2010,"Antalyaspor","Genclerbirligi","0-0",0,0,"T1",1,0,0,"D"
2011-03-13,2010,"Bucaspor","Gaziantepspor","2-1",2,1,"T1",1,3,1,"H"
2011-03-13,2010,"Fenerbahce","Konyaspor","2-0",2,0,"T1",1,2,2,"H"
2011-03-13,2010,"Sivasspor","Kayserispor","1-0",1,0,"T1",1,1,1,"H"
2011-03-18,2010,"Galatasaray","Fenerbahce","1-2",1,2,"T1",1,3,-1,"A"
2011-03-19,2010,"Besiktas","Kayserispor","4-2",4,2,"T1",1,6,2,"H"
2011-03-19,2010,"Gaziantepspor","Buyuksehyr","4-1",4,1,"T1",1,5,3,"H"
2011-03-19,2010,"Kasimpasa","Manisaspor","1-0",1,0,"T1",1,1,1,"H"
2011-03-19,2010,"Konyaspor","Antalyaspor","0-0",0,0,"T1",1,0,0,"D"
2011-03-20,2010,"Bucaspor","Sivasspor","0-4",0,4,"T1",1,4,-4,"A"
2011-03-20,2010,"Eskisehirspor","Karabukspor","1-0",1,0,"T1",1,1,1,"H"
2011-03-20,2010,"Genclerbirligi","Trabzonspor","1-2",1,2,"T1",1,3,-1,"A"
2011-03-21,2010,"Bursaspor","Ankaragucu","0-0",0,0,"T1",1,0,0,"D"
2011-04-02,2010,"Ankaragucu","Eskisehirspor","2-2",2,2,"T1",1,4,0,"D"
2011-04-02,2010,"Karabukspor","Gaziantepspor","3-2",3,2,"T1",1,5,1,"H"
2011-04-02,2010,"Sivasspor","Besiktas","1-0",1,0,"T1",1,1,1,"H"
2011-04-02,2010,"Trabzonspor","Konyaspor","1-0",1,0,"T1",1,1,1,"H"
2011-04-03,2010,"Buyuksehyr","Bucaspor","2-1",2,1,"T1",1,3,1,"H"
2011-04-03,2010,"Fenerbahce","Bursaspor","0-0",0,0,"T1",1,0,0,"D"
2011-04-03,2010,"Kayserispor","Kasimpasa","1-3",1,3,"T1",1,4,-2,"A"
2011-04-03,2010,"Manisaspor","Genclerbirligi","0-3",0,3,"T1",1,3,-3,"A"
2011-04-04,2010,"Antalyaspor","Galatasaray","3-0",3,0,"T1",1,3,3,"H"
2011-04-08,2010,"Bursaspor","Antalyaspor","2-3",2,3,"T1",1,5,-1,"A"
2011-04-09,2010,"Bucaspor","Karabukspor","2-1",2,1,"T1",1,3,1,"H"
2011-04-09,2010,"Eskisehirspor","Fenerbahce","1-3",1,3,"T1",1,4,-2,"A"
2011-04-09,2010,"Konyaspor","Manisaspor","0-0",0,0,"T1",1,0,0,"D"
2011-04-10,2010,"Buyuksehyr","Sivasspor","1-2",1,2,"T1",1,3,-1,"A"
2011-04-10,2010,"Galatasaray","Trabzonspor","0-1",0,1,"T1",1,1,-1,"A"
2011-04-10,2010,"Gaziantepspor","Ankaragucu","3-2",3,2,"T1",1,5,1,"H"
2011-04-10,2010,"Genclerbirligi","Kayserispor","4-1",4,1,"T1",1,5,3,"H"
2011-04-11,2010,"Kasimpasa","Besiktas","0-1",0,1,"T1",1,1,-1,"A"
2011-04-15,2010,"Besiktas","Genclerbirligi","2-2",2,2,"T1",1,4,0,"D"
2011-04-16,2010,"Ankaragucu","Bucaspor","5-3",5,3,"T1",1,8,2,"H"
2011-04-16,2010,"Fenerbahce","Gaziantepspor","1-0",1,0,"T1",1,1,1,"H"
2011-04-16,2010,"Karabukspor","Buyuksehyr","0-2",0,2,"T1",1,2,-2,"A"
2011-04-17,2010,"Antalyaspor","Eskisehirspor","2-2",2,2,"T1",1,4,0,"D"
2011-04-17,2010,"Kayserispor","Konyaspor","1-3",1,3,"T1",1,4,-2,"A"
2011-04-17,2010,"Sivasspor","Kasimpasa","1-1",1,1,"T1",1,2,0,"D"
2011-04-17,2010,"Trabzonspor","Bursaspor","1-0",1,0,"T1",1,1,1,"H"
2011-04-18,2010,"Manisaspor","Galatasaray","2-3",2,3,"T1",1,5,-1,"A"
2011-04-22,2010,"Eskisehirspor","Trabzonspor","0-0",0,0,"T1",1,0,0,"D"
2011-04-23,2010,"Bursaspor","Manisaspor","2-1",2,1,"T1",1,3,1,"H"
2011-04-23,2010,"Galatasaray","Kayserispor","1-1",1,1,"T1",1,2,0,"D"
2011-04-23,2010,"Karabukspor","Sivasspor","2-1",2,1,"T1",1,3,1,"H"
2011-04-24,2010,"Bucaspor","Fenerbahce","3-5",3,5,"T1",1,8,-2,"A"
2011-04-24,2010,"Buyuksehyr","Ankaragucu","1-4",1,4,"T1",1,5,-3,"A"
2011-04-24,2010,"Gaziantepspor","Antalyaspor","2-1",2,1,"T1",1,3,1,"H"
2011-04-24,2010,"Genclerbirligi","Kasimpasa","1-1",1,1,"T1",1,2,0,"D"
2011-04-25,2010,"Konyaspor","Besiktas","1-1",1,1,"T1",1,2,0,"D"
2011-04-29,2010,"Sivasspor","Genclerbirligi","1-1",1,1,"T1",1,2,0,"D"
2011-04-30,2010,"Antalyaspor","Bucaspor","3-3",3,3,"T1",1,6,0,"D"
2011-04-30,2010,"Besiktas","Galatasaray","2-0",2,0,"T1",1,2,2,"H"
2011-04-30,2010,"Kasimpasa","Konyaspor","2-2",2,2,"T1",1,4,0,"D"
2011-05-01,2010,"Fenerbahce","Buyuksehyr","2-0",2,0,"T1",1,2,2,"H"
2011-05-01,2010,"Kayserispor","Bursaspor","1-0",1,0,"T1",1,1,1,"H"
2011-05-01,2010,"Manisaspor","Eskisehirspor","3-1",3,1,"T1",1,4,2,"H"
2011-05-01,2010,"Trabzonspor","Gaziantepspor","3-0",3,0,"T1",1,3,3,"H"
2011-05-02,2010,"Ankaragucu","Karabukspor","0-0",0,0,"T1",1,0,0,"D"
2011-05-06,2010,"Eskisehirspor","Kayserispor","1-2",1,2,"T1",1,3,-1,"A"
2011-05-07,2010,"Bursaspor","Besiktas","0-3",0,3,"T1",1,3,-3,"A"
2011-05-07,2010,"Buyuksehyr","Antalyaspor","1-1",1,1,"T1",1,2,0,"D"
2011-05-07,2010,"Gaziantepspor","Manisaspor","1-0",1,0,"T1",1,1,1,"H"
2011-05-08,2010,"Bucaspor","Trabzonspor","1-2",1,2,"T1",1,3,-1,"A"
2011-05-08,2010,"Genclerbirligi","Konyaspor","2-1",2,1,"T1",1,3,1,"H"
2011-05-08,2010,"Karabukspor","Fenerbahce","0-1",0,1,"T1",1,1,-1,"A"
2011-05-08,2010,"Sivasspor","Ankaragucu","1-1",1,1,"T1",1,2,0,"D"
2011-05-09,2010,"Galatasaray","Kasimpasa","3-1",3,1,"T1",1,4,2,"H"
2011-05-13,2010,"Antalyaspor","Karabukspor","1-2",1,2,"T1",1,3,-1,"A"
2011-05-14,2010,"Genclerbirligi","Galatasaray","2-3",2,3,"T1",1,5,-1,"A"
2011-05-14,2010,"Konyaspor","Sivasspor","1-1",1,1,"T1",1,2,0,"D"
2011-05-14,2010,"Manisaspor","Bucaspor","4-2",4,2,"T1",1,6,2,"H"
2011-05-15,2010,"Fenerbahce","Ankaragucu","6-0",6,0,"T1",1,6,6,"H"
2011-05-15,2010,"Kasimpasa","Bursaspor","0-3",0,3,"T1",1,3,-3,"A"
2011-05-15,2010,"Kayserispor","Gaziantepspor","1-2",1,2,"T1",1,3,-1,"A"
2011-05-15,2010,"Trabzonspor","Buyuksehyr","3-1",3,1,"T1",1,4,2,"H"
2011-05-16,2010,"Besiktas","Eskisehirspor","3-1",3,1,"T1",1,4,2,"H"
2011-05-20,2010,"Buyuksehyr","Manisaspor","0-0",0,0,"T1",1,0,0,"D"
2011-05-20,2010,"Galatasaray","Konyaspor","2-0",2,0,"T1",1,2,2,"H"
2011-05-21,2010,"Ankaragucu","Antalyaspor","2-3",2,3,"T1",1,5,-1,"A"
2011-05-21,2010,"Bucaspor","Kayserispor","3-3",3,3,"T1",1,6,0,"D"
2011-05-21,2010,"Bursaspor","Genclerbirligi","1-0",1,0,"T1",1,1,1,"H"
2011-05-21,2010,"Gaziantepspor","Besiktas","0-0",0,0,"T1",1,0,0,"D"
2011-05-22,2010,"Eskisehirspor","Kasimpasa","4-0",4,0,"T1",1,4,4,"H"
2011-05-22,2010,"Karabukspor","Trabzonspor","0-4",0,4,"T1",1,4,-4,"A"
2011-05-22,2010,"Sivasspor","Fenerbahce","3-4",3,4,"T1",1,7,-1,"A"
2011-09-10,2011,"Ankaragucu","Mersin Idman Yurdu","1-2",1,2,"T1",1,3,-1,"A"
2011-09-10,2011,"Eskisehirspor","Besiktas","2-1",2,1,"T1",1,3,1,"H"
2011-09-10,2011,"Manisaspor","Trabzonspor","1-1",1,1,"T1",1,2,0,"D"
2011-09-10,2011,"Samsunspor","Genclerbirligi","3-2",3,2,"T1",1,5,1,"H"
2011-09-11,2011,"Antalyaspor","Gaziantepspor","1-0",1,0,"T1",1,1,1,"H"
2011-09-11,2011,"Bursaspor","Kayserispor","3-0",3,0,"T1",1,3,3,"H"
2011-09-11,2011,"Buyuksehyr","Galatasaray","2-0",2,0,"T1",1,2,2,"H"
2011-09-11,2011,"Karabukspor","Sivasspor","2-1",2,1,"T1",1,3,1,"H"
2011-09-12,2011,"Fenerbahce","Orduspor","1-0",1,0,"T1",1,1,1,"H"
2011-09-16,2011,"Gaziantepspor","Fenerbahce","1-3",1,3,"T1",1,4,-2,"A"
2011-09-16,2011,"Kayserispor","Antalyaspor","0-1",0,1,"T1",1,1,-1,"A"
2011-09-17,2011,"Genclerbirligi","Karabukspor","2-1",2,1,"T1",1,3,1,"H"
2011-09-17,2011,"Orduspor","Manisaspor","1-0",1,0,"T1",1,1,1,"H"
2011-09-17,2011,"Trabzonspor","Buyuksehyr","0-1",0,1,"T1",1,1,-1,"A"
2011-09-18,2011,"Galatasaray","Samsunspor","3-1",3,1,"T1",1,4,2,"H"
2011-09-18,2011,"Mersin Idman Yurdu","Bursaspor","1-3",1,3,"T1",1,4,-2,"A"
2011-09-18,2011,"Sivasspor","Eskisehirspor","0-4",0,4,"T1",1,4,-4,"A"
2011-09-19,2011,"Besiktas","Ankaragucu","3-1",3,1,"T1",1,4,2,"H"
2011-09-20,2011,"Buyuksehyr","Orduspor","1-1",1,1,"T1",1,2,0,"D"
2011-09-20,2011,"Fenerbahce","Manisaspor","1-1",1,1,"T1",1,2,0,"D"
2011-09-20,2011,"Gaziantepspor","Kayserispor","1-2",1,2,"T1",1,3,-1,"A"
2011-09-21,2011,"Antalyaspor","Mersin Idman Yurdu","1-2",1,2,"T1",1,3,-1,"A"
2011-09-21,2011,"Eskisehirspor","Genclerbirligi","0-0",0,0,"T1",1,0,0,"D"
2011-09-21,2011,"Karabukspor","Galatasaray","1-1",1,1,"T1",1,2,0,"D"
2011-09-21,2011,"Samsunspor","Trabzonspor","1-1",1,1,"T1",1,2,0,"D"
2011-09-22,2011,"Ankaragucu","Sivasspor","1-2",1,2,"T1",1,3,-1,"A"
2011-09-22,2011,"Bursaspor","Besiktas","1-2",1,2,"T1",1,3,-1,"A"
2011-09-23,2011,"Kayserispor","Fenerbahce","0-1",0,1,"T1",1,1,-1,"A"
2011-09-24,2011,"Manisaspor","Buyuksehyr","0-2",0,2,"T1",1,2,-2,"A"
2011-09-24,2011,"Mersin Idman Yurdu","Gaziantepspor","2-0",2,0,"T1",1,2,2,"H"
2011-09-24,2011,"Trabzonspor","Karabukspor","3-1",3,1,"T1",1,4,2,"H"
2011-09-25,2011,"Besiktas","Antalyaspor","1-0",1,0,"T1",1,1,1,"H"
2011-09-25,2011,"Genclerbirligi","Ankaragucu","1-1",1,1,"T1",1,2,0,"D"
2011-09-25,2011,"Orduspor","Samsunspor","0-0",0,0,"T1",1,0,0,"D"
2011-09-25,2011,"Sivasspor","Bursaspor","3-0",3,0,"T1",1,3,3,"H"
2011-09-26,2011,"Galatasaray","Eskisehirspor","2-0",2,0,"T1",1,2,2,"H"
2011-09-30,2011,"Bursaspor","Genclerbirligi","4-0",4,0,"T1",1,4,4,"H"
2011-10-01,2011,"Antalyaspor","Sivasspor","2-2",2,2,"T1",1,4,0,"D"
2011-10-01,2011,"Fenerbahce","Buyuksehyr","4-2",4,2,"T1",1,6,2,"H"
2011-10-01,2011,"Karabukspor","Orduspor","1-2",1,2,"T1",1,3,-1,"A"
2011-10-02,2011,"Ankaragucu","Galatasaray","0-3",0,3,"T1",1,3,-3,"A"
2011-10-02,2011,"Eskisehirspor","Trabzonspor","0-2",0,2,"T1",1,2,-2,"A"
2011-10-02,2011,"Kayserispor","Mersin Idman Yurdu","2-2",2,2,"T1",1,4,0,"D"
2011-10-02,2011,"Samsunspor","Manisaspor","1-2",1,2,"T1",1,3,-1,"A"
2011-10-03,2011,"Gaziantepspor","Besiktas","0-0",0,0,"T1",1,0,0,"D"
2011-10-14,2011,"Trabzonspor","Ankaragucu","3-2",3,2,"T1",1,5,1,"H"
2011-10-15,2011,"Besiktas","Kayserispor","0-2",0,2,"T1",1,2,-2,"A"
2011-10-15,2011,"Orduspor","Eskisehirspor","2-1",2,1,"T1",1,3,1,"H"
2011-10-15,2011,"Sivasspor","Gaziantepspor","0-0",0,0,"T1",1,0,0,"D"
2011-10-16,2011,"Buyuksehyr","Samsunspor","3-0",3,0,"T1",1,3,3,"H"
2011-10-16,2011,"Galatasaray","Bursaspor","2-1",2,1,"T1",1,3,1,"H"
2011-10-16,2011,"Genclerbirligi","Antalyaspor","3-0",3,0,"T1",1,3,3,"H"
2011-10-16,2011,"Manisaspor","Karabukspor","2-1",2,1,"T1",1,3,1,"H"
2011-10-17,2011,"Mersin Idman Yurdu","Fenerbahce","1-2",1,2,"T1",1,3,-1,"A"
2011-10-21,2011,"Antalyaspor","Galatasaray","0-0",0,0,"T1",1,0,0,"D"
2011-10-22,2011,"Bursaspor","Trabzonspor","1-1",1,1,"T1",1,2,0,"D"
2011-10-22,2011,"Eskisehirspor","Manisaspor","0-2",0,2,"T1",1,2,-2,"A"
2011-10-22,2011,"Karabukspor","Buyuksehyr","2-0",2,0,"T1",1,2,2,"H"
2011-10-23,2011,"Ankaragucu","Orduspor","0-2",0,2,"T1",1,2,-2,"A"
2011-10-23,2011,"Fenerbahce","Samsunspor","0-0",0,0,"T1",1,0,0,"D"
2011-10-23,2011,"Gaziantepspor","Genclerbirligi","3-0",3,0,"T1",1,3,3,"H"
2011-10-23,2011,"Kayserispor","Sivasspor","6-2",6,2,"T1",1,8,4,"H"
2011-10-24,2011,"Mersin Idman Yurdu","Besiktas","0-1",0,1,"T1",1,1,-1,"A"
2011-10-26,2011,"Buyuksehyr","Eskisehirspor","2-2",2,2,"T1",1,4,0,"D"
2011-10-26,2011,"Galatasaray","Gaziantepspor","2-4",2,4,"T1",1,6,-2,"A"
2011-10-26,2011,"Orduspor","Bursaspor","1-1",1,1,"T1",1,2,0,"D"
2011-10-26,2011,"Samsunspor","Karabukspor","0-0",0,0,"T1",1,0,0,"D"
2011-10-26,2011,"Trabzonspor","Antalyaspor","2-2",2,2,"T1",1,4,0,"D"
2011-10-27,2011,"Besiktas","Fenerbahce","2-2",2,2,"T1",1,4,0,"D"
2011-10-27,2011,"Genclerbirligi","Kayserispor","1-0",1,0,"T1",1,1,1,"H"
2011-10-27,2011,"Manisaspor","Ankaragucu","2-0",2,0,"T1",1,2,2,"H"
2011-10-27,2011,"Sivasspor","Mersin Idman Yurdu","1-0",1,0,"T1",1,1,1,"H"
2011-10-29,2011,"Antalyaspor","Orduspor","1-1",1,1,"T1",1,2,0,"D"
2011-10-29,2011,"Eskisehirspor","Samsunspor","1-0",1,0,"T1",1,1,1,"H"
2011-10-29,2011,"Gaziantepspor","Trabzonspor","0-1",0,1,"T1",1,1,-1,"A"
2011-10-30,2011,"Ankaragucu","Buyuksehyr","1-2",1,2,"T1",1,3,-1,"A"
2011-10-30,2011,"Besiktas","Sivasspor","3-1",3,1,"T1",1,4,2,"H"
2011-10-30,2011,"Bursaspor","Manisaspor","0-0",0,0,"T1",1,0,0,"D"
2011-10-30,2011,"Kayserispor","Galatasaray","0-2",0,2,"T1",1,2,-2,"A"
2011-10-31,2011,"Fenerbahce","Karabukspor","1-0",1,0,"T1",1,1,1,"H"
2011-10-31,2011,"Mersin Idman Yurdu","Genclerbirligi","2-1",2,1,"T1",1,3,1,"H"
2011-11-04,2011,"Samsunspor","Ankaragucu","2-2",2,2,"T1",1,4,0,"D"
2011-11-04,2011,"Sivasspor","Fenerbahce","2-0",2,0,"T1",1,2,2,"H"
2011-11-05,2011,"Galatasaray","Mersin Idman Yurdu","0-0",0,0,"T1",1,0,0,"D"
2011-11-05,2011,"Karabukspor","Eskisehirspor","1-2",1,2,"T1",1,3,-1,"A"
2011-11-05,2011,"Manisaspor","Antalyaspor","1-0",1,0,"T1",1,1,1,"H"
2011-11-05,2011,"Orduspor","Gaziantepspor","0-0",0,0,"T1",1,0,0,"D"
2011-11-06,2011,"Buyuksehyr","Bursaspor","0-0",0,0,"T1",1,0,0,"D"
2011-11-06,2011,"Genclerbirligi","Besiktas","4-2",4,2,"T1",1,6,2,"H"
2011-11-06,2011,"Trabzonspor","Kayserispor","2-1",2,1,"T1",1,3,1,"H"
2011-11-18,2011,"Mersin Idman Yurdu","Trabzonspor","1-1",1,1,"T1",1,2,0,"D"
2011-11-19,2011,"Ankaragucu","Karabukspor","2-1",2,1,"T1",1,3,1,"H"
2011-11-19,2011,"Fenerbahce","Eskisehirspor","1-0",1,0,"T1",1,1,1,"H"
2011-11-19,2011,"Kayserispor","Orduspor","1-0",1,0,"T1",1,1,1,"H"
2011-11-20,2011,"Antalyaspor","Buyuksehyr","2-1",2,1,"T1",1,3,1,"H"
2011-11-20,2011,"Besiktas","Galatasaray","0-0",0,0,"T1",1,0,0,"D"
2011-11-20,2011,"Gaziantepspor","Manisaspor","1-1",1,1,"T1",1,2,0,"D"
2011-11-20,2011,"Sivasspor","Genclerbirligi","1-1",1,1,"T1",1,2,0,"D"
2011-11-21,2011,"Bursaspor","Samsunspor","1-0",1,0,"T1",1,1,1,"H"
2011-11-25,2011,"Genclerbirligi","Fenerbahce","0-0",0,0,"T1",1,0,0,"D"
2011-11-26,2011,"Galatasaray","Sivasspor","2-1",2,1,"T1",1,3,1,"H"
2011-11-26,2011,"Orduspor","Mersin Idman Yurdu","0-1",0,1,"T1",1,1,-1,"A"
2011-11-26,2011,"Samsunspor","Antalyaspor","1-0",1,0,"T1",1,1,1,"H"
2011-11-27,2011,"Buyuksehyr","Gaziantepspor","3-1",3,1,"T1",1,4,2,"H"
2011-11-27,2011,"Eskisehirspor","Ankaragucu","3-2",3,2,"T1",1,5,1,"H"
2011-11-27,2011,"Manisaspor","Kayserispor","1-0",1,0,"T1",1,1,1,"H"
2011-11-27,2011,"Trabzonspor","Besiktas","0-1",0,1,"T1",1,1,-1,"A"
2011-11-28,2011,"Karabukspor","Bursaspor","3-1",3,1,"T1",1,4,2,"H"
2011-12-02,2011,"Sivasspor","Trabzonspor","2-2",2,2,"T1",1,4,0,"D"
2011-12-03,2011,"Fenerbahce","Ankaragucu","4-2",4,2,"T1",1,6,2,"H"
2011-12-03,2011,"Gaziantepspor","Samsunspor","1-0",1,0,"T1",1,1,1,"H"
2011-12-03,2011,"Genclerbirligi","Galatasaray","0-1",0,1,"T1",1,1,-1,"A"
2011-12-04,2011,"Antalyaspor","Karabukspor","2-1",2,1,"T1",1,3,1,"H"
2011-12-04,2011,"Bursaspor","Eskisehirspor","0-1",0,1,"T1",1,1,-1,"A"
2011-12-04,2011,"Kayserispor","Buyuksehyr","1-0",1,0,"T1",1,1,1,"H"
2011-12-04,2011,"Mersin Idman Yurdu","Manisaspor","0-0",0,0,"T1",1,0,0,"D"
2011-12-05,2011,"Besiktas","Orduspor","2-1",2,1,"T1",1,3,1,"H"
2011-12-07,2011,"Eskisehirspor","Antalyaspor","1-0",1,0,"T1",1,1,1,"H"
2011-12-07,2011,"Galatasaray","Fenerbahce","3-1",3,1,"T1",1,4,2,"H"
2011-12-07,2011,"Karabukspor","Gaziantepspor","0-0",0,0,"T1",1,0,0,"D"
2011-12-08,2011,"Ankaragucu","Bursaspor","0-0",0,0,"T1",1,0,0,"D"
2011-12-08,2011,"Buyuksehyr","Mersin Idman Yurdu","0-0",0,0,"T1",1,0,0,"D"
2011-12-08,2011,"Manisaspor","Besiktas","1-4",1,4,"T1",1,5,-3,"A"
2011-12-08,2011,"Orduspor","Sivasspor","1-2",1,2,"T1",1,3,-1,"A"
2011-12-08,2011,"Samsunspor","Kayserispor","0-1",0,1,"T1",1,1,-1,"A"
2011-12-10,2011,"Gaziantepspor","Eskisehirspor","0-1",0,1,"T1",1,1,-1,"A"
2011-12-11,2011,"Antalyaspor","Ankaragucu","1-0",1,0,"T1",1,1,1,"H"
2011-12-11,2011,"Besiktas","Buyuksehyr","1-1",1,1,"T1",1,2,0,"D"
2011-12-11,2011,"Genclerbirligi","Orduspor","3-1",3,1,"T1",1,4,2,"H"
2011-12-11,2011,"Mersin Idman Yurdu","Samsunspor","1-0",1,0,"T1",1,1,1,"H"
2011-12-11,2011,"Trabzonspor","Galatasaray","0-3",0,3,"T1",1,3,-3,"A"
2011-12-12,2011,"Bursaspor","Fenerbahce","0-2",0,2,"T1",1,2,-2,"A"
2011-12-12,2011,"Kayserispor","Karabukspor","2-0",2,0,"T1",1,2,2,"H"
2011-12-12,2011,"Sivasspor","Manisaspor","2-2",2,2,"T1",1,4,0,"D"
2011-12-14,2011,"Trabzonspor","Genclerbirligi","1-2",1,2,"T1",1,3,-1,"A"
2011-12-16,2011,"Orduspor","Galatasaray","0-2",0,2,"T1",1,2,-2,"A"
2011-12-17,2011,"Ankaragucu","Gaziantepspor","0-0",0,0,"T1",1,0,0,"D"
2011-12-17,2011,"Bursaspor","Antalyaspor","0-0",0,0,"T1",1,0,0,"D"
2011-12-17,2011,"Eskisehirspor","Kayserispor","1-0",1,0,"T1",1,1,1,"H"
2011-12-17,2011,"Karabukspor","Mersin Idman Yurdu","3-5",3,5,"T1",1,8,-2,"A"
2011-12-18,2011,"Buyuksehyr","Sivasspor","1-1",1,1,"T1",1,2,0,"D"
2011-12-18,2011,"Fenerbahce","Trabzonspor","1-0",1,0,"T1",1,1,1,"H"
2011-12-18,2011,"Manisaspor","Genclerbirligi","0-1",0,1,"T1",1,1,-1,"A"
2011-12-18,2011,"Samsunspor","Besiktas","1-1",1,1,"T1",1,2,0,"D"
2011-12-21,2011,"Antalyaspor","Fenerbahce","0-0",0,0,"T1",1,0,0,"D"
2011-12-21,2011,"Galatasaray","Manisaspor","1-0",1,0,"T1",1,1,1,"H"
2011-12-21,2011,"Kayserispor","Ankaragucu","3-0",3,0,"T1",1,3,3,"H"
2011-12-21,2011,"Mersin Idman Yurdu","Eskisehirspor","0-0",0,0,"T1",1,0,0,"D"
2011-12-21,2011,"Sivasspor","Samsunspor","3-2",3,2,"T1",1,5,1,"H"
2011-12-22,2011,"Besiktas","Karabukspor","1-0",1,0,"T1",1,1,1,"H"
2011-12-22,2011,"Gaziantepspor","Bursaspor","2-2",2,2,"T1",1,4,0,"D"
2011-12-22,2011,"Genclerbirligi","Buyuksehyr","4-0",4,0,"T1",1,4,4,"H"
2011-12-22,2011,"Trabzonspor","Orduspor","4-1",4,1,"T1",1,5,3,"H"
2012-01-03,2011,"Galatasaray","Buyuksehyr","4-1",4,1,"T1",1,5,3,"H"
2012-01-03,2011,"Kayserispor","Bursaspor","0-2",0,2,"T1",1,2,-2,"A"
2012-01-03,2011,"Mersin Idman Yurdu","Ankaragucu","1-2",1,2,"T1",1,3,-1,"A"
2012-01-03,2011,"Sivasspor","Karabukspor","3-0",3,0,"T1",1,3,3,"H"
2012-01-03,2011,"Trabzonspor","Manisaspor","2-1",2,1,"T1",1,3,1,"H"
2012-01-04,2011,"Besiktas","Eskisehirspor","2-0",2,0,"T1",1,2,2,"H"
2012-01-04,2011,"Gaziantepspor","Antalyaspor","1-0",1,0,"T1",1,1,1,"H"
2012-01-04,2011,"Genclerbirligi","Samsunspor","1-1",1,1,"T1",1,2,0,"D"
2012-01-04,2011,"Orduspor","Fenerbahce","1-1",1,1,"T1",1,2,0,"D"
2012-01-07,2011,"Bursaspor","Mersin Idman Yurdu","1-0",1,0,"T1",1,1,1,"H"
2012-01-07,2011,"Buyuksehyr","Trabzonspor","0-2",0,2,"T1",1,2,-2,"A"
2012-01-07,2011,"Samsunspor","Galatasaray","2-4",2,4,"T1",1,6,-2,"A"
2012-01-08,2011,"Ankaragucu","Besiktas","0-0",0,0,"T1",1,0,0,"D"
2012-01-08,2011,"Antalyaspor","Kayserispor","1-0",1,0,"T1",1,1,1,"H"
2012-01-08,2011,"Eskisehirspor","Sivasspor","1-1",1,1,"T1",1,2,0,"D"
2012-01-08,2011,"Karabukspor","Genclerbirligi","2-1",2,1,"T1",1,3,1,"H"
2012-01-08,2011,"Manisaspor","Orduspor","0-0",0,0,"T1",1,0,0,"D"
2012-01-09,2011,"Fenerbahce","Gaziantepspor","3-1",3,1,"T1",1,4,2,"H"
2012-01-14,2011,"Galatasaray","Karabukspor","5-1",5,1,"T1",1,6,4,"H"
2012-01-14,2011,"Genclerbirligi","Eskisehirspor","2-1",2,1,"T1",1,3,1,"H"
2012-01-15,2011,"Besiktas","Bursaspor","3-1",3,1,"T1",1,4,2,"H"
2012-01-15,2011,"Mersin Idman Yurdu","Antalyaspor","0-2",0,2,"T1",1,2,-2,"A"
2012-01-15,2011,"Orduspor","Buyuksehyr","1-0",1,0,"T1",1,1,1,"H"
2012-01-15,2011,"Sivasspor","Ankaragucu","3-0",3,0,"T1",1,3,3,"H"
2012-01-15,2011,"Trabzonspor","Samsunspor","4-0",4,0,"T1",1,4,4,"H"
2012-01-16,2011,"Kayserispor","Gaziantepspor","1-1",1,1,"T1",1,2,0,"D"
2012-01-16,2011,"Manisaspor","Fenerbahce","1-2",1,2,"T1",1,3,-1,"A"
2012-01-20,2011,"Antalyaspor","Besiktas","1-2",1,2,"T1",1,3,-1,"A"
2012-01-20,2011,"Gaziantepspor","Mersin Idman Yurdu","1-0",1,0,"T1",1,1,1,"H"
2012-01-21,2011,"Bursaspor","Sivasspor","1-2",1,2,"T1",1,3,-1,"A"
2012-01-21,2011,"Buyuksehyr","Manisaspor","3-2",3,2,"T1",1,5,1,"H"
2012-01-21,2011,"Fenerbahce","Kayserispor","4-0",4,0,"T1",1,4,4,"H"
2012-01-21,2011,"Karabukspor","Trabzonspor","2-1",2,1,"T1",1,3,1,"H"
2012-01-21,2011,"Samsunspor","Orduspor","2-0",2,0,"T1",1,2,2,"H"
2012-01-22,2011,"Ankaragucu","Genclerbirligi","0-1",0,1,"T1",1,1,-1,"A"
2012-01-22,2011,"Eskisehirspor","Galatasaray","0-0",0,0,"T1",1,0,0,"D"
2012-01-24,2011,"Besiktas","Gaziantepspor","3-2",3,2,"T1",1,5,1,"H"
2012-01-24,2011,"Manisaspor","Samsunspor","1-1",1,1,"T1",1,2,0,"D"
2012-01-24,2011,"Mersin Idman Yurdu","Kayserispor","1-2",1,2,"T1",1,3,-1,"A"
2012-01-24,2011,"Sivasspor","Antalyaspor","2-1",2,1,"T1",1,3,1,"H"
2012-01-25,2011,"Buyuksehyr","Fenerbahce","3-2",3,2,"T1",1,5,1,"H"
2012-01-25,2011,"Galatasaray","Ankaragucu","4-0",4,0,"T1",1,4,4,"H"
2012-01-25,2011,"Genclerbirligi","Bursaspor","2-2",2,2,"T1",1,4,0,"D"
2012-01-25,2011,"Orduspor","Karabukspor","3-2",3,2,"T1",1,5,1,"H"
2012-01-25,2011,"Trabzonspor","Eskisehirspor","4-1",4,1,"T1",1,5,3,"H"
2012-01-28,2011,"Antalyaspor","Genclerbirligi","2-2",2,2,"T1",1,4,0,"D"
2012-01-28,2011,"Bursaspor","Galatasaray","1-0",1,0,"T1",1,1,1,"H"
2012-01-29,2011,"Ankaragucu","Trabzonspor","0-4",0,4,"T1",1,4,-4,"A"
2012-01-29,2011,"Eskisehirspor","Orduspor","0-1",0,1,"T1",1,1,-1,"A"
2012-01-29,2011,"Fenerbahce","Mersin Idman Yurdu","2-1",2,1,"T1",1,3,1,"H"
2012-01-29,2011,"Gaziantepspor","Sivasspor","2-1",2,1,"T1",1,3,1,"H"
2012-01-29,2011,"Karabukspor","Manisaspor","2-1",2,1,"T1",1,3,1,"H"
2012-01-29,2011,"Samsunspor","Buyuksehyr","2-4",2,4,"T1",1,6,-2,"A"
2012-01-30,2011,"Kayserispor","Besiktas","1-0",1,0,"T1",1,1,1,"H"
2012-02-01,2011,"Galatasaray","Antalyaspor","1-1",1,1,"T1",1,2,0,"D"
2012-02-01,2011,"Genclerbirligi","Gaziantepspor","1-0",1,0,"T1",1,1,1,"H"
2012-02-01,2011,"Orduspor","Ankaragucu","2-0",2,0,"T1",1,2,2,"H"
2012-02-01,2011,"Trabzonspor","Bursaspor","2-1",2,1,"T1",1,3,1,"H"
2012-02-02,2011,"Besiktas","Mersin Idman Yurdu","0-1",0,1,"T1",1,1,-1,"A"
2012-02-02,2011,"Manisaspor","Eskisehirspor","2-3",2,3,"T1",1,5,-1,"A"
2012-02-02,2011,"Samsunspor","Fenerbahce","3-1",3,1,"T1",1,4,2,"H"
2012-02-02,2011,"Sivasspor","Kayserispor","1-1",1,1,"T1",1,2,0,"D"
2012-02-04,2011,"Antalyaspor","Trabzonspor","2-1",2,1,"T1",1,3,1,"H"
2012-02-04,2011,"Gaziantepspor","Galatasaray","1-2",1,2,"T1",1,3,-1,"A"
2012-02-05,2011,"Bursaspor","Orduspor","0-0",0,0,"T1",1,0,0,"D"
2012-02-05,2011,"Fenerbahce","Besiktas","2-0",2,0,"T1",1,2,2,"H"
2012-02-05,2011,"Kayserispor","Genclerbirligi","2-3",2,3,"T1",1,5,-1,"A"
2012-02-05,2011,"Mersin Idman Yurdu","Sivasspor","1-5",1,5,"T1",1,6,-4,"A"
2012-02-06,2011,"Ankaragucu","Manisaspor","0-1",0,1,"T1",1,1,-1,"A"
2012-02-06,2011,"Eskisehirspor","Buyuksehyr","3-1",3,1,"T1",1,4,2,"H"
2012-02-06,2011,"Karabukspor","Samsunspor","2-1",2,1,"T1",1,3,1,"H"
2012-02-09,2011,"Buyuksehyr","Karabukspor","2-2",2,2,"T1",1,4,0,"D"
2012-02-09,2011,"Sivasspor","Besiktas","1-1",1,1,"T1",1,2,0,"D"
2012-02-10,2011,"Trabzonspor","Gaziantepspor","4-1",4,1,"T1",1,5,3,"H"
2012-02-11,2011,"Galatasaray","Kayserispor","1-0",1,0,"T1",1,1,1,"H"
2012-02-11,2011,"Genclerbirligi","Mersin Idman Yurdu","1-2",1,2,"T1",1,3,-1,"A"
2012-02-12,2011,"Buyuksehyr","Ankaragucu","3-0",3,0,"T1",1,3,3,"H"
2012-02-12,2011,"Karabukspor","Fenerbahce","2-1",2,1,"T1",1,3,1,"H"
2012-02-12,2011,"Manisaspor","Bursaspor","1-3",1,3,"T1",1,4,-2,"A"
2012-02-12,2011,"Orduspor","Antalyaspor","3-2",3,2,"T1",1,5,1,"H"
2012-02-12,2011,"Samsunspor","Eskisehirspor","3-1",3,1,"T1",1,4,2,"H"
2012-02-17,2011,"Mersin Idman Yurdu","Galatasaray","1-3",1,3,"T1",1,4,-2,"A"
2012-02-18,2011,"Ankaragucu","Samsunspor","0-3",0,3,"T1",1,3,-3,"A"
2012-02-18,2011,"Antalyaspor","Manisaspor","2-1",2,1,"T1",1,3,1,"H"
2012-02-18,2011,"Fenerbahce","Sivasspor","4-2",4,2,"T1",1,6,2,"H"
2012-02-19,2011,"Besiktas","Genclerbirligi","3-2",3,2,"T1",1,5,1,"H"
2012-02-19,2011,"Eskisehirspor","Karabukspor","1-2",1,2,"T1",1,3,-1,"A"
2012-02-19,2011,"Gaziantepspor","Orduspor","1-0",1,0,"T1",1,1,1,"H"
2012-02-19,2011,"Kayserispor","Trabzonspor","3-3",3,3,"T1",1,6,0,"D"
2012-02-20,2011,"Bursaspor","Buyuksehyr","2-1",2,1,"T1",1,3,1,"H"
2012-02-24,2011,"Orduspor","Kayserispor","1-0",1,0,"T1",1,1,1,"H"
2012-02-25,2011,"Eskisehirspor","Fenerbahce","2-1",2,1,"T1",1,3,1,"H"
2012-02-25,2011,"Karabukspor","Ankaragucu","3-2",3,2,"T1",1,5,1,"H"
2012-02-25,2011,"Manisaspor","Gaziantepspor","0-2",0,2,"T1",1,2,-2,"A"
2012-02-25,2011,"Samsunspor","Bursaspor","0-3",0,3,"T1",1,3,-3,"A"
2012-02-26,2011,"Buyuksehyr","Antalyaspor","4-0",4,0,"T1",1,4,4,"H"
2012-02-26,2011,"Galatasaray","Besiktas","3-2",3,2,"T1",1,5,1,"H"
2012-02-26,2011,"Genclerbirligi","Sivasspor","3-3",3,3,"T1",1,6,0,"D"
2012-02-26,2011,"Trabzonspor","Mersin Idman Yurdu","2-3",2,3,"T1",1,5,-1,"A"
2012-03-03,2011,"Ankaragucu","Eskisehirspor","2-5",2,5,"T1",1,7,-3,"A"
2012-03-03,2011,"Antalyaspor","Samsunspor","0-2",0,2,"T1",1,2,-2,"A"
2012-03-03,2011,"Fenerbahce","Genclerbirligi","6-1",6,1,"T1",1,7,5,"H"
2012-03-03,2011,"Mersin Idman Yurdu","Orduspor","1-0",1,0,"T1",1,1,1,"H"
2012-03-04,2011,"Besiktas","Trabzonspor","1-2",1,2,"T1",1,3,-1,"A"
2012-03-04,2011,"Bursaspor","Karabukspor","3-0",3,0,"T1",1,3,3,"H"
2012-03-04,2011,"Gaziantepspor","Buyuksehyr","5-0",5,0,"T1",1,5,5,"H"
2012-03-04,2011,"Kayserispor","Manisaspor","2-0",2,0,"T1",1,2,2,"H"
2012-03-05,2011,"Sivasspor","Galatasaray","0-4",0,4,"T1",1,4,-4,"A"
2012-03-09,2011,"Ankaragucu","Fenerbahce","0-2",0,2,"T1",1,2,-2,"A"
2012-03-10,2011,"Buyuksehyr","Kayserispor","1-0",1,0,"T1",1,1,1,"H"
2012-03-10,2011,"Galatasaray","Genclerbirligi","2-0",2,0,"T1",1,2,2,"H"
2012-03-11,2011,"Eskisehirspor","Bursaspor","1-1",1,1,"T1",1,2,0,"D"
2012-03-11,2011,"Karabukspor","Antalyaspor","2-1",2,1,"T1",1,3,1,"H"
2012-03-11,2011,"Manisaspor","Mersin Idman Yurdu","2-0",2,0,"T1",1,2,2,"H"
2012-03-11,2011,"Orduspor","Besiktas","1-1",1,1,"T1",1,2,0,"D"
2012-03-11,2011,"Samsunspor","Gaziantepspor","0-0",0,0,"T1",1,0,0,"D"
2012-03-12,2011,"Trabzonspor","Sivasspor","2-1",2,1,"T1",1,3,1,"H"
2012-03-16,2011,"Genclerbirligi","Trabzonspor","1-1",1,1,"T1",1,2,0,"D"
2012-03-17,2011,"Antalyaspor","Eskisehirspor","0-0",0,0,"T1",1,0,0,"D"
2012-03-17,2011,"Bursaspor","Ankaragucu","2-1",2,1,"T1",1,3,1,"H"
2012-03-17,2011,"Fenerbahce","Galatasaray","2-2",2,2,"T1",1,4,0,"D"
2012-03-17,2011,"Sivasspor","Orduspor","1-1",1,1,"T1",1,2,0,"D"
2012-03-18,2011,"Gaziantepspor","Karabukspor","3-0",3,0,"T1",1,3,3,"H"
2012-03-18,2011,"Kayserispor","Samsunspor","2-0",2,0,"T1",1,2,2,"H"
2012-03-18,2011,"Mersin Idman Yurdu","Buyuksehyr","2-0",2,0,"T1",1,2,2,"H"
2012-03-19,2011,"Besiktas","Manisaspor","4-1",4,1,"T1",1,5,3,"H"
2012-03-24,2011,"Fenerbahce","Bursaspor","1-0",1,0,"T1",1,1,1,"H"
2012-03-25,2011,"Ankaragucu","Antalyaspor","0-3",0,3,"T1",1,3,-3,"A"
2012-03-25,2011,"Eskisehirspor","Gaziantepspor","0-2",0,2,"T1",1,2,-2,"A"
2012-03-25,2011,"Galatasaray","Trabzonspor","1-1",1,1,"T1",1,2,0,"D"
2012-03-25,2011,"Karabukspor","Kayserispor","1-0",1,0,"T1",1,1,1,"H"
2012-03-25,2011,"Manisaspor","Sivasspor","1-3",1,3,"T1",1,4,-2,"A"
2012-03-25,2011,"Orduspor","Genclerbirligi","0-0",0,0,"T1",1,0,0,"D"
2012-03-25,2011,"Samsunspor","Mersin Idman Yurdu","2-0",2,0,"T1",1,2,2,"H"
2012-03-26,2011,"Buyuksehyr","Besiktas","2-2",2,2,"T1",1,4,0,"D"
2012-03-30,2011,"Gaziantepspor","Ankaragucu","1-0",1,0,"T1",1,1,1,"H"
2012-03-30,2011,"Mersin Idman Yurdu","Karabukspor","0-2",0,2,"T1",1,2,-2,"A"
2012-03-31,2011,"Galatasaray","Orduspor","2-0",2,0,"T1",1,2,2,"H"
2012-03-31,2011,"Genclerbirligi","Manisaspor","3-0",3,0,"T1",1,3,3,"H"
2012-03-31,2011,"Kayserispor","Eskisehirspor","2-2",2,2,"T1",1,4,0,"D"
2012-03-31,2011,"Sivasspor","Buyuksehyr","0-1",0,1,"T1",1,1,-1,"A"
2012-04-01,2011,"Antalyaspor","Bursaspor","1-3",1,3,"T1",1,4,-2,"A"
2012-04-01,2011,"Besiktas","Samsunspor","0-1",0,1,"T1",1,1,-1,"A"
2012-04-01,2011,"Trabzonspor","Fenerbahce","1-1",1,1,"T1",1,2,0,"D"
2012-04-06,2011,"Karabukspor","Besiktas","1-1",1,1,"T1",1,2,0,"D"
2012-04-07,2011,"Ankaragucu","Kayserispor","0-5",0,5,"T1",1,5,-5,"A"
2012-04-07,2011,"Bursaspor","Gaziantepspor","0-2",0,2,"T1",1,2,-2,"A"
2012-04-07,2011,"Buyuksehyr","Genclerbirligi","1-0",1,0,"T1",1,1,1,"H"
2012-04-07,2011,"Eskisehirspor","Mersin Idman Yurdu","2-0",2,0,"T1",1,2,2,"H"
2012-04-07,2011,"Fenerbahce","Antalyaspor","2-0",2,0,"T1",1,2,2,"H"
2012-04-07,2011,"Samsunspor","Sivasspor","1-2",1,2,"T1",1,3,-1,"A"
2012-04-08,2011,"Manisaspor","Galatasaray","0-4",0,4,"T1",1,4,-4,"A"
2012-04-08,2011,"Orduspor","Trabzonspor","0-0",0,0,"T1",1,0,0,"D"
2012-08-17,2012,"Eskisehirspor","Akhisar Belediyespor","0-1",0,1,"T1",1,1,-1,"A"
2012-08-18,2012,"Elazigspor","Fenerbahce","1-1",1,1,"T1",1,2,0,"D"
2012-08-18,2012,"Gaziantepspor","Sivasspor","0-1",0,1,"T1",1,1,-1,"A"
2012-08-18,2012,"Karabukspor","Trabzonspor","1-1",1,1,"T1",1,2,0,"D"
2012-08-19,2012,"Buyuksehyr","Besiktas","1-1",1,1,"T1",1,2,0,"D"
2012-08-19,2012,"Kayserispor","Bursaspor","0-1",0,1,"T1",1,1,-1,"A"
2012-08-19,2012,"Mersin Idman Yurdu","Orduspor","0-0",0,0,"T1",1,0,0,"D"
2012-08-20,2012,"Galatasaray","Kasimpasa","2-1",2,1,"T1",1,3,1,"H"
2012-08-20,2012,"Genclerbirligi","Antalyaspor","3-1",3,1,"T1",1,4,2,"H"
2012-08-24,2012,"Kasimpasa","Karabukspor","2-1",2,1,"T1",1,3,1,"H"
2012-08-25,2012,"Akhisar Belediyespor","Genclerbirligi","0-0",0,0,"T1",1,0,0,"D"
2012-08-25,2012,"Fenerbahce","Gaziantepspor","3-0",3,0,"T1",1,3,3,"H"
2012-08-25,2012,"Orduspor","Eskisehirspor","2-0",2,0,"T1",1,2,2,"H"
2012-08-25,2012,"Sivasspor","Mersin Idman Yurdu","3-3",3,3,"T1",1,6,0,"D"
2012-08-26,2012,"Besiktas","Galatasaray","3-3",3,3,"T1",1,6,0,"D"
2012-08-26,2012,"Bursaspor","Buyuksehyr","0-1",0,1,"T1",1,1,-1,"A"
2012-08-26,2012,"Trabzonspor","Elazigspor","2-0",2,0,"T1",1,2,2,"H"
2012-08-27,2012,"Antalyaspor","Kayserispor","3-0",3,0,"T1",1,3,3,"H"
2012-08-31,2012,"Genclerbirligi","Orduspor","1-1",1,1,"T1",1,2,0,"D"
2012-08-31,2012,"Mersin Idman Yurdu","Eskisehirspor","1-3",1,3,"T1",1,4,-2,"A"
2012-09-01,2012,"Buyuksehyr","Antalyaspor","0-1",0,1,"T1",1,1,-1,"A"
2012-09-01,2012,"Elazigspor","Kasimpasa","0-3",0,3,"T1",1,3,-3,"A"
2012-09-01,2012,"Karabukspor","Besiktas","0-3",0,3,"T1",1,3,-3,"A"
2012-09-01,2012,"Kayserispor","Akhisar Belediyespor","1-1",1,1,"T1",1,2,0,"D"
2012-09-02,2012,"Galatasaray","Bursaspor","3-2",3,2,"T1",1,5,1,"H"
2012-09-02,2012,"Gaziantepspor","Trabzonspor","1-0",1,0,"T1",1,1,1,"H"
2012-09-02,2012,"Sivasspor","Fenerbahce","0-0",0,0,"T1",1,0,0,"D"
2012-09-15,2012,"Antalyaspor","Galatasaray","0-4",0,4,"T1",1,4,-4,"A"
2012-09-15,2012,"Bursaspor","Karabukspor","4-1",4,1,"T1",1,5,3,"H"
2012-09-15,2012,"Kasimpasa","Gaziantepspor","3-0",3,0,"T1",1,3,3,"H"
2012-09-16,2012,"Akhisar Belediyespor","Buyuksehyr","0-4",0,4,"T1",1,4,-4,"A"
2012-09-16,2012,"Eskisehirspor","Genclerbirligi","4-2",4,2,"T1",1,6,2,"H"
2012-09-16,2012,"Fenerbahce","Mersin Idman Yurdu","2-1",2,1,"T1",1,3,1,"H"
2012-09-16,2012,"Trabzonspor","Sivasspor","1-0",1,0,"T1",1,1,1,"H"
2012-09-17,2012,"Besiktas","Elazigspor","3-0",3,0,"T1",1,3,3,"H"
2012-09-17,2012,"Orduspor","Kayserispor","3-2",3,2,"T1",1,5,1,"H"
2012-09-21,2012,"Karabukspor","Antalyaspor","1-0",1,0,"T1",1,1,1,"H"
2012-09-22,2012,"Buyuksehyr","Orduspor","1-1",1,1,"T1",1,2,0,"D"
2012-09-22,2012,"Gaziantepspor","Besiktas","3-2",3,2,"T1",1,5,1,"H"
2012-09-22,2012,"Kayserispor","Eskisehirspor","3-2",3,2,"T1",1,5,1,"H"
2012-09-22,2012,"Mersin Idman Yurdu","Genclerbirligi","1-1",1,1,"T1",1,2,0,"D"
2012-09-23,2012,"Elazigspor","Bursaspor","1-1",1,1,"T1",1,2,0,"D"
2012-09-23,2012,"Galatasaray","Akhisar Belediyespor","3-0",3,0,"T1",1,3,3,"H"
2012-09-23,2012,"Sivasspor","Kasimpasa","1-0",1,0,"T1",1,1,1,"H"
2012-09-24,2012,"Fenerbahce","Trabzonspor","0-0",0,0,"T1",1,0,0,"D"
2012-09-28,2012,"Orduspor","Galatasaray","2-0",2,0,"T1",1,2,2,"H"
2012-09-29,2012,"Akhisar Belediyespor","Karabukspor","1-3",1,3,"T1",1,4,-2,"A"
2012-09-29,2012,"Bursaspor","Gaziantepspor","1-1",1,1,"T1",1,2,0,"D"
2012-09-29,2012,"Kasimpasa","Fenerbahce","2-0",2,0,"T1",1,2,2,"H"
2012-09-30,2012,"Antalyaspor","Elazigspor","4-0",4,0,"T1",1,4,4,"H"
2012-09-30,2012,"Eskisehirspor","Buyuksehyr","1-0",1,0,"T1",1,1,1,"H"
2012-09-30,2012,"Genclerbirligi","Kayserispor","4-0",4,0,"T1",1,4,4,"H"
2012-09-30,2012,"Trabzonspor","Mersin Idman Yurdu","1-1",1,1,"T1",1,2,0,"D"
2012-10-01,2012,"Besiktas","Sivasspor","0-1",0,1,"T1",1,1,-1,"A"
2012-10-05,2012,"Gaziantepspor","Antalyaspor","0-1",0,1,"T1",1,1,-1,"A"
2012-10-05,2012,"Karabukspor","Orduspor","1-1",1,1,"T1",1,2,0,"D"
2012-10-05,2012,"Trabzonspor","Kasimpasa","1-0",1,0,"T1",1,1,1,"H"
2012-10-06,2012,"Buyuksehyr","Genclerbirligi","0-2",0,2,"T1",1,2,-2,"A"
2012-10-06,2012,"Elazigspor","Akhisar Belediyespor","0-0",0,0,"T1",1,0,0,"D"
2012-10-06,2012,"Galatasaray","Eskisehirspor","1-1",1,1,"T1",1,2,0,"D"
2012-10-07,2012,"Fenerbahce","Besiktas","3-0",3,0,"T1",1,3,3,"H"
2012-10-07,2012,"Mersin Idman Yurdu","Kayserispor","1-2",1,2,"T1",1,3,-1,"A"
2012-10-07,2012,"Sivasspor","Bursaspor","2-2",2,2,"T1",1,4,0,"D"
2012-10-19,2012,"Genclerbirligi","Galatasaray","3-3",3,3,"T1",1,6,0,"D"
2012-10-20,2012,"Antalyaspor","Sivasspor","4-2",4,2,"T1",1,6,2,"H"
2012-10-20,2012,"Bursaspor","Fenerbahce","1-1",1,1,"T1",1,2,0,"D"
2012-10-20,2012,"Orduspor","Elazigspor","2-2",2,2,"T1",1,4,0,"D"
2012-10-21,2012,"Akhisar Belediyespor","Gaziantepspor","0-0",0,0,"T1",1,0,0,"D"
2012-10-21,2012,"Besiktas","Trabzonspor","1-1",1,1,"T1",1,2,0,"D"
2012-10-21,2012,"Eskisehirspor","Karabukspor","5-2",5,2,"T1",1,7,3,"H"
2012-10-21,2012,"Kasimpasa","Mersin Idman Yurdu","2-2",2,2,"T1",1,4,0,"D"
2012-10-22,2012,"Kayserispor","Buyuksehyr","0-1",0,1,"T1",1,1,-1,"A"
2012-10-26,2012,"Elazigspor","Eskisehirspor","1-1",1,1,"T1",1,2,0,"D"
2012-10-26,2012,"Kasimpasa","Besiktas","1-3",1,3,"T1",1,4,-2,"A"
2012-10-27,2012,"Galatasaray","Kayserispor","3-0",3,0,"T1",1,3,3,"H"
2012-10-27,2012,"Mersin Idman Yurdu","Buyuksehyr","2-0",2,0,"T1",1,2,2,"H"
2012-10-27,2012,"Sivasspor","Akhisar Belediyespor","1-2",1,2,"T1",1,3,-1,"A"
2012-10-28,2012,"Gaziantepspor","Orduspor","3-0",3,0,"T1",1,3,3,"H"
2012-10-28,2012,"Karabukspor","Genclerbirligi","0-0",0,0,"T1",1,0,0,"D"
2012-10-28,2012,"Trabzonspor","Bursaspor","0-1",0,1,"T1",1,1,-1,"A"
2012-10-29,2012,"Fenerbahce","Antalyaspor","1-3",1,3,"T1",1,4,-2,"A"
2012-11-02,2012,"Buyuksehyr","Galatasaray","1-3",1,3,"T1",1,4,-2,"A"
2012-11-03,2012,"Akhisar Belediyespor","Fenerbahce","1-2",1,2,"T1",1,3,-1,"A"
2012-11-03,2012,"Eskisehirspor","Gaziantepspor","4-0",4,0,"T1",1,4,4,"H"
2012-11-03,2012,"Kayserispor","Karabukspor","3-0",3,0,"T1",1,3,3,"H"
2012-11-04,2012,"Besiktas","Mersin Idman Yurdu","3-0",3,0,"T1",1,3,3,"H"
2012-11-04,2012,"Genclerbirligi","Elazigspor","1-2",1,2,"T1",1,3,-1,"A"
2012-11-04,2012,"Orduspor","Sivasspor","2-0",2,0,"T1",1,2,2,"H"
2012-11-05,2012,"Antalyaspor","Trabzonspor","2-1",2,1,"T1",1,3,1,"H"
2012-11-05,2012,"Bursaspor","Kasimpasa","1-2",1,2,"T1",1,3,-1,"A"
2012-11-09,2012,"Besiktas","Bursaspor","3-3",3,3,"T1",1,6,0,"D"
2012-11-09,2012,"Sivasspor","Eskisehirspor","1-0",1,0,"T1",1,1,1,"H"
2012-11-10,2012,"Karabukspor","Buyuksehyr","3-1",3,1,"T1",1,4,2,"H"
2012-11-10,2012,"Kasimpasa","Antalyaspor","1-1",1,1,"T1",1,2,0,"D"
2012-11-10,2012,"Trabzonspor","Akhisar Belediyespor","3-1",3,1,"T1",1,4,2,"H"
2012-11-11,2012,"Elazigspor","Kayserispor","0-4",0,4,"T1",1,4,-4,"A"
2012-11-11,2012,"Fenerbahce","Orduspor","2-1",2,1,"T1",1,3,1,"H"
2012-11-11,2012,"Gaziantepspor","Genclerbirligi","2-3",2,3,"T1",1,5,-1,"A"
2012-11-11,2012,"Mersin Idman Yurdu","Galatasaray","1-1",1,1,"T1",1,2,0,"D"
2012-11-16,2012,"Galatasaray","Karabukspor","1-3",1,3,"T1",1,4,-2,"A"
2012-11-17,2012,"Buyuksehyr","Elazigspor","1-1",1,1,"T1",1,2,0,"D"
2012-11-17,2012,"Eskisehirspor","Fenerbahce","1-1",1,1,"T1",1,2,0,"D"
2012-11-17,2012,"Genclerbirligi","Sivasspor","1-1",1,1,"T1",1,2,0,"D"
2012-11-18,2012,"Akhisar Belediyespor","Kasimpasa","0-2",0,2,"T1",1,2,-2,"A"
2012-11-18,2012,"Antalyaspor","Besiktas","3-5",3,5,"T1",1,8,-2,"A"
2012-11-18,2012,"Bursaspor","Mersin Idman Yurdu","3-0",3,0,"T1",1,3,3,"H"
2012-11-18,2012,"Kayserispor","Gaziantepspor","1-1",1,1,"T1",1,2,0,"D"
2012-11-19,2012,"Orduspor","Trabzonspor","1-2",1,2,"T1",1,3,-1,"A"
2012-11-23,2012,"Besiktas","Akhisar Belediyespor","3-1",3,1,"T1",1,4,2,"H"
2012-11-23,2012,"Mersin Idman Yurdu","Karabukspor","2-1",2,1,"T1",1,3,1,"H"
2012-11-24,2012,"Bursaspor","Antalyaspor","1-1",1,1,"T1",1,2,0,"D"
2012-11-24,2012,"Elazigspor","Galatasaray","0-1",0,1,"T1",1,1,-1,"A"
2012-11-24,2012,"Kasimpasa","Orduspor","1-1",1,1,"T1",1,2,0,"D"
2012-11-25,2012,"Fenerbahce","Genclerbirligi","4-1",4,1,"T1",1,5,3,"H"
2012-11-25,2012,"Gaziantepspor","Buyuksehyr","2-1",2,1,"T1",1,3,1,"H"
2012-11-25,2012,"Sivasspor","Kayserispor","4-2",4,2,"T1",1,6,2,"H"
2012-11-26,2012,"Trabzonspor","Eskisehirspor","0-3",0,3,"T1",1,3,-3,"A"
2012-11-30,2012,"Galatasaray","Gaziantepspor","1-1",1,1,"T1",1,2,0,"D"
2012-12-01,2012,"Akhisar Belediyespor","Bursaspor","2-2",2,2,"T1",1,4,0,"D"
2012-12-01,2012,"Karabukspor","Elazigspor","0-1",0,1,"T1",1,1,-1,"A"
2012-12-01,2012,"Orduspor","Besiktas","1-2",1,2,"T1",1,3,-1,"A"
2012-12-02,2012,"Antalyaspor","Mersin Idman Yurdu","1-0",1,0,"T1",1,1,1,"H"
2012-12-02,2012,"Buyuksehyr","Sivasspor","2-0",2,0,"T1",1,2,2,"H"
2012-12-02,2012,"Eskisehirspor","Kasimpasa","2-2",2,2,"T1",1,4,0,"D"
2012-12-02,2012,"Kayserispor","Fenerbahce","1-1",1,1,"T1",1,2,0,"D"
2012-12-03,2012,"Genclerbirligi","Trabzonspor","0-4",0,4,"T1",1,4,-4,"A"
2012-12-07,2012,"Besiktas","Eskisehirspor","2-2",2,2,"T1",1,4,0,"D"
2012-12-07,2012,"Elazigspor","Mersin Idman Yurdu","1-0",1,0,"T1",1,1,1,"H"
2012-12-08,2012,"Bursaspor","Orduspor","1-0",1,0,"T1",1,1,1,"H"
2012-12-08,2012,"Gaziantepspor","Karabukspor","0-2",0,2,"T1",1,2,-2,"A"
2012-12-08,2012,"Kasimpasa","Genclerbirligi","2-2",2,2,"T1",1,4,0,"D"
2012-12-08,2012,"Sivasspor","Galatasaray","1-3",1,3,"T1",1,4,-2,"A"
2012-12-09,2012,"Fenerbahce","Buyuksehyr","2-1",2,1,"T1",1,3,1,"H"
2012-12-09,2012,"Trabzonspor","Kayserispor","1-1",1,1,"T1",1,2,0,"D"
2012-12-14,2012,"Eskisehirspor","Bursaspor","2-2",2,2,"T1",1,4,0,"D"
2012-12-15,2012,"Elazigspor","Gaziantepspor","0-0",0,0,"T1",1,0,0,"D"
2012-12-15,2012,"Genclerbirligi","Besiktas","1-1",1,1,"T1",1,2,0,"D"
2012-12-15,2012,"Mersin Idman Yurdu","Akhisar Belediyespor","2-1",2,1,"T1",1,3,1,"H"
2012-12-16,2012,"Buyuksehyr","Trabzonspor","2-1",2,1,"T1",1,3,1,"H"
2012-12-16,2012,"Galatasaray","Fenerbahce","2-1",2,1,"T1",1,3,1,"H"
2012-12-16,2012,"Karabukspor","Sivasspor","1-0",1,0,"T1",1,1,1,"H"
2012-12-16,2012,"Orduspor","Antalyaspor","1-1",1,1,"T1",1,2,0,"D"
2012-12-17,2012,"Kayserispor","Kasimpasa","1-0",1,0,"T1",1,1,1,"H"
2012-12-21,2012,"Akhisar Belediyespor","Orduspor","0-0",0,0,"T1",1,0,0,"D"
2012-12-21,2012,"Besiktas","Kayserispor","3-1",3,1,"T1",1,4,2,"H"
2012-12-22,2012,"Fenerbahce","Karabukspor","1-3",1,3,"T1",1,4,-2,"A"
2012-12-22,2012,"Kasimpasa","Buyuksehyr","0-2",0,2,"T1",1,2,-2,"A"
2012-12-23,2012,"Antalyaspor","Eskisehirspor","2-1",2,1,"T1",1,3,1,"H"
2012-12-23,2012,"Bursaspor","Genclerbirligi","0-0",0,0,"T1",1,0,0,"D"
2012-12-23,2012,"Gaziantepspor","Mersin Idman Yurdu","2-1",2,1,"T1",1,3,1,"H"
2012-12-23,2012,"Sivasspor","Elazigspor","3-1",3,1,"T1",1,4,2,"H"
2012-12-23,2012,"Trabzonspor","Galatasaray","0-0",0,0,"T1",1,0,0,"D"
2013-01-09,2012,"Akhisar Belediyespor","Antalyaspor","1-0",1,0,"T1",1,1,1,"H"
2013-01-18,2012,"Kasimpasa","Galatasaray","2-1",2,1,"T1",1,3,1,"H"
2013-01-19,2012,"Besiktas","Buyuksehyr","2-2",2,2,"T1",1,4,0,"D"
2013-01-19,2012,"Bursaspor","Kayserispor","2-1",2,1,"T1",1,3,1,"H"
2013-01-19,2012,"Sivasspor","Gaziantepspor","0-0",0,0,"T1",1,0,0,"D"
2013-01-20,2012,"Antalyaspor","Genclerbirligi","3-5",3,5,"T1",1,8,-2,"A"
2013-01-20,2012,"Fenerbahce","Elazigspor","2-2",2,2,"T1",1,4,0,"D"
2013-01-20,2012,"Trabzonspor","Karabukspor","1-3",1,3,"T1",1,4,-2,"A"
2013-01-21,2012,"Akhisar Belediyespor","Eskisehirspor","1-1",1,1,"T1",1,2,0,"D"
2013-01-21,2012,"Orduspor","Mersin Idman Yurdu","1-1",1,1,"T1",1,2,0,"D"
2013-01-25,2012,"Karabukspor","Kasimpasa","0-3",0,3,"T1",1,3,-3,"A"
2013-01-26,2012,"Buyuksehyr","Bursaspor","4-1",4,1,"T1",1,5,3,"H"
2013-01-26,2012,"Gaziantepspor","Fenerbahce","1-2",1,2,"T1",1,3,-1,"A"
2013-01-26,2012,"Genclerbirligi","Akhisar Belediyespor","1-0",1,0,"T1",1,1,1,"H"
2013-01-27,2012,"Elazigspor","Trabzonspor","3-1",3,1,"T1",1,4,2,"H"
2013-01-27,2012,"Galatasaray","Besiktas","2-1",2,1,"T1",1,3,1,"H"
2013-01-27,2012,"Kayserispor","Antalyaspor","2-0",2,0,"T1",1,2,2,"H"
2013-01-27,2012,"Mersin Idman Yurdu","Sivasspor","3-0",3,0,"T1",1,3,3,"H"
2013-01-28,2012,"Eskisehirspor","Orduspor","1-0",1,0,"T1",1,1,1,"H"
2013-02-01,2012,"Akhisar Belediyespor","Kayserispor","1-2",1,2,"T1",1,3,-1,"A"
2013-02-01,2012,"Besiktas","Karabukspor","2-2",2,2,"T1",1,4,0,"D"
2013-02-02,2012,"Antalyaspor","Buyuksehyr","1-0",1,0,"T1",1,1,1,"H"
2013-02-02,2012,"Bursaspor","Galatasaray","1-1",1,1,"T1",1,2,0,"D"
2013-02-02,2012,"Kasimpasa","Elazigspor","0-0",0,0,"T1",1,0,0,"D"
2013-02-03,2012,"Eskisehirspor","Mersin Idman Yurdu","0-0",0,0,"T1",1,0,0,"D"
2013-02-03,2012,"Fenerbahce","Sivasspor","1-2",1,2,"T1",1,3,-1,"A"
2013-02-03,2012,"Orduspor","Genclerbirligi","2-1",2,1,"T1",1,3,1,"H"
2013-02-03,2012,"Trabzonspor","Gaziantepspor","4-1",4,1,"T1",1,5,3,"H"
2013-02-09,2012,"Buyuksehyr","Akhisar Belediyespor","0-2",0,2,"T1",1,2,-2,"A"
2013-02-09,2012,"Elazigspor","Besiktas","1-3",1,3,"T1",1,4,-2,"A"
2013-02-09,2012,"Genclerbirligi","Eskisehirspor","0-2",0,2,"T1",1,2,-2,"A"
2013-02-09,2012,"Karabukspor","Bursaspor","0-3",0,3,"T1",1,3,-3,"A"
2013-02-10,2012,"Galatasaray","Antalyaspor","2-0",2,0,"T1",1,2,2,"H"
2013-02-10,2012,"Kayserispor","Orduspor","0-0",0,0,"T1",1,0,0,"D"
2013-02-10,2012,"Mersin Idman Yurdu","Fenerbahce","0-1",0,1,"T1",1,1,-1,"A"
2013-02-10,2012,"Sivasspor","Trabzonspor","2-0",2,0,"T1",1,2,2,"H"
2013-02-11,2012,"Gaziantepspor","Kasimpasa","2-1",2,1,"T1",1,3,1,"H"
2013-02-15,2012,"Akhisar Belediyespor","Galatasaray","1-2",1,2,"T1",1,3,-1,"A"
2013-02-16,2012,"Antalyaspor","Karabukspor","0-0",0,0,"T1",1,0,0,"D"
2013-02-16,2012,"Besiktas","Gaziantepspor","1-1",1,1,"T1",1,2,0,"D"
2013-02-16,2012,"Eskisehirspor","Kayserispor","0-3",0,3,"T1",1,3,-3,"A"
2013-02-17,2012,"Bursaspor","Elazigspor","1-0",1,0,"T1",1,1,1,"H"
2013-02-17,2012,"Genclerbirligi","Mersin Idman Yurdu","3-1",3,1,"T1",1,4,2,"H"
2013-02-17,2012,"Orduspor","Buyuksehyr","2-2",2,2,"T1",1,4,0,"D"
2013-02-17,2012,"Trabzonspor","Fenerbahce","0-3",0,3,"T1",1,3,-3,"A"
2013-02-18,2012,"Kasimpasa","Sivasspor","1-0",1,0,"T1",1,1,1,"H"
2013-02-22,2012,"Gaziantepspor","Bursaspor","2-1",2,1,"T1",1,3,1,"H"
2013-02-23,2012,"Buyuksehyr","Eskisehirspor","2-2",2,2,"T1",1,4,0,"D"
2013-02-23,2012,"Elazigspor","Antalyaspor","2-1",2,1,"T1",1,3,1,"H"
2013-02-23,2012,"Mersin Idman Yurdu","Trabzonspor","0-1",0,1,"T1",1,1,-1,"A"
2013-02-23,2012,"Sivasspor","Besiktas","0-1",0,1,"T1",1,1,-1,"A"
2013-02-24,2012,"Fenerbahce","Kasimpasa","3-1",3,1,"T1",1,4,2,"H"
2013-02-24,2012,"Karabukspor","Akhisar Belediyespor","0-2",0,2,"T1",1,2,-2,"A"
2013-02-24,2012,"Kayserispor","Genclerbirligi","1-0",1,0,"T1",1,1,1,"H"
2013-02-25,2012,"Galatasaray","Orduspor","4-2",4,2,"T1",1,6,2,"H"
2013-03-01,2012,"Genclerbirligi","Buyuksehyr","0-0",0,0,"T1",1,0,0,"D"
2013-03-02,2012,"Akhisar Belediyespor","Elazigspor","0-1",0,1,"T1",1,1,-1,"A"
2013-03-02,2012,"Eskisehirspor","Galatasaray","0-0",0,0,"T1",1,0,0,"D"
2013-03-02,2012,"Orduspor","Karabukspor","3-2",3,2,"T1",1,5,1,"H"
2013-03-03,2012,"Antalyaspor","Gaziantepspor","5-2",5,2,"T1",1,7,3,"H"
2013-03-03,2012,"Besiktas","Fenerbahce","3-2",3,2,"T1",1,5,1,"H"
2013-03-03,2012,"Bursaspor","Sivasspor","1-0",1,0,"T1",1,1,1,"H"
2013-03-03,2012,"Kayserispor","Mersin Idman Yurdu","2-1",2,1,"T1",1,3,1,"H"
2013-03-04,2012,"Kasimpasa","Trabzonspor","2-0",2,0,"T1",1,2,2,"H"
2013-03-08,2012,"Galatasaray","Genclerbirligi","0-1",0,1,"T1",1,1,-1,"A"
2013-03-09,2012,"Buyuksehyr","Kayserispor","0-0",0,0,"T1",1,0,0,"D"
2013-03-09,2012,"Gaziantepspor","Akhisar Belediyespor","2-2",2,2,"T1",1,4,0,"D"
2013-03-09,2012,"Trabzonspor","Besiktas","0-0",0,0,"T1",1,0,0,"D"
2013-03-10,2012,"Elazigspor","Orduspor","1-0",1,0,"T1",1,1,1,"H"
2013-03-10,2012,"Fenerbahce","Bursaspor","4-1",4,1,"T1",1,5,3,"H"
2013-03-10,2012,"Karabukspor","Eskisehirspor","0-0",0,0,"T1",1,0,0,"D"
2013-03-10,2012,"Sivasspor","Antalyaspor","2-1",2,1,"T1",1,3,1,"H"
2013-03-11,2012,"Mersin Idman Yurdu","Kasimpasa","1-1",1,1,"T1",1,2,0,"D"
2013-03-15,2012,"Bursaspor","Trabzonspor","3-2",3,2,"T1",1,5,1,"H"
2013-03-15,2012,"Eskisehirspor","Elazigspor","2-2",2,2,"T1",1,4,0,"D"
2013-03-16,2012,"Besiktas","Kasimpasa","1-3",1,3,"T1",1,4,-2,"A"
2013-03-16,2012,"Buyuksehyr","Mersin Idman Yurdu","4-2",4,2,"T1",1,6,2,"H"
2013-03-16,2012,"Genclerbirligi","Karabukspor","2-1",2,1,"T1",1,3,1,"H"
2013-03-17,2012,"Akhisar Belediyespor","Sivasspor","2-1",2,1,"T1",1,3,1,"H"
2013-03-17,2012,"Antalyaspor","Fenerbahce","1-2",1,2,"T1",1,3,-1,"A"
2013-03-17,2012,"Kayserispor","Galatasaray","1-3",1,3,"T1",1,4,-2,"A"
2013-03-17,2012,"Orduspor","Gaziantepspor","2-3",2,3,"T1",1,5,-1,"A"
2013-03-30,2012,"Galatasaray","Buyuksehyr","2-0",2,0,"T1",1,2,2,"H"
2013-03-30,2012,"Gaziantepspor","Eskisehirspor","2-0",2,0,"T1",1,2,2,"H"
2013-03-30,2012,"Sivasspor","Orduspor","3-2",3,2,"T1",1,5,1,"H"
2013-03-31,2012,"Elazigspor","Genclerbirligi","1-1",1,1,"T1",1,2,0,"D"
2013-03-31,2012,"Fenerbahce","Akhisar Belediyespor","2-0",2,0,"T1",1,2,2,"H"
2013-03-31,2012,"Kasimpasa","Bursaspor","2-0",2,0,"T1",1,2,2,"H"
2013-03-31,2012,"Trabzonspor","Antalyaspor","2-0",2,0,"T1",1,2,2,"H"
2013-04-01,2012,"Karabukspor","Kayserispor","3-1",3,1,"T1",1,4,2,"H"
2013-04-01,2012,"Mersin Idman Yurdu","Besiktas","1-2",1,2,"T1",1,3,-1,"A"
2013-04-05,2012,"Antalyaspor","Kasimpasa","3-2",3,2,"T1",1,5,1,"H"
2013-04-06,2012,"Buyuksehyr","Karabukspor","2-2",2,2,"T1",1,4,0,"D"
2013-04-06,2012,"Galatasaray","Mersin Idman Yurdu","3-1",3,1,"T1",1,4,2,"H"
2013-04-06,2012,"Kayserispor","Elazigspor","4-1",4,1,"T1",1,5,3,"H"
2013-04-07,2012,"Akhisar Belediyespor","Trabzonspor","1-0",1,0,"T1",1,1,1,"H"
2013-04-07,2012,"Eskisehirspor","Sivasspor","2-1",2,1,"T1",1,3,1,"H"
2013-04-07,2012,"Genclerbirligi","Gaziantepspor","2-2",2,2,"T1",1,4,0,"D"
2013-04-07,2012,"Orduspor","Fenerbahce","0-2",0,2,"T1",1,2,-2,"A"
2013-04-08,2012,"Bursaspor","Besiktas","3-0",3,0,"T1",1,3,3,"H"
2013-04-12,2012,"Sivasspor","Genclerbirligi","1-1",1,1,"T1",1,2,0,"D"
2013-04-12,2012,"Trabzonspor","Orduspor","1-0",1,0,"T1",1,1,1,"H"
2013-04-13,2012,"Karabukspor","Galatasaray","0-1",0,1,"T1",1,1,-1,"A"
2013-04-13,2012,"Mersin Idman Yurdu","Bursaspor","0-1",0,1,"T1",1,1,-1,"A"
2013-04-14,2012,"Elazigspor","Buyuksehyr","1-0",1,0,"T1",1,1,1,"H"
2013-04-14,2012,"Fenerbahce","Eskisehirspor","1-0",1,0,"T1",1,1,1,"H"
2013-04-14,2012,"Gaziantepspor","Kayserispor","0-1",0,1,"T1",1,1,-1,"A"
2013-04-14,2012,"Kasimpasa","Akhisar Belediyespor","0-1",0,1,"T1",1,1,-1,"A"
2013-04-15,2012,"Besiktas","Antalyaspor","1-0",1,0,"T1",1,1,1,"H"
2013-04-19,2012,"Galatasaray","Elazigspor","3-1",3,1,"T1",1,4,2,"H"
2013-04-20,2012,"Akhisar Belediyespor","Besiktas","4-1",4,1,"T1",1,5,3,"H"
2013-04-20,2012,"Karabukspor","Mersin Idman Yurdu","1-0",1,0,"T1",1,1,1,"H"
2013-04-20,2012,"Orduspor","Kasimpasa","0-2",0,2,"T1",1,2,-2,"A"
2013-04-21,2012,"Antalyaspor","Bursaspor","0-1",0,1,"T1",1,1,-1,"A"
2013-04-21,2012,"Buyuksehyr","Gaziantepspor","1-3",1,3,"T1",1,4,-2,"A"
2013-04-21,2012,"Genclerbirligi","Fenerbahce","2-0",2,0,"T1",1,2,2,"H"
2013-04-21,2012,"Kayserispor","Sivasspor","1-1",1,1,"T1",1,2,0,"D"
2013-04-22,2012,"Eskisehirspor","Trabzonspor","0-1",0,1,"T1",1,1,-1,"A"
2013-04-26,2012,"Mersin Idman Yurdu","Antalyaspor","1-1",1,1,"T1",1,2,0,"D"
2013-04-27,2012,"Besiktas","Orduspor","2-0",2,0,"T1",1,2,2,"H"
2013-04-27,2012,"Bursaspor","Akhisar Belediyespor","1-1",1,1,"T1",1,2,0,"D"
2013-04-27,2012,"Elazigspor","Karabukspor","1-0",1,0,"T1",1,1,1,"H"
2013-04-27,2012,"Sivasspor","Buyuksehyr","4-1",4,1,"T1",1,5,3,"H"
2013-04-27,2012,"Trabzonspor","Genclerbirligi","2-0",2,0,"T1",1,2,2,"H"
2013-04-28,2012,"Fenerbahce","Kayserispor","2-1",2,1,"T1",1,3,1,"H"
2013-04-28,2012,"Gaziantepspor","Galatasaray","0-1",0,1,"T1",1,1,-1,"A"
2013-04-28,2012,"Kasimpasa","Eskisehirspor","1-2",1,2,"T1",1,3,-1,"A"
2013-05-03,2012,"Genclerbirligi","Kasimpasa","0-0",0,0,"T1",1,0,0,"D"
2013-05-04,2012,"Kayserispor","Trabzonspor","2-1",2,1,"T1",1,3,1,"H"
2013-05-04,2012,"Orduspor","Bursaspor","2-4",2,4,"T1",1,6,-2,"A"
2013-05-05,2012,"Antalyaspor","Akhisar Belediyespor","4-3",4,3,"T1",1,7,1,"H"
2013-05-05,2012,"Buyuksehyr","Fenerbahce","2-0",2,0,"T1",1,2,2,"H"
2013-05-05,2012,"Eskisehirspor","Besiktas","1-2",1,2,"T1",1,3,-1,"A"
2013-05-05,2012,"Galatasaray","Sivasspor","4-2",4,2,"T1",1,6,2,"H"
2013-05-05,2012,"Karabukspor","Gaziantepspor","0-2",0,2,"T1",1,2,-2,"A"
2013-05-05,2012,"Mersin Idman Yurdu","Elazigspor","0-2",0,2,"T1",1,2,-2,"A"
2013-05-10,2012,"Gaziantepspor","Elazigspor","1-1",1,1,"T1",1,2,0,"D"
2013-05-10,2012,"Kasimpasa","Kayserispor","1-2",1,2,"T1",1,3,-1,"A"
2013-05-11,2012,"Antalyaspor","Orduspor","1-0",1,0,"T1",1,1,1,"H"
2013-05-11,2012,"Besiktas","Genclerbirligi","3-0",3,0,"T1",1,3,3,"H"
2013-05-12,2012,"Fenerbahce","Galatasaray","2-1",2,1,"T1",1,3,1,"H"
2013-05-13,2012,"Akhisar Belediyespor","Mersin Idman Yurdu","1-0",1,0,"T1",1,1,1,"H"
2013-05-13,2012,"Bursaspor","Eskisehirspor","0-0",0,0,"T1",1,0,0,"D"
2013-05-13,2012,"Sivasspor","Karabukspor","2-1",2,1,"T1",1,3,1,"H"
2013-05-13,2012,"Trabzonspor","Buyuksehyr","4-3",4,3,"T1",1,7,1,"H"
2013-05-17,2012,"Mersin Idman Yurdu","Gaziantepspor","1-2",1,2,"T1",1,3,-1,"A"
2013-05-18,2012,"Buyuksehyr","Kasimpasa","1-2",1,2,"T1",1,3,-1,"A"
2013-05-18,2012,"Galatasaray","Trabzonspor","2-0",2,0,"T1",1,2,2,"H"
2013-05-18,2012,"Karabukspor","Fenerbahce","3-2",3,2,"T1",1,5,1,"H"
2013-05-18,2012,"Orduspor","Akhisar Belediyespor","0-2",0,2,"T1",1,2,-2,"A"
2013-05-19,2012,"Elazigspor","Sivasspor","0-0",0,0,"T1",1,0,0,"D"
2013-05-19,2012,"Eskisehirspor","Antalyaspor","3-1",3,1,"T1",1,4,2,"H"
2013-05-19,2012,"Genclerbirligi","Bursaspor","2-2",2,2,"T1",1,4,0,"D"
2013-05-19,2012,"Kayserispor","Besiktas","2-0",2,0,"T1",1,2,2,"H"
2013-08-16,2013,"Antalyaspor","Erciyesspor","0-0",0,0,"T1",1,0,0,"D"
2013-08-17,2013,"Karabukspor","Kasimpasa","2-0",2,0,"T1",1,2,2,"H"
2013-08-17,2013,"Konyaspor","Fenerbahce","3-2",3,2,"T1",1,5,1,"H"
2013-08-17,2013,"Rizespor","Genclerbirligi","1-0",1,0,"T1",1,1,1,"H"
2013-08-18,2013,"Akhisar Belediyespor","Elazigspor","3-1",3,1,"T1",1,4,2,"H"
2013-08-18,2013,"Besiktas","Trabzonspor","2-0",2,0,"T1",1,2,2,"H"
2013-08-18,2013,"Eskisehirspor","Bursaspor","2-0",2,0,"T1",1,2,2,"H"
2013-08-19,2013,"Galatasaray","Gaziantepspor","2-1",2,1,"T1",1,3,1,"H"
2013-08-19,2013,"Kayserispor","Sivasspor","1-0",1,0,"T1",1,1,1,"H"
2013-08-23,2013,"Genclerbirligi","Akhisar Belediyespor","3-0",3,0,"T1",1,3,3,"H"
2013-08-24,2013,"Fenerbahce","Eskisehirspor","1-0",1,0,"T1",1,1,1,"H"
2013-08-24,2013,"Gaziantepspor","Antalyaspor","0-0",0,0,"T1",1,0,0,"D"
2013-08-24,2013,"Kasimpasa","Kayserispor","3-1",3,1,"T1",1,4,2,"H"
2013-08-25,2013,"Bursaspor","Galatasaray","1-1",1,1,"T1",1,2,0,"D"
2013-08-25,2013,"Elazigspor","Karabukspor","2-2",2,2,"T1",1,4,0,"D"
2013-08-25,2013,"Sivasspor","Konyaspor","2-0",2,0,"T1",1,2,2,"H"
2013-08-26,2013,"Erciyesspor","Besiktas","2-4",2,4,"T1",1,6,-2,"A"
2013-08-26,2013,"Trabzonspor","Rizespor","2-1",2,1,"T1",1,3,1,"H"
2013-08-30,2013,"Eskisehirspor","Galatasaray","0-0",0,0,"T1",1,0,0,"D"
2013-08-30,2013,"Konyaspor","Kasimpasa","1-2",1,2,"T1",1,3,-1,"A"
2013-08-31,2013,"Antalyaspor","Bursaspor","1-2",1,2,"T1",1,3,-1,"A"
2013-08-31,2013,"Fenerbahce","Sivasspor","5-2",5,2,"T1",1,7,3,"H"
2013-08-31,2013,"Kayserispor","Elazigspor","1-3",1,3,"T1",1,4,-2,"A"
2013-09-01,2013,"Akhisar Belediyespor","Trabzonspor","3-0",3,0,"T1",1,3,3,"H"
2013-09-01,2013,"Besiktas","Gaziantepspor","2-0",2,0,"T1",1,2,2,"H"
2013-09-01,2013,"Karabukspor","Genclerbirligi","1-0",1,0,"T1",1,1,1,"H"
2013-09-01,2013,"Rizespor","Erciyesspor","2-1",2,1,"T1",1,3,1,"H"
2013-09-13,2013,"Galatasaray","Antalyaspor","1-1",1,1,"T1",1,2,0,"D"
2013-09-14,2013,"Erciyesspor","Akhisar Belediyespor","1-0",1,0,"T1",1,1,1,"H"
2013-09-14,2013,"Gaziantepspor","Rizespor","2-5",2,5,"T1",1,7,-3,"A"
2013-09-14,2013,"Trabzonspor","Karabukspor","1-0",1,0,"T1",1,1,1,"H"
2013-09-15,2013,"Bursaspor","Besiktas","0-3",0,3,"T1",1,3,-3,"A"
2013-09-15,2013,"Elazigspor","Konyaspor","2-0",2,0,"T1",1,2,2,"H"
2013-09-15,2013,"Genclerbirligi","Kayserispor","1-1",1,1,"T1",1,2,0,"D"
2013-09-15,2013,"Sivasspor","Eskisehirspor","3-2",3,2,"T1",1,5,1,"H"
2013-09-16,2013,"Kasimpasa","Fenerbahce","2-3",2,3,"T1",1,5,-1,"A"
2013-09-20,2013,"Akhisar Belediyespor","Gaziantepspor","2-0",2,0,"T1",1,2,2,"H"
2013-09-20,2013,"Karabukspor","Erciyesspor","0-0",0,0,"T1",1,0,0,"D"
2013-09-21,2013,"Eskisehirspor","Antalyaspor","2-1",2,1,"T1",1,3,1,"H"
2013-09-21,2013,"Fenerbahce","Elazigspor","4-0",4,0,"T1",1,4,4,"H"
2013-09-21,2013,"Konyaspor","Genclerbirligi","1-0",1,0,"T1",1,1,1,"H"
2013-09-21,2013,"Sivasspor","Kasimpasa","1-2",1,2,"T1",1,3,-1,"A"
2013-09-22,2013,"Besiktas","Galatasaray","0-3",0,3,"T1",1,3,-3,"A"
2013-09-22,2013,"Rizespor","Bursaspor","2-1",2,1,"T1",1,3,1,"H"
2013-09-23,2013,"Kayserispor","Trabzonspor","0-1",0,1,"T1",1,1,-1,"A"
2013-09-27,2013,"Bursaspor","Akhisar Belediyespor","0-0",0,0,"T1",1,0,0,"D"
2013-09-28,2013,"Galatasaray","Rizespor","1-1",1,1,"T1",1,2,0,"D"
2013-09-28,2013,"Gaziantepspor","Karabukspor","3-0",3,0,"T1",1,3,3,"H"
2013-09-29,2013,"Elazigspor","Sivasspor","2-4",2,4,"T1",1,6,-2,"A"
2013-09-29,2013,"Genclerbirligi","Fenerbahce","0-1",0,1,"T1",1,1,-1,"A"
2013-09-29,2013,"Kasimpasa","Eskisehirspor","0-2",0,2,"T1",1,2,-2,"A"
2013-09-29,2013,"Trabzonspor","Konyaspor","2-0",2,0,"T1",1,2,2,"H"
2013-09-30,2013,"Antalyaspor","Besiktas","2-0",2,0,"T1",1,2,2,"H"
2013-09-30,2013,"Erciyesspor","Kayserispor","1-1",1,1,"T1",1,2,0,"D"
2013-10-04,2013,"Karabukspor","Bursaspor","0-1",0,1,"T1",1,1,-1,"A"
2013-10-05,2013,"Eskisehirspor","Besiktas","0-1",0,1,"T1",1,1,-1,"A"
2013-10-05,2013,"Kayserispor","Gaziantepspor","0-1",0,1,"T1",1,1,-1,"A"
2013-10-05,2013,"Konyaspor","Erciyesspor","1-0",1,0,"T1",1,1,1,"H"
2013-10-06,2013,"Akhisar Belediyespor","Galatasaray","2-1",2,1,"T1",1,3,1,"H"
2013-10-06,2013,"Fenerbahce","Trabzonspor","0-0",0,0,"T1",1,0,0,"D"
2013-10-06,2013,"Kasimpasa","Elazigspor","4-0",4,0,"T1",1,4,4,"H"
2013-10-06,2013,"Rizespor","Antalyaspor","1-2",1,2,"T1",1,3,-1,"A"
2013-10-06,2013,"Sivasspor","Genclerbirligi","2-0",2,0,"T1",1,2,2,"H"
2013-10-19,2013,"Elazigspor","Eskisehirspor","0-2",0,2,"T1",1,2,-2,"A"
2013-10-19,2013,"Galatasaray","Karabukspor","2-1",2,1,"T1",1,3,1,"H"
2013-10-19,2013,"Genclerbirligi","Kasimpasa","1-3",1,3,"T1",1,4,-2,"A"
2013-10-20,2013,"Antalyaspor","Akhisar Belediyespor","1-0",1,0,"T1",1,1,1,"H"
2013-10-20,2013,"Erciyesspor","Fenerbahce","1-2",1,2,"T1",1,3,-1,"A"
2013-10-20,2013,"Gaziantepspor","Konyaspor","3-3",3,3,"T1",1,6,0,"D"
2013-10-20,2013,"Trabzonspor","Sivasspor","0-0",0,0,"T1",1,0,0,"D"
2013-10-21,2013,"Besiktas","Rizespor","0-0",0,0,"T1",1,0,0,"D"
2013-10-21,2013,"Bursaspor","Kayserispor","2-0",2,0,"T1",1,2,2,"H"
2013-10-25,2013,"Fenerbahce","Gaziantepspor","3-1",3,1,"T1",1,4,2,"H"
2013-10-25,2013,"Sivasspor","Erciyesspor","2-0",2,0,"T1",1,2,2,"H"
2013-10-26,2013,"Akhisar Belediyespor","Besiktas","3-3",3,3,"T1",1,6,0,"D"
2013-10-26,2013,"Elazigspor","Genclerbirligi","1-2",1,2,"T1",1,3,-1,"A"
2013-10-26,2013,"Karabukspor","Antalyaspor","1-1",1,1,"T1",1,2,0,"D"
2013-10-27,2013,"Eskisehirspor","Rizespor","4-1",4,1,"T1",1,5,3,"H"
2013-10-27,2013,"Kayserispor","Galatasaray","2-4",2,4,"T1",1,6,-2,"A"
2013-10-27,2013,"Konyaspor","Bursaspor","0-1",0,1,"T1",1,1,-1,"A"
2013-10-28,2013,"Kasimpasa","Trabzonspor","3-2",3,2,"T1",1,5,1,"H"
2013-11-01,2013,"Galatasaray","Konyaspor","2-1",2,1,"T1",1,3,1,"H"
2013-11-02,2013,"Bursaspor","Fenerbahce","2-3",2,3,"T1",1,5,-1,"A"
2013-11-02,2013,"Erciyesspor","Kasimpasa","0-3",0,3,"T1",1,3,-3,"A"
2013-11-03,2013,"Besiktas","Karabukspor","0-0",0,0,"T1",1,0,0,"D"
2013-11-03,2013,"Rizespor","Akhisar Belediyespor","0-0",0,0,"T1",1,0,0,"D"
2013-11-03,2013,"Trabzonspor","Elazigspor","4-0",4,0,"T1",1,4,4,"H"
2013-11-04,2013,"Antalyaspor","Kayserispor","2-2",2,2,"T1",1,4,0,"D"
2013-11-04,2013,"Gaziantepspor","Sivasspor","0-4",0,4,"T1",1,4,-4,"A"
2013-11-04,2013,"Genclerbirligi","Eskisehirspor","2-0",2,0,"T1",1,2,2,"H"
2013-11-08,2013,"Elazigspor","Erciyesspor","0-1",0,1,"T1",1,1,-1,"A"
2013-11-08,2013,"Eskisehirspor","Akhisar Belediyespor","2-0",2,0,"T1",1,2,2,"H"
2013-11-09,2013,"Karabukspor","Rizespor","2-1",2,1,"T1",1,3,1,"H"
2013-11-09,2013,"Kasimpasa","Gaziantepspor","3-0",3,0,"T1",1,3,3,"H"
2013-11-09,2013,"Kayserispor","Besiktas","0-3",0,3,"T1",1,3,-3,"A"
2013-11-09,2013,"Sivasspor","Bursaspor","2-1",2,1,"T1",1,3,1,"H"
2013-11-10,2013,"Fenerbahce","Galatasaray","2-0",2,0,"T1",1,2,2,"H"
2013-11-10,2013,"Genclerbirligi","Trabzonspor","3-2",3,2,"T1",1,5,1,"H"
2013-11-10,2013,"Konyaspor","Antalyaspor","2-0",2,0,"T1",1,2,2,"H"
2013-11-23,2013,"Bursaspor","Kasimpasa","1-1",1,1,"T1",1,2,0,"D"
2013-11-23,2013,"Galatasaray","Sivasspor","2-1",2,1,"T1",1,3,1,"H"
2013-11-23,2013,"Rizespor","Kayserispor","0-2",0,2,"T1",1,2,-2,"A"
2013-11-24,2013,"Antalyaspor","Fenerbahce","1-2",1,2,"T1",1,3,-1,"A"
2013-11-24,2013,"Erciyesspor","Genclerbirligi","1-0",1,0,"T1",1,1,1,"H"
2013-11-24,2013,"Gaziantepspor","Elazigspor","3-1",3,1,"T1",1,4,2,"H"
2013-11-24,2013,"Trabzonspor","Eskisehirspor","1-0",1,0,"T1",1,1,1,"H"
2013-11-25,2013,"Akhisar Belediyespor","Karabukspor","0-1",0,1,"T1",1,1,-1,"A"
2013-11-25,2013,"Besiktas","Konyaspor","3-1",3,1,"T1",1,4,2,"H"
2013-11-29,2013,"Elazigspor","Bursaspor","1-2",1,2,"T1",1,3,-1,"A"
2013-11-29,2013,"Sivasspor","Antalyaspor","0-3",0,3,"T1",1,3,-3,"A"
2013-11-30,2013,"Fenerbahce","Besiktas","3-3",3,3,"T1",1,6,0,"D"
2013-11-30,2013,"Genclerbirligi","Gaziantepspor","1-3",1,3,"T1",1,4,-2,"A"
2013-11-30,2013,"Kayserispor","Akhisar Belediyespor","0-0",0,0,"T1",1,0,0,"D"
2013-12-01,2013,"Eskisehirspor","Karabukspor","0-0",0,0,"T1",1,0,0,"D"
2013-12-01,2013,"Kasimpasa","Galatasaray","1-1",1,1,"T1",1,2,0,"D"
2013-12-01,2013,"Trabzonspor","Erciyesspor","3-1",3,1,"T1",1,4,2,"H"
2013-12-02,2013,"Konyaspor","Rizespor","2-1",2,1,"T1",1,3,1,"H"
2013-12-06,2013,"Galatasaray","Elazigspor","2-0",2,0,"T1",1,2,2,"H"
2013-12-07,2013,"Antalyaspor","Kasimpasa","1-1",1,1,"T1",1,2,0,"D"
2013-12-07,2013,"Rizespor","Fenerbahce","1-2",1,2,"T1",1,3,-1,"A"
2013-12-08,2013,"Akhisar Belediyespor","Konyaspor","2-1",2,1,"T1",1,3,1,"H"
2013-12-08,2013,"Bursaspor","Genclerbirligi","0-0",0,0,"T1",1,0,0,"D"
2013-12-08,2013,"Gaziantepspor","Trabzonspor","3-2",3,2,"T1",1,5,1,"H"
2013-12-08,2013,"Karabukspor","Kayserispor","1-0",1,0,"T1",1,1,1,"H"
2013-12-09,2013,"Besiktas","Sivasspor","1-1",1,1,"T1",1,2,0,"D"
2013-12-09,2013,"Erciyesspor","Eskisehirspor","0-2",0,2,"T1",1,2,-2,"A"
2013-12-13,2013,"Fenerbahce","Akhisar Belediyespor","4-0",4,0,"T1",1,4,4,"H"
2013-12-13,2013,"Konyaspor","Karabukspor","2-3",2,3,"T1",1,5,-1,"A"
2013-12-14,2013,"Elazigspor","Antalyaspor","4-1",4,1,"T1",1,5,3,"H"
2013-12-14,2013,"Kayserispor","Eskisehirspor","1-1",1,1,"T1",1,2,0,"D"
2013-12-14,2013,"Sivasspor","Rizespor","3-1",3,1,"T1",1,4,2,"H"
2013-12-15,2013,"Gaziantepspor","Erciyesspor","2-1",2,1,"T1",1,3,1,"H"
2013-12-15,2013,"Genclerbirligi","Galatasaray","1-1",1,1,"T1",1,2,0,"D"
2013-12-16,2013,"Trabzonspor","Bursaspor","2-2",2,2,"T1",1,4,0,"D"
2013-12-20,2013,"Rizespor","Kasimpasa","0-0",0,0,"T1",1,0,0,"D"
2013-12-21,2013,"Besiktas","Elazigspor","4-1",4,1,"T1",1,5,3,"H"
2013-12-22,2013,"Antalyaspor","Genclerbirligi","2-3",2,3,"T1",1,5,-1,"A"
2013-12-22,2013,"Eskisehirspor","Gaziantepspor","2-0",2,0,"T1",1,2,2,"H"
2013-12-22,2013,"Galatasaray","Trabzonspor","2-1",2,1,"T1",1,3,1,"H"
2013-12-22,2013,"Karabukspor","Fenerbahce","2-1",2,1,"T1",1,3,1,"H"
2013-12-22,2013,"Kayserispor","Konyaspor","0-0",0,0,"T1",1,0,0,"D"
2013-12-23,2013,"Akhisar Belediyespor","Sivasspor","2-1",2,1,"T1",1,3,1,"H"
2013-12-23,2013,"Bursaspor","Erciyesspor","3-1",3,1,"T1",1,4,2,"H"
2013-12-27,2013,"Genclerbirligi","Besiktas","1-0",1,0,"T1",1,1,1,"H"
2013-12-27,2013,"Kasimpasa","Akhisar Belediyespor","2-4",2,4,"T1",1,6,-2,"A"
2013-12-28,2013,"Elazigspor","Rizespor","1-0",1,0,"T1",1,1,1,"H"
2013-12-28,2013,"Erciyesspor","Galatasaray","1-3",1,3,"T1",1,4,-2,"A"
2013-12-28,2013,"Gaziantepspor","Bursaspor","0-0",0,0,"T1",1,0,0,"D"
2013-12-29,2013,"Fenerbahce","Kayserispor","5-1",5,1,"T1",1,6,4,"H"
2013-12-29,2013,"Konyaspor","Eskisehirspor","4-1",4,1,"T1",1,5,3,"H"
2013-12-29,2013,"Sivasspor","Karabukspor","3-1",3,1,"T1",1,4,2,"H"
2013-12-29,2013,"Trabzonspor","Antalyaspor","2-1",2,1,"T1",1,3,1,"H"
2014-01-24,2013,"Kasimpasa","Karabukspor","0-0",0,0,"T1",1,0,0,"D"
2014-01-25,2013,"Bursaspor","Eskisehirspor","3-1",3,1,"T1",1,4,2,"H"
2014-01-25,2013,"Genclerbirligi","Rizespor","3-1",3,1,"T1",1,4,2,"H"
2014-01-25,2013,"Trabzonspor","Besiktas","1-1",1,1,"T1",1,2,0,"D"
2014-01-26,2013,"Elazigspor","Akhisar Belediyespor","2-1",2,1,"T1",1,3,1,"H"
2014-01-26,2013,"Erciyesspor","Antalyaspor","1-3",1,3,"T1",1,4,-2,"A"
2014-01-26,2013,"Gaziantepspor","Galatasaray","0-0",0,0,"T1",1,0,0,"D"
2014-01-26,2013,"Sivasspor","Kayserispor","3-0",3,0,"T1",1,3,3,"H"
2014-01-27,2013,"Fenerbahce","Konyaspor","2-1",2,1,"T1",1,3,1,"H"
2014-01-31,2013,"Besiktas","Erciyesspor","3-2",3,2,"T1",1,5,1,"H"
2014-02-01,2013,"Antalyaspor","Gaziantepspor","0-1",0,1,"T1",1,1,-1,"A"
2014-02-01,2013,"Eskisehirspor","Fenerbahce","2-1",2,1,"T1",1,3,1,"H"
2014-02-01,2013,"Kayserispor","Kasimpasa","0-0",0,0,"T1",1,0,0,"D"
2014-02-02,2013,"Akhisar Belediyespor","Genclerbirligi","3-1",3,1,"T1",1,4,2,"H"
2014-02-02,2013,"Galatasaray","Bursaspor","6-0",6,0,"T1",1,6,6,"H"
2014-02-02,2013,"Karabukspor","Elazigspor","3-1",3,1,"T1",1,4,2,"H"
2014-02-02,2013,"Konyaspor","Sivasspor","3-0",3,0,"T1",1,3,3,"H"
2014-02-03,2013,"Rizespor","Trabzonspor","0-0",0,0,"T1",1,0,0,"D"
2014-02-07,2013,"Gaziantepspor","Besiktas","1-2",1,2,"T1",1,3,-1,"A"
2014-02-07,2013,"Kasimpasa","Konyaspor","1-3",1,3,"T1",1,4,-2,"A"
2014-02-08,2013,"Erciyesspor","Rizespor","1-1",1,1,"T1",1,2,0,"D"
2014-02-08,2013,"Galatasaray","Eskisehirspor","3-0",3,0,"T1",1,3,3,"H"
2014-02-09,2013,"Bursaspor","Antalyaspor","1-1",1,1,"T1",1,2,0,"D"
2014-02-09,2013,"Elazigspor","Kayserispor","3-0",3,0,"T1",1,3,3,"H"
2014-02-09,2013,"Sivasspor","Fenerbahce","2-0",2,0,"T1",1,2,2,"H"
2014-02-09,2013,"Trabzonspor","Akhisar Belediyespor","2-4",2,4,"T1",1,6,-2,"A"
2014-02-10,2013,"Genclerbirligi","Karabukspor","1-2",1,2,"T1",1,3,-1,"A"
2014-02-11,2013,"Kasimpasa","Besiktas","0-3",0,3,"T1",1,3,-3,"A"
2014-02-14,2013,"Rizespor","Gaziantepspor","5-1",5,1,"T1",1,6,4,"H"
2014-02-15,2013,"Karabukspor","Trabzonspor","2-2",2,2,"T1",1,4,0,"D"
2014-02-15,2013,"Kayserispor","Genclerbirligi","1-0",1,0,"T1",1,1,1,"H"
2014-02-16,2013,"Akhisar Belediyespor","Erciyesspor","0-2",0,2,"T1",1,2,-2,"A"
2014-02-16,2013,"Besiktas","Bursaspor","1-0",1,0,"T1",1,1,1,"H"
2014-02-16,2013,"Fenerbahce","Kasimpasa","2-1",2,1,"T1",1,3,1,"H"
2014-02-17,2013,"Antalyaspor","Galatasaray","2-2",2,2,"T1",1,4,0,"D"
2014-02-17,2013,"Eskisehirspor","Sivasspor","2-2",2,2,"T1",1,4,0,"D"
2014-02-17,2013,"Konyaspor","Elazigspor","2-3",2,3,"T1",1,5,-1,"A"
2014-02-21,2013,"Bursaspor","Rizespor","2-0",2,0,"T1",1,2,2,"H"
2014-02-22,2013,"Erciyesspor","Karabukspor","2-1",2,1,"T1",1,3,1,"H"
2014-02-22,2013,"Galatasaray","Besiktas","1-0",1,0,"T1",1,1,1,"H"
2014-02-22,2013,"Gaziantepspor","Akhisar Belediyespor","1-1",1,1,"T1",1,2,0,"D"
2014-02-23,2013,"Antalyaspor","Eskisehirspor","0-0",0,0,"T1",1,0,0,"D"
2014-02-23,2013,"Genclerbirligi","Konyaspor","2-2",2,2,"T1",1,4,0,"D"
2014-02-23,2013,"Kasimpasa","Sivasspor","6-2",6,2,"T1",1,8,4,"H"
2014-02-23,2013,"Trabzonspor","Kayserispor","2-1",2,1,"T1",1,3,1,"H"
2014-02-24,2013,"Elazigspor","Fenerbahce","1-1",1,1,"T1",1,2,0,"D"
2014-02-28,2013,"Akhisar Belediyespor","Bursaspor","2-1",2,1,"T1",1,3,1,"H"
2014-02-28,2013,"Besiktas","Antalyaspor","0-0",0,0,"T1",1,0,0,"D"
2014-03-01,2013,"Eskisehirspor","Kasimpasa","0-0",0,0,"T1",1,0,0,"D"
2014-03-01,2013,"Fenerbahce","Genclerbirligi","2-0",2,0,"T1",1,2,2,"H"
2014-03-01,2013,"Karabukspor","Gaziantepspor","0-1",0,1,"T1",1,1,-1,"A"
2014-03-02,2013,"Kayserispor","Erciyesspor","0-4",0,4,"T1",1,4,-4,"A"
2014-03-02,2013,"Konyaspor","Trabzonspor","0-0",0,0,"T1",1,0,0,"D"
2014-03-02,2013,"Rizespor","Galatasaray","1-1",1,1,"T1",1,2,0,"D"
2014-03-02,2013,"Sivasspor","Elazigspor","1-3",1,3,"T1",1,4,-2,"A"
2014-03-08,2013,"Bursaspor","Karabukspor","1-0",1,0,"T1",1,1,1,"H"
2014-03-08,2013,"Elazigspor","Kasimpasa","0-0",0,0,"T1",1,0,0,"D"
2014-03-08,2013,"Erciyesspor","Konyaspor","1-0",1,0,"T1",1,1,1,"H"
2014-03-08,2013,"Galatasaray","Akhisar Belediyespor","6-1",6,1,"T1",1,7,5,"H"
2014-03-09,2013,"Antalyaspor","Rizespor","1-2",1,2,"T1",1,3,-1,"A"
2014-03-09,2013,"Besiktas","Eskisehirspor","1-0",1,0,"T1",1,1,1,"H"
2014-03-09,2013,"Gaziantepspor","Kayserispor","2-1",2,1,"T1",1,3,1,"H"
2014-03-09,2013,"Genclerbirligi","Sivasspor","2-1",2,1,"T1",1,3,1,"H"
2014-03-10,2013,"Trabzonspor","Fenerbahce","0-3",0,3,"T1",1,3,-3,"A"
2014-03-14,2013,"Karabukspor","Galatasaray","0-0",0,0,"T1",1,0,0,"D"
2014-03-15,2013,"Akhisar Belediyespor","Antalyaspor","0-0",0,0,"T1",1,0,0,"D"
2014-03-15,2013,"Kasimpasa","Genclerbirligi","1-2",1,2,"T1",1,3,-1,"A"
2014-03-15,2013,"Rizespor","Besiktas","2-2",2,2,"T1",1,4,0,"D"
2014-03-16,2013,"Eskisehirspor","Elazigspor","1-0",1,0,"T1",1,1,1,"H"
2014-03-16,2013,"Fenerbahce","Erciyesspor","2-1",2,1,"T1",1,3,1,"H"
2014-03-16,2013,"Konyaspor","Gaziantepspor","0-1",0,1,"T1",1,1,-1,"A"
2014-03-16,2013,"Sivasspor","Trabzonspor","0-4",0,4,"T1",1,4,-4,"A"
2014-03-17,2013,"Kayserispor","Bursaspor","2-0",2,0,"T1",1,2,2,"H"
2014-03-21,2013,"Trabzonspor","Kasimpasa","0-0",0,0,"T1",1,0,0,"D"
2014-03-22,2013,"Antalyaspor","Karabukspor","0-0",0,0,"T1",1,0,0,"D"
2014-03-22,2013,"Bursaspor","Konyaspor","1-2",1,2,"T1",1,3,-1,"A"
2014-03-22,2013,"Galatasaray","Kayserispor","0-1",0,1,"T1",1,1,-1,"A"
2014-03-22,2013,"Rizespor","Eskisehirspor","0-0",0,0,"T1",1,0,0,"D"
2014-03-23,2013,"Besiktas","Akhisar Belediyespor","3-0",3,0,"T1",1,3,3,"H"
2014-03-23,2013,"Erciyesspor","Sivasspor","1-1",1,1,"T1",1,2,0,"D"
2014-03-23,2013,"Genclerbirligi","Elazigspor","3-1",3,1,"T1",1,4,2,"H"
2014-03-24,2013,"Gaziantepspor","Fenerbahce","0-3",0,3,"T1",1,3,-3,"A"
2014-03-28,2013,"Karabukspor","Besiktas","1-0",1,0,"T1",1,1,1,"H"
2014-03-28,2013,"Kasimpasa","Erciyesspor","3-0",3,0,"T1",1,3,3,"H"
2014-03-29,2013,"Akhisar Belediyespor","Rizespor","2-3",2,3,"T1",1,5,-1,"A"
2014-03-29,2013,"Elazigspor","Trabzonspor","0-0",0,0,"T1",1,0,0,"D"
2014-03-29,2013,"Konyaspor","Galatasaray","0-0",0,0,"T1",1,0,0,"D"
2014-03-29,2013,"Sivasspor","Gaziantepspor","3-2",3,2,"T1",1,5,1,"H"
2014-03-31,2013,"Eskisehirspor","Genclerbirligi","0-1",0,1,"T1",1,1,-1,"A"
2014-03-31,2013,"Fenerbahce","Bursaspor","3-0",3,0,"T1",1,3,3,"H"
2014-03-31,2013,"Kayserispor","Antalyaspor","3-1",3,1,"T1",1,4,2,"H"
2014-04-04,2013,"Gaziantepspor","Kasimpasa","2-2",2,2,"T1",1,4,0,"D"
2014-04-05,2013,"Akhisar Belediyespor","Eskisehirspor","0-0",0,0,"T1",1,0,0,"D"
2014-04-05,2013,"Antalyaspor","Konyaspor","1-1",1,1,"T1",1,2,0,"D"
2014-04-05,2013,"Besiktas","Kayserispor","2-1",2,1,"T1",1,3,1,"H"
2014-04-05,2013,"Rizespor","Karabukspor","0-1",0,1,"T1",1,1,-1,"A"
2014-04-06,2013,"Bursaspor","Sivasspor","4-3",4,3,"T1",1,7,1,"H"
2014-04-06,2013,"Erciyesspor","Elazigspor","3-0",3,0,"T1",1,3,3,"H"
2014-04-06,2013,"Galatasaray","Fenerbahce","1-0",1,0,"T1",1,1,1,"H"
2014-04-07,2013,"Trabzonspor","Genclerbirligi","3-0",3,0,"T1",1,3,3,"H"
2014-04-11,2013,"Konyaspor","Besiktas","1-1",1,1,"T1",1,2,0,"D"
2014-04-12,2013,"Karabukspor","Akhisar Belediyespor","0-2",0,2,"T1",1,2,-2,"A"
2014-04-12,2013,"Kasimpasa","Bursaspor","1-1",1,1,"T1",1,2,0,"D"
2014-04-12,2013,"Kayserispor","Rizespor","0-2",0,2,"T1",1,2,-2,"A"
2014-04-12,2013,"Sivasspor","Galatasaray","2-1",2,1,"T1",1,3,1,"H"
2014-04-13,2013,"Eskisehirspor","Trabzonspor","2-2",2,2,"T1",1,4,0,"D"
2014-04-13,2013,"Fenerbahce","Antalyaspor","4-1",4,1,"T1",1,5,3,"H"
2014-04-13,2013,"Genclerbirligi","Erciyesspor","0-0",0,0,"T1",1,0,0,"D"
2014-04-14,2013,"Elazigspor","Gaziantepspor","2-1",2,1,"T1",1,3,1,"H"
2014-04-18,2013,"Erciyesspor","Trabzonspor","0-5",0,5,"T1",1,5,-5,"A"
2014-04-19,2013,"Akhisar Belediyespor","Kayserispor","2-2",2,2,"T1",1,4,0,"D"
2014-04-19,2013,"Bursaspor","Elazigspor","1-0",1,0,"T1",1,1,1,"H"
2014-04-19,2013,"Galatasaray","Kasimpasa","0-4",0,4,"T1",1,4,-4,"A"
2014-04-19,2013,"Gaziantepspor","Genclerbirligi","0-1",0,1,"T1",1,1,-1,"A"
2014-04-20,2013,"Besiktas","Fenerbahce","1-1",1,1,"T1",1,2,0,"D"
2014-04-20,2013,"Rizespor","Konyaspor","3-1",3,1,"T1",1,4,2,"H"
2014-04-21,2013,"Antalyaspor","Sivasspor","1-2",1,2,"T1",1,3,-1,"A"
2014-04-21,2013,"Karabukspor","Eskisehirspor","0-0",0,0,"T1",1,0,0,"D"
2014-04-25,2013,"Genclerbirligi","Bursaspor","1-0",1,0,"T1",1,1,1,"H"
2014-04-26,2013,"Trabzonspor","Gaziantepspor","2-1",2,1,"T1",1,3,1,"H"
2014-04-27,2013,"Elazigspor","Galatasaray","0-1",0,1,"T1",1,1,-1,"A"
2014-04-27,2013,"Eskisehirspor","Erciyesspor","0-1",0,1,"T1",1,1,-1,"A"
2014-04-27,2013,"Fenerbahce","Rizespor","0-0",0,0,"T1",1,0,0,"D"
2014-04-27,2013,"Kasimpasa","Antalyaspor","2-0",2,0,"T1",1,2,2,"H"
2014-04-27,2013,"Kayserispor","Karabukspor","1-3",1,3,"T1",1,4,-2,"A"
2014-04-27,2013,"Konyaspor","Akhisar Belediyespor","4-0",4,0,"T1",1,4,4,"H"
2014-04-27,2013,"Sivasspor","Besiktas","3-0",3,0,"T1",1,3,3,"H"
2014-05-03,2013,"Antalyaspor","Elazigspor","1-2",1,2,"T1",1,3,-1,"A"
2014-05-03,2013,"Besiktas","Kasimpasa","2-1",2,1,"T1",1,3,1,"H"
2014-05-03,2013,"Erciyesspor","Gaziantepspor","1-0",1,0,"T1",1,1,1,"H"
2014-05-03,2013,"Eskisehirspor","Kayserispor","1-4",1,4,"T1",1,5,-3,"A"
2014-05-03,2013,"Galatasaray","Genclerbirligi","3-2",3,2,"T1",1,5,1,"H"
2014-05-03,2013,"Karabukspor","Konyaspor","2-2",2,2,"T1",1,4,0,"D"
2014-05-04,2013,"Akhisar Belediyespor","Fenerbahce","3-1",3,1,"T1",1,4,2,"H"
2014-05-04,2013,"Bursaspor","Trabzonspor","2-2",2,2,"T1",1,4,0,"D"
2014-05-04,2013,"Rizespor","Sivasspor","1-1",1,1,"T1",1,2,0,"D"
2014-05-09,2013,"Fenerbahce","Karabukspor","4-0",4,0,"T1",1,4,4,"H"
2014-05-10,2013,"Genclerbirligi","Antalyaspor","1-2",1,2,"T1",1,3,-1,"A"
2014-05-11,2013,"Elazigspor","Besiktas","0-1",0,1,"T1",1,1,-1,"A"
2014-05-11,2013,"Erciyesspor","Bursaspor","1-1",1,1,"T1",1,2,0,"D"
2014-05-11,2013,"Gaziantepspor","Eskisehirspor","1-1",1,1,"T1",1,2,0,"D"
2014-05-11,2013,"Kasimpasa","Rizespor","1-1",1,1,"T1",1,2,0,"D"
2014-05-11,2013,"Konyaspor","Kayserispor","3-0",3,0,"T1",1,3,3,"H"
2014-05-11,2013,"Sivasspor","Akhisar Belediyespor","3-1",3,1,"T1",1,4,2,"H"
2014-05-11,2013,"Trabzonspor","Galatasaray","1-4",1,4,"T1",1,5,-3,"A"
2014-05-16,2013,"Eskisehirspor","Konyaspor","1-1",1,1,"T1",1,2,0,"D"
2014-05-16,2013,"Kayserispor","Fenerbahce","0-2",0,2,"T1",1,2,-2,"A"
2014-05-17,2013,"Besiktas","Genclerbirligi","1-1",1,1,"T1",1,2,0,"D"
2014-05-17,2013,"Bursaspor","Gaziantepspor","3-1",3,1,"T1",1,4,2,"H"
2014-05-17,2013,"Galatasaray","Erciyesspor","2-1",2,1,"T1",1,3,1,"H"
2014-05-17,2013,"Rizespor","Elazigspor","3-1",3,1,"T1",1,4,2,"H"
2014-05-18,2013,"Akhisar Belediyespor","Kasimpasa","1-3",1,3,"T1",1,4,-2,"A"
2014-05-18,2013,"Antalyaspor","Trabzonspor","0-2",0,2,"T1",1,2,-2,"A"
2014-05-18,2013,"Karabukspor","Sivasspor","1-0",1,0,"T1",1,1,1,"H"
2014-08-29,2014,"Balikesirspor","Akhisar Belediyespor","1-2",1,2,"T1",1,3,-1,"A"
2014-08-29,2014,"Rizespor","Genclerbirligi","1-1",1,1,"T1",1,2,0,"D"
2014-08-30,2014,"Bursaspor","Galatasaray","0-2",0,2,"T1",1,2,-2,"A"
2014-08-30,2014,"Buyuksehyr","Kasimpasa","1-1",1,1,"T1",1,2,0,"D"
2014-08-30,2014,"Eskisehirspor","Konyaspor","2-1",2,1,"T1",1,3,1,"H"
2014-08-30,2014,"Mersin Idman Yurdu","Besiktas","0-1",0,1,"T1",1,1,-1,"A"
2014-08-31,2014,"Erciyesspor","Trabzonspor","0-0",0,0,"T1",1,0,0,"D"
2014-08-31,2014,"Fenerbahce","Karabukspor","3-2",3,2,"T1",1,5,1,"H"
2014-08-31,2014,"Sivasspor","Gaziantepspor","1-2",1,2,"T1",1,3,-1,"A"
2014-09-13,2014,"Galatasaray","Eskisehirspor","0-0",0,0,"T1",1,0,0,"D"
2014-09-13,2014,"Genclerbirligi","Bursaspor","1-2",1,2,"T1",1,3,-1,"A"
2014-09-13,2014,"Karabukspor","Buyuksehyr","0-0",0,0,"T1",1,0,0,"D"
2014-09-13,2014,"Konyaspor","Balikesirspor","2-0",2,0,"T1",1,2,2,"H"
2014-09-14,2014,"Gaziantepspor","Erciyesspor","2-2",2,2,"T1",1,4,0,"D"
2014-09-14,2014,"Kasimpasa","Mersin Idman Yurdu","2-2",2,2,"T1",1,4,0,"D"
2014-09-14,2014,"Trabzonspor","Fenerbahce","0-0",0,0,"T1",1,0,0,"D"
2014-09-15,2014,"Akhisar Belediyespor","Sivasspor","2-2",2,2,"T1",1,4,0,"D"
2014-09-15,2014,"Besiktas","Rizespor","1-1",1,1,"T1",1,2,0,"D"
2014-09-19,2014,"Eskisehirspor","Genclerbirligi","0-2",0,2,"T1",1,2,-2,"A"
2014-09-20,2014,"Balikesirspor","Galatasaray","2-0",2,0,"T1",1,2,2,"H"
2014-09-20,2014,"Erciyesspor","Akhisar Belediyespor","1-2",1,2,"T1",1,3,-1,"A"
2014-09-20,2014,"Mersin Idman Yurdu","Rizespor","2-0",2,0,"T1",1,2,2,"H"
2014-09-21,2014,"Fenerbahce","Gaziantepspor","1-0",1,0,"T1",1,1,1,"H"
2014-09-21,2014,"Kasimpasa","Karabukspor","2-1",2,1,"T1",1,3,1,"H"
2014-09-21,2014,"Sivasspor","Konyaspor","0-0",0,0,"T1",1,0,0,"D"
2014-09-22,2014,"Bursaspor","Besiktas","0-1",0,1,"T1",1,1,-1,"A"
2014-09-22,2014,"Buyuksehyr","Trabzonspor","1-1",1,1,"T1",1,2,0,"D"
2014-09-26,2014,"Galatasaray","Sivasspor","2-1",2,1,"T1",1,3,1,"H"
2014-09-27,2014,"Besiktas","Eskisehirspor","1-1",1,1,"T1",1,2,0,"D"
2014-09-27,2014,"Trabzonspor","Kasimpasa","1-1",1,1,"T1",1,2,0,"D"
2014-09-28,2014,"Akhisar Belediyespor","Fenerbahce","2-0",2,0,"T1",1,2,2,"H"
2014-09-28,2014,"Genclerbirligi","Balikesirspor","3-1",3,1,"T1",1,4,2,"H"
2014-09-28,2014,"Konyaspor","Erciyesspor","1-1",1,1,"T1",1,2,0,"D"
2014-09-28,2014,"Rizespor","Bursaspor","0-1",0,1,"T1",1,1,-1,"A"
2014-09-29,2014,"Gaziantepspor","Buyuksehyr","0-0",0,0,"T1",1,0,0,"D"
2014-09-29,2014,"Karabukspor","Mersin Idman Yurdu","0-2",0,2,"T1",1,2,-2,"A"
2014-10-03,2014,"Mersin Idman Yurdu","Bursaspor","2-1",2,1,"T1",1,3,1,"H"
2014-10-04,2014,"Erciyesspor","Galatasaray","1-2",1,2,"T1",1,3,-1,"A"
2014-10-04,2014,"Fenerbahce","Konyaspor","2-1",2,1,"T1",1,3,1,"H"
2014-10-04,2014,"Kasimpasa","Gaziantepspor","4-2",4,2,"T1",1,6,2,"H"
2014-10-04,2014,"Sivasspor","Genclerbirligi","1-0",1,0,"T1",1,1,1,"H"
2014-10-05,2014,"Balikesirspor","Besiktas","0-1",0,1,"T1",1,1,-1,"A"
2014-10-05,2014,"Buyuksehyr","Akhisar Belediyespor","4-0",4,0,"T1",1,4,4,"H"
2014-10-05,2014,"Eskisehirspor","Rizespor","1-2",1,2,"T1",1,3,-1,"A"
2014-10-05,2014,"Karabukspor","Trabzonspor","3-0",3,0,"T1",1,3,3,"H"
2014-10-18,2014,"Galatasaray","Fenerbahce","2-1",2,1,"T1",1,3,1,"H"
2014-10-18,2014,"Gaziantepspor","Karabukspor","1-0",1,0,"T1",1,1,1,"H"
2014-10-18,2014,"Konyaspor","Buyuksehyr","0-0",0,0,"T1",1,0,0,"D"
2014-10-19,2014,"Akhisar Belediyespor","Kasimpasa","2-0",2,0,"T1",1,2,2,"H"
2014-10-19,2014,"Besiktas","Sivasspor","3-2",3,2,"T1",1,5,1,"H"
2014-10-19,2014,"Bursaspor","Eskisehirspor","2-2",2,2,"T1",1,4,0,"D"
2014-10-19,2014,"Trabzonspor","Mersin Idman Yurdu","3-1",3,1,"T1",1,4,2,"H"
2014-10-20,2014,"Genclerbirligi","Erciyesspor","0-0",0,0,"T1",1,0,0,"D"
2014-10-20,2014,"Rizespor","Balikesirspor","2-2",2,2,"T1",1,4,0,"D"
2014-10-24,2014,"Karabukspor","Akhisar Belediyespor","2-1",2,1,"T1",1,3,1,"H"
2014-10-24,2014,"Kasimpasa","Konyaspor","2-0",2,0,"T1",1,2,2,"H"
2014-10-25,2014,"Balikesirspor","Bursaspor","0-5",0,5,"T1",1,5,-5,"A"
2014-10-25,2014,"Fenerbahce","Genclerbirligi","2-1",2,1,"T1",1,3,1,"H"
2014-10-25,2014,"Sivasspor","Rizespor","0-1",0,1,"T1",1,1,-1,"A"
2014-10-26,2014,"Buyuksehyr","Galatasaray","4-0",4,0,"T1",1,4,4,"H"
2014-10-26,2014,"Mersin Idman Yurdu","Eskisehirspor","4-2",4,2,"T1",1,6,2,"H"
2014-10-26,2014,"Trabzonspor","Gaziantepspor","4-4",4,4,"T1",1,8,0,"D"
2014-10-27,2014,"Erciyesspor","Besiktas","3-2",3,2,"T1",1,5,1,"H"
2014-10-31,2014,"Galatasaray","Kasimpasa","2-1",2,1,"T1",1,3,1,"H"
2014-11-01,2014,"Akhisar Belediyespor","Trabzonspor","1-1",1,1,"T1",1,2,0,"D"
2014-11-01,2014,"Bursaspor","Sivasspor","3-0",3,0,"T1",1,3,3,"H"
2014-11-01,2014,"Genclerbirligi","Buyuksehyr","1-0",1,0,"T1",1,1,1,"H"
2014-11-02,2014,"Besiktas","Fenerbahce","0-2",0,2,"T1",1,2,-2,"A"
2014-11-02,2014,"Gaziantepspor","Mersin Idman Yurdu","1-0",1,0,"T1",1,1,1,"H"
2014-11-02,2014,"Rizespor","Erciyesspor","1-1",1,1,"T1",1,2,0,"D"
2014-11-03,2014,"Eskisehirspor","Balikesirspor","2-2",2,2,"T1",1,4,0,"D"
2014-11-03,2014,"Konyaspor","Karabukspor","1-0",1,0,"T1",1,1,1,"H"
2014-11-07,2014,"Gaziantepspor","Akhisar Belediyespor","1-0",1,0,"T1",1,1,1,"H"
2014-11-07,2014,"Sivasspor","Eskisehirspor","1-1",1,1,"T1",1,2,0,"D"
2014-11-08,2014,"Fenerbahce","Rizespor","2-1",2,1,"T1",1,3,1,"H"
2014-11-08,2014,"Karabukspor","Galatasaray","1-2",1,2,"T1",1,3,-1,"A"
2014-11-08,2014,"Mersin Idman Yurdu","Balikesirspor","2-1",2,1,"T1",1,3,1,"H"
2014-11-09,2014,"Buyuksehyr","Besiktas","1-2",1,2,"T1",1,3,-1,"A"
2014-11-09,2014,"Erciyesspor","Bursaspor","1-1",1,1,"T1",1,2,0,"D"
2014-11-09,2014,"Kasimpasa","Genclerbirligi","2-2",2,2,"T1",1,4,0,"D"
2014-11-09,2014,"Trabzonspor","Konyaspor","3-2",3,2,"T1",1,5,1,"H"
2014-11-22,2014,"Akhisar Belediyespor","Mersin Idman Yurdu","1-1",1,1,"T1",1,2,0,"D"
2014-11-22,2014,"Galatasaray","Trabzonspor","0-3",0,3,"T1",1,3,-3,"A"
2014-11-22,2014,"Rizespor","Buyuksehyr","0-2",0,2,"T1",1,2,-2,"A"
2014-11-23,2014,"Besiktas","Kasimpasa","2-0",2,0,"T1",1,2,2,"H"
2014-11-23,2014,"Eskisehirspor","Erciyesspor","2-1",2,1,"T1",1,3,1,"H"
2014-11-23,2014,"Genclerbirligi","Karabukspor","2-2",2,2,"T1",1,4,0,"D"
2014-11-23,2014,"Konyaspor","Gaziantepspor","2-0",2,0,"T1",1,2,2,"H"
2014-11-24,2014,"Balikesirspor","Sivasspor","1-3",1,3,"T1",1,4,-2,"A"
2014-11-24,2014,"Bursaspor","Fenerbahce","1-1",1,1,"T1",1,2,0,"D"
2014-11-28,2014,"Akhisar Belediyespor","Konyaspor","0-0",0,0,"T1",1,0,0,"D"
2014-11-28,2014,"Buyuksehyr","Bursaspor","0-0",0,0,"T1",1,0,0,"D"
2014-11-29,2014,"Erciyesspor","Balikesirspor","4-0",4,0,"T1",1,4,4,"H"
2014-11-29,2014,"Gaziantepspor","Galatasaray","0-1",0,1,"T1",1,1,-1,"A"
2014-11-29,2014,"Kasimpasa","Rizespor","3-1",3,1,"T1",1,4,2,"H"
2014-11-30,2014,"Fenerbahce","Eskisehirspor","2-2",2,2,"T1",1,4,0,"D"
2014-11-30,2014,"Mersin Idman Yurdu","Sivasspor","2-0",2,0,"T1",1,2,2,"H"
2014-12-01,2014,"Karabukspor","Besiktas","1-2",1,2,"T1",1,3,-1,"A"
2014-12-01,2014,"Trabzonspor","Genclerbirligi","4-1",4,1,"T1",1,5,3,"H"
2014-12-06,2014,"Balikesirspor","Fenerbahce","0-1",0,1,"T1",1,1,-1,"A"
2014-12-06,2014,"Galatasaray","Akhisar Belediyespor","2-1",2,1,"T1",1,3,1,"H"
2014-12-06,2014,"Genclerbirligi","Gaziantepspor","2-0",2,0,"T1",1,2,2,"H"
2014-12-06,2014,"Konyaspor","Mersin Idman Yurdu","2-0",2,0,"T1",1,2,2,"H"
2014-12-07,2014,"Besiktas","Trabzonspor","3-0",3,0,"T1",1,3,3,"H"
2014-12-07,2014,"Bursaspor","Kasimpasa","5-1",5,1,"T1",1,6,4,"H"
2014-12-07,2014,"Eskisehirspor","Buyuksehyr","0-1",0,1,"T1",1,1,-1,"A"
2014-12-07,2014,"Rizespor","Karabukspor","0-3",0,3,"T1",1,3,-3,"A"
2014-12-08,2014,"Sivasspor","Erciyesspor","1-1",1,1,"T1",1,2,0,"D"
2014-12-12,2014,"Fenerbahce","Sivasspor","4-1",4,1,"T1",1,5,3,"H"
2014-12-13,2014,"Akhisar Belediyespor","Genclerbirligi","1-1",1,1,"T1",1,2,0,"D"
2014-12-13,2014,"Buyuksehyr","Balikesirspor","1-0",1,0,"T1",1,1,1,"H"
2014-12-13,2014,"Kasimpasa","Eskisehirspor","1-0",1,0,"T1",1,1,1,"H"
2014-12-13,2014,"Konyaspor","Galatasaray","0-5",0,5,"T1",1,5,-5,"A"
2014-12-14,2014,"Gaziantepspor","Besiktas","0-1",0,1,"T1",1,1,-1,"A"
2014-12-14,2014,"Karabukspor","Bursaspor","3-2",3,2,"T1",1,5,1,"H"
2014-12-14,2014,"Mersin Idman Yurdu","Erciyesspor","1-1",1,1,"T1",1,2,0,"D"
2014-12-15,2014,"Trabzonspor","Rizespor","3-2",3,2,"T1",1,5,1,"H"
2014-12-19,2014,"Erciyesspor","Fenerbahce","0-1",0,1,"T1",1,1,-1,"A"
2014-12-20,2014,"Eskisehirspor","Karabukspor","1-1",1,1,"T1",1,2,0,"D"
2014-12-20,2014,"Galatasaray","Mersin Idman Yurdu","3-2",3,2,"T1",1,5,1,"H"
2014-12-20,2014,"Genclerbirligi","Konyaspor","5-0",5,0,"T1",1,5,5,"H"
2014-12-20,2014,"Sivasspor","Buyuksehyr","0-2",0,2,"T1",1,2,-2,"A"
2014-12-21,2014,"Balikesirspor","Kasimpasa","5-3",5,3,"T1",1,8,2,"H"
2014-12-21,2014,"Besiktas","Akhisar Belediyespor","3-1",3,1,"T1",1,4,2,"H"
2014-12-21,2014,"Bursaspor","Trabzonspor","3-3",3,3,"T1",1,6,0,"D"
2014-12-22,2014,"Rizespor","Gaziantepspor","0-1",0,1,"T1",1,1,-1,"A"
2014-12-26,2014,"Genclerbirligi","Galatasaray","1-1",1,1,"T1",1,2,0,"D"
2014-12-27,2014,"Buyuksehyr","Erciyesspor","3-1",3,1,"T1",1,4,2,"H"
2014-12-27,2014,"Fenerbahce","Mersin Idman Yurdu","1-0",1,0,"T1",1,1,1,"H"
2014-12-27,2014,"Karabukspor","Balikesirspor","0-1",0,1,"T1",1,1,-1,"A"
2014-12-28,2014,"Akhisar Belediyespor","Rizespor","0-4",0,4,"T1",1,4,-4,"A"
2014-12-28,2014,"Gaziantepspor","Bursaspor","1-2",1,2,"T1",1,3,-1,"A"
2014-12-28,2014,"Kasimpasa","Sivasspor","0-0",0,0,"T1",1,0,0,"D"
2014-12-28,2014,"Konyaspor","Besiktas","1-2",1,2,"T1",1,3,-1,"A"
2014-12-29,2014,"Trabzonspor","Eskisehirspor","1-4",1,4,"T1",1,5,-3,"A"
2015-01-03,2014,"Bursaspor","Akhisar Belediyespor","3-1",3,1,"T1",1,4,2,"H"
2015-01-03,2014,"Fenerbahce","Buyuksehyr","2-0",2,0,"T1",1,2,2,"H"
2015-01-03,2014,"Rizespor","Konyaspor","1-1",1,1,"T1",1,2,0,"D"
2015-01-04,2014,"Besiktas","Galatasaray","0-2",0,2,"T1",1,2,-2,"A"
2015-01-04,2014,"Erciyesspor","Kasimpasa","2-5",2,5,"T1",1,7,-3,"A"
2015-01-04,2014,"Eskisehirspor","Gaziantepspor","1-3",1,3,"T1",1,4,-2,"A"
2015-01-04,2014,"Sivasspor","Karabukspor","2-0",2,0,"T1",1,2,2,"H"
2015-01-05,2014,"Balikesirspor","Trabzonspor","2-2",2,2,"T1",1,4,0,"D"
2015-01-05,2014,"Mersin Idman Yurdu","Genclerbirligi","1-1",1,1,"T1",1,2,0,"D"
2015-01-23,2014,"Konyaspor","Bursaspor","2-3",2,3,"T1",1,5,-1,"A"
2015-01-23,2014,"Trabzonspor","Sivasspor","3-1",3,1,"T1",1,4,2,"H"
2015-01-24,2014,"Akhisar Belediyespor","Eskisehirspor","2-2",2,2,"T1",1,4,0,"D"
2015-01-24,2014,"Buyuksehyr","Mersin Idman Yurdu","2-2",2,2,"T1",1,4,0,"D"
2015-01-24,2014,"Gaziantepspor","Balikesirspor","1-0",1,0,"T1",1,1,1,"H"
2015-01-24,2014,"Kasimpasa","Fenerbahce","0-3",0,3,"T1",1,3,-3,"A"
2015-01-25,2014,"Galatasaray","Rizespor","2-0",2,0,"T1",1,2,2,"H"
2015-01-25,2014,"Karabukspor","Erciyesspor","1-2",1,2,"T1",1,3,-1,"A"
2015-01-26,2014,"Genclerbirligi","Besiktas","0-2",0,2,"T1",1,2,-2,"A"
2015-01-30,2014,"Akhisar Belediyespor","Balikesirspor","2-2",2,2,"T1",1,4,0,"D"
2015-01-30,2014,"Trabzonspor","Erciyesspor","2-1",2,1,"T1",1,3,1,"H"
2015-01-31,2014,"Gaziantepspor","Sivasspor","1-3",1,3,"T1",1,4,-2,"A"
2015-01-31,2014,"Karabukspor","Fenerbahce","1-2",1,2,"T1",1,3,-1,"A"
2015-01-31,2014,"Kasimpasa","Buyuksehyr","0-1",0,1,"T1",1,1,-1,"A"
2015-02-01,2014,"Besiktas","Mersin Idman Yurdu","2-1",2,1,"T1",1,3,1,"H"
2015-02-01,2014,"Galatasaray","Bursaspor","2-2",2,2,"T1",1,4,0,"D"
2015-02-01,2014,"Genclerbirligi","Rizespor","0-2",0,2,"T1",1,2,-2,"A"
2015-02-01,2014,"Konyaspor","Eskisehirspor","1-0",1,0,"T1",1,1,1,"H"
2015-02-06,2014,"Buyuksehyr","Karabukspor","2-2",2,2,"T1",1,4,0,"D"
2015-02-07,2014,"Erciyesspor","Gaziantepspor","0-1",0,1,"T1",1,1,-1,"A"
2015-02-07,2014,"Fenerbahce","Trabzonspor","0-0",0,0,"T1",1,0,0,"D"
2015-02-07,2014,"Sivasspor","Akhisar Belediyespor","2-0",2,0,"T1",1,2,2,"H"
2015-02-08,2014,"Balikesirspor","Konyaspor","0-1",0,1,"T1",1,1,-1,"A"
2015-02-08,2014,"Bursaspor","Genclerbirligi","3-1",3,1,"T1",1,4,2,"H"
2015-02-08,2014,"Mersin Idman Yurdu","Kasimpasa","6-2",6,2,"T1",1,8,4,"H"
2015-02-08,2014,"Rizespor","Besiktas","1-2",1,2,"T1",1,3,-1,"A"
2015-02-09,2014,"Eskisehirspor","Galatasaray","1-2",1,2,"T1",1,3,-1,"A"
2015-02-14,2014,"Akhisar Belediyespor","Erciyesspor","1-0",1,0,"T1",1,1,1,"H"
2015-02-14,2014,"Gaziantepspor","Fenerbahce","0-5",0,5,"T1",1,5,-5,"A"
2015-02-14,2014,"Karabukspor","Kasimpasa","0-0",0,0,"T1",1,0,0,"D"
2015-02-15,2014,"Besiktas","Bursaspor","3-2",3,2,"T1",1,5,1,"H"
2015-02-15,2014,"Konyaspor","Sivasspor","0-1",0,1,"T1",1,1,-1,"A"
2015-02-15,2014,"Rizespor","Mersin Idman Yurdu","0-4",0,4,"T1",1,4,-4,"A"
2015-02-15,2014,"Trabzonspor","Buyuksehyr","3-2",3,2,"T1",1,5,1,"H"
2015-02-16,2014,"Galatasaray","Balikesirspor","3-1",3,1,"T1",1,4,2,"H"
2015-02-16,2014,"Genclerbirligi","Eskisehirspor","1-2",1,2,"T1",1,3,-1,"A"
2015-02-20,2014,"Erciyesspor","Konyaspor","3-0",3,0,"T1",1,3,3,"H"
2015-02-21,2014,"Bursaspor","Rizespor","1-1",1,1,"T1",1,2,0,"D"
2015-02-21,2014,"Buyuksehyr","Gaziantepspor","1-0",1,0,"T1",1,1,1,"H"
2015-02-21,2014,"Sivasspor","Galatasaray","2-3",2,3,"T1",1,5,-1,"A"
2015-02-22,2014,"Balikesirspor","Genclerbirligi","0-1",0,1,"T1",1,1,-1,"A"
2015-02-22,2014,"Eskisehirspor","Besiktas","1-0",1,0,"T1",1,1,1,"H"
2015-02-22,2014,"Kasimpasa","Trabzonspor","1-1",1,1,"T1",1,2,0,"D"
2015-02-22,2014,"Mersin Idman Yurdu","Karabukspor","2-1",2,1,"T1",1,3,1,"H"
2015-02-23,2014,"Fenerbahce","Akhisar Belediyespor","1-2",1,2,"T1",1,3,-1,"A"
2015-02-27,2014,"Galatasaray","Erciyesspor","3-1",3,1,"T1",1,4,2,"H"
2015-02-28,2014,"Genclerbirligi","Sivasspor","0-0",0,0,"T1",1,0,0,"D"
2015-02-28,2014,"Konyaspor","Fenerbahce","1-1",1,1,"T1",1,2,0,"D"
2015-02-28,2014,"Rizespor","Eskisehirspor","3-0",3,0,"T1",1,3,3,"H"
2015-03-01,2014,"Akhisar Belediyespor","Buyuksehyr","0-2",0,2,"T1",1,2,-2,"A"
2015-03-01,2014,"Besiktas","Balikesirspor","2-2",2,2,"T1",1,4,0,"D"
2015-03-01,2014,"Bursaspor","Mersin Idman Yurdu","2-1",2,1,"T1",1,3,1,"H"
2015-03-01,2014,"Gaziantepspor","Kasimpasa","0-2",0,2,"T1",1,2,-2,"A"
2015-03-02,2014,"Trabzonspor","Karabukspor","3-2",3,2,"T1",1,5,1,"H"
2015-03-06,2014,"Kasimpasa","Akhisar Belediyespor","2-2",2,2,"T1",1,4,0,"D"
2015-03-07,2014,"Balikesirspor","Rizespor","2-2",2,2,"T1",1,4,0,"D"
2015-03-07,2014,"Erciyesspor","Genclerbirligi","2-4",2,4,"T1",1,6,-2,"A"
2015-03-07,2014,"Eskisehirspor","Bursaspor","0-0",0,0,"T1",1,0,0,"D"
2015-03-08,2014,"Buyuksehyr","Konyaspor","0-0",0,0,"T1",1,0,0,"D"
2015-03-08,2014,"Fenerbahce","Galatasaray","1-0",1,0,"T1",1,1,1,"H"
2015-03-08,2014,"Karabukspor","Gaziantepspor","0-0",0,0,"T1",1,0,0,"D"
2015-03-08,2014,"Sivasspor","Besiktas","0-1",0,1,"T1",1,1,-1,"A"
2015-03-09,2014,"Mersin Idman Yurdu","Trabzonspor","1-5",1,5,"T1",1,6,-4,"A"
2015-03-13,2014,"Bursaspor","Balikesirspor","4-2",4,2,"T1",1,6,2,"H"
2015-03-13,2014,"Konyaspor","Kasimpasa","2-1",2,1,"T1",1,3,1,"H"
2015-03-14,2014,"Akhisar Belediyespor","Karabukspor","5-1",5,1,"T1",1,6,4,"H"
2015-03-14,2014,"Galatasaray","Buyuksehyr","2-2",2,2,"T1",1,4,0,"D"
2015-03-14,2014,"Rizespor","Sivasspor","2-1",2,1,"T1",1,3,1,"H"
2015-03-15,2014,"Besiktas","Erciyesspor","5-1",5,1,"T1",1,6,4,"H"
2015-03-15,2014,"Eskisehirspor","Mersin Idman Yurdu","2-0",2,0,"T1",1,2,2,"H"
2015-03-15,2014,"Genclerbirligi","Fenerbahce","2-1",2,1,"T1",1,3,1,"H"
2015-03-16,2014,"Gaziantepspor","Trabzonspor","2-0",2,0,"T1",1,2,2,"H"
2015-03-20,2014,"Balikesirspor","Eskisehirspor","4-1",4,1,"T1",1,5,3,"H"
2015-03-20,2014,"Karabukspor","Konyaspor","0-1",0,1,"T1",1,1,-1,"A"
2015-03-21,2014,"Erciyesspor","Rizespor","0-3",0,3,"T1",1,3,-3,"A"
2015-03-21,2014,"Kasimpasa","Galatasaray","2-3",2,3,"T1",1,5,-1,"A"
2015-03-21,2014,"Mersin Idman Yurdu","Gaziantepspor","0-1",0,1,"T1",1,1,-1,"A"
2015-03-21,2014,"Sivasspor","Bursaspor","4-1",4,1,"T1",1,5,3,"H"
2015-03-22,2014,"Buyuksehyr","Genclerbirligi","3-1",3,1,"T1",1,4,2,"H"
2015-03-22,2014,"Fenerbahce","Besiktas","1-0",1,0,"T1",1,1,1,"H"
2015-03-22,2014,"Trabzonspor","Akhisar Belediyespor","2-0",2,0,"T1",1,2,2,"H"
2015-04-04,2014,"Balikesirspor","Mersin Idman Yurdu","1-3",1,3,"T1",1,4,-2,"A"
2015-04-04,2014,"Eskisehirspor","Sivasspor","1-3",1,3,"T1",1,4,-2,"A"
2015-04-04,2014,"Genclerbirligi","Kasimpasa","5-2",5,2,"T1",1,7,3,"H"
2015-04-04,2014,"Rizespor","Fenerbahce","1-5",1,5,"T1",1,6,-4,"A"
2015-04-05,2014,"Akhisar Belediyespor","Gaziantepspor","3-0",3,0,"T1",1,3,3,"H"
2015-04-05,2014,"Bursaspor","Erciyesspor","3-0",3,0,"T1",1,3,3,"H"
2015-04-05,2014,"Galatasaray","Karabukspor","4-2",4,2,"T1",1,6,2,"H"
2015-04-05,2014,"Konyaspor","Trabzonspor","1-0",1,0,"T1",1,1,1,"H"
2015-04-06,2014,"Besiktas","Buyuksehyr","0-0",0,0,"T1",1,0,0,"D"
2015-04-17,2014,"Gaziantepspor","Konyaspor","1-1",1,1,"T1",1,2,0,"D"
2015-04-18,2014,"Karabukspor","Genclerbirligi","2-1",2,1,"T1",1,3,1,"H"
2015-04-18,2014,"Kasimpasa","Besiktas","1-5",1,5,"T1",1,6,-4,"A"
2015-04-19,2014,"Buyuksehyr","Rizespor","3-1",3,1,"T1",1,4,2,"H"
2015-04-19,2014,"Erciyesspor","Eskisehirspor","0-1",0,1,"T1",1,1,-1,"A"
2015-04-19,2014,"Sivasspor","Balikesirspor","1-1",1,1,"T1",1,2,0,"D"
2015-04-19,2014,"Trabzonspor","Galatasaray","2-1",2,1,"T1",1,3,1,"H"
2015-04-20,2014,"Fenerbahce","Bursaspor","1-0",1,0,"T1",1,1,1,"H"
2015-04-20,2014,"Mersin Idman Yurdu","Akhisar Belediyespor","1-1",1,1,"T1",1,2,0,"D"
2015-04-24,2014,"Sivasspor","Mersin Idman Yurdu","1-2",1,2,"T1",1,3,-1,"A"
2015-04-25,2014,"Bursaspor","Buyuksehyr","4-1",4,1,"T1",1,5,3,"H"
2015-04-25,2014,"Eskisehirspor","Fenerbahce","1-1",1,1,"T1",1,2,0,"D"
2015-04-25,2014,"Rizespor","Kasimpasa","1-3",1,3,"T1",1,4,-2,"A"
2015-04-26,2014,"Balikesirspor","Erciyesspor","1-1",1,1,"T1",1,2,0,"D"
2015-04-26,2014,"Galatasaray","Gaziantepspor","1-0",1,0,"T1",1,1,1,"H"
2015-04-26,2014,"Genclerbirligi","Trabzonspor","1-1",1,1,"T1",1,2,0,"D"
2015-04-26,2014,"Konyaspor","Akhisar Belediyespor","2-1",2,1,"T1",1,3,1,"H"
2015-04-27,2014,"Besiktas","Karabukspor","2-1",2,1,"T1",1,3,1,"H"
2015-05-02,2014,"Buyuksehyr","Eskisehirspor","1-1",1,1,"T1",1,2,0,"D"
2015-05-02,2014,"Fenerbahce","Balikesirspor","4-3",4,3,"T1",1,7,1,"H"
2015-05-02,2014,"Karabukspor","Rizespor","2-0",2,0,"T1",1,2,2,"H"
2015-05-02,2014,"Mersin Idman Yurdu","Konyaspor","3-1",3,1,"T1",1,4,2,"H"
2015-05-03,2014,"Gaziantepspor","Genclerbirligi","0-3",0,3,"T1",1,3,-3,"A"
2015-05-03,2014,"Kasimpasa","Bursaspor","5-3",5,3,"T1",1,8,2,"H"
2015-05-03,2014,"Trabzonspor","Besiktas","0-2",0,2,"T1",1,2,-2,"A"
2015-05-04,2014,"Akhisar Belediyespor","Galatasaray","0-2",0,2,"T1",1,2,-2,"A"
2015-05-04,2014,"Erciyesspor","Sivasspor","2-3",2,3,"T1",1,5,-1,"A"
2015-05-08,2014,"Erciyesspor","Mersin Idman Yurdu","2-2",2,2,"T1",1,4,0,"D"
2015-05-08,2014,"Eskisehirspor","Kasimpasa","4-1",4,1,"T1",1,5,3,"H"
2015-05-08,2014,"Galatasaray","Konyaspor","1-0",1,0,"T1",1,1,1,"H"
2015-05-09,2014,"Balikesirspor","Buyuksehyr","1-2",1,2,"T1",1,3,-1,"A"
2015-05-09,2014,"Bursaspor","Karabukspor","7-1",7,1,"T1",1,8,6,"H"
2015-05-09,2014,"Genclerbirligi","Akhisar Belediyespor","0-0",0,0,"T1",1,0,0,"D"
2015-05-09,2014,"Sivasspor","Fenerbahce","2-3",2,3,"T1",1,5,-1,"A"
2015-05-10,2014,"Besiktas","Gaziantepspor","1-1",1,1,"T1",1,2,0,"D"
2015-05-10,2014,"Rizespor","Trabzonspor","0-2",0,2,"T1",1,2,-2,"A"
2015-05-12,2014,"Buyuksehyr","Sivasspor","2-1",2,1,"T1",1,3,1,"H"
2015-05-12,2014,"Karabukspor","Eskisehirspor","2-2",2,2,"T1",1,4,0,"D"
2015-05-12,2014,"Kasimpasa","Balikesirspor","2-3",2,3,"T1",1,5,-1,"A"
2015-05-12,2014,"Konyaspor","Genclerbirligi","1-0",1,0,"T1",1,1,1,"H"
2015-05-12,2014,"Mersin Idman Yurdu","Galatasaray","0-1",0,1,"T1",1,1,-1,"A"
2015-05-13,2014,"Fenerbahce","Erciyesspor","1-1",1,1,"T1",1,2,0,"D"
2015-05-13,2014,"Gaziantepspor","Rizespor","1-2",1,2,"T1",1,3,-1,"A"
2015-05-13,2014,"Trabzonspor","Bursaspor","1-0",1,0,"T1",1,1,1,"H"
2015-05-14,2014,"Akhisar Belediyespor","Besiktas","1-1",1,1,"T1",1,2,0,"D"
2015-05-16,2014,"Balikesirspor","Karabukspor","4-2",4,2,"T1",1,6,2,"H"
2015-05-16,2014,"Galatasaray","Genclerbirligi","1-0",1,0,"T1",1,1,1,"H"
2015-05-16,2014,"Sivasspor","Kasimpasa","1-1",1,1,"T1",1,2,0,"D"
2015-05-17,2014,"Bursaspor","Gaziantepspor","2-0",2,0,"T1",1,2,2,"H"
2015-05-17,2014,"Erciyesspor","Buyuksehyr","0-1",0,1,"T1",1,1,-1,"A"
2015-05-17,2014,"Eskisehirspor","Trabzonspor","2-0",2,0,"T1",1,2,2,"H"
2015-05-17,2014,"Mersin Idman Yurdu","Fenerbahce","0-1",0,1,"T1",1,1,-1,"A"
2015-05-18,2014,"Besiktas","Konyaspor","0-1",0,1,"T1",1,1,-1,"A"
2015-05-18,2014,"Rizespor","Akhisar Belediyespor","3-1",3,1,"T1",1,4,2,"H"
2015-05-22,2014,"Genclerbirligi","Mersin Idman Yurdu","1-2",1,2,"T1",1,3,-1,"A"
2015-05-23,2014,"Kasimpasa","Erciyesspor","3-3",3,3,"T1",1,6,0,"D"
2015-05-23,2014,"Konyaspor","Rizespor","1-1",1,1,"T1",1,2,0,"D"
2015-05-23,2014,"Trabzonspor","Balikesirspor","3-2",3,2,"T1",1,5,1,"H"
2015-05-24,2014,"Galatasaray","Besiktas","2-0",2,0,"T1",1,2,2,"H"
2015-05-24,2014,"Gaziantepspor","Eskisehirspor","3-2",3,2,"T1",1,5,1,"H"
2015-05-24,2014,"Karabukspor","Sivasspor","2-1",2,1,"T1",1,3,1,"H"
2015-05-25,2014,"Akhisar Belediyespor","Bursaspor","0-1",0,1,"T1",1,1,-1,"A"
2015-05-25,2014,"Buyuksehyr","Fenerbahce","2-2",2,2,"T1",1,4,0,"D"
2015-05-29,2014,"Balikesirspor","Gaziantepspor","1-1",1,1,"T1",1,2,0,"D"
2015-05-29,2014,"Besiktas","Genclerbirligi","2-1",2,1,"T1",1,3,1,"H"
2015-05-29,2014,"Erciyesspor","Karabukspor","4-3",4,3,"T1",1,7,1,"H"
2015-05-29,2014,"Eskisehirspor","Akhisar Belediyespor","1-3",1,3,"T1",1,4,-2,"A"
2015-05-30,2014,"Bursaspor","Konyaspor","0-0",0,0,"T1",1,0,0,"D"
2015-05-30,2014,"Fenerbahce","Kasimpasa","2-0",2,0,"T1",1,2,2,"H"
2015-05-30,2014,"Mersin Idman Yurdu","Buyuksehyr","2-2",2,2,"T1",1,4,0,"D"
2015-05-30,2014,"Rizespor","Galatasaray","1-1",1,1,"T1",1,2,0,"D"
2015-05-30,2014,"Sivasspor","Trabzonspor","1-1",1,1,"T1",1,2,0,"D"
2015-08-14,2015,"Fenerbahce","Eskisehirspor","2-0",2,0,"T1",1,2,2,"H"
2015-08-15,2015,"Buyuksehyr","Antalyaspor","2-3",2,3,"T1",1,5,-1,"A"
2015-08-15,2015,"Sivasspor","Galatasaray","2-2",2,2,"T1",1,4,0,"D"
2015-08-15,2015,"Trabzonspor","Bursaspor","1-0",1,0,"T1",1,1,1,"H"
2015-08-16,2015,"Gaziantepspor","Kasimpasa","0-3",0,3,"T1",1,3,-3,"A"
2015-08-16,2015,"Konyaspor","Akhisar Belediyespor","1-1",1,1,"T1",1,2,0,"D"
2015-08-16,2015,"Mersin Idman Yurdu","Besiktas","2-5",2,5,"T1",1,7,-3,"A"
2015-08-16,2015,"Osmanlispor","Kayserispor","1-1",1,1,"T1",1,2,0,"D"
2015-08-17,2015,"Genclerbirligi","Rizespor","2-3",2,3,"T1",1,5,-1,"A"
2015-08-21,2015,"Kasimpasa","Buyuksehyr","1-0",1,0,"T1",1,1,1,"H"
2015-08-22,2015,"Akhisar Belediyespor","Mersin Idman Yurdu","2-0",2,0,"T1",1,2,2,"H"
2015-08-22,2015,"Besiktas","Trabzonspor","1-2",1,2,"T1",1,3,-1,"A"
2015-08-22,2015,"Kayserispor","Konyaspor","1-1",1,1,"T1",1,2,0,"D"
2015-08-23,2015,"Antalyaspor","Genclerbirligi","3-1",3,1,"T1",1,4,2,"H"
2015-08-23,2015,"Bursaspor","Gaziantepspor","0-1",0,1,"T1",1,1,-1,"A"
2015-08-23,2015,"Eskisehirspor","Sivasspor","4-2",4,2,"T1",1,6,2,"H"
2015-08-23,2015,"Rizespor","Fenerbahce","1-1",1,1,"T1",1,2,0,"D"
2015-08-24,2015,"Galatasaray","Osmanlispor","1-2",1,2,"T1",1,3,-1,"A"
2015-08-28,2015,"Gaziantepspor","Besiktas","0-4",0,4,"T1",1,4,-4,"A"
2015-08-29,2015,"Buyuksehyr","Bursaspor","2-1",2,1,"T1",1,3,1,"H"
2015-08-29,2015,"Genclerbirligi","Kasimpasa","1-0",1,0,"T1",1,1,1,"H"
2015-08-29,2015,"Konyaspor","Galatasaray","1-4",1,4,"T1",1,5,-3,"A"
2015-08-29,2015,"Mersin Idman Yurdu","Kayserispor","1-2",1,2,"T1",1,3,-1,"A"
2015-08-30,2015,"Eskisehirspor","Rizespor","1-1",1,1,"T1",1,2,0,"D"
2015-08-30,2015,"Fenerbahce","Antalyaspor","2-1",2,1,"T1",1,3,1,"H"
2015-08-30,2015,"Sivasspor","Osmanlispor","1-1",1,1,"T1",1,2,0,"D"
2015-08-30,2015,"Trabzonspor","Akhisar Belediyespor","2-2",2,2,"T1",1,4,0,"D"
2015-09-12,2015,"Akhisar Belediyespor","Gaziantepspor","0-0",0,0,"T1",1,0,0,"D"
2015-09-12,2015,"Antalyaspor","Eskisehirspor","2-0",2,0,"T1",1,2,2,"H"
2015-09-12,2015,"Bursaspor","Genclerbirligi","3-2",3,2,"T1",1,5,1,"H"
2015-09-12,2015,"Galatasaray","Mersin Idman Yurdu","1-1",1,1,"T1",1,2,0,"D"
2015-09-13,2015,"Besiktas","Buyuksehyr","2-0",2,0,"T1",1,2,2,"H"
2015-09-13,2015,"Kasimpasa","Fenerbahce","0-1",0,1,"T1",1,1,-1,"A"
2015-09-13,2015,"Osmanlispor","Konyaspor","1-2",1,2,"T1",1,3,-1,"A"
2015-09-13,2015,"Rizespor","Sivasspor","1-1",1,1,"T1",1,2,0,"D"
2015-09-14,2015,"Kayserispor","Trabzonspor","0-1",0,1,"T1",1,1,-1,"A"
2015-09-18,2015,"Buyuksehyr","Akhisar Belediyespor","2-0",2,0,"T1",1,2,2,"H"
2015-09-18,2015,"Mersin Idman Yurdu","Osmanlispor","0-4",0,4,"T1",1,4,-4,"A"
2015-09-19,2015,"Eskisehirspor","Kasimpasa","0-3",0,3,"T1",1,3,-3,"A"
2015-09-19,2015,"Rizespor","Antalyaspor","5-1",5,1,"T1",1,6,4,"H"
2015-09-19,2015,"Sivasspor","Konyaspor","0-0",0,0,"T1",1,0,0,"D"
2015-09-19,2015,"Trabzonspor","Galatasaray","0-1",0,1,"T1",1,1,-1,"A"
2015-09-20,2015,"Fenerbahce","Bursaspor","2-1",2,1,"T1",1,3,1,"H"
2015-09-20,2015,"Gaziantepspor","Kayserispor","1-0",1,0,"T1",1,1,1,"H"
2015-09-21,2015,"Genclerbirligi","Besiktas","1-1",1,1,"T1",1,2,0,"D"
2015-09-26,2015,"Akhisar Belediyespor","Genclerbirligi","1-0",1,0,"T1",1,1,1,"H"
2015-09-26,2015,"Galatasaray","Gaziantepspor","2-1",2,1,"T1",1,3,1,"H"
2015-09-26,2015,"Osmanlispor","Trabzonspor","3-1",3,1,"T1",1,4,2,"H"
2015-09-27,2015,"Antalyaspor","Sivasspor","1-1",1,1,"T1",1,2,0,"D"
2015-09-27,2015,"Besiktas","Fenerbahce","3-2",3,2,"T1",1,5,1,"H"
2015-09-27,2015,"Konyaspor","Mersin Idman Yurdu","2-0",2,0,"T1",1,2,2,"H"
2015-09-28,2015,"Bursaspor","Eskisehirspor","2-0",2,0,"T1",1,2,2,"H"
2015-09-28,2015,"Kasimpasa","Rizespor","1-1",1,1,"T1",1,2,0,"D"
2015-09-28,2015,"Kayserispor","Buyuksehyr","0-1",0,1,"T1",1,1,-1,"A"
2015-10-02,2015,"Sivasspor","Mersin Idman Yurdu","2-2",2,2,"T1",1,4,0,"D"
2015-10-02,2015,"Trabzonspor","Konyaspor","1-2",1,2,"T1",1,3,-1,"A"
2015-10-03,2015,"Buyuksehyr","Galatasaray","0-2",0,2,"T1",1,2,-2,"A"
2015-10-03,2015,"Gaziantepspor","Osmanlispor","2-1",2,1,"T1",1,3,1,"H"
2015-10-03,2015,"Genclerbirligi","Kayserispor","2-0",2,0,"T1",1,2,2,"H"
2015-10-04,2015,"Antalyaspor","Kasimpasa","0-0",0,0,"T1",1,0,0,"D"
2015-10-04,2015,"Eskisehirspor","Besiktas","1-2",1,2,"T1",1,3,-1,"A"
2015-10-04,2015,"Fenerbahce","Akhisar Belediyespor","2-2",2,2,"T1",1,4,0,"D"
2015-10-04,2015,"Rizespor","Bursaspor","2-3",2,3,"T1",1,5,-1,"A"
2015-10-17,2015,"Bursaspor","Antalyaspor","0-2",0,2,"T1",1,2,-2,"A"
2015-10-17,2015,"Galatasaray","Genclerbirligi","4-1",4,1,"T1",1,5,3,"H"
2015-10-17,2015,"Konyaspor","Gaziantepspor","2-1",2,1,"T1",1,3,1,"H"
2015-10-18,2015,"Akhisar Belediyespor","Eskisehirspor","1-0",1,0,"T1",1,1,1,"H"
2015-10-18,2015,"Besiktas","Rizespor","1-0",1,0,"T1",1,1,1,"H"
2015-10-18,2015,"Kasimpasa","Sivasspor","2-1",2,1,"T1",1,3,1,"H"
2015-10-18,2015,"Kayserispor","Fenerbahce","0-1",0,1,"T1",1,1,-1,"A"
2015-10-19,2015,"Mersin Idman Yurdu","Trabzonspor","3-2",3,2,"T1",1,5,1,"H"
2015-10-19,2015,"Osmanlispor","Buyuksehyr","0-3",0,3,"T1",1,3,-3,"A"
2015-10-23,2015,"Eskisehirspor","Kayserispor","1-3",1,3,"T1",1,4,-2,"A"
2015-10-23,2015,"Rizespor","Akhisar Belediyespor","0-2",0,2,"T1",1,2,-2,"A"
2015-10-24,2015,"Gaziantepspor","Mersin Idman Yurdu","1-0",1,0,"T1",1,1,1,"H"
2015-10-24,2015,"Genclerbirligi","Osmanlispor","1-0",1,0,"T1",1,1,1,"H"
2015-10-24,2015,"Kasimpasa","Bursaspor","0-1",0,1,"T1",1,1,-1,"A"
2015-10-24,2015,"Sivasspor","Trabzonspor","0-2",0,2,"T1",1,2,-2,"A"
2015-10-25,2015,"Buyuksehyr","Konyaspor","4-0",4,0,"T1",1,4,4,"H"
2015-10-25,2015,"Fenerbahce","Galatasaray","1-1",1,1,"T1",1,2,0,"D"
2015-10-26,2015,"Antalyaspor","Besiktas","1-5",1,5,"T1",1,6,-4,"A"
2015-10-28,2015,"Bursaspor","Sivasspor","1-0",1,0,"T1",1,1,1,"H"
2015-10-28,2015,"Kayserispor","Rizespor","0-0",0,0,"T1",1,0,0,"D"
2015-10-28,2015,"Trabzonspor","Gaziantepspor","2-2",2,2,"T1",1,4,0,"D"
2015-10-29,2015,"Galatasaray","Eskisehirspor","4-0",4,0,"T1",1,4,4,"H"
2015-10-29,2015,"Mersin Idman Yurdu","Buyuksehyr","1-1",1,1,"T1",1,2,0,"D"
2015-10-29,2015,"Osmanlispor","Fenerbahce","0-1",0,1,"T1",1,1,-1,"A"
2015-10-30,2015,"Akhisar Belediyespor","Antalyaspor","2-1",2,1,"T1",1,3,1,"H"
2015-10-30,2015,"Besiktas","Kasimpasa","3-3",3,3,"T1",1,6,0,"D"
2015-10-30,2015,"Konyaspor","Genclerbirligi","0-0",0,0,"T1",1,0,0,"D"
2015-11-06,2015,"Eskisehirspor","Osmanlispor","0-2",0,2,"T1",1,2,-2,"A"
2015-11-06,2015,"Genclerbirligi","Mersin Idman Yurdu","1-1",1,1,"T1",1,2,0,"D"
2015-11-07,2015,"Antalyaspor","Kayserispor","1-1",1,1,"T1",1,2,0,"D"
2015-11-07,2015,"Buyuksehyr","Trabzonspor","1-0",1,0,"T1",1,1,1,"H"
2015-11-07,2015,"Kasimpasa","Akhisar Belediyespor","2-1",2,1,"T1",1,3,1,"H"
2015-11-07,2015,"Rizespor","Galatasaray","4-3",4,3,"T1",1,7,1,"H"
2015-11-08,2015,"Bursaspor","Besiktas","0-1",0,1,"T1",1,1,-1,"A"
2015-11-08,2015,"Fenerbahce","Konyaspor","1-0",1,0,"T1",1,1,1,"H"
2015-11-08,2015,"Sivasspor","Gaziantepspor","3-0",3,0,"T1",1,3,3,"H"
2015-11-21,2015,"Akhisar Belediyespor","Bursaspor","3-1",3,1,"T1",1,4,2,"H"
2015-11-21,2015,"Galatasaray","Antalyaspor","3-3",3,3,"T1",1,6,0,"D"
2015-11-21,2015,"Kayserispor","Kasimpasa","0-0",0,0,"T1",1,0,0,"D"
2015-11-21,2015,"Mersin Idman Yurdu","Fenerbahce","1-3",1,3,"T1",1,4,-2,"A"
2015-11-22,2015,"Besiktas","Sivasspor","2-0",2,0,"T1",1,2,2,"H"
2015-11-22,2015,"Konyaspor","Eskisehirspor","3-2",3,2,"T1",1,5,1,"H"
2015-11-22,2015,"Osmanlispor","Rizespor","0-1",0,1,"T1",1,1,-1,"A"
2015-11-22,2015,"Trabzonspor","Genclerbirligi","1-0",1,0,"T1",1,1,1,"H"
2015-11-23,2015,"Gaziantepspor","Buyuksehyr","0-1",0,1,"T1",1,1,-1,"A"
2015-11-27,2015,"Antalyaspor","Osmanlispor","1-1",1,1,"T1",1,2,0,"D"
2015-11-27,2015,"Bursaspor","Kayserispor","1-2",1,2,"T1",1,3,-1,"A"
2015-11-27,2015,"Rizespor","Konyaspor","0-0",0,0,"T1",1,0,0,"D"
2015-11-28,2015,"Eskisehirspor","Mersin Idman Yurdu","3-2",3,2,"T1",1,5,1,"H"
2015-11-28,2015,"Sivasspor","Buyuksehyr","2-2",2,2,"T1",1,4,0,"D"
2015-11-29,2015,"Besiktas","Akhisar Belediyespor","0-2",0,2,"T1",1,2,-2,"A"
2015-11-29,2015,"Genclerbirligi","Gaziantepspor","2-2",2,2,"T1",1,4,0,"D"
2015-11-29,2015,"Kasimpasa","Galatasaray","2-2",2,2,"T1",1,4,0,"D"
2015-11-30,2015,"Fenerbahce","Trabzonspor","2-0",2,0,"T1",1,2,2,"H"
2015-12-04,2015,"Galatasaray","Bursaspor","3-0",3,0,"T1",1,3,3,"H"
2015-12-05,2015,"Kayserispor","Besiktas","1-2",1,2,"T1",1,3,-1,"A"
2015-12-05,2015,"Konyaspor","Antalyaspor","3-2",3,2,"T1",1,5,1,"H"
2015-12-05,2015,"Osmanlispor","Kasimpasa","0-1",0,1,"T1",1,1,-1,"A"
2015-12-06,2015,"Buyuksehyr","Genclerbirligi","2-0",2,0,"T1",1,2,2,"H"
2015-12-06,2015,"Gaziantepspor","Fenerbahce","2-2",2,2,"T1",1,4,0,"D"
2015-12-06,2015,"Mersin Idman Yurdu","Rizespor","3-0",3,0,"T1",1,3,3,"H"
2015-12-07,2015,"Akhisar Belediyespor","Sivasspor","1-0",1,0,"T1",1,1,1,"H"
2015-12-07,2015,"Trabzonspor","Eskisehirspor","3-1",3,1,"T1",1,4,2,"H"
2015-12-11,2015,"Bursaspor","Osmanlispor","0-4",0,4,"T1",1,4,-4,"A"
2015-12-12,2015,"Antalyaspor","Mersin Idman Yurdu","3-2",3,2,"T1",1,5,1,"H"
2015-12-12,2015,"Eskisehirspor","Gaziantepspor","1-2",1,2,"T1",1,3,-1,"A"
2015-12-12,2015,"Kasimpasa","Konyaspor","2-1",2,1,"T1",1,3,1,"H"
2015-12-12,2015,"Rizespor","Trabzonspor","3-0",3,0,"T1",1,3,3,"H"
2015-12-13,2015,"Fenerbahce","Buyuksehyr","1-0",1,0,"T1",1,1,1,"H"
2015-12-13,2015,"Genclerbirligi","Sivasspor","0-1",0,1,"T1",1,1,-1,"A"
2015-12-13,2015,"Kayserispor","Akhisar Belediyespor","3-2",3,2,"T1",1,5,1,"H"
2015-12-14,2015,"Besiktas","Galatasaray","2-1",2,1,"T1",1,3,1,"H"
2015-12-19,2015,"Gaziantepspor","Rizespor","2-0",2,0,"T1",1,2,2,"H"
2015-12-19,2015,"Konyaspor","Bursaspor","1-0",1,0,"T1",1,1,1,"H"
2015-12-19,2015,"Mersin Idman Yurdu","Kasimpasa","1-2",1,2,"T1",1,3,-1,"A"
2015-12-19,2015,"Trabzonspor","Antalyaspor","3-0",3,0,"T1",1,3,3,"H"
2015-12-20,2015,"Buyuksehyr","Eskisehirspor","2-1",2,1,"T1",1,3,1,"H"
2015-12-20,2015,"Galatasaray","Akhisar Belediyespor","3-2",3,2,"T1",1,5,1,"H"
2015-12-20,2015,"Genclerbirligi","Fenerbahce","0-1",0,1,"T1",1,1,-1,"A"
2015-12-20,2015,"Sivasspor","Kayserispor","0-0",0,0,"T1",1,0,0,"D"
2015-12-21,2015,"Osmanlispor","Besiktas","2-3",2,3,"T1",1,5,-1,"A"
2015-12-26,2015,"Antalyaspor","Gaziantepspor","0-0",0,0,"T1",1,0,0,"D"
2015-12-26,2015,"Kasimpasa","Trabzonspor","1-1",1,1,"T1",1,2,0,"D"
2015-12-26,2015,"Rizespor","Buyuksehyr","2-1",2,1,"T1",1,3,1,"H"
2015-12-27,2015,"Akhisar Belediyespor","Osmanlispor","0-0",0,0,"T1",1,0,0,"D"
2015-12-27,2015,"Besiktas","Konyaspor","4-0",4,0,"T1",1,4,4,"H"
2015-12-27,2015,"Bursaspor","Mersin Idman Yurdu","2-1",2,1,"T1",1,3,1,"H"
2015-12-27,2015,"Kayserispor","Galatasaray","1-1",1,1,"T1",1,2,0,"D"
2015-12-28,2015,"Eskisehirspor","Genclerbirligi","2-0",2,0,"T1",1,2,2,"H"
2015-12-28,2015,"Fenerbahce","Sivasspor","2-1",2,1,"T1",1,3,1,"H"
2016-01-16,2015,"Akhisar Belediyespor","Konyaspor","0-2",0,2,"T1",1,2,-2,"A"
2016-01-16,2015,"Galatasaray","Sivasspor","3-1",3,1,"T1",1,4,2,"H"
2016-01-16,2015,"Kasimpasa","Gaziantepspor","1-2",1,2,"T1",1,3,-1,"A"
2016-01-16,2015,"Kayserispor","Osmanlispor","1-0",1,0,"T1",1,1,1,"H"
2016-01-17,2015,"Antalyaspor","Buyuksehyr","1-2",1,2,"T1",1,3,-1,"A"
2016-01-17,2015,"Bursaspor","Trabzonspor","4-2",4,2,"T1",1,6,2,"H"
2016-01-17,2015,"Rizespor","Genclerbirligi","2-3",2,3,"T1",1,5,-1,"A"
2016-01-18,2015,"Eskisehirspor","Fenerbahce","0-3",0,3,"T1",1,3,-3,"A"
2016-01-23,2015,"Konyaspor","Kayserispor","1-0",1,0,"T1",1,1,1,"H"
2016-01-23,2015,"Mersin Idman Yurdu","Akhisar Belediyespor","0-0",0,0,"T1",1,0,0,"D"
2016-01-23,2015,"Osmanlispor","Galatasaray","3-2",3,2,"T1",1,5,1,"H"
2016-01-24,2015,"Fenerbahce","Rizespor","2-1",2,1,"T1",1,3,1,"H"
2016-01-24,2015,"Gaziantepspor","Bursaspor","2-3",2,3,"T1",1,5,-1,"A"
2016-01-24,2015,"Genclerbirligi","Antalyaspor","1-0",1,0,"T1",1,1,1,"H"
2016-01-24,2015,"Sivasspor","Eskisehirspor","1-2",1,2,"T1",1,3,-1,"A"
2016-01-25,2015,"Buyuksehyr","Kasimpasa","1-1",1,1,"T1",1,2,0,"D"
2016-02-05,2015,"Antalyaspor","Fenerbahce","4-2",4,2,"T1",1,6,2,"H"
2016-02-05,2015,"Osmanlispor","Sivasspor","4-0",4,0,"T1",1,4,4,"H"
2016-02-06,2015,"Bursaspor","Buyuksehyr","3-3",3,3,"T1",1,6,0,"D"
2016-02-06,2015,"Galatasaray","Konyaspor","0-0",0,0,"T1",1,0,0,"D"
2016-02-06,2015,"Kayserispor","Mersin Idman Yurdu","0-1",0,1,"T1",1,1,-1,"A"
2016-02-07,2015,"Akhisar Belediyespor","Trabzonspor","2-1",2,1,"T1",1,3,1,"H"
2016-02-07,2015,"Besiktas","Gaziantepspor","4-0",4,0,"T1",1,4,4,"H"
2016-02-07,2015,"Rizespor","Eskisehirspor","1-1",1,1,"T1",1,2,0,"D"
2016-02-08,2015,"Kasimpasa","Genclerbirligi","0-1",0,1,"T1",1,1,-1,"A"
2016-02-12,2015,"Fenerbahce","Kasimpasa","3-1",3,1,"T1",1,4,2,"H"
2016-02-13,2015,"Genclerbirligi","Bursaspor","2-0",2,0,"T1",1,2,2,"H"
2016-02-13,2015,"Konyaspor","Osmanlispor","1-1",1,1,"T1",1,2,0,"D"
2016-02-13,2015,"Mersin Idman Yurdu","Galatasaray","2-1",2,1,"T1",1,3,1,"H"
2016-02-14,2015,"Buyuksehyr","Besiktas","2-2",2,2,"T1",1,4,0,"D"
2016-02-14,2015,"Eskisehirspor","Antalyaspor","3-2",3,2,"T1",1,5,1,"H"
2016-02-14,2015,"Gaziantepspor","Akhisar Belediyespor","0-1",0,1,"T1",1,1,-1,"A"
2016-02-14,2015,"Sivasspor","Rizespor","2-1",2,1,"T1",1,3,1,"H"
2016-02-15,2015,"Trabzonspor","Kayserispor","2-1",2,1,"T1",1,3,1,"H"
2016-02-17,2015,"Besiktas","Mersin Idman Yurdu","1-0",1,0,"T1",1,1,1,"H"
2016-02-19,2015,"Konyaspor","Sivasspor","2-1",2,1,"T1",1,3,1,"H"
2016-02-20,2015,"Antalyaspor","Rizespor","2-1",2,1,"T1",1,3,1,"H"
2016-02-20,2015,"Bursaspor","Fenerbahce","0-0",0,0,"T1",1,0,0,"D"
2016-02-20,2015,"Kasimpasa","Eskisehirspor","2-1",2,1,"T1",1,3,1,"H"
2016-02-21,2015,"Akhisar Belediyespor","Buyuksehyr","0-0",0,0,"T1",1,0,0,"D"
2016-02-21,2015,"Galatasaray","Trabzonspor","2-1",2,1,"T1",1,3,1,"H"
2016-02-21,2015,"Kayserispor","Gaziantepspor","2-2",2,2,"T1",1,4,0,"D"
2016-02-21,2015,"Osmanlispor","Mersin Idman Yurdu","3-1",3,1,"T1",1,4,2,"H"
2016-02-22,2015,"Besiktas","Genclerbirligi","1-0",1,0,"T1",1,1,1,"H"
2016-02-26,2015,"Buyuksehyr","Kayserispor","1-0",1,0,"T1",1,1,1,"H"
2016-02-27,2015,"Eskisehirspor","Bursaspor","0-1",0,1,"T1",1,1,-1,"A"
2016-02-27,2015,"Mersin Idman Yurdu","Konyaspor","0-2",0,2,"T1",1,2,-2,"A"
2016-02-27,2015,"Rizespor","Kasimpasa","2-0",2,0,"T1",1,2,2,"H"
2016-02-27,2015,"Trabzonspor","Osmanlispor","1-2",1,2,"T1",1,3,-1,"A"
2016-02-28,2015,"Gaziantepspor","Galatasaray","2-0",2,0,"T1",1,2,2,"H"
2016-02-28,2015,"Genclerbirligi","Akhisar Belediyespor","3-1",3,1,"T1",1,4,2,"H"
2016-02-28,2015,"Sivasspor","Antalyaspor","0-0",0,0,"T1",1,0,0,"D"
2016-02-29,2015,"Fenerbahce","Besiktas","2-0",2,0,"T1",1,2,2,"H"
2016-03-04,2015,"Mersin Idman Yurdu","Sivasspor","1-0",1,0,"T1",1,1,1,"H"
2016-03-05,2015,"Bursaspor","Rizespor","1-0",1,0,"T1",1,1,1,"H"
2016-03-05,2015,"Kayserispor","Genclerbirligi","0-2",0,2,"T1",1,2,-2,"A"
2016-03-05,2015,"Osmanlispor","Gaziantepspor","1-1",1,1,"T1",1,2,0,"D"
2016-03-06,2015,"Akhisar Belediyespor","Fenerbahce","0-3",0,3,"T1",1,3,-3,"A"
2016-03-06,2015,"Galatasaray","Buyuksehyr","3-3",3,3,"T1",1,6,0,"D"
2016-03-06,2015,"Kasimpasa","Antalyaspor","2-1",2,1,"T1",1,3,1,"H"
2016-03-06,2015,"Konyaspor","Trabzonspor","2-0",2,0,"T1",1,2,2,"H"
2016-03-07,2015,"Besiktas","Eskisehirspor","3-1",3,1,"T1",1,4,2,"H"
2016-03-11,2015,"Trabzonspor","Mersin Idman Yurdu","1-0",1,0,"T1",1,1,1,"H"
2016-03-12,2015,"Buyuksehyr","Osmanlispor","2-3",2,3,"T1",1,5,-1,"A"
2016-03-12,2015,"Gaziantepspor","Konyaspor","0-1",0,1,"T1",1,1,-1,"A"
2016-03-12,2015,"Rizespor","Besiktas","1-2",1,2,"T1",1,3,-1,"A"
2016-03-13,2015,"Eskisehirspor","Akhisar Belediyespor","3-3",3,3,"T1",1,6,0,"D"
2016-03-13,2015,"Fenerbahce","Kayserispor","1-0",1,0,"T1",1,1,1,"H"
2016-03-13,2015,"Genclerbirligi","Galatasaray","1-1",1,1,"T1",1,2,0,"D"
2016-03-14,2015,"Antalyaspor","Bursaspor","3-0",3,0,"T1",1,3,3,"H"
2016-03-14,2015,"Sivasspor","Kasimpasa","1-0",1,0,"T1",1,1,1,"H"
2016-03-15,2015,"Trabzonspor","Besiktas","0-2",0,2,"T1",1,2,-2,"A"
2016-03-18,2015,"Akhisar Belediyespor","Rizespor","1-1",1,1,"T1",1,2,0,"D"
2016-03-18,2015,"Kayserispor","Eskisehirspor","0-0",0,0,"T1",1,0,0,"D"
2016-03-19,2015,"Besiktas","Antalyaspor","1-0",1,0,"T1",1,1,1,"H"
2016-03-19,2015,"Osmanlispor","Genclerbirligi","3-1",3,1,"T1",1,4,2,"H"
2016-03-19,2015,"Trabzonspor","Sivasspor","1-0",1,0,"T1",1,1,1,"H"
2016-03-20,2015,"Bursaspor","Kasimpasa","4-1",4,1,"T1",1,5,3,"H"
2016-03-20,2015,"Konyaspor","Buyuksehyr","1-1",1,1,"T1",1,2,0,"D"
2016-03-20,2015,"Mersin Idman Yurdu","Gaziantepspor","0-0",0,0,"T1",1,0,0,"D"
2016-04-02,2015,"Eskisehirspor","Galatasaray","4-3",4,3,"T1",1,7,1,"H"
2016-04-02,2015,"Gaziantepspor","Trabzonspor","0-1",0,1,"T1",1,1,-1,"A"
2016-04-02,2015,"Genclerbirligi","Konyaspor","0-1",0,1,"T1",1,1,-1,"A"
2016-04-03,2015,"Antalyaspor","Akhisar Belediyespor","2-2",2,2,"T1",1,4,0,"D"
2016-04-03,2015,"Buyuksehyr","Mersin Idman Yurdu","3-0",3,0,"T1",1,3,3,"H"
2016-04-03,2015,"Fenerbahce","Osmanlispor","0-0",0,0,"T1",1,0,0,"D"
2016-04-03,2015,"Sivasspor","Bursaspor","1-2",1,2,"T1",1,3,-1,"A"
2016-04-04,2015,"Kasimpasa","Besiktas","2-1",2,1,"T1",1,3,1,"H"
2016-04-04,2015,"Rizespor","Kayserispor","0-0",0,0,"T1",1,0,0,"D"
2016-04-08,2015,"Gaziantepspor","Sivasspor","0-1",0,1,"T1",1,1,-1,"A"
2016-04-09,2015,"Galatasaray","Rizespor","1-1",1,1,"T1",1,2,0,"D"
2016-04-09,2015,"Kayserispor","Antalyaspor","0-0",0,0,"T1",1,0,0,"D"
2016-04-09,2015,"Osmanlispor","Eskisehirspor","0-0",0,0,"T1",1,0,0,"D"
2016-04-10,2015,"Konyaspor","Fenerbahce","2-1",2,1,"T1",1,3,1,"H"
2016-04-10,2015,"Mersin Idman Yurdu","Genclerbirligi","1-3",1,3,"T1",1,4,-2,"A"
2016-04-10,2015,"Trabzonspor","Buyuksehyr","1-1",1,1,"T1",1,2,0,"D"
2016-04-11,2015,"Akhisar Belediyespor","Kasimpasa","0-1",0,1,"T1",1,1,-1,"A"
2016-04-11,2015,"Besiktas","Bursaspor","3-2",3,2,"T1",1,5,1,"H"
2016-04-13,2015,"Galatasaray","Fenerbahce","0-0",0,0,"T1",1,0,0,"D"
2016-04-16,2015,"Antalyaspor","Galatasaray","4-2",4,2,"T1",1,6,2,"H"
2016-04-16,2015,"Eskisehirspor","Konyaspor","1-2",1,2,"T1",1,3,-1,"A"
2016-04-16,2015,"Rizespor","Osmanlispor","0-1",0,1,"T1",1,1,-1,"A"
2016-04-16,2015,"Sivasspor","Besiktas","1-2",1,2,"T1",1,3,-1,"A"
2016-04-17,2015,"Bursaspor","Akhisar Belediyespor","0-2",0,2,"T1",1,2,-2,"A"
2016-04-17,2015,"Buyuksehyr","Gaziantepspor","4-1",4,1,"T1",1,5,3,"H"
2016-04-17,2015,"Fenerbahce","Mersin Idman Yurdu","4-1",4,1,"T1",1,5,3,"H"
2016-04-17,2015,"Kasimpasa","Kayserispor","1-2",1,2,"T1",1,3,-1,"A"
2016-04-18,2015,"Genclerbirligi","Trabzonspor","3-1",3,1,"T1",1,4,2,"H"
2016-04-22,2015,"Kayserispor","Bursaspor","2-1",2,1,"T1",1,3,1,"H"
2016-04-23,2015,"Akhisar Belediyespor","Besiktas","3-3",3,3,"T1",1,6,0,"D"
2016-04-23,2015,"Buyuksehyr","Sivasspor","2-2",2,2,"T1",1,4,0,"D"
2016-04-23,2015,"Osmanlispor","Antalyaspor","3-0",3,0,"T1",1,3,3,"H"
2016-04-24,2015,"Galatasaray","Kasimpasa","4-1",4,1,"T1",1,5,3,"H"
2016-04-24,2015,"Konyaspor","Rizespor","3-1",3,1,"T1",1,4,2,"H"
2016-04-24,2015,"Mersin Idman Yurdu","Eskisehirspor","1-2",1,2,"T1",1,3,-1,"A"
2016-04-24,2015,"Trabzonspor","Fenerbahce","0-4",0,4,"T1",1,4,-4,"A"
2016-04-25,2015,"Gaziantepspor","Genclerbirligi","1-3",1,3,"T1",1,4,-2,"A"
2016-04-29,2015,"Bursaspor","Galatasaray","1-1",1,1,"T1",1,2,0,"D"
2016-04-29,2015,"Rizespor","Mersin Idman Yurdu","2-0",2,0,"T1",1,2,2,"H"
2016-04-30,2015,"Besiktas","Kayserispor","4-0",4,0,"T1",1,4,4,"H"
2016-04-30,2015,"Eskisehirspor","Trabzonspor","1-0",1,0,"T1",1,1,1,"H"
2016-04-30,2015,"Genclerbirligi","Buyuksehyr","0-0",0,0,"T1",1,0,0,"D"
2016-05-01,2015,"Antalyaspor","Konyaspor","1-0",1,0,"T1",1,1,1,"H"
2016-05-01,2015,"Fenerbahce","Gaziantepspor","3-0",3,0,"T1",1,3,3,"H"
2016-05-01,2015,"Sivasspor","Akhisar Belediyespor","1-1",1,1,"T1",1,2,0,"D"
2016-05-02,2015,"Kasimpasa","Osmanlispor","1-1",1,1,"T1",1,2,0,"D"
2016-05-07,2015,"Gaziantepspor","Eskisehirspor","1-1",1,1,"T1",1,2,0,"D"
2016-05-07,2015,"Osmanlispor","Bursaspor","3-3",3,3,"T1",1,6,0,"D"
2016-05-07,2015,"Sivasspor","Genclerbirligi","2-1",2,1,"T1",1,3,1,"H"
2016-05-08,2015,"Akhisar Belediyespor","Kayserispor","1-1",1,1,"T1",1,2,0,"D"
2016-05-08,2015,"Galatasaray","Besiktas","0-1",0,1,"T1",1,1,-1,"A"
2016-05-08,2015,"Mersin Idman Yurdu","Antalyaspor","0-1",0,1,"T1",1,1,-1,"A"
2016-05-08,2015,"Trabzonspor","Rizespor","6-0",6,0,"T1",1,6,6,"H"
2016-05-09,2015,"Buyuksehyr","Fenerbahce","2-1",2,1,"T1",1,3,1,"H"
2016-05-09,2015,"Konyaspor","Kasimpasa","2-0",2,0,"T1",1,2,2,"H"
2016-05-13,2015,"Antalyaspor","Trabzonspor","7-0",7,0,"T1",1,7,7,"H"
2016-05-14,2015,"Bursaspor","Konyaspor","1-1",1,1,"T1",1,2,0,"D"
2016-05-14,2015,"Eskisehirspor","Buyuksehyr","1-2",1,2,"T1",1,3,-1,"A"
2016-05-14,2015,"Kayserispor","Sivasspor","1-1",1,1,"T1",1,2,0,"D"
2016-05-14,2015,"Rizespor","Gaziantepspor","1-0",1,0,"T1",1,1,1,"H"
2016-05-15,2015,"Akhisar Belediyespor","Galatasaray","1-2",1,2,"T1",1,3,-1,"A"
2016-05-15,2015,"Besiktas","Osmanlispor","3-1",3,1,"T1",1,4,2,"H"
2016-05-15,2015,"Fenerbahce","Genclerbirligi","2-1",2,1,"T1",1,3,1,"H"
2016-05-15,2015,"Kasimpasa","Mersin Idman Yurdu","7-0",7,0,"T1",1,7,7,"H"
2016-05-18,2015,"Buyuksehyr","Rizespor","1-0",1,0,"T1",1,1,1,"H"
2016-05-18,2015,"Konyaspor","Besiktas","2-1",2,1,"T1",1,3,1,"H"
2016-05-18,2015,"Mersin Idman Yurdu","Bursaspor","2-5",2,5,"T1",1,7,-3,"A"
2016-05-19,2015,"Galatasaray","Kayserispor","6-0",6,0,"T1",1,6,6,"H"
2016-05-19,2015,"Gaziantepspor","Antalyaspor","2-0",2,0,"T1",1,2,2,"H"
2016-05-19,2015,"Genclerbirligi","Eskisehirspor","3-1",3,1,"T1",1,4,2,"H"
2016-05-19,2015,"Osmanlispor","Akhisar Belediyespor","1-0",1,0,"T1",1,1,1,"H"
2016-05-19,2015,"Sivasspor","Fenerbahce","2-2",2,2,"T1",1,4,0,"D"
2016-05-19,2015,"Trabzonspor","Kasimpasa","0-6",0,6,"T1",1,6,-6,"A"
2016-08-19,2016,"Adanaspor","Bursaspor","1-2",1,2,"T1",1,3,-1,"A"
2016-08-20,2016,"Besiktas","Alanyaspor","4-1",4,1,"T1",1,5,3,"H"
2016-08-20,2016,"Rizespor","Konyaspor","1-1",1,1,"T1",1,2,0,"D"
2016-08-20,2016,"Trabzonspor","Kasimpasa","2-0",2,0,"T1",1,2,2,"H"
2016-08-21,2016,"Antalyaspor","Osmanlispor","0-0",0,0,"T1",1,0,0,"D"
2016-08-21,2016,"Buyuksehyr","Fenerbahce","1-0",1,0,"T1",1,1,1,"H"
2016-08-21,2016,"Genclerbirligi","Gaziantepspor","2-0",2,0,"T1",1,2,2,"H"
2016-08-21,2016,"Kayserispor","Akhisar Belediyespor","0-2",0,2,"T1",1,2,-2,"A"
2016-08-22,2016,"Galatasaray","Karabukspor","1-0",1,0,"T1",1,1,1,"H"
2016-08-26,2016,"Alanyaspor","Antalyaspor","2-1",2,1,"T1",1,3,1,"H"
2016-08-26,2016,"Konyaspor","Besiktas","2-2",2,2,"T1",1,4,0,"D"
2016-08-27,2016,"Akhisar Belediyespor","Galatasaray","1-3",1,3,"T1",1,4,-2,"A"
2016-08-27,2016,"Gaziantepspor","Trabzonspor","1-0",1,0,"T1",1,1,1,"H"
2016-08-27,2016,"Kasimpasa","Adanaspor","1-1",1,1,"T1",1,2,0,"D"
2016-08-28,2016,"Bursaspor","Buyuksehyr","0-2",0,2,"T1",1,2,-2,"A"
2016-08-28,2016,"Fenerbahce","Kayserispor","3-3",3,3,"T1",1,6,0,"D"
2016-08-28,2016,"Karabukspor","Rizespor","3-0",3,0,"T1",1,3,3,"H"
2016-08-28,2016,"Osmanlispor","Genclerbirligi","2-2",2,2,"T1",1,4,0,"D"
2016-09-10,2016,"Adanaspor","Gaziantepspor","0-0",0,0,"T1",1,0,0,"D"
2016-09-10,2016,"Besiktas","Karabukspor","3-1",3,1,"T1",1,4,2,"H"
2016-09-10,2016,"Buyuksehyr","Kasimpasa","3-1",3,1,"T1",1,4,2,"H"
2016-09-10,2016,"Genclerbirligi","Alanyaspor","0-0",0,0,"T1",1,0,0,"D"
2016-09-10,2016,"Kayserispor","Galatasaray","1-1",1,1,"T1",1,2,0,"D"
2016-09-11,2016,"Antalyaspor","Konyaspor","1-3",1,3,"T1",1,4,-2,"A"
2016-09-11,2016,"Fenerbahce","Bursaspor","0-1",0,1,"T1",1,1,-1,"A"
2016-09-11,2016,"Rizespor","Akhisar Belediyespor","1-0",1,0,"T1",1,1,1,"H"
2016-09-11,2016,"Trabzonspor","Osmanlispor","0-2",0,2,"T1",1,2,-2,"A"
2016-09-16,2016,"Bursaspor","Kayserispor","3-1",3,1,"T1",1,4,2,"H"
2016-09-16,2016,"Karabukspor","Antalyaspor","3-2",3,2,"T1",1,5,1,"H"
2016-09-17,2016,"Alanyaspor","Trabzonspor","3-0",3,0,"T1",1,3,3,"H"
2016-09-17,2016,"Galatasaray","Rizespor","2-0",2,0,"T1",1,2,2,"H"
2016-09-18,2016,"Akhisar Belediyespor","Besiktas","0-2",0,2,"T1",1,2,-2,"A"
2016-09-18,2016,"Gaziantepspor","Buyuksehyr","0-1",0,1,"T1",1,1,-1,"A"
2016-09-18,2016,"Konyaspor","Genclerbirligi","1-1",1,1,"T1",1,2,0,"D"
2016-09-18,2016,"Osmanlispor","Adanaspor","1-0",1,0,"T1",1,1,1,"H"
2016-09-19,2016,"Kasimpasa","Fenerbahce","1-5",1,5,"T1",1,6,-4,"A"
2016-09-23,2016,"Antalyaspor","Akhisar Belediyespor","0-0",0,0,"T1",1,0,0,"D"
2016-09-24,2016,"Besiktas","Galatasaray","2-2",2,2,"T1",1,4,0,"D"
2016-09-24,2016,"Buyuksehyr","Osmanlispor","2-2",2,2,"T1",1,4,0,"D"
2016-09-24,2016,"Trabzonspor","Konyaspor","1-0",1,0,"T1",1,1,1,"H"
2016-09-25,2016,"Bursaspor","Kasimpasa","1-0",1,0,"T1",1,1,1,"H"
2016-09-25,2016,"Fenerbahce","Gaziantepspor","2-1",2,1,"T1",1,3,1,"H"
2016-09-25,2016,"Genclerbirligi","Karabukspor","2-0",2,0,"T1",1,2,2,"H"
2016-09-25,2016,"Kayserispor","Rizespor","2-1",2,1,"T1",1,3,1,"H"
2016-09-26,2016,"Adanaspor","Alanyaspor","3-2",3,2,"T1",1,5,1,"H"
2016-09-30,2016,"Akhisar Belediyespor","Genclerbirligi","0-0",0,0,"T1",1,0,0,"D"
2016-10-01,2016,"Gaziantepspor","Bursaspor","3-2",3,2,"T1",1,5,1,"H"
2016-10-01,2016,"Karabukspor","Trabzonspor","4-0",4,0,"T1",1,4,4,"H"
2016-10-01,2016,"Kasimpasa","Kayserispor","3-1",3,1,"T1",1,4,2,"H"
2016-10-01,2016,"Rizespor","Besiktas","0-1",0,1,"T1",1,1,-1,"A"
2016-10-02,2016,"Alanyaspor","Buyuksehyr","0-5",0,5,"T1",1,5,-5,"A"
2016-10-02,2016,"Galatasaray","Antalyaspor","3-1",3,1,"T1",1,4,2,"H"
2016-10-02,2016,"Konyaspor","Adanaspor","1-0",1,0,"T1",1,1,1,"H"
2016-10-02,2016,"Osmanlispor","Fenerbahce","1-1",1,1,"T1",1,2,0,"D"
2016-10-15,2016,"Adanaspor","Karabukspor","1-2",1,2,"T1",1,3,-1,"A"
2016-10-15,2016,"Genclerbirligi","Galatasaray","0-1",0,1,"T1",1,1,-1,"A"
2016-10-15,2016,"Kasimpasa","Gaziantepspor","0-0",0,0,"T1",1,0,0,"D"
2016-10-15,2016,"Kayserispor","Besiktas","0-1",0,1,"T1",1,1,-1,"A"
2016-10-16,2016,"Bursaspor","Osmanlispor","0-0",0,0,"T1",1,0,0,"D"
2016-10-16,2016,"Buyuksehyr","Konyaspor","1-1",1,1,"T1",1,2,0,"D"
2016-10-16,2016,"Fenerbahce","Alanyaspor","1-1",1,1,"T1",1,2,0,"D"
2016-10-16,2016,"Trabzonspor","Akhisar Belediyespor","0-0",0,0,"T1",1,0,0,"D"
2016-10-17,2016,"Antalyaspor","Rizespor","1-1",1,1,"T1",1,2,0,"D"
2016-10-21,2016,"Gaziantepspor","Kayserispor","1-2",1,2,"T1",1,3,-1,"A"
2016-10-21,2016,"Rizespor","Genclerbirligi","2-1",2,1,"T1",1,3,1,"H"
2016-10-22,2016,"Akhisar Belediyespor","Adanaspor","1-0",1,0,"T1",1,1,1,"H"
2016-10-22,2016,"Alanyaspor","Bursaspor","0-2",0,2,"T1",1,2,-2,"A"
2016-10-22,2016,"Galatasaray","Trabzonspor","0-1",0,1,"T1",1,1,-1,"A"
2016-10-23,2016,"Besiktas","Antalyaspor","3-0",3,0,"T1",1,3,3,"H"
2016-10-23,2016,"Karabukspor","Buyuksehyr","0-2",0,2,"T1",1,2,-2,"A"
2016-10-23,2016,"Osmanlispor","Kasimpasa","1-2",1,2,"T1",1,3,-1,"A"
2016-10-24,2016,"Konyaspor","Fenerbahce","0-1",0,1,"T1",1,1,-1,"A"
2016-10-28,2016,"Genclerbirligi","Besiktas","1-1",1,1,"T1",1,2,0,"D"
2016-10-29,2016,"Adanaspor","Galatasaray","0-1",0,1,"T1",1,1,-1,"A"
2016-10-29,2016,"Bursaspor","Konyaspor","2-0",2,0,"T1",1,2,2,"H"
2016-10-29,2016,"Gaziantepspor","Osmanlispor","3-1",3,1,"T1",1,4,2,"H"
2016-10-30,2016,"Buyuksehyr","Akhisar Belediyespor","5-1",5,1,"T1",1,6,4,"H"
2016-10-30,2016,"Fenerbahce","Karabukspor","5-0",5,0,"T1",1,5,5,"H"
2016-10-30,2016,"Trabzonspor","Rizespor","2-2",2,2,"T1",1,4,0,"D"
2016-10-31,2016,"Kasimpasa","Alanyaspor","2-1",2,1,"T1",1,3,1,"H"
2016-10-31,2016,"Kayserispor","Antalyaspor","0-1",0,1,"T1",1,1,-1,"A"
2016-11-04,2016,"Galatasaray","Buyuksehyr","1-2",1,2,"T1",1,3,-1,"A"
2016-11-05,2016,"Alanyaspor","Gaziantepspor","4-3",4,3,"T1",1,7,1,"H"
2016-11-05,2016,"Antalyaspor","Genclerbirligi","1-0",1,0,"T1",1,1,1,"H"
2016-11-05,2016,"Besiktas","Trabzonspor","2-1",2,1,"T1",1,3,1,"H"
2016-11-05,2016,"Karabukspor","Bursaspor","0-0",0,0,"T1",1,0,0,"D"
2016-11-06,2016,"Akhisar Belediyespor","Fenerbahce","1-3",1,3,"T1",1,4,-2,"A"
2016-11-06,2016,"Konyaspor","Kasimpasa","2-1",2,1,"T1",1,3,1,"H"
2016-11-06,2016,"Osmanlispor","Kayserispor","1-1",1,1,"T1",1,2,0,"D"
2016-11-06,2016,"Rizespor","Adanaspor","2-2",2,2,"T1",1,4,0,"D"
2016-11-19,2016,"Adanaspor","Besiktas","1-2",1,2,"T1",1,3,-1,"A"
2016-11-19,2016,"Bursaspor","Akhisar Belediyespor","0-0",0,0,"T1",1,0,0,"D"
2016-11-19,2016,"Gaziantepspor","Konyaspor","0-3",0,3,"T1",1,3,-3,"A"
2016-11-19,2016,"Osmanlispor","Alanyaspor","2-0",2,0,"T1",1,2,2,"H"
2016-11-20,2016,"Fenerbahce","Galatasaray","2-0",2,0,"T1",1,2,2,"H"
2016-11-20,2016,"Kasimpasa","Karabukspor","2-2",2,2,"T1",1,4,0,"D"
2016-11-20,2016,"Kayserispor","Genclerbirligi","0-2",0,2,"T1",1,2,-2,"A"
2016-11-21,2016,"Buyuksehyr","Rizespor","2-1",2,1,"T1",1,3,1,"H"
2016-11-21,2016,"Trabzonspor","Antalyaspor","0-1",0,1,"T1",1,1,-1,"A"
2016-11-25,2016,"Alanyaspor","Kayserispor","3-0",3,0,"T1",1,3,3,"H"
2016-11-25,2016,"Galatasaray","Bursaspor","3-1",3,1,"T1",1,4,2,"H"
2016-11-26,2016,"Akhisar Belediyespor","Kasimpasa","1-0",1,0,"T1",1,1,1,"H"
2016-11-26,2016,"Antalyaspor","Adanaspor","1-0",1,0,"T1",1,1,1,"H"
2016-11-26,2016,"Besiktas","Buyuksehyr","1-1",1,1,"T1",1,2,0,"D"
2016-11-26,2016,"Karabukspor","Gaziantepspor","2-0",2,0,"T1",1,2,2,"H"
2016-11-27,2016,"Genclerbirligi","Trabzonspor","0-0",0,0,"T1",1,0,0,"D"
2016-11-27,2016,"Rizespor","Fenerbahce","1-5",1,5,"T1",1,6,-4,"A"
2016-11-28,2016,"Konyaspor","Osmanlispor","1-1",1,1,"T1",1,2,0,"D"
2016-12-03,2016,"Buyuksehyr","Antalyaspor","2-2",2,2,"T1",1,4,0,"D"
2016-12-03,2016,"Fenerbahce","Besiktas","0-0",0,0,"T1",1,0,0,"D"
2016-12-04,2016,"Adanaspor","Genclerbirligi","0-2",0,2,"T1",1,2,-2,"A"
2016-12-04,2016,"Alanyaspor","Konyaspor","2-3",2,3,"T1",1,5,-1,"A"
2016-12-04,2016,"Gaziantepspor","Akhisar Belediyespor","1-2",1,2,"T1",1,3,-1,"A"
2016-12-04,2016,"Kasimpasa","Galatasaray","1-2",1,2,"T1",1,3,-1,"A"
2016-12-04,2016,"Osmanlispor","Karabukspor","2-1",2,1,"T1",1,3,1,"H"
2016-12-05,2016,"Bursaspor","Rizespor","2-1",2,1,"T1",1,3,1,"H"
2016-12-05,2016,"Kayserispor","Trabzonspor","0-1",0,1,"T1",1,1,-1,"A"
2016-12-09,2016,"Trabzonspor","Adanaspor","4-1",4,1,"T1",1,5,3,"H"
2016-12-10,2016,"Besiktas","Bursaspor","2-1",2,1,"T1",1,3,1,"H"
2016-12-10,2016,"Genclerbirligi","Buyuksehyr","0-0",0,0,"T1",1,0,0,"D"
2016-12-10,2016,"Rizespor","Kasimpasa","0-1",0,1,"T1",1,1,-1,"A"
2016-12-11,2016,"Akhisar Belediyespor","Osmanlispor","1-2",1,2,"T1",1,3,-1,"A"
2016-12-11,2016,"Galatasaray","Gaziantepspor","3-1",3,1,"T1",1,4,2,"H"
2016-12-11,2016,"Karabukspor","Alanyaspor","0-2",0,2,"T1",1,2,-2,"A"
2016-12-11,2016,"Konyaspor","Kayserispor","1-0",1,0,"T1",1,1,1,"H"
2016-12-12,2016,"Antalyaspor","Fenerbahce","1-0",1,0,"T1",1,1,1,"H"
2016-12-17,2016,"Buyuksehyr","Trabzonspor","1-0",1,0,"T1",1,1,1,"H"
2016-12-17,2016,"Kasimpasa","Besiktas","2-1",2,1,"T1",1,3,1,"H"
2016-12-18,2016,"Adanaspor","Kayserispor","2-1",2,1,"T1",1,3,1,"H"
2016-12-18,2016,"Alanyaspor","Akhisar Belediyespor","0-0",0,0,"T1",1,0,0,"D"
2016-12-18,2016,"Gaziantepspor","Rizespor","1-2",1,2,"T1",1,3,-1,"A"
2016-12-18,2016,"Karabukspor","Konyaspor","1-1",1,1,"T1",1,2,0,"D"
2016-12-18,2016,"Osmanlispor","Galatasaray","2-2",2,2,"T1",1,4,0,"D"
2016-12-19,2016,"Bursaspor","Antalyaspor","2-1",2,1,"T1",1,3,1,"H"
2016-12-19,2016,"Fenerbahce","Genclerbirligi","3-0",3,0,"T1",1,3,3,"H"
2016-12-24,2016,"Adanaspor","Buyuksehyr","1-1",1,1,"T1",1,2,0,"D"
2016-12-24,2016,"Besiktas","Gaziantepspor","1-0",1,0,"T1",1,1,1,"H"
2016-12-25,2016,"Akhisar Belediyespor","Konyaspor","1-0",1,0,"T1",1,1,1,"H"
2016-12-25,2016,"Antalyaspor","Kasimpasa","2-1",2,1,"T1",1,3,1,"H"
2016-12-25,2016,"Galatasaray","Alanyaspor","5-1",5,1,"T1",1,6,4,"H"
2016-12-25,2016,"Kayserispor","Karabukspor","2-0",2,0,"T1",1,2,2,"H"
2016-12-25,2016,"Rizespor","Osmanlispor","0-1",0,1,"T1",1,1,-1,"A"
2016-12-26,2016,"Genclerbirligi","Bursaspor","3-1",3,1,"T1",1,4,2,"H"
2016-12-26,2016,"Trabzonspor","Fenerbahce","0-3",0,3,"T1",1,3,-3,"A"
2017-01-13,2016,"Bursaspor","Trabzonspor","1-2",1,2,"T1",1,3,-1,"A"
2017-01-14,2016,"Alanyaspor","Rizespor","2-3",2,3,"T1",1,5,-1,"A"
2017-01-14,2016,"Buyuksehyr","Kayserispor","5-0",5,0,"T1",1,5,5,"H"
2017-01-14,2016,"Karabukspor","Akhisar Belediyespor","1-0",1,0,"T1",1,1,1,"H"
2017-01-14,2016,"Konyaspor","Galatasaray","0-1",0,1,"T1",1,1,-1,"A"
2017-01-15,2016,"Fenerbahce","Adanaspor","2-2",2,2,"T1",1,4,0,"D"
2017-01-15,2016,"Gaziantepspor","Antalyaspor","0-3",0,3,"T1",1,3,-3,"A"
2017-01-15,2016,"Kasimpasa","Genclerbirligi","3-0",3,0,"T1",1,3,3,"H"
2017-01-16,2016,"Osmanlispor","Besiktas","0-2",0,2,"T1",1,2,-2,"A"
2017-01-21,2016,"Akhisar Belediyespor","Kayserispor","0-0",0,0,"T1",1,0,0,"D"
2017-01-21,2016,"Bursaspor","Adanaspor","0-1",0,1,"T1",1,1,-1,"A"
2017-01-21,2016,"Karabukspor","Galatasaray","2-1",2,1,"T1",1,3,1,"H"
2017-01-21,2016,"Konyaspor","Rizespor","2-1",2,1,"T1",1,3,1,"H"
2017-01-22,2016,"Fenerbahce","Buyuksehyr","1-0",1,0,"T1",1,1,1,"H"
2017-01-22,2016,"Kasimpasa","Trabzonspor","0-1",0,1,"T1",1,1,-1,"A"
2017-01-22,2016,"Osmanlispor","Antalyaspor","1-2",1,2,"T1",1,3,-1,"A"
2017-01-23,2016,"Alanyaspor","Besiktas","1-4",1,4,"T1",1,5,-3,"A"
2017-01-28,2016,"Antalyaspor","Alanyaspor","2-1",2,1,"T1",1,3,1,"H"
2017-01-28,2016,"Galatasaray","Akhisar Belediyespor","6-0",6,0,"T1",1,6,6,"H"
2017-01-28,2016,"Rizespor","Karabukspor","1-0",1,0,"T1",1,1,1,"H"
2017-01-29,2016,"Buyuksehyr","Bursaspor","1-0",1,0,"T1",1,1,1,"H"
2017-01-29,2016,"Genclerbirligi","Osmanlispor","1-1",1,1,"T1",1,2,0,"D"
2017-01-29,2016,"Kayserispor","Fenerbahce","4-1",4,1,"T1",1,5,3,"H"
2017-01-29,2016,"Trabzonspor","Gaziantepspor","4-0",4,0,"T1",1,4,4,"H"
2017-01-30,2016,"Adanaspor","Kasimpasa","2-0",2,0,"T1",1,2,2,"H"
2017-01-30,2016,"Besiktas","Konyaspor","5-1",5,1,"T1",1,6,4,"H"
2017-02-10,2016,"Karabukspor","Besiktas","2-1",2,1,"T1",1,3,1,"H"
2017-02-11,2016,"Alanyaspor","Genclerbirligi","3-0",3,0,"T1",1,3,3,"H"
2017-02-11,2016,"Bursaspor","Fenerbahce","1-1",1,1,"T1",1,2,0,"D"
2017-02-11,2016,"Osmanlispor","Trabzonspor","0-1",0,1,"T1",1,1,-1,"A"
2017-02-12,2016,"Akhisar Belediyespor","Rizespor","1-0",1,0,"T1",1,1,1,"H"
2017-02-12,2016,"Galatasaray","Kayserispor","1-2",1,2,"T1",1,3,-1,"A"
2017-02-12,2016,"Kasimpasa","Buyuksehyr","4-0",4,0,"T1",1,4,4,"H"
2017-02-12,2016,"Konyaspor","Antalyaspor","1-1",1,1,"T1",1,2,0,"D"
2017-02-13,2016,"Gaziantepspor","Adanaspor","1-0",1,0,"T1",1,1,1,"H"
2017-02-17,2016,"Kayserispor","Bursaspor","2-0",2,0,"T1",1,2,2,"H"
2017-02-18,2016,"Antalyaspor","Karabukspor","1-0",1,0,"T1",1,1,1,"H"
2017-02-18,2016,"Buyuksehyr","Gaziantepspor","0-0",0,0,"T1",1,0,0,"D"
2017-02-18,2016,"Rizespor","Galatasaray","1-1",1,1,"T1",1,2,0,"D"
2017-02-19,2016,"Adanaspor","Osmanlispor","1-5",1,5,"T1",1,6,-4,"A"
2017-02-19,2016,"Besiktas","Akhisar Belediyespor","3-1",3,1,"T1",1,4,2,"H"
2017-02-19,2016,"Fenerbahce","Kasimpasa","0-0",0,0,"T1",1,0,0,"D"
2017-02-19,2016,"Genclerbirligi","Konyaspor","2-0",2,0,"T1",1,2,2,"H"
2017-02-20,2016,"Trabzonspor","Alanyaspor","0-0",0,0,"T1",1,0,0,"D"
2017-02-24,2016,"Kasimpasa","Bursaspor","4-0",4,0,"T1",1,4,4,"H"
2017-02-24,2016,"Rizespor","Kayserispor","2-4",2,4,"T1",1,6,-2,"A"
2017-02-25,2016,"Akhisar Belediyespor","Antalyaspor","3-0",3,0,"T1",1,3,3,"H"
2017-02-25,2016,"Alanyaspor","Adanaspor","4-1",4,1,"T1",1,5,3,"H"
2017-02-25,2016,"Konyaspor","Trabzonspor","1-1",1,1,"T1",1,2,0,"D"
2017-02-26,2016,"Gaziantepspor","Fenerbahce","1-1",1,1,"T1",1,2,0,"D"
2017-02-26,2016,"Karabukspor","Genclerbirligi","1-0",1,0,"T1",1,1,1,"H"
2017-02-26,2016,"Osmanlispor","Buyuksehyr","0-1",0,1,"T1",1,1,-1,"A"
2017-02-27,2016,"Galatasaray","Besiktas","0-1",0,1,"T1",1,1,-1,"A"
2017-03-03,2016,"Trabzonspor","Karabukspor","1-0",1,0,"T1",1,1,1,"H"
2017-03-04,2016,"Besiktas","Rizespor","1-0",1,0,"T1",1,1,1,"H"
2017-03-04,2016,"Bursaspor","Gaziantepspor","2-1",2,1,"T1",1,3,1,"H"
2017-03-05,2016,"Adanaspor","Konyaspor","0-1",0,1,"T1",1,1,-1,"A"
2017-03-05,2016,"Buyuksehyr","Alanyaspor","2-1",2,1,"T1",1,3,1,"H"
2017-03-05,2016,"Fenerbahce","Osmanlispor","1-0",1,0,"T1",1,1,1,"H"
2017-03-05,2016,"Kayserispor","Kasimpasa","2-2",2,2,"T1",1,4,0,"D"
2017-03-06,2016,"Antalyaspor","Galatasaray","2-3",2,3,"T1",1,5,-1,"A"
2017-03-06,2016,"Genclerbirligi","Akhisar Belediyespor","2-0",2,0,"T1",1,2,2,"H"
2017-03-10,2016,"Alanyaspor","Fenerbahce","2-3",2,3,"T1",1,5,-1,"A"
2017-03-11,2016,"Galatasaray","Genclerbirligi","3-2",3,2,"T1",1,5,1,"H"
2017-03-11,2016,"Gaziantepspor","Kasimpasa","0-2",0,2,"T1",1,2,-2,"A"
2017-03-11,2016,"Karabukspor","Adanaspor","2-0",2,0,"T1",1,2,2,"H"
2017-03-11,2016,"Osmanlispor","Bursaspor","1-1",1,1,"T1",1,2,0,"D"
2017-03-12,2016,"Besiktas","Kayserispor","2-2",2,2,"T1",1,4,0,"D"
2017-03-12,2016,"Konyaspor","Buyuksehyr","0-3",0,3,"T1",1,3,-3,"A"
2017-03-12,2016,"Rizespor","Antalyaspor","1-2",1,2,"T1",1,3,-1,"A"
2017-03-13,2016,"Akhisar Belediyespor","Trabzonspor","1-3",1,3,"T1",1,4,-2,"A"
2017-03-17,2016,"Fenerbahce","Konyaspor","2-3",2,3,"T1",1,5,-1,"A"
2017-03-18,2016,"Adanaspor","Akhisar Belediyespor","2-1",2,1,"T1",1,3,1,"H"
2017-03-18,2016,"Kasimpasa","Osmanlispor","3-2",3,2,"T1",1,5,1,"H"
2017-03-18,2016,"Kayserispor","Gaziantepspor","3-4",3,4,"T1",1,7,-1,"A"
2017-03-18,2016,"Trabzonspor","Galatasaray","2-0",2,0,"T1",1,2,2,"H"
2017-03-19,2016,"Antalyaspor","Besiktas","0-0",0,0,"T1",1,0,0,"D"
2017-03-19,2016,"Bursaspor","Alanyaspor","1-3",1,3,"T1",1,4,-2,"A"
2017-03-19,2016,"Buyuksehyr","Karabukspor","3-3",3,3,"T1",1,6,0,"D"
2017-03-19,2016,"Genclerbirligi","Rizespor","1-0",1,0,"T1",1,1,1,"H"
2017-04-01,2016,"Akhisar Belediyespor","Buyuksehyr","2-1",2,1,"T1",1,3,1,"H"
2017-04-01,2016,"Alanyaspor","Kasimpasa","3-1",3,1,"T1",1,4,2,"H"
2017-04-01,2016,"Antalyaspor","Kayserispor","2-1",2,1,"T1",1,3,1,"H"
2017-04-01,2016,"Karabukspor","Fenerbahce","0-1",0,1,"T1",1,1,-1,"A"
2017-04-02,2016,"Besiktas","Genclerbirligi","3-0",3,0,"T1",1,3,3,"H"
2017-04-02,2016,"Konyaspor","Bursaspor","2-0",2,0,"T1",1,2,2,"H"
2017-04-02,2016,"Osmanlispor","Gaziantepspor","0-2",0,2,"T1",1,2,-2,"A"
2017-04-02,2016,"Rizespor","Trabzonspor","0-1",0,1,"T1",1,1,-1,"A"
2017-04-03,2016,"Galatasaray","Adanaspor","4-0",4,0,"T1",1,4,4,"H"
2017-04-07,2016,"Bursaspor","Karabukspor","3-0",3,0,"T1",1,3,3,"H"
2017-04-08,2016,"Gaziantepspor","Alanyaspor","2-3",2,3,"T1",1,5,-1,"A"
2017-04-08,2016,"Genclerbirligi","Antalyaspor","1-1",1,1,"T1",1,2,0,"D"
2017-04-08,2016,"Trabzonspor","Besiktas","3-4",3,4,"T1",1,7,-1,"A"
2017-04-09,2016,"Adanaspor","Rizespor","1-3",1,3,"T1",1,4,-2,"A"
2017-04-09,2016,"Fenerbahce","Akhisar Belediyespor","3-1",3,1,"T1",1,4,2,"H"
2017-04-09,2016,"Kayserispor","Osmanlispor","1-4",1,4,"T1",1,5,-3,"A"
2017-04-10,2016,"Buyuksehyr","Galatasaray","4-0",4,0,"T1",1,4,4,"H"
2017-04-10,2016,"Kasimpasa","Konyaspor","1-1",1,1,"T1",1,2,0,"D"
2017-04-12,2016,"Gaziantepspor","Genclerbirligi","0-1",0,1,"T1",1,1,-1,"A"
2017-04-21,2016,"Karabukspor","Kasimpasa","0-0",0,0,"T1",1,0,0,"D"
2017-04-21,2016,"Konyaspor","Gaziantepspor","1-2",1,2,"T1",1,3,-1,"A"
2017-04-22,2016,"Alanyaspor","Osmanlispor","0-1",0,1,"T1",1,1,-1,"A"
2017-04-22,2016,"Antalyaspor","Trabzonspor","0-3",0,3,"T1",1,3,-3,"A"
2017-04-22,2016,"Genclerbirligi","Kayserispor","2-1",2,1,"T1",1,3,1,"H"
2017-04-22,2016,"Rizespor","Buyuksehyr","3-3",3,3,"T1",1,6,0,"D"
2017-04-23,2016,"Akhisar Belediyespor","Bursaspor","5-1",5,1,"T1",1,6,4,"H"
2017-04-23,2016,"Galatasaray","Fenerbahce","0-1",0,1,"T1",1,1,-1,"A"
2017-04-24,2016,"Besiktas","Adanaspor","3-2",3,2,"T1",1,5,1,"H"
2017-04-28,2016,"Gaziantepspor","Karabukspor","0-0",0,0,"T1",1,0,0,"D"
2017-04-29,2016,"Kayserispor","Alanyaspor","3-0",3,0,"T1",1,3,3,"H"
2017-04-29,2016,"Trabzonspor","Genclerbirligi","0-0",0,0,"T1",1,0,0,"D"
2017-04-30,2016,"Adanaspor","Antalyaspor","2-5",2,5,"T1",1,7,-3,"A"
2017-04-30,2016,"Buyuksehyr","Besiktas","3-1",3,1,"T1",1,4,2,"H"
2017-04-30,2016,"Fenerbahce","Rizespor","2-1",2,1,"T1",1,3,1,"H"
2017-04-30,2016,"Kasimpasa","Akhisar Belediyespor","0-2",0,2,"T1",1,2,-2,"A"
2017-05-01,2016,"Bursaspor","Galatasaray","0-5",0,5,"T1",1,5,-5,"A"
2017-05-01,2016,"Osmanlispor","Konyaspor","0-0",0,0,"T1",1,0,0,"D"
2017-05-05,2016,"Antalyaspor","Buyuksehyr","0-1",0,1,"T1",1,1,-1,"A"
2017-05-06,2016,"Galatasaray","Kasimpasa","1-3",1,3,"T1",1,4,-2,"A"
2017-05-06,2016,"Genclerbirligi","Adanaspor","0-1",0,1,"T1",1,1,-1,"A"
2017-05-06,2016,"Konyaspor","Alanyaspor","2-3",2,3,"T1",1,5,-1,"A"
2017-05-06,2016,"Trabzonspor","Kayserispor","2-3",2,3,"T1",1,5,-1,"A"
2017-05-07,2016,"Besiktas","Fenerbahce","1-1",1,1,"T1",1,2,0,"D"
2017-05-07,2016,"Rizespor","Bursaspor","6-0",6,0,"T1",1,6,6,"H"
2017-05-08,2016,"Akhisar Belediyespor","Gaziantepspor","6-0",6,0,"T1",1,6,6,"H"
2017-05-08,2016,"Karabukspor","Osmanlispor","1-0",1,0,"T1",1,1,1,"H"
2017-05-12,2016,"Kasimpasa","Rizespor","4-2",4,2,"T1",1,6,2,"H"
2017-05-12,2016,"Kayserispor","Konyaspor","2-1",2,1,"T1",1,3,1,"H"
2017-05-13,2016,"Adanaspor","Trabzonspor","1-1",1,1,"T1",1,2,0,"D"
2017-05-13,2016,"Buyuksehyr","Genclerbirligi","2-1",2,1,"T1",1,3,1,"H"
2017-05-13,2016,"Fenerbahce","Antalyaspor","0-1",0,1,"T1",1,1,-1,"A"
2017-05-14,2016,"Alanyaspor","Karabukspor","4-2",4,2,"T1",1,6,2,"H"
2017-05-14,2016,"Gaziantepspor","Galatasaray","1-2",1,2,"T1",1,3,-1,"A"
2017-05-14,2016,"Osmanlispor","Akhisar Belediyespor","0-4",0,4,"T1",1,4,-4,"A"
2017-05-15,2016,"Bursaspor","Besiktas","0-2",0,2,"T1",1,2,-2,"A"
2017-05-19,2016,"Galatasaray","Osmanlispor","2-0",2,0,"T1",1,2,2,"H"
2017-05-20,2016,"Antalyaspor","Bursaspor","2-1",2,1,"T1",1,3,1,"H"
2017-05-20,2016,"Besiktas","Kasimpasa","4-1",4,1,"T1",1,5,3,"H"
2017-05-20,2016,"Kayserispor","Adanaspor","1-1",1,1,"T1",1,2,0,"D"
2017-05-20,2016,"Rizespor","Gaziantepspor","2-0",2,0,"T1",1,2,2,"H"
2017-05-21,2016,"Konyaspor","Karabukspor","3-0",3,0,"T1",1,3,3,"H"
2017-05-21,2016,"Trabzonspor","Buyuksehyr","0-0",0,0,"T1",1,0,0,"D"
2017-05-22,2016,"Akhisar Belediyespor","Alanyaspor","3-0",3,0,"T1",1,3,3,"H"
2017-05-22,2016,"Genclerbirligi","Fenerbahce","1-2",1,2,"T1",1,3,-1,"A"
2017-05-27,2016,"Buyuksehyr","Adanaspor","2-1",2,1,"T1",1,3,1,"H"
2017-05-27,2016,"Fenerbahce","Trabzonspor","1-1",1,1,"T1",1,2,0,"D"
2017-05-27,2016,"Kasimpasa","Antalyaspor","0-3",0,3,"T1",1,3,-3,"A"
2017-05-27,2016,"Konyaspor","Akhisar Belediyespor","0-3",0,3,"T1",1,3,-3,"A"
2017-05-28,2016,"Bursaspor","Genclerbirligi","1-2",1,2,"T1",1,3,-1,"A"
2017-05-28,2016,"Gaziantepspor","Besiktas","0-4",0,4,"T1",1,4,-4,"A"
2017-05-28,2016,"Karabukspor","Kayserispor","2-2",2,2,"T1",1,4,0,"D"
2017-05-28,2016,"Osmanlispor","Rizespor","1-2",1,2,"T1",1,3,-1,"A"
2017-05-29,2016,"Alanyaspor","Galatasaray","2-3",2,3,"T1",1,5,-1,"A"
2017-06-02,2016,"Akhisar Belediyespor","Karabukspor","2-3",2,3,"T1",1,5,-1,"A"
2017-06-02,2016,"Antalyaspor","Gaziantepspor","4-1",4,1,"T1",1,5,3,"H"
2017-06-02,2016,"Genclerbirligi","Kasimpasa","1-0",1,0,"T1",1,1,1,"H"
2017-06-03,2016,"Adanaspor","Fenerbahce","1-3",1,3,"T1",1,4,-2,"A"
2017-06-03,2016,"Besiktas","Osmanlispor","4-0",4,0,"T1",1,4,4,"H"
2017-06-03,2016,"Galatasaray","Konyaspor","2-1",2,1,"T1",1,3,1,"H"
2017-06-03,2016,"Kayserispor","Buyuksehyr","0-1",0,1,"T1",1,1,-1,"A"
2017-06-03,2016,"Rizespor","Alanyaspor","1-0",1,0,"T1",1,1,1,"H"
2017-06-03,2016,"Trabzonspor","Bursaspor","1-2",1,2,"T1",1,3,-1,"A"
2017-08-11,2017,"Buyuksehyr","Bursaspor","1-0",1,0,"T1",1,1,1,"H"
2017-08-12,2017,"Akhisar Belediyespor","Sivasspor","1-0",1,0,"T1",1,1,1,"H"
2017-08-12,2017,"Alanyaspor","Kasimpasa","1-3",1,3,"T1",1,4,-2,"A"
2017-08-12,2017,"Genclerbirligi","Karabukspor","1-1",1,1,"T1",1,2,0,"D"
2017-08-12,2017,"Goztep","Fenerbahce","2-2",2,2,"T1",1,4,0,"D"
2017-08-13,2017,"Besiktas","Antalyaspor","2-0",2,0,"T1",1,2,2,"H"
2017-08-13,2017,"Trabzonspor","Konyaspor","2-1",2,1,"T1",1,3,1,"H"
2017-08-13,2017,"Yeni Malatyaspor","Osmanlispor","3-1",3,1,"T1",1,4,2,"H"
2017-08-14,2017,"Galatasaray","Kayserispor","4-1",4,1,"T1",1,5,3,"H"
2017-08-18,2017,"Kasimpasa","Besiktas","2-2",2,2,"T1",1,4,0,"D"
2017-08-19,2017,"Bursaspor","Alanyaspor","3-2",3,2,"T1",1,5,1,"H"
2017-08-19,2017,"Karabukspor","Buyuksehyr","3-1",3,1,"T1",1,4,2,"H"
2017-08-19,2017,"Osmanlispor","Galatasaray","1-3",1,3,"T1",1,4,-2,"A"
2017-08-19,2017,"Sivasspor","Yeni Malatyaspor","2-0",2,0,"T1",1,2,2,"H"
2017-08-20,2017,"Antalyaspor","Akhisar Belediyespor","2-2",2,2,"T1",1,4,0,"D"
2017-08-20,2017,"Fenerbahce","Trabzonspor","2-2",2,2,"T1",1,4,0,"D"
2017-08-20,2017,"Kayserispor","Goztep","1-0",1,0,"T1",1,1,1,"H"
2017-08-21,2017,"Konyaspor","Genclerbirligi","3-0",3,0,"T1",1,3,3,"H"
2017-08-25,2017,"Alanyaspor","Karabukspor","1-1",1,1,"T1",1,2,0,"D"
2017-08-25,2017,"Galatasaray","Sivasspor","3-0",3,0,"T1",1,3,3,"H"
2017-08-26,2017,"Besiktas","Bursaspor","2-1",2,1,"T1",1,3,1,"H"
2017-08-26,2017,"Goztep","Trabzonspor","3-2",3,2,"T1",1,5,1,"H"
2017-08-26,2017,"Kayserispor","Osmanlispor","2-2",2,2,"T1",1,4,0,"D"
2017-08-26,2017,"Yeni Malatyaspor","Antalyaspor","1-1",1,1,"T1",1,2,0,"D"
2017-08-27,2017,"Akhisar Belediyespor","Kasimpasa","2-1",2,1,"T1",1,3,1,"H"
2017-08-27,2017,"Buyuksehyr","Konyaspor","2-1",2,1,"T1",1,3,1,"H"
2017-08-27,2017,"Genclerbirligi","Fenerbahce","1-2",1,2,"T1",1,3,-1,"A"
2017-09-09,2017,"Fenerbahce","Buyuksehyr","2-3",2,3,"T1",1,5,-1,"A"
2017-09-09,2017,"Karabukspor","Besiktas","0-1",0,1,"T1",1,1,-1,"A"
2017-09-09,2017,"Konyaspor","Alanyaspor","0-2",0,2,"T1",1,2,-2,"A"
2017-09-09,2017,"Sivasspor","Kayserispor","0-2",0,2,"T1",1,2,-2,"A"
2017-09-10,2017,"Antalyaspor","Galatasaray","1-1",1,1,"T1",1,2,0,"D"
2017-09-10,2017,"Bursaspor","Akhisar Belediyespor","3-0",3,0,"T1",1,3,3,"H"
2017-09-10,2017,"Osmanlispor","Goztep","0-2",0,2,"T1",1,2,-2,"A"
2017-09-10,2017,"Trabzonspor","Genclerbirligi","3-1",3,1,"T1",1,4,2,"H"
2017-09-11,2017,"Kasimpasa","Yeni Malatyaspor","3-2",3,2,"T1",1,5,1,"H"
2017-09-15,2017,"Kayserispor","Antalyaspor","2-0",2,0,"T1",1,2,2,"H"
2017-09-16,2017,"Akhisar Belediyespor","Karabukspor","2-1",2,1,"T1",1,3,1,"H"
2017-09-16,2017,"Galatasaray","Kasimpasa","2-0",2,0,"T1",1,2,2,"H"
2017-09-16,2017,"Yeni Malatyaspor","Bursaspor","2-4",2,4,"T1",1,6,-2,"A"
2017-09-17,2017,"Alanyaspor","Fenerbahce","1-4",1,4,"T1",1,5,-3,"A"
2017-09-17,2017,"Buyuksehyr","Trabzonspor","2-2",2,2,"T1",1,4,0,"D"
2017-09-17,2017,"Goztep","Genclerbirligi","3-2",3,2,"T1",1,5,1,"H"
2017-09-17,2017,"Osmanlispor","Sivasspor","2-4",2,4,"T1",1,6,-2,"A"
2017-09-18,2017,"Besiktas","Konyaspor","2-0",2,0,"T1",1,2,2,"H"
2017-09-22,2017,"Trabzonspor","Alanyaspor","3-4",3,4,"T1",1,7,-1,"A"
2017-09-23,2017,"Fenerbahce","Besiktas","2-1",2,1,"T1",1,3,1,"H"
2017-09-23,2017,"Genclerbirligi","Buyuksehyr","1-0",1,0,"T1",1,1,1,"H"
2017-09-23,2017,"Konyaspor","Akhisar Belediyespor","2-0",2,0,"T1",1,2,2,"H"
2017-09-24,2017,"Bursaspor","Galatasaray","1-2",1,2,"T1",1,3,-1,"A"
2017-09-24,2017,"Karabukspor","Yeni Malatyaspor","2-4",2,4,"T1",1,6,-2,"A"
2017-09-24,2017,"Kasimpasa","Kayserispor","1-1",1,1,"T1",1,2,0,"D"
2017-09-24,2017,"Sivasspor","Goztep","2-3",2,3,"T1",1,5,-1,"A"
2017-09-25,2017,"Antalyaspor","Osmanlispor","3-0",3,0,"T1",1,3,3,"H"
2017-09-29,2017,"Akhisar Belediyespor","Fenerbahce","1-0",1,0,"T1",1,1,1,"H"
2017-09-30,2017,"Galatasaray","Karabukspor","3-2",3,2,"T1",1,5,1,"H"
2017-09-30,2017,"Kayserispor","Bursaspor","3-1",3,1,"T1",1,4,2,"H"
2017-09-30,2017,"Osmanlispor","Kasimpasa","3-0",3,0,"T1",1,3,3,"H"
2017-09-30,2017,"Sivasspor","Antalyaspor","3-1",3,1,"T1",1,4,2,"H"
2017-10-01,2017,"Alanyaspor","Genclerbirligi","4-1",4,1,"T1",1,5,3,"H"
2017-10-01,2017,"Besiktas","Trabzonspor","2-2",2,2,"T1",1,4,0,"D"
2017-10-01,2017,"Goztep","Buyuksehyr","1-2",1,2,"T1",1,3,-1,"A"
2017-10-01,2017,"Yeni Malatyaspor","Konyaspor","1-1",1,1,"T1",1,2,0,"D"
2017-10-13,2017,"Genclerbirligi","Besiktas","2-1",2,1,"T1",1,3,1,"H"
2017-10-14,2017,"Antalyaspor","Goztep","1-3",1,3,"T1",1,4,-2,"A"
2017-10-14,2017,"Buyuksehyr","Alanyaspor","2-1",2,1,"T1",1,3,1,"H"
2017-10-14,2017,"Karabukspor","Kayserispor","1-0",1,0,"T1",1,1,1,"H"
2017-10-14,2017,"Konyaspor","Galatasaray","0-2",0,2,"T1",1,2,-2,"A"
2017-10-15,2017,"Fenerbahce","Yeni Malatyaspor","3-1",3,1,"T1",1,4,2,"H"
2017-10-15,2017,"Kasimpasa","Sivasspor","2-3",2,3,"T1",1,5,-1,"A"
2017-10-15,2017,"Trabzonspor","Akhisar Belediyespor","1-6",1,6,"T1",1,7,-5,"A"
2017-10-16,2017,"Bursaspor","Osmanlispor","3-1",3,1,"T1",1,4,2,"H"
2017-10-20,2017,"Antalyaspor","Kasimpasa","2-1",2,1,"T1",1,3,1,"H"
2017-10-20,2017,"Goztep","Alanyaspor","3-3",3,3,"T1",1,6,0,"D"
2017-10-21,2017,"Akhisar Belediyespor","Genclerbirligi","3-3",3,3,"T1",1,6,0,"D"
2017-10-21,2017,"Osmanlispor","Karabukspor","3-0",3,0,"T1",1,3,3,"H"
2017-10-21,2017,"Yeni Malatyaspor","Trabzonspor","1-0",1,0,"T1",1,1,1,"H"
2017-10-22,2017,"Galatasaray","Fenerbahce","0-0",0,0,"T1",1,0,0,"D"
2017-10-22,2017,"Kayserispor","Konyaspor","2-1",2,1,"T1",1,3,1,"H"
2017-10-22,2017,"Sivasspor","Bursaspor","0-0",0,0,"T1",1,0,0,"D"
2017-10-23,2017,"Besiktas","Buyuksehyr","1-1",1,1,"T1",1,2,0,"D"
2017-10-27,2017,"Kasimpasa","Goztep","3-1",3,1,"T1",1,4,2,"H"
2017-10-28,2017,"Alanyaspor","Besiktas","1-2",1,2,"T1",1,3,-1,"A"
2017-10-28,2017,"Buyuksehyr","Akhisar Belediyespor","2-1",2,1,"T1",1,3,1,"H"
2017-10-28,2017,"Genclerbirligi","Yeni Malatyaspor","0-1",0,1,"T1",1,1,-1,"A"
2017-10-29,2017,"Bursaspor","Antalyaspor","4-0",4,0,"T1",1,4,4,"H"
2017-10-29,2017,"Karabukspor","Sivasspor","0-1",0,1,"T1",1,1,-1,"A"
2017-10-29,2017,"Konyaspor","Osmanlispor","1-0",1,0,"T1",1,1,1,"H"
2017-10-29,2017,"Trabzonspor","Galatasaray","2-1",2,1,"T1",1,3,1,"H"
2017-10-30,2017,"Fenerbahce","Kayserispor","3-3",3,3,"T1",1,6,0,"D"
2017-11-03,2017,"Galatasaray","Genclerbirligi","5-1",5,1,"T1",1,6,4,"H"
2017-11-04,2017,"Antalyaspor","Karabukspor","2-1",2,1,"T1",1,3,1,"H"
2017-11-04,2017,"Kasimpasa","Bursaspor","2-2",2,2,"T1",1,4,0,"D"
2017-11-04,2017,"Kayserispor","Trabzonspor","0-0",0,0,"T1",1,0,0,"D"
2017-11-04,2017,"Osmanlispor","Fenerbahce","1-1",1,1,"T1",1,2,0,"D"
2017-11-05,2017,"Akhisar Belediyespor","Alanyaspor","0-4",0,4,"T1",1,4,-4,"A"
2017-11-05,2017,"Goztep","Besiktas","1-3",1,3,"T1",1,4,-2,"A"
2017-11-05,2017,"Sivasspor","Konyaspor","2-1",2,1,"T1",1,3,1,"H"
2017-11-05,2017,"Yeni Malatyaspor","Buyuksehyr","0-2",0,2,"T1",1,2,-2,"A"
2017-11-17,2017,"Besiktas","Akhisar Belediyespor","0-0",0,0,"T1",1,0,0,"D"
2017-11-18,2017,"Bursaspor","Goztep","0-0",0,0,"T1",1,0,0,"D"
2017-11-18,2017,"Buyuksehyr","Galatasaray","5-1",5,1,"T1",1,6,4,"H"
2017-11-18,2017,"Konyaspor","Antalyaspor","1-1",1,1,"T1",1,2,0,"D"
2017-11-19,2017,"Alanyaspor","Yeni Malatyaspor","1-0",1,0,"T1",1,1,1,"H"
2017-11-19,2017,"Fenerbahce","Sivasspor","4-1",4,1,"T1",1,5,3,"H"
2017-11-19,2017,"Genclerbirligi","Kayserispor","1-2",1,2,"T1",1,3,-1,"A"
2017-11-19,2017,"Trabzonspor","Osmanlispor","4-3",4,3,"T1",1,7,1,"H"
2017-11-20,2017,"Karabukspor","Kasimpasa","0-2",0,2,"T1",1,2,-2,"A"
2017-11-24,2017,"Osmanlispor","Genclerbirligi","2-0",2,0,"T1",1,2,2,"H"
2017-11-25,2017,"Galatasaray","Alanyaspor","2-0",2,0,"T1",1,2,2,"H"
2017-11-25,2017,"Goztep","Akhisar Belediyespor","2-0",2,0,"T1",1,2,2,"H"
2017-11-25,2017,"Yeni Malatyaspor","Besiktas","0-0",0,0,"T1",1,0,0,"D"
2017-11-26,2017,"Antalyaspor","Fenerbahce","0-1",0,1,"T1",1,1,-1,"A"
2017-11-26,2017,"Bursaspor","Karabukspor","2-1",2,1,"T1",1,3,1,"H"
2017-11-26,2017,"Kasimpasa","Konyaspor","2-1",2,1,"T1",1,3,1,"H"
2017-11-26,2017,"Sivasspor","Trabzonspor","1-2",1,2,"T1",1,3,-1,"A"
2017-11-27,2017,"Kayserispor","Buyuksehyr","1-1",1,1,"T1",1,2,0,"D"
2017-12-02,2017,"Akhisar Belediyespor","Yeni Malatyaspor","0-0",0,0,"T1",1,0,0,"D"
2017-12-02,2017,"Besiktas","Galatasaray","3-0",3,0,"T1",1,3,3,"H"
2017-12-02,2017,"Karabukspor","Goztep","0-1",0,1,"T1",1,1,-1,"A"
2017-12-03,2017,"Buyuksehyr","Osmanlispor","1-0",1,0,"T1",1,1,1,"H"
2017-12-03,2017,"Fenerbahce","Kasimpasa","4-2",4,2,"T1",1,6,2,"H"
2017-12-03,2017,"Genclerbirligi","Sivasspor","4-0",4,0,"T1",1,4,4,"H"
2017-12-03,2017,"Konyaspor","Bursaspor","0-3",0,3,"T1",1,3,-3,"A"
2017-12-04,2017,"Alanyaspor","Kayserispor","1-2",1,2,"T1",1,3,-1,"A"
2017-12-04,2017,"Trabzonspor","Antalyaspor","3-0",3,0,"T1",1,3,3,"H"
2017-12-08,2017,"Bursaspor","Fenerbahce","0-1",0,1,"T1",1,1,-1,"A"
2017-12-09,2017,"Antalyaspor","Genclerbirligi","1-1",1,1,"T1",1,2,0,"D"
2017-12-09,2017,"Galatasaray","Akhisar Belediyespor","4-2",4,2,"T1",1,6,2,"H"
2017-12-09,2017,"Kasimpasa","Trabzonspor","0-3",0,3,"T1",1,3,-3,"A"
2017-12-09,2017,"Yeni Malatyaspor","Goztep","2-3",2,3,"T1",1,5,-1,"A"
2017-12-10,2017,"Kayserispor","Besiktas","1-1",1,1,"T1",1,2,0,"D"
2017-12-10,2017,"Osmanlispor","Alanyaspor","3-0",3,0,"T1",1,3,3,"H"
2017-12-10,2017,"Sivasspor","Buyuksehyr","1-0",1,0,"T1",1,1,1,"H"
2017-12-11,2017,"Konyaspor","Karabukspor","2-0",2,0,"T1",1,2,2,"H"
2017-12-16,2017,"Alanyaspor","Sivasspor","1-1",1,1,"T1",1,2,0,"D"
2017-12-16,2017,"Genclerbirligi","Kasimpasa","0-0",0,0,"T1",1,0,0,"D"
2017-12-16,2017,"Trabzonspor","Bursaspor","1-0",1,0,"T1",1,1,1,"H"
2017-12-17,2017,"Akhisar Belediyespor","Kayserispor","0-2",0,2,"T1",1,2,-2,"A"
2017-12-17,2017,"Besiktas","Osmanlispor","5-1",5,1,"T1",1,6,4,"H"
2017-12-17,2017,"Buyuksehyr","Antalyaspor","4-1",4,1,"T1",1,5,3,"H"
2017-12-17,2017,"Yeni Malatyaspor","Galatasaray","2-1",2,1,"T1",1,3,1,"H"
2017-12-18,2017,"Fenerbahce","Karabukspor","2-0",2,0,"T1",1,2,2,"H"
2017-12-18,2017,"Goztep","Konyaspor","1-0",1,0,"T1",1,1,1,"H"
2017-12-22,2017,"Antalyaspor","Alanyaspor","3-1",3,1,"T1",1,4,2,"H"
2017-12-23,2017,"Bursaspor","Genclerbirligi","1-1",1,1,"T1",1,2,0,"D"
2017-12-23,2017,"Konyaspor","Fenerbahce","1-1",1,1,"T1",1,2,0,"D"
2017-12-23,2017,"Sivasspor","Besiktas","2-1",2,1,"T1",1,3,1,"H"
2017-12-24,2017,"Galatasaray","Goztep","3-1",3,1,"T1",1,4,2,"H"
2017-12-24,2017,"Karabukspor","Trabzonspor","1-1",1,1,"T1",1,2,0,"D"
2017-12-24,2017,"Kasimpasa","Buyuksehyr","1-2",1,2,"T1",1,3,-1,"A"
2017-12-24,2017,"Kayserispor","Yeni Malatyaspor","0-1",0,1,"T1",1,1,-1,"A"
2017-12-25,2017,"Osmanlispor","Akhisar Belediyespor","3-2",3,2,"T1",1,5,1,"H"
2018-01-19,2017,"Kasimpasa","Alanyaspor","3-2",3,2,"T1",1,5,1,"H"
2018-01-20,2017,"Fenerbahce","Goztep","2-1",2,1,"T1",1,3,1,"H"
2018-01-20,2017,"Karabukspor","Genclerbirligi","0-2",0,2,"T1",1,2,-2,"A"
2018-01-20,2017,"Osmanlispor","Yeni Malatyaspor","0-0",0,0,"T1",1,0,0,"D"
2018-01-21,2017,"Antalyaspor","Besiktas","1-2",1,2,"T1",1,3,-1,"A"
2018-01-21,2017,"Bursaspor","Buyuksehyr","0-3",0,3,"T1",1,3,-3,"A"
2018-01-21,2017,"Konyaspor","Trabzonspor","2-2",2,2,"T1",1,4,0,"D"
2018-01-21,2017,"Sivasspor","Akhisar Belediyespor","1-1",1,1,"T1",1,2,0,"D"
2018-01-22,2017,"Kayserispor","Galatasaray","1-3",1,3,"T1",1,4,-2,"A"
2018-01-26,2017,"Besiktas","Kasimpasa","2-1",2,1,"T1",1,3,1,"H"
2018-01-26,2017,"Genclerbirligi","Konyaspor","2-1",2,1,"T1",1,3,1,"H"
2018-01-27,2017,"Alanyaspor","Bursaspor","3-1",3,1,"T1",1,4,2,"H"
2018-01-27,2017,"Galatasaray","Osmanlispor","2-0",2,0,"T1",1,2,2,"H"
2018-01-27,2017,"Goztep","Kayserispor","1-1",1,1,"T1",1,2,0,"D"
2018-01-28,2017,"Akhisar Belediyespor","Antalyaspor","1-1",1,1,"T1",1,2,0,"D"
2018-01-28,2017,"Trabzonspor","Fenerbahce","1-1",1,1,"T1",1,2,0,"D"
2018-01-28,2017,"Yeni Malatyaspor","Sivasspor","1-0",1,0,"T1",1,1,1,"H"
2018-01-29,2017,"Buyuksehyr","Karabukspor","5-0",5,0,"T1",1,5,5,"H"
2018-02-02,2017,"Bursaspor","Besiktas","2-2",2,2,"T1",1,4,0,"D"
2018-02-03,2017,"Antalyaspor","Yeni Malatyaspor","3-1",3,1,"T1",1,4,2,"H"
2018-02-03,2017,"Fenerbahce","Genclerbirligi","2-2",2,2,"T1",1,4,0,"D"
2018-02-03,2017,"Karabukspor","Alanyaspor","1-0",1,0,"T1",1,1,1,"H"
2018-02-04,2017,"Kasimpasa","Akhisar Belediyespor","2-0",2,0,"T1",1,2,2,"H"
2018-02-04,2017,"Konyaspor","Buyuksehyr","1-1",1,1,"T1",1,2,0,"D"
2018-02-04,2017,"Osmanlispor","Kayserispor","0-1",0,1,"T1",1,1,-1,"A"
2018-02-04,2017,"Sivasspor","Galatasaray","2-1",2,1,"T1",1,3,1,"H"
2018-02-05,2017,"Trabzonspor","Goztep","0-0",0,0,"T1",1,0,0,"D"
2018-02-09,2017,"Yeni Malatyaspor","Kasimpasa","1-1",1,1,"T1",1,2,0,"D"
2018-02-10,2017,"Besiktas","Karabukspor","5-0",5,0,"T1",1,5,5,"H"
2018-02-10,2017,"Genclerbirligi","Trabzonspor","0-0",0,0,"T1",1,0,0,"D"
2018-02-10,2017,"Goztep","Osmanlispor","3-3",3,3,"T1",1,6,0,"D"
2018-02-11,2017,"Akhisar Belediyespor","Bursaspor","1-0",1,0,"T1",1,1,1,"H"
2018-02-11,2017,"Alanyaspor","Konyaspor","1-2",1,2,"T1",1,3,-1,"A"
2018-02-11,2017,"Buyuksehyr","Fenerbahce","0-2",0,2,"T1",1,2,-2,"A"
2018-02-11,2017,"Kayserispor","Sivasspor","1-1",1,1,"T1",1,2,0,"D"
2018-02-12,2017,"Galatasaray","Antalyaspor","3-0",3,0,"T1",1,3,3,"H"
2018-02-16,2017,"Konyaspor","Besiktas","1-1",1,1,"T1",1,2,0,"D"
2018-02-17,2017,"Antalyaspor","Kayserispor","2-1",2,1,"T1",1,3,1,"H"
2018-02-17,2017,"Fenerbahce","Alanyaspor","3-0",3,0,"T1",1,3,3,"H"
2018-02-17,2017,"Sivasspor","Osmanlispor","3-2",3,2,"T1",1,5,1,"H"
2018-02-18,2017,"Bursaspor","Yeni Malatyaspor","0-0",0,0,"T1",1,0,0,"D"
2018-02-18,2017,"Karabukspor","Akhisar Belediyespor","0-3",0,3,"T1",1,3,-3,"A"
2018-02-18,2017,"Kasimpasa","Galatasaray","2-1",2,1,"T1",1,3,1,"H"
2018-02-18,2017,"Trabzonspor","Buyuksehyr","0-1",0,1,"T1",1,1,-1,"A"
2018-02-19,2017,"Genclerbirligi","Goztep","3-0",3,0,"T1",1,3,3,"H"
2018-02-23,2017,"Akhisar Belediyespor","Konyaspor","3-0",3,0,"T1",1,3,3,"H"
2018-02-23,2017,"Galatasaray","Bursaspor","5-0",5,0,"T1",1,5,5,"H"
2018-02-24,2017,"Alanyaspor","Trabzonspor","1-2",1,2,"T1",1,3,-1,"A"
2018-02-24,2017,"Kayserispor","Kasimpasa","3-2",3,2,"T1",1,5,1,"H"
2018-02-25,2017,"Besiktas","Fenerbahce","3-1",3,1,"T1",1,4,2,"H"
2018-02-25,2017,"Goztep","Sivasspor","1-0",1,0,"T1",1,1,1,"H"
2018-02-25,2017,"Osmanlispor","Antalyaspor","0-0",0,0,"T1",1,0,0,"D"
2018-02-25,2017,"Yeni Malatyaspor","Karabukspor","3-1",3,1,"T1",1,4,2,"H"
2018-02-26,2017,"Buyuksehyr","Genclerbirligi","1-1",1,1,"T1",1,2,0,"D"
2018-03-02,2017,"Bursaspor","Kayserispor","1-0",1,0,"T1",1,1,1,"H"
2018-03-03,2017,"Buyuksehyr","Goztep","2-0",2,0,"T1",1,2,2,"H"
2018-03-03,2017,"Karabukspor","Galatasaray","0-7",0,7,"T1",1,7,-7,"A"
2018-03-03,2017,"Kasimpasa","Osmanlispor","1-1",1,1,"T1",1,2,0,"D"
2018-03-04,2017,"Antalyaspor","Sivasspor","1-4",1,4,"T1",1,5,-3,"A"
2018-03-04,2017,"Fenerbahce","Akhisar Belediyespor","2-3",2,3,"T1",1,5,-1,"A"
2018-03-04,2017,"Genclerbirligi","Alanyaspor","0-1",0,1,"T1",1,1,-1,"A"
2018-03-04,2017,"Konyaspor","Yeni Malatyaspor","0-1",0,1,"T1",1,1,-1,"A"
2018-03-05,2017,"Trabzonspor","Besiktas","0-2",0,2,"T1",1,2,-2,"A"
2018-03-09,2017,"Alanyaspor","Buyuksehyr","4-1",4,1,"T1",1,5,3,"H"
2018-03-10,2017,"Besiktas","Genclerbirligi","1-0",1,0,"T1",1,1,1,"H"
2018-03-10,2017,"Osmanlispor","Bursaspor","2-1",2,1,"T1",1,3,1,"H"
2018-03-10,2017,"Sivasspor","Kasimpasa","2-2",2,2,"T1",1,4,0,"D"
2018-03-11,2017,"Galatasaray","Konyaspor","2-1",2,1,"T1",1,3,1,"H"
2018-03-11,2017,"Goztep","Antalyaspor","2-1",2,1,"T1",1,3,1,"H"
2018-03-11,2017,"Kayserispor","Karabukspor","3-2",3,2,"T1",1,5,1,"H"
2018-03-11,2017,"Yeni Malatyaspor","Fenerbahce","0-2",0,2,"T1",1,2,-2,"A"
2018-03-12,2017,"Akhisar Belediyespor","Trabzonspor","1-3",1,3,"T1",1,4,-2,"A"
2018-03-16,2017,"Karabukspor","Osmanlispor","0-4",0,4,"T1",1,4,-4,"A"
2018-03-16,2017,"Kasimpasa","Antalyaspor","2-3",2,3,"T1",1,5,-1,"A"
2018-03-17,2017,"Bursaspor","Sivasspor","1-0",1,0,"T1",1,1,1,"H"
2018-03-17,2017,"Fenerbahce","Galatasaray","0-0",0,0,"T1",1,0,0,"D"
2018-03-17,2017,"Genclerbirligi","Akhisar Belediyespor","1-1",1,1,"T1",1,2,0,"D"
2018-03-18,2017,"Alanyaspor","Goztep","1-1",1,1,"T1",1,2,0,"D"
2018-03-18,2017,"Buyuksehyr","Besiktas","1-0",1,0,"T1",1,1,1,"H"
2018-03-18,2017,"Konyaspor","Kayserispor","2-0",2,0,"T1",1,2,2,"H"
2018-03-18,2017,"Trabzonspor","Yeni Malatyaspor","4-1",4,1,"T1",1,5,3,"H"
2018-03-30,2017,"Sivasspor","Karabukspor","1-0",1,0,"T1",1,1,1,"H"
2018-03-31,2017,"Antalyaspor","Bursaspor","2-0",2,0,"T1",1,2,2,"H"
2018-03-31,2017,"Besiktas","Alanyaspor","1-0",1,0,"T1",1,1,1,"H"
2018-03-31,2017,"Yeni Malatyaspor","Genclerbirligi","4-1",4,1,"T1",1,5,3,"H"
2018-04-01,2017,"Akhisar Belediyespor","Buyuksehyr","1-2",1,2,"T1",1,3,-1,"A"
2018-04-01,2017,"Galatasaray","Trabzonspor","2-1",2,1,"T1",1,3,1,"H"
2018-04-01,2017,"Goztep","Kasimpasa","0-2",0,2,"T1",1,2,-2,"A"
2018-04-01,2017,"Osmanlispor","Konyaspor","0-0",0,0,"T1",1,0,0,"D"
2018-04-02,2017,"Kayserispor","Fenerbahce","0-5",0,5,"T1",1,5,-5,"A"
2018-04-06,2017,"Buyuksehyr","Yeni Malatyaspor","1-0",1,0,"T1",1,1,1,"H"
2018-04-07,2017,"Besiktas","Goztep","5-1",5,1,"T1",1,6,4,"H"
2018-04-07,2017,"Karabukspor","Antalyaspor","1-2",1,2,"T1",1,3,-1,"A"
2018-04-07,2017,"Trabzonspor","Kayserispor","4-0",4,0,"T1",1,4,4,"H"
2018-04-08,2017,"Alanyaspor","Akhisar Belediyespor","3-1",3,1,"T1",1,4,2,"H"
2018-04-08,2017,"Bursaspor","Kasimpasa","0-1",0,1,"T1",1,1,-1,"A"
2018-04-08,2017,"Fenerbahce","Osmanlispor","2-0",2,0,"T1",1,2,2,"H"
2018-04-08,2017,"Konyaspor","Sivasspor","5-0",5,0,"T1",1,5,5,"H"
2018-04-09,2017,"Genclerbirligi","Galatasaray","1-0",1,0,"T1",1,1,1,"H"
2018-04-13,2017,"Akhisar Belediyespor","Besiktas","0-3",0,3,"T1",1,3,-3,"A"
2018-04-14,2017,"Kasimpasa","Karabukspor","2-0",2,0,"T1",1,2,2,"H"
2018-04-14,2017,"Sivasspor","Fenerbahce","1-2",1,2,"T1",1,3,-1,"A"
2018-04-14,2017,"Yeni Malatyaspor","Alanyaspor","1-1",1,1,"T1",1,2,0,"D"
2018-04-15,2017,"Antalyaspor","Konyaspor","0-0",0,0,"T1",1,0,0,"D"
2018-04-15,2017,"Galatasaray","Buyuksehyr","2-0",2,0,"T1",1,2,2,"H"
2018-04-15,2017,"Goztep","Bursaspor","2-1",2,1,"T1",1,3,1,"H"
2018-04-15,2017,"Kayserispor","Genclerbirligi","3-2",3,2,"T1",1,5,1,"H"
2018-04-16,2017,"Osmanlispor","Trabzonspor","3-3",3,3,"T1",1,6,0,"D"
2018-04-20,2017,"Buyuksehyr","Kayserispor","3-1",3,1,"T1",1,4,2,"H"
2018-04-21,2017,"Alanyaspor","Galatasaray","2-3",2,3,"T1",1,5,-1,"A"
2018-04-21,2017,"Genclerbirligi","Osmanlispor","0-3",0,3,"T1",1,3,-3,"A"
2018-04-21,2017,"Karabukspor","Bursaspor","1-4",1,4,"T1",1,5,-3,"A"
2018-04-21,2017,"Trabzonspor","Sivasspor","0-2",0,2,"T1",1,2,-2,"A"
2018-04-22,2017,"Akhisar Belediyespor","Goztep","1-1",1,1,"T1",1,2,0,"D"
2018-04-22,2017,"Besiktas","Yeni Malatyaspor","3-1",3,1,"T1",1,4,2,"H"
2018-04-22,2017,"Konyaspor","Kasimpasa","2-0",2,0,"T1",1,2,2,"H"
2018-04-23,2017,"Fenerbahce","Antalyaspor","4-1",4,1,"T1",1,5,3,"H"
2018-04-27,2017,"Goztep","Karabukspor","5-0",5,0,"T1",1,5,5,"H"
2018-04-28,2017,"Antalyaspor","Trabzonspor","1-2",1,2,"T1",1,3,-1,"A"
2018-04-28,2017,"Kasimpasa","Fenerbahce","1-4",1,4,"T1",1,5,-3,"A"
2018-04-28,2017,"Kayserispor","Alanyaspor","1-2",1,2,"T1",1,3,-1,"A"
2018-04-28,2017,"Sivasspor","Genclerbirligi","1-0",1,0,"T1",1,1,1,"H"
2018-04-29,2017,"Galatasaray","Besiktas","2-0",2,0,"T1",1,2,2,"H"
2018-04-29,2017,"Osmanlispor","Buyuksehyr","1-4",1,4,"T1",1,5,-3,"A"
2018-04-29,2017,"Yeni Malatyaspor","Akhisar Belediyespor","0-0",0,0,"T1",1,0,0,"D"
2018-04-30,2017,"Bursaspor","Konyaspor","2-1",2,1,"T1",1,3,1,"H"
2018-05-04,2017,"Buyuksehyr","Sivasspor","1-1",1,1,"T1",1,2,0,"D"
2018-05-05,2017,"Alanyaspor","Osmanlispor","1-1",1,1,"T1",1,2,0,"D"
2018-05-05,2017,"Karabukspor","Konyaspor","0-1",0,1,"T1",1,1,-1,"A"
2018-05-05,2017,"Trabzonspor","Kasimpasa","2-5",2,5,"T1",1,7,-3,"A"
2018-05-06,2017,"Akhisar Belediyespor","Galatasaray","1-2",1,2,"T1",1,3,-1,"A"
2018-05-06,2017,"Fenerbahce","Bursaspor","2-1",2,1,"T1",1,3,1,"H"
2018-05-06,2017,"Genclerbirligi","Antalyaspor","0-1",0,1,"T1",1,1,-1,"A"
2018-05-07,2017,"Besiktas","Kayserispor","2-0",2,0,"T1",1,2,2,"H"
2018-05-07,2017,"Goztep","Yeni Malatyaspor","0-0",0,0,"T1",1,0,0,"D"
2018-05-11,2017,"Antalyaspor","Buyuksehyr","0-2",0,2,"T1",1,2,-2,"A"
2018-05-12,2017,"Galatasaray","Yeni Malatyaspor","2-0",2,0,"T1",1,2,2,"H"
2018-05-12,2017,"Kasimpasa","Genclerbirligi","3-1",3,1,"T1",1,4,2,"H"
2018-05-12,2017,"Konyaspor","Goztep","1-1",1,1,"T1",1,2,0,"D"
2018-05-13,2017,"Bursaspor","Trabzonspor","1-3",1,3,"T1",1,4,-2,"A"
2018-05-13,2017,"Osmanlispor","Besiktas","2-3",2,3,"T1",1,5,-1,"A"
2018-05-13,2017,"Sivasspor","Alanyaspor","2-2",2,2,"T1",1,4,0,"D"
2018-05-14,2017,"Karabukspor","Fenerbahce","0-7",0,7,"T1",1,7,-7,"A"
2018-05-14,2017,"Kayserispor","Akhisar Belediyespor","1-2",1,2,"T1",1,3,-1,"A"
2018-05-18,2017,"Akhisar Belediyespor","Osmanlispor","2-1",2,1,"T1",1,3,1,"H"
2018-05-18,2017,"Alanyaspor","Antalyaspor","3-2",3,2,"T1",1,5,1,"H"
2018-05-18,2017,"Genclerbirligi","Bursaspor","1-0",1,0,"T1",1,1,1,"H"
2018-05-18,2017,"Trabzonspor","Karabukspor","3-0",3,0,"T1",1,3,3,"H"
2018-05-18,2017,"Yeni Malatyaspor","Kayserispor","3-2",3,2,"T1",1,5,1,"H"
2018-05-19,2017,"Besiktas","Sivasspor","5-1",5,1,"T1",1,6,4,"H"
2018-05-19,2017,"Buyuksehyr","Kasimpasa","3-2",3,2,"T1",1,5,1,"H"
2018-05-19,2017,"Fenerbahce","Konyaspor","3-2",3,2,"T1",1,5,1,"H"
2018-05-19,2017,"Goztep","Galatasaray","0-1",0,1,"T1",1,1,-1,"A"
2018-08-10,2018,"Ankaragucu","Galatasaray","1-3",1,3,"T1",1,4,-2,"A"
2018-08-11,2018,"Fenerbahce","Bursaspor","2-1",2,1,"T1",1,3,1,"H"
2018-08-11,2018,"Rizespor","Kasimpasa","2-3",2,3,"T1",1,5,-1,"A"
2018-08-11,2018,"Sivasspor","Alanyaspor","1-0",1,0,"T1",1,1,1,"H"
2018-08-12,2018,"Besiktas","Akhisar Belediyespor","2-1",2,1,"T1",1,3,1,"H"
2018-08-12,2018,"Buyuksehyr","Trabzonspor","2-0",2,0,"T1",1,2,2,"H"
2018-08-12,2018,"Goztep","Yeni Malatyaspor","1-3",1,3,"T1",1,4,-2,"A"
2018-08-12,2018,"Konyaspor","Erzurum","3-2",3,2,"T1",1,5,1,"H"
2018-08-13,2018,"Kayserispor","Antalyaspor","2-0",2,0,"T1",1,2,2,"H"
2018-08-17,2018,"Trabzonspor","Sivasspor","3-1",3,1,"T1",1,4,2,"H"
2018-08-18,2018,"Antalyaspor","Konyaspor","3-3",3,3,"T1",1,6,0,"D"
2018-08-18,2018,"Bursaspor","Kayserispor","0-0",0,0,"T1",1,0,0,"D"
2018-08-18,2018,"Yeni Malatyaspor","Fenerbahce","1-0",1,0,"T1",1,1,1,"H"
2018-08-19,2018,"Akhisar Belediyespor","Rizespor","1-1",1,1,"T1",1,2,0,"D"
2018-08-19,2018,"Alanyaspor","Ankaragucu","0-2",0,2,"T1",1,2,-2,"A"
2018-08-19,2018,"Erzurum","Besiktas","1-3",1,3,"T1",1,4,-2,"A"
2018-08-19,2018,"Galatasaray","Goztep","1-0",1,0,"T1",1,1,1,"H"
2018-08-20,2018,"Kasimpasa","Buyuksehyr","2-1",2,1,"T1",1,3,1,"H"
2018-08-24,2018,"Rizespor","Erzurum","0-0",0,0,"T1",1,0,0,"D"
2018-08-25,2018,"Ankaragucu","Trabzonspor","2-2",2,2,"T1",1,4,0,"D"
2018-08-25,2018,"Goztep","Fenerbahce","1-0",1,0,"T1",1,1,1,"H"
2018-08-25,2018,"Kayserispor","Yeni Malatyaspor","0-0",0,0,"T1",1,0,0,"D"
2018-08-26,2018,"Besiktas","Antalyaspor","2-3",2,3,"T1",1,5,-1,"A"
2018-08-26,2018,"Konyaspor","Bursaspor","1-1",1,1,"T1",1,2,0,"D"
2018-08-26,2018,"Sivasspor","Kasimpasa","0-3",0,3,"T1",1,3,-3,"A"
2018-08-27,2018,"Buyuksehyr","Akhisar Belediyespor","3-1",3,1,"T1",1,4,2,"H"
2018-08-27,2018,"Galatasaray","Alanyaspor","6-0",6,0,"T1",1,6,6,"H"
2018-08-31,2018,"Yeni Malatyaspor","Konyaspor","0-1",0,1,"T1",1,1,-1,"A"
2018-09-01,2018,"Akhisar Belediyespor","Sivasspor","1-1",1,1,"T1",1,2,0,"D"
2018-09-01,2018,"Alanyaspor","Goztep","1-0",1,0,"T1",1,1,1,"H"
2018-09-01,2018,"Fenerbahce","Kayserispor","2-3",2,3,"T1",1,5,-1,"A"
2018-09-01,2018,"Trabzonspor","Galatasaray","4-0",4,0,"T1",1,4,4,"H"
2018-09-02,2018,"Antalyaspor","Rizespor","2-1",2,1,"T1",1,3,1,"H"
2018-09-02,2018,"Bursaspor","Besiktas","1-1",1,1,"T1",1,2,0,"D"
2018-09-02,2018,"Erzurum","Buyuksehyr","0-1",0,1,"T1",1,1,-1,"A"
2018-09-02,2018,"Kasimpasa","Ankaragucu","2-1",2,1,"T1",1,3,1,"H"
2018-09-14,2018,"Galatasaray","Kasimpasa","4-1",4,1,"T1",1,5,3,"H"
2018-09-15,2018,"Ankaragucu","Akhisar Belediyespor","1-0",1,0,"T1",1,1,1,"H"
2018-09-15,2018,"Besiktas","Yeni Malatyaspor","2-1",2,1,"T1",1,3,1,"H"
2018-09-15,2018,"Goztep","Kayserispor","2-0",2,0,"T1",1,2,2,"H"
2018-09-16,2018,"Buyuksehyr","Antalyaspor","4-0",4,0,"T1",1,4,4,"H"
2018-09-16,2018,"Konyaspor","Fenerbahce","0-1",0,1,"T1",1,1,-1,"A"
2018-09-16,2018,"Rizespor","Bursaspor","1-1",1,1,"T1",1,2,0,"D"
2018-09-16,2018,"Sivasspor","Erzurum","2-2",2,2,"T1",1,4,0,"D"
2018-09-17,2018,"Alanyaspor","Trabzonspor","1-0",1,0,"T1",1,1,1,"H"
2018-09-21,2018,"Bursaspor","Buyuksehyr","0-0",0,0,"T1",1,0,0,"D"
2018-09-21,2018,"Erzurum","Ankaragucu","0-1",0,1,"T1",1,1,-1,"A"
2018-09-22,2018,"Kayserispor","Konyaspor","0-2",0,2,"T1",1,2,-2,"A"
2018-09-22,2018,"Trabzonspor","Goztep","1-2",1,2,"T1",1,3,-1,"A"
2018-09-22,2018,"Yeni Malatyaspor","Rizespor","1-0",1,0,"T1",1,1,1,"H"
2018-09-23,2018,"Akhisar Belediyespor","Galatasaray","3-0",3,0,"T1",1,3,3,"H"
2018-09-23,2018,"Antalyaspor","Sivasspor","2-1",2,1,"T1",1,3,1,"H"
2018-09-23,2018,"Kasimpasa","Alanyaspor","1-2",1,2,"T1",1,3,-1,"A"
2018-09-24,2018,"Fenerbahce","Besiktas","1-1",1,1,"T1",1,2,0,"D"
2018-09-28,2018,"Galatasaray","Erzurum","1-0",1,0,"T1",1,1,1,"H"
2018-09-29,2018,"Alanyaspor","Akhisar Belediyespor","2-1",2,1,"T1",1,3,1,"H"
2018-09-29,2018,"Besiktas","Kayserispor","2-0",2,0,"T1",1,2,2,"H"
2018-09-29,2018,"Trabzonspor","Kasimpasa","4-2",4,2,"T1",1,6,2,"H"
2018-09-30,2018,"Goztep","Konyaspor","3-2",3,2,"T1",1,5,1,"H"
2018-09-30,2018,"Rizespor","Fenerbahce","3-0",3,0,"T1",1,3,3,"H"
2018-09-30,2018,"Sivasspor","Bursaspor","2-0",2,0,"T1",1,2,2,"H"
2018-10-01,2018,"Ankaragucu","Antalyaspor","0-1",0,1,"T1",1,1,-1,"A"
2018-10-01,2018,"Buyuksehyr","Yeni Malatyaspor","1-1",1,1,"T1",1,2,0,"D"
2018-10-05,2018,"Kasimpasa","Goztep","3-1",3,1,"T1",1,4,2,"H"
2018-10-06,2018,"Antalyaspor","Galatasaray","0-1",0,1,"T1",1,1,-1,"A"
2018-10-06,2018,"Bursaspor","Ankaragucu","1-0",1,0,"T1",1,1,1,"H"
2018-10-06,2018,"Erzurum","Alanyaspor","1-0",1,0,"T1",1,1,1,"H"
2018-10-06,2018,"Kayserispor","Rizespor","2-2",2,2,"T1",1,4,0,"D"
2018-10-07,2018,"Akhisar Belediyespor","Trabzonspor","1-3",1,3,"T1",1,4,-2,"A"
2018-10-07,2018,"Fenerbahce","Buyuksehyr","0-0",0,0,"T1",1,0,0,"D"
2018-10-07,2018,"Konyaspor","Besiktas","2-2",2,2,"T1",1,4,0,"D"
2018-10-07,2018,"Yeni Malatyaspor","Sivasspor","4-4",4,4,"T1",1,8,0,"D"
2018-10-19,2018,"Galatasaray","Bursaspor","1-1",1,1,"T1",1,2,0,"D"
2018-10-20,2018,"Buyuksehyr","Kayserispor","1-0",1,0,"T1",1,1,1,"H"
2018-10-20,2018,"Kasimpasa","Akhisar Belediyespor","5-0",5,0,"T1",1,5,5,"H"
2018-10-20,2018,"Sivasspor","Fenerbahce","0-0",0,0,"T1",1,0,0,"D"
2018-10-21,2018,"Alanyaspor","Antalyaspor","0-1",0,1,"T1",1,1,-1,"A"
2018-10-21,2018,"Ankaragucu","Yeni Malatyaspor","1-0",1,0,"T1",1,1,1,"H"
2018-10-21,2018,"Goztep","Besiktas","2-0",2,0,"T1",1,2,2,"H"
2018-10-21,2018,"Rizespor","Konyaspor","1-1",1,1,"T1",1,2,0,"D"
2018-10-22,2018,"Trabzonspor","Erzurum","0-0",0,0,"T1",1,0,0,"D"
2018-10-26,2018,"Bursaspor","Alanyaspor","2-0",2,0,"T1",1,2,2,"H"
2018-10-27,2018,"Antalyaspor","Trabzonspor","1-1",1,1,"T1",1,2,0,"D"
2018-10-27,2018,"Erzurum","Kasimpasa","1-1",1,1,"T1",1,2,0,"D"
2018-10-27,2018,"Konyaspor","Buyuksehyr","0-1",0,1,"T1",1,1,-1,"A"
2018-10-28,2018,"Fenerbahce","Ankaragucu","1-3",1,3,"T1",1,4,-2,"A"
2018-10-28,2018,"Kayserispor","Sivasspor","2-0",2,0,"T1",1,2,2,"H"
2018-10-28,2018,"Yeni Malatyaspor","Galatasaray","2-0",2,0,"T1",1,2,2,"H"
2018-10-29,2018,"Akhisar Belediyespor","Goztep","1-0",1,0,"T1",1,1,1,"H"
2018-10-29,2018,"Besiktas","Rizespor","4-1",4,1,"T1",1,5,3,"H"
2018-11-02,2018,"Galatasaray","Fenerbahce","2-2",2,2,"T1",1,4,0,"D"
2018-11-03,2018,"Akhisar Belediyespor","Erzurum","1-1",1,1,"T1",1,2,0,"D"
2018-11-03,2018,"Buyuksehyr","Besiktas","1-0",1,0,"T1",1,1,1,"H"
2018-11-03,2018,"Kasimpasa","Antalyaspor","1-2",1,2,"T1",1,3,-1,"A"
2018-11-04,2018,"Alanyaspor","Yeni Malatyaspor","0-1",0,1,"T1",1,1,-1,"A"
2018-11-04,2018,"Ankaragucu","Kayserispor","3-1",3,1,"T1",1,4,2,"H"
2018-11-04,2018,"Trabzonspor","Bursaspor","1-1",1,1,"T1",1,2,0,"D"
2018-11-05,2018,"Goztep","Rizespor","2-0",2,0,"T1",1,2,2,"H"
2018-11-05,2018,"Sivasspor","Konyaspor","0-0",0,0,"T1",1,0,0,"D"
2018-11-09,2018,"Yeni Malatyaspor","Trabzonspor","5-0",5,0,"T1",1,5,5,"H"
2018-11-10,2018,"Erzurum","Goztep","2-1",2,1,"T1",1,3,1,"H"
2018-11-10,2018,"Kayserispor","Galatasaray","0-3",0,3,"T1",1,3,-3,"A"
2018-11-10,2018,"Konyaspor","Ankaragucu","2-0",2,0,"T1",1,2,2,"H"
2018-11-10,2018,"Rizespor","Buyuksehyr","1-2",1,2,"T1",1,3,-1,"A"
2018-11-11,2018,"Antalyaspor","Akhisar Belediyespor","1-2",1,2,"T1",1,3,-1,"A"
2018-11-11,2018,"Besiktas","Sivasspor","1-2",1,2,"T1",1,3,-1,"A"
2018-11-11,2018,"Bursaspor","Kasimpasa","1-2",1,2,"T1",1,3,-1,"A"
2018-11-11,2018,"Fenerbahce","Alanyaspor","2-0",2,0,"T1",1,2,2,"H"
2018-11-23,2018,"Galatasaray","Konyaspor","1-1",1,1,"T1",1,2,0,"D"
2018-11-24,2018,"Alanyaspor","Kayserispor","5-0",5,0,"T1",1,5,5,"H"
2018-11-24,2018,"Ankaragucu","Besiktas","1-4",1,4,"T1",1,5,-3,"A"
2018-11-24,2018,"Erzurum","Antalyaspor","1-0",1,0,"T1",1,1,1,"H"
2018-11-25,2018,"Akhisar Belediyespor","Bursaspor","2-4",2,4,"T1",1,6,-2,"A"
2018-11-25,2018,"Kasimpasa","Yeni Malatyaspor","3-0",3,0,"T1",1,3,3,"H"
2018-11-25,2018,"Sivasspor","Rizespor","1-1",1,1,"T1",1,2,0,"D"
2018-11-25,2018,"Trabzonspor","Fenerbahce","2-1",2,1,"T1",1,3,1,"H"
2018-11-26,2018,"Goztep","Buyuksehyr","0-2",0,2,"T1",1,2,-2,"A"
2018-11-30,2018,"Konyaspor","Alanyaspor","2-0",2,0,"T1",1,2,2,"H"
2018-11-30,2018,"Rizespor","Ankaragucu","1-1",1,1,"T1",1,2,0,"D"
2018-12-01,2018,"Antalyaspor","Goztep","1-0",1,0,"T1",1,1,1,"H"
2018-12-01,2018,"Buyuksehyr","Sivasspor","0-1",0,1,"T1",1,1,-1,"A"
2018-12-01,2018,"Kayserispor","Trabzonspor","0-2",0,2,"T1",1,2,-2,"A"
2018-12-02,2018,"Besiktas","Galatasaray","1-0",1,0,"T1",1,1,1,"H"
2018-12-02,2018,"Bursaspor","Erzurum","2-1",2,1,"T1",1,3,1,"H"
2018-12-03,2018,"Fenerbahce","Kasimpasa","2-2",2,2,"T1",1,4,0,"D"
2018-12-03,2018,"Yeni Malatyaspor","Akhisar Belediyespor","1-1",1,1,"T1",1,2,0,"D"
2018-12-07,2018,"Alanyaspor","Besiktas","0-0",0,0,"T1",1,0,0,"D"
2018-12-08,2018,"Galatasaray","Rizespor","2-2",2,2,"T1",1,4,0,"D"
2018-12-08,2018,"Sivasspor","Goztep","2-0",2,0,"T1",1,2,2,"H"
2018-12-08,2018,"Trabzonspor","Konyaspor","3-0",3,0,"T1",1,3,3,"H"
2018-12-09,2018,"Akhisar Belediyespor","Fenerbahce","3-0",3,0,"T1",1,3,3,"H"
2018-12-09,2018,"Bursaspor","Antalyaspor","0-2",0,2,"T1",1,2,-2,"A"
2018-12-09,2018,"Erzurum","Yeni Malatyaspor","1-3",1,3,"T1",1,4,-2,"A"
2018-12-10,2018,"Ankaragucu","Buyuksehyr","0-1",0,1,"T1",1,1,-1,"A"
2018-12-10,2018,"Kasimpasa","Kayserispor","0-3",0,3,"T1",1,3,-3,"A"
2018-12-14,2018,"Goztep","Bursaspor","0-0",0,0,"T1",1,0,0,"D"
2018-12-15,2018,"Buyuksehyr","Galatasaray","1-1",1,1,"T1",1,2,0,"D"
2018-12-15,2018,"Konyaspor","Kasimpasa","3-2",3,2,"T1",1,5,1,"H"
2018-12-15,2018,"Rizespor","Alanyaspor","1-1",1,1,"T1",1,2,0,"D"
2018-12-15,2018,"Sivasspor","Ankaragucu","4-0",4,0,"T1",1,4,4,"H"
2018-12-16,2018,"Besiktas","Trabzonspor","2-2",2,2,"T1",1,4,0,"D"
2018-12-16,2018,"Kayserispor","Akhisar Belediyespor","1-0",1,0,"T1",1,1,1,"H"
2018-12-16,2018,"Yeni Malatyaspor","Antalyaspor","2-0",2,0,"T1",1,2,2,"H"
2018-12-17,2018,"Fenerbahce","Erzurum","2-2",2,2,"T1",1,4,0,"D"
2018-12-22,2018,"Alanyaspor","Buyuksehyr","1-1",1,1,"T1",1,2,0,"D"
2018-12-22,2018,"Ankaragucu","Goztep","0-3",0,3,"T1",1,3,-3,"A"
2018-12-22,2018,"Kasimpasa","Besiktas","4-1",4,1,"T1",1,5,3,"H"
2018-12-23,2018,"Bursaspor","Yeni Malatyaspor","1-1",1,1,"T1",1,2,0,"D"
2018-12-23,2018,"Erzurum","Kayserispor","1-1",1,1,"T1",1,2,0,"D"
2018-12-23,2018,"Galatasaray","Sivasspor","4-2",4,2,"T1",1,6,2,"H"
2018-12-23,2018,"Trabzonspor","Rizespor","4-1",4,1,"T1",1,5,3,"H"
2018-12-24,2018,"Akhisar Belediyespor","Konyaspor","0-0",0,0,"T1",1,0,0,"D"
2018-12-24,2018,"Antalyaspor","Fenerbahce","0-0",0,0,"T1",1,0,0,"D"
2019-01-18,2018,"Akhisar Belediyespor","Besiktas","1-3",1,3,"T1",1,4,-2,"A"
2019-01-19,2018,"Antalyaspor","Kayserispor","0-0",0,0,"T1",1,0,0,"D"
2019-01-19,2018,"Erzurum","Konyaspor","1-2",1,2,"T1",1,3,-1,"A"
2019-01-19,2018,"Galatasaray","Ankaragucu","6-0",6,0,"T1",1,6,6,"H"
2019-01-19,2018,"Yeni Malatyaspor","Goztep","3-2",3,2,"T1",1,5,1,"H"
2019-01-20,2018,"Alanyaspor","Sivasspor","2-0",2,0,"T1",1,2,2,"H"
2019-01-20,2018,"Trabzonspor","Buyuksehyr","2-4",2,4,"T1",1,6,-2,"A"
2019-01-21,2018,"Bursaspor","Fenerbahce","1-1",1,1,"T1",1,2,0,"D"
2019-01-21,2018,"Kasimpasa","Rizespor","0-1",0,1,"T1",1,1,-1,"A"
2019-01-25,2018,"Besiktas","Erzurum","1-1",1,1,"T1",1,2,0,"D"
2019-01-26,2018,"Goztep","Galatasaray","0-1",0,1,"T1",1,1,-1,"A"
2019-01-26,2018,"Kayserispor","Bursaspor","1-1",1,1,"T1",1,2,0,"D"
2019-01-27,2018,"Konyaspor","Antalyaspor","2-0",2,0,"T1",1,2,2,"H"
2019-01-27,2018,"Rizespor","Akhisar Belediyespor","3-1",3,1,"T1",1,4,2,"H"
2019-01-27,2018,"Sivasspor","Trabzonspor","1-1",1,1,"T1",1,2,0,"D"
2019-01-28,2018,"Ankaragucu","Alanyaspor","0-2",0,2,"T1",1,2,-2,"A"
2019-01-28,2018,"Buyuksehyr","Kasimpasa","2-0",2,0,"T1",1,2,2,"H"
2019-01-28,2018,"Fenerbahce","Yeni Malatyaspor","3-2",3,2,"T1",1,5,1,"H"
2019-02-01,2018,"Fenerbahce","Goztep","2-0",2,0,"T1",1,2,2,"H"
2019-02-02,2018,"Alanyaspor","Galatasaray","1-1",1,1,"T1",1,2,0,"D"
2019-02-02,2018,"Kasimpasa","Sivasspor","1-3",1,3,"T1",1,4,-2,"A"
2019-02-02,2018,"Trabzonspor","Ankaragucu","1-0",1,0,"T1",1,1,1,"H"
2019-02-02,2018,"Yeni Malatyaspor","Kayserispor","1-1",1,1,"T1",1,2,0,"D"
2019-02-03,2018,"Akhisar Belediyespor","Buyuksehyr","0-3",0,3,"T1",1,3,-3,"A"
2019-02-03,2018,"Antalyaspor","Besiktas","2-6",2,6,"T1",1,8,-4,"A"
2019-02-03,2018,"Erzurum","Rizespor","0-1",0,1,"T1",1,1,-1,"A"
2019-02-04,2018,"Bursaspor","Konyaspor","0-0",0,0,"T1",1,0,0,"D"
2019-02-08,2018,"Kayserispor","Fenerbahce","1-0",1,0,"T1",1,1,1,"H"
2019-02-09,2018,"Besiktas","Bursaspor","2-0",2,0,"T1",1,2,2,"H"
2019-02-09,2018,"Buyuksehyr","Erzurum","1-1",1,1,"T1",1,2,0,"D"
2019-02-09,2018,"Rizespor","Antalyaspor","1-1",1,1,"T1",1,2,0,"D"
2019-02-10,2018,"Galatasaray","Trabzonspor","3-1",3,1,"T1",1,4,2,"H"
2019-02-10,2018,"Goztep","Alanyaspor","3-2",3,2,"T1",1,5,1,"H"
2019-02-10,2018,"Konyaspor","Yeni Malatyaspor","1-1",1,1,"T1",1,2,0,"D"
2019-02-11,2018,"Ankaragucu","Kasimpasa","3-0",3,0,"T1",1,3,3,"H"
2019-02-11,2018,"Sivasspor","Akhisar Belediyespor","2-1",2,1,"T1",1,3,1,"H"
2019-02-15,2018,"Yeni Malatyaspor","Besiktas","1-2",1,2,"T1",1,3,-1,"A"
2019-02-16,2018,"Akhisar Belediyespor","Ankaragucu","0-0",0,0,"T1",1,0,0,"D"
2019-02-16,2018,"Bursaspor","Rizespor","0-2",0,2,"T1",1,2,-2,"A"
2019-02-16,2018,"Fenerbahce","Konyaspor","1-1",1,1,"T1",1,2,0,"D"
2019-02-17,2018,"Erzurum","Sivasspor","4-2",4,2,"T1",1,6,2,"H"
2019-02-17,2018,"Kasimpasa","Galatasaray","1-4",1,4,"T1",1,5,-3,"A"
2019-02-17,2018,"Kayserispor","Goztep","2-1",2,1,"T1",1,3,1,"H"
2019-02-17,2018,"Trabzonspor","Alanyaspor","0-2",0,2,"T1",1,2,-2,"A"
2019-02-18,2018,"Antalyaspor","Buyuksehyr","0-1",0,1,"T1",1,1,-1,"A"
2019-02-22,2018,"Goztep","Trabzonspor","1-3",1,3,"T1",1,4,-2,"A"
2019-02-22,2018,"Rizespor","Yeni Malatyaspor","3-0",3,0,"T1",1,3,3,"H"
2019-02-23,2018,"Alanyaspor","Kasimpasa","3-0",3,0,"T1",1,3,3,"H"
2019-02-23,2018,"Buyuksehyr","Bursaspor","3-0",3,0,"T1",1,3,3,"H"
2019-02-23,2018,"Sivasspor","Antalyaspor","1-2",1,2,"T1",1,3,-1,"A"
2019-02-24,2018,"Ankaragucu","Erzurum","2-1",2,1,"T1",1,3,1,"H"
2019-02-24,2018,"Galatasaray","Akhisar Belediyespor","1-0",1,0,"T1",1,1,1,"H"
2019-02-24,2018,"Konyaspor","Kayserispor","0-1",0,1,"T1",1,1,-1,"A"
2019-02-25,2018,"Besiktas","Fenerbahce","3-3",3,3,"T1",1,6,0,"D"
2019-03-01,2018,"Antalyaspor","Ankaragucu","2-4",2,4,"T1",1,6,-2,"A"
2019-03-02,2018,"Bursaspor","Sivasspor","3-2",3,2,"T1",1,5,1,"H"
2019-03-02,2018,"Fenerbahce","Rizespor","3-2",3,2,"T1",1,5,1,"H"
2019-03-02,2018,"Kayserispor","Besiktas","2-2",2,2,"T1",1,4,0,"D"
2019-03-03,2018,"Erzurum","Galatasaray","1-1",1,1,"T1",1,2,0,"D"
2019-03-03,2018,"Konyaspor","Goztep","1-1",1,1,"T1",1,2,0,"D"
2019-03-03,2018,"Yeni Malatyaspor","Buyuksehyr","0-2",0,2,"T1",1,2,-2,"A"
2019-03-04,2018,"Akhisar Belediyespor","Alanyaspor","3-1",3,1,"T1",1,4,2,"H"
2019-03-04,2018,"Kasimpasa","Trabzonspor","2-2",2,2,"T1",1,4,0,"D"
2019-03-08,2018,"Sivasspor","Yeni Malatyaspor","2-0",2,0,"T1",1,2,2,"H"
2019-03-09,2018,"Ankaragucu","Bursaspor","0-0",0,0,"T1",1,0,0,"D"
2019-03-09,2018,"Buyuksehyr","Fenerbahce","2-1",2,1,"T1",1,3,1,"H"
2019-03-09,2018,"Trabzonspor","Akhisar Belediyespor","2-1",2,1,"T1",1,3,1,"H"
2019-03-10,2018,"Alanyaspor","Erzurum","2-1",2,1,"T1",1,3,1,"H"
2019-03-10,2018,"Besiktas","Konyaspor","3-2",3,2,"T1",1,5,1,"H"
2019-03-10,2018,"Goztep","Kasimpasa","0-0",0,0,"T1",1,0,0,"D"
2019-03-10,2018,"Rizespor","Kayserispor","3-0",3,0,"T1",1,3,3,"H"
2019-03-11,2018,"Galatasaray","Antalyaspor","5-0",5,0,"T1",1,5,5,"H"
2019-03-15,2018,"Fenerbahce","Sivasspor","2-1",2,1,"T1",1,3,1,"H"
2019-03-16,2018,"Akhisar Belediyespor","Kasimpasa","2-3",2,3,"T1",1,5,-1,"A"
2019-03-16,2018,"Antalyaspor","Alanyaspor","3-0",3,0,"T1",1,3,3,"H"
2019-03-16,2018,"Besiktas","Goztep","1-0",1,0,"T1",1,1,1,"H"
2019-03-16,2018,"Erzurum","Trabzonspor","0-1",0,1,"T1",1,1,-1,"A"
2019-03-16,2018,"Konyaspor","Rizespor","0-2",0,2,"T1",1,2,-2,"A"
2019-03-17,2018,"Bursaspor","Galatasaray","2-3",2,3,"T1",1,5,-1,"A"
2019-03-17,2018,"Kayserispor","Buyuksehyr","1-1",1,1,"T1",1,2,0,"D"
2019-03-17,2018,"Yeni Malatyaspor","Ankaragucu","3-1",3,1,"T1",1,4,2,"H"
2019-04-05,2018,"Trabzonspor","Antalyaspor","4-1",4,1,"T1",1,5,3,"H"
2019-04-06,2018,"Alanyaspor","Bursaspor","1-0",1,0,"T1",1,1,1,"H"
2019-04-06,2018,"Galatasaray","Yeni Malatyaspor","3-0",3,0,"T1",1,3,3,"H"
2019-04-06,2018,"Sivasspor","Kayserispor","1-3",1,3,"T1",1,4,-2,"A"
2019-04-07,2018,"Ankaragucu","Fenerbahce","1-1",1,1,"T1",1,2,0,"D"
2019-04-07,2018,"Buyuksehyr","Konyaspor","2-0",2,0,"T1",1,2,2,"H"
2019-04-07,2018,"Goztep","Akhisar Belediyespor","0-1",0,1,"T1",1,1,-1,"A"
2019-04-07,2018,"Kasimpasa","Erzurum","2-1",2,1,"T1",1,3,1,"H"
2019-04-08,2018,"Rizespor","Besiktas","2-7",2,7,"T1",1,9,-5,"A"
2019-04-12,2018,"Bursaspor","Trabzonspor","0-1",0,1,"T1",1,1,-1,"A"
2019-04-13,2018,"Besiktas","Buyuksehyr","2-1",2,1,"T1",1,3,1,"H"
2019-04-13,2018,"Konyaspor","Sivasspor","1-1",1,1,"T1",1,2,0,"D"
2019-04-13,2018,"Rizespor","Goztep","1-0",1,0,"T1",1,1,1,"H"
2019-04-14,2018,"Antalyaspor","Kasimpasa","1-0",1,0,"T1",1,1,1,"H"
2019-04-14,2018,"Fenerbahce","Galatasaray","1-1",1,1,"T1",1,2,0,"D"
2019-04-14,2018,"Kayserispor","Ankaragucu","0-2",0,2,"T1",1,2,-2,"A"
2019-04-14,2018,"Yeni Malatyaspor","Alanyaspor","1-1",1,1,"T1",1,2,0,"D"
2019-04-15,2018,"Erzurum","Akhisar Belediyespor","2-1",2,1,"T1",1,3,1,"H"
2019-04-19,2018,"Kasimpasa","Bursaspor","1-1",1,1,"T1",1,2,0,"D"
2019-04-20,2018,"Akhisar Belediyespor","Antalyaspor","1-2",1,2,"T1",1,3,-1,"A"
2019-04-20,2018,"Galatasaray","Kayserispor","3-1",3,1,"T1",1,4,2,"H"
2019-04-20,2018,"Goztep","Erzurum","0-1",0,1,"T1",1,1,-1,"A"
2019-04-20,2018,"Trabzonspor","Yeni Malatyaspor","2-1",2,1,"T1",1,3,1,"H"
2019-04-21,2018,"Alanyaspor","Fenerbahce","1-0",1,0,"T1",1,1,1,"H"
2019-04-21,2018,"Ankaragucu","Konyaspor","0-0",0,0,"T1",1,0,0,"D"
2019-04-21,2018,"Buyuksehyr","Rizespor","1-1",1,1,"T1",1,2,0,"D"
2019-04-22,2018,"Sivasspor","Besiktas","1-2",1,2,"T1",1,3,-1,"A"
2019-04-26,2018,"Buyuksehyr","Goztep","0-2",0,2,"T1",1,2,-2,"A"
2019-04-27,2018,"Antalyaspor","Erzurum","1-1",1,1,"T1",1,2,0,"D"
2019-04-27,2018,"Fenerbahce","Trabzonspor","1-1",1,1,"T1",1,2,0,"D"
2019-04-27,2018,"Rizespor","Sivasspor","0-0",0,0,"T1",1,0,0,"D"
2019-04-28,2018,"Besiktas","Ankaragucu","4-1",4,1,"T1",1,5,3,"H"
2019-04-28,2018,"Bursaspor","Akhisar Belediyespor","0-0",0,0,"T1",1,0,0,"D"
2019-04-28,2018,"Kayserispor","Alanyaspor","1-1",1,1,"T1",1,2,0,"D"
2019-04-29,2018,"Konyaspor","Galatasaray","0-0",0,0,"T1",1,0,0,"D"
2019-04-29,2018,"Yeni Malatyaspor","Kasimpasa","2-1",2,1,"T1",1,3,1,"H"
2019-05-03,2018,"Sivasspor","Buyuksehyr","0-0",0,0,"T1",1,0,0,"D"
2019-05-04,2018,"Ankaragucu","Rizespor","2-2",2,2,"T1",1,4,0,"D"
2019-05-04,2018,"Erzurum","Bursaspor","2-0",2,0,"T1",1,2,2,"H"
2019-05-04,2018,"Kasimpasa","Fenerbahce","1-3",1,3,"T1",1,4,-2,"A"
2019-05-05,2018,"Akhisar Belediyespor","Yeni Malatyaspor","0-2",0,2,"T1",1,2,-2,"A"
2019-05-05,2018,"Galatasaray","Besiktas","2-0",2,0,"T1",1,2,2,"H"
2019-05-05,2018,"Goztep","Antalyaspor","4-1",4,1,"T1",1,5,3,"H"
2019-05-06,2018,"Alanyaspor","Konyaspor","2-4",2,4,"T1",1,6,-2,"A"
2019-05-06,2018,"Trabzonspor","Kayserispor","4-2",4,2,"T1",1,6,2,"H"
2019-05-10,2018,"Antalyaspor","Bursaspor","0-1",0,1,"T1",1,1,-1,"A"
2019-05-11,2018,"Fenerbahce","Akhisar Belediyespor","2-1",2,1,"T1",1,3,1,"H"
2019-05-11,2018,"Goztep","Sivasspor","3-3",3,3,"T1",1,6,0,"D"
2019-05-11,2018,"Rizespor","Galatasaray","2-3",2,3,"T1",1,5,-1,"A"
2019-05-12,2018,"Buyuksehyr","Ankaragucu","2-1",2,1,"T1",1,3,1,"H"
2019-05-12,2018,"Kayserispor","Kasimpasa","2-1",2,1,"T1",1,3,1,"H"
2019-05-12,2018,"Konyaspor","Trabzonspor","2-2",2,2,"T1",1,4,0,"D"
2019-05-12,2018,"Yeni Malatyaspor","Erzurum","3-1",3,1,"T1",1,4,2,"H"
2019-05-13,2018,"Besiktas","Alanyaspor","2-1",2,1,"T1",1,3,1,"H"
2019-05-17,2018,"Kasimpasa","Konyaspor","1-1",1,1,"T1",1,2,0,"D"
2019-05-18,2018,"Antalyaspor","Yeni Malatyaspor","3-0",3,0,"T1",1,3,3,"H"
2019-05-18,2018,"Trabzonspor","Besiktas","2-1",2,1,"T1",1,3,1,"H"
2019-05-19,2018,"Akhisar Belediyespor","Kayserispor","2-2",2,2,"T1",1,4,0,"D"
2019-05-19,2018,"Alanyaspor","Rizespor","1-1",1,1,"T1",1,2,0,"D"
2019-05-19,2018,"Bursaspor","Goztep","0-0",0,0,"T1",1,0,0,"D"
2019-05-19,2018,"Galatasaray","Buyuksehyr","2-1",2,1,"T1",1,3,1,"H"
2019-05-20,2018,"Ankaragucu","Sivasspor","3-1",3,1,"T1",1,4,2,"H"
2019-05-20,2018,"Erzurum","Fenerbahce","0-1",0,1,"T1",1,1,-1,"A"
2019-05-24,2018,"Besiktas","Kasimpasa","3-2",3,2,"T1",1,5,1,"H"
2019-05-24,2018,"Buyuksehyr","Alanyaspor","1-1",1,1,"T1",1,2,0,"D"
2019-05-24,2018,"Rizespor","Trabzonspor","2-3",2,3,"T1",1,5,-1,"A"
2019-05-24,2018,"Sivasspor","Galatasaray","4-3",4,3,"T1",1,7,1,"H"
2019-05-25,2018,"Konyaspor","Akhisar Belediyespor","0-0",0,0,"T1",1,0,0,"D"
2019-05-26,2018,"Fenerbahce","Antalyaspor","3-1",3,1,"T1",1,4,2,"H"
2019-05-26,2018,"Goztep","Ankaragucu","2-1",2,1,"T1",1,3,1,"H"
2019-05-26,2018,"Kayserispor","Erzurum","0-2",0,2,"T1",1,2,-2,"A"
2019-05-26,2018,"Yeni Malatyaspor","Bursaspor","1-2",1,2,"T1",1,3,-1,"A"
2019-08-16,2019,"Denizlispor","Galatasaray","2-0",2,0,"T1",1,2,2,"H"
2019-08-17,2019,"Genclerbirligi","Rizespor","0-1",0,1,"T1",1,1,-1,"A"
2019-08-17,2019,"Kayserispor","Alanyaspor","0-1",0,1,"T1",1,1,-1,"A"
2019-08-17,2019,"Sivasspor","Besiktas","3-0",3,0,"T1",1,3,3,"H"
2019-08-18,2019,"Konyaspor","Ankaragucu","0-0",0,0,"T1",1,0,0,"D"
2019-08-18,2019,"Goztep","Antalyaspor","0-1",0,1,"T1",1,1,-1,"A"
2019-08-18,2019,"Kasimpasa","Trabzonspor","1-1",1,1,"T1",1,2,0,"D"
2019-08-18,2019,"Yeni Malatyaspor","Buyuksehyr","3-0",3,0,"T1",1,3,3,"H"
2019-08-19,2019,"Fenerbahce","Gaziantep FK","5-0",5,0,"T1",1,5,5,"H"
2019-08-23,2019,"Besiktas","Goztep","3-0",3,0,"T1",1,3,3,"H"
2019-08-24,2019,"Ankaragucu","Kayserispor","1-1",1,1,"T1",1,2,0,"D"
2019-08-24,2019,"Alanyaspor","Kasimpasa","4-1",4,1,"T1",1,5,3,"H"
2019-08-24,2019,"Buyuksehyr","Fenerbahce","1-2",1,2,"T1",1,3,-1,"A"
2019-08-25,2019,"Rizespor","Sivasspor","2-1",2,1,"T1",1,3,1,"H"
2019-08-25,2019,"Trabzonspor","Yeni Malatyaspor","2-1",2,1,"T1",1,3,1,"H"
2019-08-25,2019,"Antalyaspor","Denizlispor","0-2",0,2,"T1",1,2,-2,"A"
2019-08-25,2019,"Galatasaray","Konyaspor","1-1",1,1,"T1",1,2,0,"D"
2019-08-26,2019,"Gaziantep FK","Genclerbirligi","4-1",4,1,"T1",1,5,3,"H"
2019-08-30,2019,"Kasimpasa","Ankaragucu","0-1",0,1,"T1",1,1,-1,"A"
2019-08-30,2019,"Kayserispor","Galatasaray","2-3",2,3,"T1",1,5,-1,"A"
2019-08-31,2019,"Konyaspor","Antalyaspor","2-2",2,2,"T1",1,4,0,"D"
2019-08-31,2019,"Besiktas","Rizespor","1-1",1,1,"T1",1,2,0,"D"
2019-08-31,2019,"Goztep","Denizlispor","0-0",0,0,"T1",1,0,0,"D"
2019-09-01,2019,"Genclerbirligi","Buyuksehyr","1-2",1,2,"T1",1,3,-1,"A"
2019-09-01,2019,"Sivasspor","Gaziantep FK","1-1",1,1,"T1",1,2,0,"D"
2019-09-01,2019,"Fenerbahce","Trabzonspor","1-1",1,1,"T1",1,2,0,"D"
2019-09-01,2019,"Yeni Malatyaspor","Alanyaspor","2-3",2,3,"T1",1,5,-1,"A"
2019-09-13,2019,"Galatasaray","Kasimpasa","1-0",1,0,"T1",1,1,1,"H"
2019-09-14,2019,"Buyuksehyr","Sivasspor","1-1",1,1,"T1",1,2,0,"D"
2019-09-14,2019,"Antalyaspor","Kayserispor","2-2",2,2,"T1",1,4,0,"D"
2019-09-14,2019,"Gaziantep FK","Besiktas","3-2",3,2,"T1",1,5,1,"H"
2019-09-15,2019,"Ankaragucu","Yeni Malatyaspor","0-4",0,4,"T1",1,4,-4,"A"
2019-09-15,2019,"Rizespor","Goztep","0-0",0,0,"T1",1,0,0,"D"
2019-09-15,2019,"Denizlispor","Konyaspor","0-1",0,1,"T1",1,1,-1,"A"
2019-09-15,2019,"Trabzonspor","Genclerbirligi","2-2",2,2,"T1",1,4,0,"D"
2019-09-16,2019,"Alanyaspor","Fenerbahce","3-1",3,1,"T1",1,4,2,"H"
2019-09-20,2019,"Goztep","Konyaspor","1-0",1,0,"T1",1,1,1,"H"
2019-09-21,2019,"Kasimpasa","Antalyaspor","3-0",3,0,"T1",1,3,3,"H"
2019-09-21,2019,"Kayserispor","Denizlispor","1-1",1,1,"T1",1,2,0,"D"
2019-09-21,2019,"Fenerbahce","Ankaragucu","2-1",2,1,"T1",1,3,1,"H"
2019-09-22,2019,"Rizespor","Gaziantep FK","1-2",1,2,"T1",1,3,-1,"A"
2019-09-22,2019,"Genclerbirligi","Alanyaspor","1-1",1,1,"T1",1,2,0,"D"
2019-09-22,2019,"Yeni Malatyaspor","Galatasaray","1-1",1,1,"T1",1,2,0,"D"
2019-09-23,2019,"Besiktas","Buyuksehyr","1-1",1,1,"T1",1,2,0,"D"
2019-09-23,2019,"Sivasspor","Trabzonspor","2-1",2,1,"T1",1,3,1,"H"
2019-09-27,2019,"Buyuksehyr","Rizespor","5-0",5,0,"T1",1,5,5,"H"
2019-09-28,2019,"Denizlispor","Kasimpasa","0-1",0,1,"T1",1,1,-1,"A"
2019-09-28,2019,"Alanyaspor","Sivasspor","1-1",1,1,"T1",1,2,0,"D"
2019-09-28,2019,"Galatasaray","Fenerbahce","0-0",0,0,"T1",1,0,0,"D"
2019-09-29,2019,"Konyaspor","Kayserispor","2-1",2,1,"T1",1,3,1,"H"
2019-09-29,2019,"Ankaragucu","Genclerbirligi","2-1",2,1,"T1",1,3,1,"H"
2019-09-29,2019,"Antalyaspor","Yeni Malatyaspor","3-0",3,0,"T1",1,3,3,"H"
2019-09-29,2019,"Trabzonspor","Besiktas","4-1",4,1,"T1",1,5,3,"H"
2019-09-30,2019,"Gaziantep FK","Goztep","1-1",1,1,"T1",1,2,0,"D"
2019-10-04,2019,"Fenerbahce","Antalyaspor","0-1",0,1,"T1",1,1,-1,"A"
2019-10-04,2019,"Yeni Malatyaspor","Denizlispor","5-1",5,1,"T1",1,6,4,"H"
2019-10-05,2019,"Kasimpasa","Konyaspor","1-4",1,4,"T1",1,5,-3,"A"
2019-10-05,2019,"Goztep","Kayserispor","4-0",4,0,"T1",1,4,4,"H"
2019-10-05,2019,"Genclerbirligi","Galatasaray","0-0",0,0,"T1",1,0,0,"D"
2019-10-06,2019,"Sivasspor","Ankaragucu","3-1",3,1,"T1",1,4,2,"H"
2019-10-06,2019,"Besiktas","Alanyaspor","2-0",2,0,"T1",1,2,2,"H"
2019-10-06,2019,"Gaziantep FK","Buyuksehyr","1-2",1,2,"T1",1,3,-1,"A"
2019-10-06,2019,"Rizespor","Trabzonspor","1-2",1,2,"T1",1,3,-1,"A"
2019-10-18,2019,"Galatasaray","Sivasspor","3-2",3,2,"T1",1,5,1,"H"
2019-10-19,2019,"Antalyaspor","Genclerbirligi","0-6",0,6,"T1",1,6,-6,"A"
2019-10-19,2019,"Buyuksehyr","Goztep","2-1",2,1,"T1",1,3,1,"H"
2019-10-19,2019,"Trabzonspor","Gaziantep FK","4-1",4,1,"T1",1,5,3,"H"
2019-10-19,2019,"Ankaragucu","Besiktas","0-0",0,0,"T1",1,0,0,"D"
2019-10-20,2019,"Kayserispor","Kasimpasa","1-1",1,1,"T1",1,2,0,"D"
2019-10-20,2019,"Alanyaspor","Rizespor","5-2",5,2,"T1",1,7,3,"H"
2019-10-20,2019,"Denizlispor","Fenerbahce","1-2",1,2,"T1",1,3,-1,"A"
2019-10-21,2019,"Konyaspor","Yeni Malatyaspor","0-2",0,2,"T1",1,2,-2,"A"
2019-10-25,2019,"Rizespor","Ankaragucu","2-0",2,0,"T1",1,2,2,"H"
2019-10-26,2019,"Sivasspor","Antalyaspor","2-1",2,1,"T1",1,3,1,"H"
2019-10-26,2019,"Gaziantep FK","Alanyaspor","1-1",1,1,"T1",1,2,0,"D"
2019-10-26,2019,"Fenerbahce","Konyaspor","5-1",5,1,"T1",1,6,4,"H"
2019-10-27,2019,"Yeni Malatyaspor","Kayserispor","4-0",4,0,"T1",1,4,4,"H"
2019-10-27,2019,"Genclerbirligi","Denizlispor","0-2",0,2,"T1",1,2,-2,"A"
2019-10-27,2019,"Goztep","Kasimpasa","1-4",1,4,"T1",1,5,-3,"A"
2019-10-27,2019,"Besiktas","Galatasaray","1-0",1,0,"T1",1,1,1,"H"
2019-10-28,2019,"Buyuksehyr","Trabzonspor","2-2",2,2,"T1",1,4,0,"D"
2019-11-01,2019,"Galatasaray","Rizespor","2-0",2,0,"T1",1,2,2,"H"
2019-11-02,2019,"Konyaspor","Genclerbirligi","1-1",1,1,"T1",1,2,0,"D"
2019-11-02,2019,"Alanyaspor","Buyuksehyr","0-0",0,0,"T1",1,0,0,"D"
2019-11-02,2019,"Trabzonspor","Goztep","0-1",0,1,"T1",1,1,-1,"A"
2019-11-02,2019,"Antalyaspor","Besiktas","1-2",1,2,"T1",1,3,-1,"A"
2019-11-03,2019,"Denizlispor","Sivasspor","0-2",0,2,"T1",1,2,-2,"A"
2019-11-03,2019,"Kasimpasa","Yeni Malatyaspor","2-2",2,2,"T1",1,4,0,"D"
2019-11-03,2019,"Kayserispor","Fenerbahce","1-0",1,0,"T1",1,1,1,"H"
2019-11-04,2019,"Ankaragucu","Gaziantep FK","1-2",1,2,"T1",1,3,-1,"A"
2019-11-08,2019,"Fenerbahce","Kasimpasa","3-2",3,2,"T1",1,5,1,"H"
2019-11-09,2019,"Genclerbirligi","Kayserispor","2-1",2,1,"T1",1,3,1,"H"
2019-11-09,2019,"Rizespor","Antalyaspor","1-0",1,0,"T1",1,1,1,"H"
2019-11-09,2019,"Sivasspor","Konyaspor","2-0",2,0,"T1",1,2,2,"H"
2019-11-09,2019,"Gaziantep FK","Galatasaray","0-2",0,2,"T1",1,2,-2,"A"
2019-11-10,2019,"Goztep","Yeni Malatyaspor","1-1",1,1,"T1",1,2,0,"D"
2019-11-10,2019,"Trabzonspor","Alanyaspor","1-0",1,0,"T1",1,1,1,"H"
2019-11-10,2019,"Besiktas","Denizlispor","1-0",1,0,"T1",1,1,1,"H"
2019-11-10,2019,"Buyuksehyr","Ankaragucu","2-1",2,1,"T1",1,3,1,"H"
2019-11-22,2019,"Galatasaray","Buyuksehyr","0-1",0,1,"T1",1,1,-1,"A"
2019-11-23,2019,"Denizlispor","Rizespor","2-0",2,0,"T1",1,2,2,"H"
2019-11-23,2019,"Ankaragucu","Trabzonspor","0-3",0,3,"T1",1,3,-3,"A"
2019-11-23,2019,"Konyaspor","Besiktas","0-1",0,1,"T1",1,1,-1,"A"
2019-11-24,2019,"Kayserispor","Sivasspor","1-4",1,4,"T1",1,5,-3,"A"
2019-11-24,2019,"Alanyaspor","Goztep","0-1",0,1,"T1",1,1,-1,"A"
2019-11-24,2019,"Kasimpasa","Genclerbirligi","1-2",1,2,"T1",1,3,-1,"A"
2019-11-24,2019,"Yeni Malatyaspor","Fenerbahce","0-0",0,0,"T1",1,0,0,"D"
2019-11-25,2019,"Antalyaspor","Gaziantep FK","1-1",1,1,"T1",1,2,0,"D"
2019-11-29,2019,"Genclerbirligi","Yeni Malatyaspor","3-3",3,3,"T1",1,6,0,"D"
2019-11-30,2019,"Rizespor","Konyaspor","3-1",3,1,"T1",1,4,2,"H"
2019-11-30,2019,"Sivasspor","Kasimpasa","2-0",2,0,"T1",1,2,2,"H"
2019-11-30,2019,"Alanyaspor","Ankaragucu","5-0",5,0,"T1",1,5,5,"H"
2019-11-30,2019,"Goztep","Fenerbahce","2-2",2,2,"T1",1,4,0,"D"
2019-12-01,2019,"Gaziantep FK","Denizlispor","1-2",1,2,"T1",1,3,-1,"A"
2019-12-01,2019,"Buyuksehyr","Antalyaspor","2-0",2,0,"T1",1,2,2,"H"
2019-12-01,2019,"Trabzonspor","Galatasaray","1-1",1,1,"T1",1,2,0,"D"
2019-12-02,2019,"Besiktas","Kayserispor","4-1",4,1,"T1",1,5,3,"H"
2019-12-06,2019,"Fenerbahce","Genclerbirligi","5-2",5,2,"T1",1,7,3,"H"
2019-12-07,2019,"Yeni Malatyaspor","Sivasspor","1-3",1,3,"T1",1,4,-2,"A"
2019-12-07,2019,"Ankaragucu","Goztep","1-3",1,3,"T1",1,4,-2,"A"
2019-12-07,2019,"Galatasaray","Alanyaspor","1-0",1,0,"T1",1,1,1,"H"
2019-12-08,2019,"Konyaspor","Gaziantep FK","0-0",0,0,"T1",1,0,0,"D"
2019-12-08,2019,"Antalyaspor","Trabzonspor","1-3",1,3,"T1",1,4,-2,"A"
2019-12-08,2019,"Denizlispor","Buyuksehyr","1-1",1,1,"T1",1,2,0,"D"
2019-12-08,2019,"Kasimpasa","Besiktas","2-3",2,3,"T1",1,5,-1,"A"
2019-12-09,2019,"Kayserispor","Rizespor","1-0",1,0,"T1",1,1,1,"H"
2019-12-13,2019,"Alanyaspor","Antalyaspor","0-0",0,0,"T1",1,0,0,"D"
2019-12-14,2019,"Rizespor","Kasimpasa","0-3",0,3,"T1",1,3,-3,"A"
2019-12-14,2019,"Genclerbirligi","Goztep","3-1",3,1,"T1",1,4,2,"H"
2019-12-14,2019,"Galatasaray","Ankaragucu","2-2",2,2,"T1",1,4,0,"D"
2019-12-15,2019,"Gaziantep FK","Kayserispor","3-0",3,0,"T1",1,3,3,"H"
2019-12-15,2019,"Sivasspor","Fenerbahce","3-1",3,1,"T1",1,4,2,"H"
2019-12-15,2019,"Besiktas","Yeni Malatyaspor","0-2",0,2,"T1",1,2,-2,"A"
2019-12-16,2019,"Buyuksehyr","Konyaspor","1-1",1,1,"T1",1,2,0,"D"
2019-12-16,2019,"Trabzonspor","Denizlispor","1-2",1,2,"T1",1,3,-1,"A"
2019-12-20,2019,"Antalyaspor","Ankaragucu","2-2",2,2,"T1",1,4,0,"D"
2019-12-21,2019,"Yeni Malatyaspor","Rizespor","0-2",0,2,"T1",1,2,-2,"A"
2019-12-21,2019,"Kasimpasa","Gaziantep FK","3-4",3,4,"T1",1,7,-1,"A"
2019-12-21,2019,"Goztep","Galatasaray","2-1",2,1,"T1",1,3,1,"H"
2019-12-22,2019,"Genclerbirligi","Sivasspor","2-2",2,2,"T1",1,4,0,"D"
2019-12-22,2019,"Kayserispor","Buyuksehyr","1-4",1,4,"T1",1,5,-3,"A"
2019-12-22,2019,"Fenerbahce","Besiktas","3-1",3,1,"T1",1,4,2,"H"
2019-12-23,2019,"Denizlispor","Alanyaspor","1-5",1,5,"T1",1,6,-4,"A"
2019-12-23,2019,"Konyaspor","Trabzonspor","0-1",0,1,"T1",1,1,-1,"A"
2019-12-27,2019,"Besiktas","Genclerbirligi","4-1",4,1,"T1",1,5,3,"H"
2019-12-28,2019,"Ankaragucu","Denizlispor","2-2",2,2,"T1",1,4,0,"D"
2019-12-28,2019,"Buyuksehyr","Kasimpasa","5-1",5,1,"T1",1,6,4,"H"
2019-12-28,2019,"Trabzonspor","Kayserispor","6-2",6,2,"T1",1,8,4,"H"
2019-12-28,2019,"Galatasaray","Antalyaspor","5-0",5,0,"T1",1,5,5,"H"
2019-12-29,2019,"Sivasspor","Goztep","1-0",1,0,"T1",1,1,1,"H"
2019-12-29,2019,"Alanyaspor","Konyaspor","2-1",2,1,"T1",1,3,1,"H"
2019-12-29,2019,"Gaziantep FK","Yeni Malatyaspor","1-1",1,1,"T1",1,2,0,"D"
2019-12-29,2019,"Rizespor","Fenerbahce","1-2",1,2,"T1",1,3,-1,"A"
2020-01-17,2019,"Ankaragucu","Konyaspor","0-1",0,1,"T1",1,1,-1,"A"
2020-01-18,2019,"Alanyaspor","Kayserispor","5-1",5,1,"T1",1,6,4,"H"
2020-01-18,2019,"Buyuksehyr","Yeni Malatyaspor","4-1",4,1,"T1",1,5,3,"H"
2020-01-18,2019,"Gaziantep FK","Fenerbahce","0-2",0,2,"T1",1,2,-2,"A"
2020-01-19,2019,"Antalyaspor","Goztep","0-3",0,3,"T1",1,3,-3,"A"
2020-01-19,2019,"Galatasaray","Denizlispor","2-1",2,1,"T1",1,3,1,"H"
2020-01-19,2019,"Trabzonspor","Kasimpasa","6-0",6,0,"T1",1,6,6,"H"
2020-01-19,2019,"Besiktas","Sivasspor","1-2",1,2,"T1",1,3,-1,"A"
2020-01-20,2019,"Rizespor","Genclerbirligi","2-0",2,0,"T1",1,2,2,"H"
2020-01-24,2019,"Genclerbirligi","Gaziantep FK","1-0",1,0,"T1",1,1,1,"H"
2020-01-25,2019,"Kayserispor","Ankaragucu","1-1",1,1,"T1",1,2,0,"D"
2020-01-25,2019,"Kasimpasa","Alanyaspor","1-2",1,2,"T1",1,3,-1,"A"
2020-01-25,2019,"Fenerbahce","Buyuksehyr","2-0",2,0,"T1",1,2,2,"H"
2020-01-26,2019,"Denizlispor","Antalyaspor","0-3",0,3,"T1",1,3,-3,"A"
2020-01-26,2019,"Goztep","Besiktas","2-1",2,1,"T1",1,3,1,"H"
2020-01-26,2019,"Konyaspor","Galatasaray","0-3",0,3,"T1",1,3,-3,"A"
2020-01-27,2019,"Sivasspor","Rizespor","1-1",1,1,"T1",1,2,0,"D"
2020-01-31,2019,"Buyuksehyr","Genclerbirligi","3-1",3,1,"T1",1,4,2,"H"
2020-02-01,2019,"Antalyaspor","Konyaspor","0-0",0,0,"T1",1,0,0,"D"
2020-02-01,2019,"Rizespor","Besiktas","1-2",1,2,"T1",1,3,-1,"A"
2020-02-01,2019,"Trabzonspor","Fenerbahce","2-1",2,1,"T1",1,3,1,"H"
2020-02-02,2019,"Ankaragucu","Kasimpasa","1-1",1,1,"T1",1,2,0,"D"
2020-02-02,2019,"Alanyaspor","Yeni Malatyaspor","2-1",2,1,"T1",1,3,1,"H"
2020-02-02,2019,"Gaziantep FK","Sivasspor","5-1",5,1,"T1",1,6,4,"H"
2020-02-02,2019,"Galatasaray","Kayserispor","4-1",4,1,"T1",1,5,3,"H"
2020-02-03,2019,"Denizlispor","Goztep","1-1",1,1,"T1",1,2,0,"D"
2020-02-07,2019,"Yeni Malatyaspor","Ankaragucu","0-1",0,1,"T1",1,1,-1,"A"
2020-02-08,2019,"Konyaspor","Denizlispor","0-0",0,0,"T1",1,0,0,"D"
2020-02-08,2019,"Besiktas","Gaziantep FK","3-0",3,0,"T1",1,3,3,"H"
2020-02-08,2019,"Genclerbirligi","Trabzonspor","0-2",0,2,"T1",1,2,-2,"A"
2020-02-08,2019,"Fenerbahce","Alanyaspor","1-1",1,1,"T1",1,2,0,"D"
2020-02-09,2019,"Kayserispor","Antalyaspor","2-2",2,2,"T1",1,4,0,"D"
2020-02-09,2019,"Sivasspor","Buyuksehyr","1-1",1,1,"T1",1,2,0,"D"
2020-02-09,2019,"Kasimpasa","Galatasaray","0-3",0,3,"T1",1,3,-3,"A"
2020-02-14,2019,"Buyuksehyr","Besiktas","1-0",1,0,"T1",1,1,1,"H"
2020-02-15,2019,"Denizlispor","Kayserispor","0-1",0,1,"T1",1,1,-1,"A"
2020-02-15,2019,"Konyaspor","Goztep","1-3",1,3,"T1",1,4,-2,"A"
2020-02-15,2019,"Ankaragucu","Fenerbahce","2-1",2,1,"T1",1,3,1,"H"
2020-02-16,2019,"Alanyaspor","Genclerbirligi","0-1",0,1,"T1",1,1,-1,"A"
2020-02-16,2019,"Trabzonspor","Sivasspor","2-1",2,1,"T1",1,3,1,"H"
2020-02-16,2019,"Galatasaray","Yeni Malatyaspor","1-0",1,0,"T1",1,1,1,"H"
2020-02-17,2019,"Antalyaspor","Kasimpasa","3-1",3,1,"T1",1,4,2,"H"
2020-02-17,2019,"Gaziantep FK","Rizespor","2-0",2,0,"T1",1,2,2,"H"
2020-02-21,2019,"Sivasspor","Alanyaspor","1-0",1,0,"T1",1,1,1,"H"
2020-02-22,2019,"Kayserispor","Konyaspor","2-2",2,2,"T1",1,4,0,"D"
2020-02-22,2019,"Goztep","Gaziantep FK","1-1",1,1,"T1",1,2,0,"D"
2020-02-22,2019,"Besiktas","Trabzonspor","2-2",2,2,"T1",1,4,0,"D"
2020-02-23,2019,"Yeni Malatyaspor","Antalyaspor","1-2",1,2,"T1",1,3,-1,"A"
2020-02-23,2019,"Genclerbirligi","Ankaragucu","1-0",1,0,"T1",1,1,1,"H"
2020-02-23,2019,"Fenerbahce","Galatasaray","1-3",1,3,"T1",1,4,-2,"A"
2020-02-24,2019,"Kasimpasa","Denizlispor","2-0",2,0,"T1",1,2,2,"H"
2020-02-24,2019,"Rizespor","Buyuksehyr","1-2",1,2,"T1",1,3,-1,"A"
2020-02-28,2019,"Alanyaspor","Besiktas","1-2",1,2,"T1",1,3,-1,"A"
2020-02-29,2019,"Konyaspor","Kasimpasa","0-0",0,0,"T1",1,0,0,"D"
2020-02-29,2019,"Trabzonspor","Rizespor","5-2",5,2,"T1",1,7,3,"H"
2020-02-29,2019,"Antalyaspor","Fenerbahce","2-2",2,2,"T1",1,4,0,"D"
2020-03-01,2019,"Denizlispor","Yeni Malatyaspor","2-0",2,0,"T1",1,2,2,"H"
2020-03-01,2019,"Ankaragucu","Sivasspor","0-3",0,3,"T1",1,3,-3,"A"
2020-03-01,2019,"Galatasaray","Genclerbirligi","3-0",3,0,"T1",1,3,3,"H"
2020-03-02,2019,"Buyuksehyr","Gaziantep FK","3-1",3,1,"T1",1,4,2,"H"
2020-03-02,2019,"Kayserispor","Goztep","1-0",1,0,"T1",1,1,1,"H"
2020-03-06,2019,"Besiktas","Ankaragucu","2-1",2,1,"T1",1,3,1,"H"
2020-03-07,2019,"Yeni Malatyaspor","Konyaspor","1-1",1,1,"T1",1,2,0,"D"
2020-03-07,2019,"Gaziantep FK","Trabzonspor","1-1",1,1,"T1",1,2,0,"D"
2020-03-07,2019,"Goztep","Buyuksehyr","0-3",0,3,"T1",1,3,-3,"A"
2020-03-07,2019,"Fenerbahce","Denizlispor","2-2",2,2,"T1",1,4,0,"D"
2020-03-08,2019,"Kasimpasa","Kayserispor","5-1",5,1,"T1",1,6,4,"H"
2020-03-08,2019,"Rizespor","Alanyaspor","1-1",1,1,"T1",1,2,0,"D"
2020-03-08,2019,"Sivasspor","Galatasaray","2-2",2,2,"T1",1,4,0,"D"
2020-03-09,2019,"Genclerbirligi","Antalyaspor","1-1",1,1,"T1",1,2,0,"D"
2020-03-11,2019,"Yeni Malatyaspor","Trabzonspor","1-3",1,3,"T1",1,4,-2,"A"
2020-03-13,2019,"Ankaragucu","Rizespor","2-1",2,1,"T1",1,3,1,"H"
2020-03-13,2019,"Kasimpasa","Goztep","2-0",2,0,"T1",1,2,2,"H"
2020-03-14,2019,"Denizlispor","Genclerbirligi","1-0",1,0,"T1",1,1,1,"H"
2020-03-14,2019,"Alanyaspor","Gaziantep FK","1-0",1,0,"T1",1,1,1,"H"
2020-03-14,2019,"Konyaspor","Fenerbahce","1-0",1,0,"T1",1,1,1,"H"
2020-03-15,2019,"Kayserispor","Yeni Malatyaspor","2-1",2,1,"T1",1,3,1,"H"
2020-03-15,2019,"Trabzonspor","Buyuksehyr","1-1",1,1,"T1",1,2,0,"D"
2020-03-15,2019,"Galatasaray","Besiktas","0-0",0,0,"T1",1,0,0,"D"
2020-03-16,2019,"Antalyaspor","Sivasspor","1-0",1,0,"T1",1,1,1,"H"
2020-03-17,2019,"Goztep","Rizespor","2-0",2,0,"T1",1,2,2,"H"
2020-06-12,2019,"Fenerbahce","Kayserispor","2-1",2,1,"T1",1,3,1,"H"
2020-06-12,2019,"Goztep","Trabzonspor","1-3",1,3,"T1",1,4,-2,"A"
2020-06-13,2019,"Buyuksehyr","Alanyaspor","2-0",2,0,"T1",1,2,2,"H"
2020-06-13,2019,"Besiktas","Antalyaspor","1-2",1,2,"T1",1,3,-1,"A"
2020-06-13,2019,"Yeni Malatyaspor","Kasimpasa","1-2",1,2,"T1",1,3,-1,"A"
2020-06-14,2019,"Genclerbirligi","Konyaspor","2-1",2,1,"T1",1,3,1,"H"
2020-06-14,2019,"Gaziantep FK","Ankaragucu","1-1",1,1,"T1",1,2,0,"D"
2020-06-14,2019,"Rizespor","Galatasaray","2-0",2,0,"T1",1,2,2,"H"
2020-06-15,2019,"Sivasspor","Denizlispor","1-0",1,0,"T1",1,1,1,"H"
2020-06-19,2019,"Ankaragucu","Buyuksehyr","1-2",1,2,"T1",1,3,-1,"A"
2020-06-20,2019,"Kayserispor","Genclerbirligi","2-0",2,0,"T1",1,2,2,"H"
2020-06-20,2019,"Denizlispor","Besiktas","1-5",1,5,"T1",1,6,-4,"A"
2020-06-20,2019,"Yeni Malatyaspor","Goztep","2-1",2,1,"T1",1,3,1,"H"
2020-06-21,2019,"Kasimpasa","Fenerbahce","2-0",2,0,"T1",1,2,2,"H"
2020-06-21,2019,"Galatasaray","Gaziantep FK","3-3",3,3,"T1",1,6,0,"D"
2020-06-21,2019,"Konyaspor","Sivasspor","2-2",2,2,"T1",1,4,0,"D"
2020-06-22,2019,"Alanyaspor","Trabzonspor","2-2",2,2,"T1",1,4,0,"D"
2020-06-22,2019,"Antalyaspor","Rizespor","3-1",3,1,"T1",1,4,2,"H"
2020-06-26,2019,"Besiktas","Konyaspor","3-0",3,0,"T1",1,3,3,"H"
2020-06-27,2019,"Fenerbahce","Yeni Malatyaspor","3-2",3,2,"T1",1,5,1,"H"
2020-06-27,2019,"Goztep","Alanyaspor","3-3",3,3,"T1",1,6,0,"D"
2020-06-27,2019,"Trabzonspor","Ankaragucu","1-1",1,1,"T1",1,2,0,"D"
2020-06-28,2019,"Rizespor","Denizlispor","2-2",2,2,"T1",1,4,0,"D"
2020-06-28,2019,"Sivasspor","Kayserispor","0-2",0,2,"T1",1,2,-2,"A"
2020-06-28,2019,"Buyuksehyr","Galatasaray","1-1",1,1,"T1",1,2,0,"D"
2020-06-28,2019,"Gaziantep FK","Antalyaspor","1-1",1,1,"T1",1,2,0,"D"
2020-06-29,2019,"Genclerbirligi","Kasimpasa","0-2",0,2,"T1",1,2,-2,"A"
2020-07-03,2019,"Denizlispor","Gaziantep FK","0-1",0,1,"T1",1,1,-1,"A"
2020-07-04,2019,"Ankaragucu","Alanyaspor","1-4",1,4,"T1",1,5,-3,"A"
2020-07-04,2019,"Yeni Malatyaspor","Genclerbirligi","0-0",0,0,"T1",1,0,0,"D"
2020-07-04,2019,"Antalyaspor","Buyuksehyr","0-2",0,2,"T1",1,2,-2,"A"
2020-07-04,2019,"Fenerbahce","Goztep","2-1",2,1,"T1",1,3,1,"H"
2020-07-05,2019,"Kasimpasa","Sivasspor","0-0",0,0,"T1",1,0,0,"D"
2020-07-05,2019,"Galatasaray","Trabzonspor","1-3",1,3,"T1",1,4,-2,"A"
2020-07-05,2019,"Konyaspor","Rizespor","1-0",1,0,"T1",1,1,1,"H"
2020-07-06,2019,"Kayserispor","Besiktas","3-1",3,1,"T1",1,4,2,"H"
2020-07-07,2019,"Genclerbirligi","Fenerbahce","1-1",1,1,"T1",1,2,0,"D"
2020-07-07,2019,"Buyuksehyr","Denizlispor","2-0",2,0,"T1",1,2,2,"H"
2020-07-08,2019,"Sivasspor","Yeni Malatyaspor","0-1",0,1,"T1",1,1,-1,"A"
2020-07-08,2019,"Trabzonspor","Antalyaspor","2-2",2,2,"T1",1,4,0,"D"
2020-07-08,2019,"Alanyaspor","Galatasaray","4-1",4,1,"T1",1,5,3,"H"
2020-07-08,2019,"Goztep","Ankaragucu","2-2",2,2,"T1",1,4,0,"D"
2020-07-09,2019,"Rizespor","Kayserispor","3-2",3,2,"T1",1,5,1,"H"
2020-07-09,2019,"Besiktas","Kasimpasa","3-2",3,2,"T1",1,5,1,"H"
2020-07-09,2019,"Gaziantep FK","Konyaspor","3-1",3,1,"T1",1,4,2,"H"
2020-07-11,2019,"Goztep","Genclerbirligi","1-3",1,3,"T1",1,4,-2,"A"
2020-07-12,2019,"Ankaragucu","Galatasaray","1-0",1,0,"T1",1,1,1,"H"
2020-07-12,2019,"Antalyaspor","Alanyaspor","1-0",1,0,"T1",1,1,1,"H"
2020-07-12,2019,"Fenerbahce","Sivasspor","1-2",1,2,"T1",1,3,-1,"A"
2020-07-13,2019,"Kasimpasa","Rizespor","2-0",2,0,"T1",1,2,2,"H"
2020-07-13,2019,"Kayserispor","Gaziantep FK","1-1",1,1,"T1",1,2,0,"D"
2020-07-13,2019,"Denizlispor","Trabzonspor","2-1",2,1,"T1",1,3,1,"H"
2020-07-13,2019,"Konyaspor","Buyuksehyr","4-3",4,3,"T1",1,7,1,"H"
2020-07-13,2019,"Yeni Malatyaspor","Besiktas","0-1",0,1,"T1",1,1,-1,"A"
2020-07-18,2019,"Galatasaray","Goztep","3-1",3,1,"T1",1,4,2,"H"
2020-07-18,2019,"Gaziantep FK","Kasimpasa","2-2",2,2,"T1",1,4,0,"D"
2020-07-19,2019,"Alanyaspor","Denizlispor","1-0",1,0,"T1",1,1,1,"H"
2020-07-19,2019,"Ankaragucu","Antalyaspor","0-1",0,1,"T1",1,1,-1,"A"
2020-07-19,2019,"Besiktas","Fenerbahce","2-0",2,0,"T1",1,2,2,"H"
2020-07-19,2019,"Buyuksehyr","Kayserispor","1-0",1,0,"T1",1,1,1,"H"
2020-07-19,2019,"Rizespor","Yeni Malatyaspor","3-0",3,0,"T1",1,3,3,"H"
2020-07-19,2019,"Sivasspor","Genclerbirligi","2-0",2,0,"T1",1,2,2,"H"
2020-07-19,2019,"Trabzonspor","Konyaspor","3-4",3,4,"T1",1,7,-1,"A"
2020-07-24,2019,"Antalyaspor","Galatasaray","2-2",2,2,"T1",1,4,0,"D"
2020-07-25,2019,"Denizlispor","Ankaragucu","0-1",0,1,"T1",1,1,-1,"A"
2020-07-25,2019,"Fenerbahce","Rizespor","3-1",3,1,"T1",1,4,2,"H"
2020-07-25,2019,"Genclerbirligi","Besiktas","0-3",0,3,"T1",1,3,-3,"A"
2020-07-25,2019,"Goztep","Sivasspor","3-1",3,1,"T1",1,4,2,"H"
2020-07-25,2019,"Kayserispor","Trabzonspor","1-2",1,2,"T1",1,3,-1,"A"
2020-07-25,2019,"Konyaspor","Alanyaspor","2-3",2,3,"T1",1,5,-1,"A"
2020-07-25,2019,"Yeni Malatyaspor","Gaziantep FK","0-1",0,1,"T1",1,1,-1,"A"
2020-07-26,2019,"Kasimpasa","Buyuksehyr","3-2",3,2,"T1",1,5,1,"H"
2020-09-11,2020,"Rizespor","Fenerbahce","1-2",1,2,"T1",1,3,-1,"A"
2020-09-12,2020,"Karagumruk SK","Yeni Malatyaspor","3-0",3,0,"T1",1,3,3,"H"
2020-09-12,2020,"Sivasspor","Alanyaspor","0-2",0,2,"T1",1,2,-2,"A"
2020-09-12,2020,"Galatasaray","Gaziantep FK","3-1",3,1,"T1",1,4,2,"H"
2020-09-12,2020,"Goztep","Denizlispor","5-1",5,1,"T1",1,6,4,"H"
2020-09-13,2020,"Ankaragucu","Erzurum","1-2",1,2,"T1",1,3,-1,"A"
2020-09-13,2020,"Kayserispor","Kasimpasa","1-0",1,0,"T1",1,1,1,"H"
2020-09-13,2020,"Antalyaspor","Genclerbirligi","2-0",2,0,"T1",1,2,2,"H"
2020-09-13,2020,"Trabzonspor","Besiktas","1-3",1,3,"T1",1,4,-2,"A"
2020-09-14,2020,"Hatayspor","Buyuksehyr","2-0",2,0,"T1",1,2,2,"H"
2020-09-18,2020,"Yeni Malatyaspor","Goztep","1-1",1,1,"T1",1,2,0,"D"
2020-09-19,2020,"Genclerbirligi","Konyaspor","0-0",0,0,"T1",1,0,0,"D"
2020-09-19,2020,"Denizlispor","Trabzonspor","0-0",0,0,"T1",1,0,0,"D"
2020-09-19,2020,"Alanyaspor","Kayserispor","2-0",2,0,"T1",1,2,2,"H"
2020-09-19,2020,"Besiktas","Antalyaspor","1-1",1,1,"T1",1,2,0,"D"
2020-09-20,2020,"Erzurum","Sivasspor","1-2",1,2,"T1",1,3,-1,"A"
2020-09-20,2020,"Kasimpasa","Rizespor","2-0",2,0,"T1",1,2,2,"H"
2020-09-20,2020,"Buyuksehyr","Galatasaray","0-2",0,2,"T1",1,2,-2,"A"
2020-09-20,2020,"Gaziantep FK","Karagumruk SK","2-2",2,2,"T1",1,4,0,"D"
2020-09-21,2020,"Fenerbahce","Hatayspor","0-0",0,0,"T1",1,0,0,"D"
2020-09-25,2020,"Karagumruk SK","Buyuksehyr","2-0",2,0,"T1",1,2,2,"H"
2020-09-26,2020,"Kayserispor","Erzurum","1-3",1,3,"T1",1,4,-2,"A"
2020-09-26,2020,"Goztep","Gaziantep FK","2-2",2,2,"T1",1,4,0,"D"
2020-09-26,2020,"Hatayspor","Kasimpasa","1-0",1,0,"T1",1,1,1,"H"
2020-09-26,2020,"Trabzonspor","Yeni Malatyaspor","3-1",3,1,"T1",1,4,2,"H"
2020-09-27,2020,"Rizespor","Alanyaspor","1-1",1,1,"T1",1,2,0,"D"
2020-09-27,2020,"Konyaspor","Besiktas","4-1",4,1,"T1",1,5,3,"H"
2020-09-27,2020,"Sivasspor","Ankaragucu","0-0",0,0,"T1",1,0,0,"D"
2020-09-27,2020,"Galatasaray","Fenerbahce","0-0",0,0,"T1",1,0,0,"D"
2020-09-28,2020,"Antalyaspor","Denizlispor","1-0",1,0,"T1",1,1,1,"H"
2020-10-02,2020,"Ankaragucu","Kayserispor","0-1",0,1,"T1",1,1,-1,"A"
2020-10-02,2020,"Gaziantep FK","Trabzonspor","1-1",1,1,"T1",1,2,0,"D"
2020-10-03,2020,"Yeni Malatyaspor","Antalyaspor","1-0",1,0,"T1",1,1,1,"H"
2020-10-03,2020,"Buyuksehyr","Goztep","0-0",0,0,"T1",1,0,0,"D"
2020-10-03,2020,"Erzurum","Rizespor","0-0",0,0,"T1",1,0,0,"D"
2020-10-03,2020,"Fenerbahce","Karagumruk SK","2-1",2,1,"T1",1,3,1,"H"
2020-10-04,2020,"Denizlispor","Konyaspor","0-0",0,0,"T1",1,0,0,"D"
2020-10-04,2020,"Alanyaspor","Hatayspor","6-0",6,0,"T1",1,6,6,"H"
2020-10-04,2020,"Besiktas","Genclerbirligi","0-1",0,1,"T1",1,1,-1,"A"
2020-10-04,2020,"Kasimpasa","Galatasaray","1-0",1,0,"T1",1,1,1,"H"
2020-10-17,2020,"Rizespor","Ankaragucu","5-3",5,3,"T1",1,8,2,"H"
2020-10-17,2020,"Kayserispor","Sivasspor","1-3",1,3,"T1",1,4,-2,"A"
2020-10-17,2020,"Konyaspor","Yeni Malatyaspor","1-1",1,1,"T1",1,2,0,"D"
2020-10-17,2020,"Trabzonspor","Buyuksehyr","0-2",0,2,"T1",1,2,-2,"A"
2020-10-18,2020,"Antalyaspor","Gaziantep FK","1-1",1,1,"T1",1,2,0,"D"
2020-10-18,2020,"Karagumruk SK","Kasimpasa","1-1",1,1,"T1",1,2,0,"D"
2020-10-18,2020,"Goztep","Fenerbahce","2-3",2,3,"T1",1,5,-1,"A"
2020-10-19,2020,"Galatasaray","Alanyaspor","1-2",1,2,"T1",1,3,-1,"A"
2020-10-19,2020,"Genclerbirligi","Denizlispor","1-2",1,2,"T1",1,3,-1,"A"
2020-10-23,2020,"Kasimpasa","Goztep","0-0",0,0,"T1",1,0,0,"D"
2020-10-24,2020,"Gaziantep FK","Konyaspor","1-0",1,0,"T1",1,1,1,"H"
2020-10-24,2020,"Buyuksehyr","Antalyaspor","5-1",5,1,"T1",1,6,4,"H"
2020-10-24,2020,"Erzurum","Galatasaray","1-2",1,2,"T1",1,3,-1,"A"
2020-10-25,2020,"Yeni Malatyaspor","Genclerbirligi","2-1",2,1,"T1",1,3,1,"H"
2020-10-25,2020,"Alanyaspor","Karagumruk SK","2-0",2,0,"T1",1,2,2,"H"
2020-10-25,2020,"Fenerbahce","Trabzonspor","3-1",3,1,"T1",1,4,2,"H"
2020-10-26,2020,"Denizlispor","Besiktas","2-3",2,3,"T1",1,5,-1,"A"
2020-10-26,2020,"Sivasspor","Rizespor","0-2",0,2,"T1",1,2,-2,"A"
2020-10-30,2020,"Karagumruk SK","Erzurum","5-1",5,1,"T1",1,6,4,"H"
2020-10-30,2020,"Trabzonspor","Kasimpasa","3-4",3,4,"T1",1,7,-1,"A"
2020-10-31,2020,"Genclerbirligi","Gaziantep FK","1-1",1,1,"T1",1,2,0,"D"
2020-10-31,2020,"Galatasaray","Ankaragucu","1-0",1,0,"T1",1,1,1,"H"
2020-11-01,2020,"Rizespor","Kayserispor","1-0",1,0,"T1",1,1,1,"H"
2020-11-01,2020,"Konyaspor","Buyuksehyr","1-2",1,2,"T1",1,3,-1,"A"
2020-11-01,2020,"Besiktas","Yeni Malatyaspor","1-0",1,0,"T1",1,1,1,"H"
2020-11-02,2020,"Antalyaspor","Fenerbahce","1-2",1,2,"T1",1,3,-1,"A"
2020-11-02,2020,"Hatayspor","Sivasspor","1-1",1,1,"T1",1,2,0,"D"
2020-11-06,2020,"Gaziantep FK","Besiktas","3-1",3,1,"T1",1,4,2,"H"
2020-11-07,2020,"Kasimpasa","Antalyaspor","2-2",2,2,"T1",1,4,0,"D"
2020-11-07,2020,"Alanyaspor","Trabzonspor","1-1",1,1,"T1",1,2,0,"D"
2020-11-07,2020,"Erzurum","Goztep","1-1",1,1,"T1",1,2,0,"D"
2020-11-07,2020,"Fenerbahce","Konyaspor","0-2",0,2,"T1",1,2,-2,"A"
2020-11-08,2020,"Ankaragucu","Karagumruk SK","2-2",2,2,"T1",1,4,0,"D"
2020-11-08,2020,"Yeni Malatyaspor","Denizlispor","2-0",2,0,"T1",1,2,2,"H"
2020-11-08,2020,"Buyuksehyr","Genclerbirligi","2-1",2,1,"T1",1,3,1,"H"
2020-11-08,2020,"Kayserispor","Hatayspor","0-1",0,1,"T1",1,1,-1,"A"
2020-11-08,2020,"Sivasspor","Galatasaray","1-2",1,2,"T1",1,3,-1,"A"
2020-11-21,2020,"Karagumruk SK","Sivasspor","1-1",1,1,"T1",1,2,0,"D"
2020-11-21,2020,"Denizlispor","Gaziantep FK","0-1",0,1,"T1",1,1,-1,"A"
2020-11-21,2020,"Genclerbirligi","Fenerbahce","1-5",1,5,"T1",1,6,-4,"A"
2020-11-21,2020,"Besiktas","Buyuksehyr","3-2",3,2,"T1",1,5,1,"H"
2020-11-22,2020,"Hatayspor","Rizespor","2-2",2,2,"T1",1,4,0,"D"
2020-11-22,2020,"Goztep","Ankaragucu","3-1",3,1,"T1",1,4,2,"H"
2020-11-22,2020,"Konyaspor","Kasimpasa","2-1",2,1,"T1",1,3,1,"H"
2020-11-22,2020,"Antalyaspor","Alanyaspor","0-2",0,2,"T1",1,2,-2,"A"
2020-11-22,2020,"Trabzonspor","Erzurum","1-0",1,0,"T1",1,1,1,"H"
2020-11-23,2020,"Galatasaray","Kayserispor","1-1",1,1,"T1",1,2,0,"D"
2020-11-27,2020,"Ankaragucu","Trabzonspor","0-1",0,1,"T1",1,1,-1,"A"
2020-11-28,2020,"Gaziantep FK","Yeni Malatyaspor","2-2",2,2,"T1",1,4,0,"D"
2020-11-28,2020,"Buyuksehyr","Denizlispor","3-3",3,3,"T1",1,6,0,"D"
2020-11-28,2020,"Rizespor","Galatasaray","0-4",0,4,"T1",1,4,-4,"A"
2020-11-29,2020,"Erzurum","Antalyaspor","2-2",2,2,"T1",1,4,0,"D"
2020-11-29,2020,"Alanyaspor","Konyaspor","1-0",1,0,"T1",1,1,1,"H"
2020-11-29,2020,"Kasimpasa","Genclerbirligi","2-0",2,0,"T1",1,2,2,"H"
2020-11-29,2020,"Fenerbahce","Besiktas","3-4",3,4,"T1",1,7,-1,"A"
2020-11-30,2020,"Kayserispor","Karagumruk SK","0-0",0,0,"T1",1,0,0,"D"
2020-11-30,2020,"Sivasspor","Goztep","0-1",0,1,"T1",1,1,-1,"A"
2020-12-04,2020,"Besiktas","Kasimpasa","3-0",3,0,"T1",1,3,3,"H"
2020-12-05,2020,"Genclerbirligi","Alanyaspor","2-1",2,1,"T1",1,3,1,"H"
2020-12-05,2020,"Goztep","Kayserispor","1-1",1,1,"T1",1,2,0,"D"
2020-12-05,2020,"Konyaspor","Erzurum","2-0",2,0,"T1",1,2,2,"H"
2020-12-05,2020,"Yeni Malatyaspor","Buyuksehyr","1-1",1,1,"T1",1,2,0,"D"
2020-12-05,2020,"Galatasaray","Hatayspor","3-0",3,0,"T1",1,3,3,"H"
2020-12-06,2020,"Karagumruk SK","Rizespor","2-1",2,1,"T1",1,3,1,"H"
2020-12-06,2020,"Antalyaspor","Ankaragucu","1-0",1,0,"T1",1,1,1,"H"
2020-12-06,2020,"Denizlispor","Fenerbahce","0-2",0,2,"T1",1,2,-2,"A"
2020-12-07,2020,"Trabzonspor","Sivasspor","1-1",1,1,"T1",1,2,0,"D"
2020-12-09,2020,"Goztep","Alanyaspor","1-0",1,0,"T1",1,1,1,"H"
2020-12-09,2020,"Hatayspor","Erzurum","3-0",3,0,"T1",1,3,3,"H"
2020-12-11,2020,"Kasimpasa","Denizlispor","3-2",3,2,"T1",1,5,1,"H"
2020-12-12,2020,"Hatayspor","Karagumruk SK","3-1",3,1,"T1",1,4,2,"H"
2020-12-12,2020,"Kayserispor","Trabzonspor","0-0",0,0,"T1",1,0,0,"D"
2020-12-12,2020,"Rizespor","Goztep","3-2",3,2,"T1",1,5,1,"H"
2020-12-12,2020,"Ankaragucu","Konyaspor","4-3",4,3,"T1",1,7,1,"H"
2020-12-12,2020,"Fenerbahce","Yeni Malatyaspor","0-3",0,3,"T1",1,3,-3,"A"
2020-12-13,2020,"Erzurum","Genclerbirligi","0-1",0,1,"T1",1,1,-1,"A"
2020-12-13,2020,"Alanyaspor","Besiktas","2-1",2,1,"T1",1,3,1,"H"
2020-12-13,2020,"Buyuksehyr","Gaziantep FK","1-2",1,2,"T1",1,3,-1,"A"
2020-12-14,2020,"Sivasspor","Antalyaspor","0-0",0,0,"T1",1,0,0,"D"
2020-12-15,2020,"Ankaragucu","Hatayspor","2-0",2,0,"T1",1,2,2,"H"
2020-12-18,2020,"Karagumruk SK","Galatasaray","2-1",2,1,"T1",1,3,1,"H"
2020-12-19,2020,"Goztep","Hatayspor","0-1",0,1,"T1",1,1,-1,"A"
2020-12-19,2020,"Trabzonspor","Rizespor","2-1",2,1,"T1",1,3,1,"H"
2020-12-19,2020,"Yeni Malatyaspor","Kasimpasa","2-0",2,0,"T1",1,2,2,"H"
2020-12-19,2020,"Gaziantep FK","Fenerbahce","3-1",3,1,"T1",1,4,2,"H"
2020-12-20,2020,"Genclerbirligi","Ankaragucu","1-1",1,1,"T1",1,2,0,"D"
2020-12-20,2020,"Denizlispor","Alanyaspor","1-0",1,0,"T1",1,1,1,"H"
2020-12-20,2020,"Besiktas","Erzurum","4-0",4,0,"T1",1,4,4,"H"
2020-12-21,2020,"Antalyaspor","Kayserispor","2-0",2,0,"T1",1,2,2,"H"
2020-12-21,2020,"Konyaspor","Sivasspor","0-1",0,1,"T1",1,1,-1,"A"
2020-12-22,2020,"Hatayspor","Trabzonspor","0-1",0,1,"T1",1,1,-1,"A"
2020-12-22,2020,"Galatasaray","Goztep","3-1",3,1,"T1",1,4,2,"H"
2020-12-23,2020,"Alanyaspor","Yeni Malatyaspor","1-1",1,1,"T1",1,2,0,"D"
2020-12-23,2020,"Erzurum","Denizlispor","1-2",1,2,"T1",1,3,-1,"A"
2020-12-23,2020,"Fenerbahce","Buyuksehyr","4-1",4,1,"T1",1,5,3,"H"
2020-12-23,2020,"Kasimpasa","Gaziantep FK","0-4",0,4,"T1",1,4,-4,"A"
2020-12-24,2020,"Kayserispor","Konyaspor","1-2",1,2,"T1",1,3,-1,"A"
2020-12-24,2020,"Sivasspor","Genclerbirligi","3-1",3,1,"T1",1,4,2,"H"
2020-12-24,2020,"Ankaragucu","Besiktas","0-1",0,1,"T1",1,1,-1,"A"
2020-12-24,2020,"Rizespor","Antalyaspor","2-1",2,1,"T1",1,3,1,"H"
2020-12-26,2020,"Goztep","Karagumruk SK","1-1",1,1,"T1",1,2,0,"D"
2020-12-26,2020,"Trabzonspor","Galatasaray","0-2",0,2,"T1",1,2,-2,"A"
2020-12-27,2020,"Gaziantep FK","Alanyaspor","3-1",3,1,"T1",1,4,2,"H"
2020-12-27,2020,"Denizlispor","Ankaragucu","1-2",1,2,"T1",1,3,-1,"A"
2020-12-27,2020,"Yeni Malatyaspor","Erzurum","1-3",1,3,"T1",1,4,-2,"A"
2020-12-27,2020,"Buyuksehyr","Kasimpasa","2-2",2,2,"T1",1,4,0,"D"
2020-12-28,2020,"Genclerbirligi","Kayserispor","3-2",3,2,"T1",1,5,1,"H"
2020-12-28,2020,"Konyaspor","Rizespor","1-1",1,1,"T1",1,2,0,"D"
2020-12-28,2020,"Besiktas","Sivasspor","3-0",3,0,"T1",1,3,3,"H"
2020-12-29,2020,"Antalyaspor","Hatayspor","0-6",0,6,"T1",1,6,-6,"A"
2021-01-02,2020,"Erzurum","Gaziantep FK","1-1",1,1,"T1",1,2,0,"D"
2021-01-02,2020,"Sivasspor","Denizlispor","2-2",2,2,"T1",1,4,0,"D"
2021-01-02,2020,"Alanyaspor","Buyuksehyr","3-0",3,0,"T1",1,3,3,"H"
2021-01-02,2020,"Ankaragucu","Yeni Malatyaspor","3-1",3,1,"T1",1,4,2,"H"
2021-01-02,2020,"Galatasaray","Antalyaspor","0-0",0,0,"T1",1,0,0,"D"
2021-01-02,2020,"Hatayspor","Konyaspor","2-1",2,1,"T1",1,3,1,"H"
2021-01-03,2020,"Rizespor","Genclerbirligi","1-1",1,1,"T1",1,2,0,"D"
2021-01-03,2020,"Karagumruk SK","Trabzonspor","1-2",1,2,"T1",1,3,-1,"A"
2021-01-03,2020,"Kayserispor","Besiktas","0-2",0,2,"T1",1,2,-2,"A"
2021-01-04,2020,"Kasimpasa","Fenerbahce","0-3",0,3,"T1",1,3,-3,"A"
2021-01-05,2020,"Gaziantep FK","Ankaragucu","2-0",2,0,"T1",1,2,2,"H"
2021-01-05,2020,"Yeni Malatyaspor","Sivasspor","2-2",2,2,"T1",1,4,0,"D"
2021-01-05,2020,"Konyaspor","Galatasaray","4-3",4,3,"T1",1,7,1,"H"
2021-01-06,2020,"Denizlispor","Kayserispor","0-1",0,1,"T1",1,1,-1,"A"
2021-01-06,2020,"Buyuksehyr","Erzurum","1-0",1,0,"T1",1,1,1,"H"
2021-01-06,2020,"Genclerbirligi","Hatayspor","3-1",3,1,"T1",1,4,2,"H"
2021-01-06,2020,"Trabzonspor","Goztep","1-0",1,0,"T1",1,1,1,"H"
2021-01-06,2020,"Antalyaspor","Karagumruk SK","3-1",3,1,"T1",1,4,2,"H"
2021-01-06,2020,"Besiktas","Rizespor","6-0",6,0,"T1",1,6,6,"H"
2021-01-07,2020,"Fenerbahce","Alanyaspor","2-1",2,1,"T1",1,3,1,"H"
2021-01-09,2020,"Sivasspor","Gaziantep FK","2-1",2,1,"T1",1,3,1,"H"
2021-01-09,2020,"Goztep","Antalyaspor","0-1",0,1,"T1",1,1,-1,"A"
2021-01-09,2020,"Kayserispor","Yeni Malatyaspor","1-0",1,0,"T1",1,1,1,"H"
2021-01-09,2020,"Galatasaray","Genclerbirligi","6-0",6,0,"T1",1,6,6,"H"
2021-01-10,2020,"Karagumruk SK","Konyaspor","2-1",2,1,"T1",1,3,1,"H"
2021-01-10,2020,"Ankaragucu","Buyuksehyr","1-2",1,2,"T1",1,3,-1,"A"
2021-01-10,2020,"Rizespor","Denizlispor","1-1",1,1,"T1",1,2,0,"D"
2021-01-10,2020,"Hatayspor","Besiktas","2-2",2,2,"T1",1,4,0,"D"
2021-01-11,2020,"Erzurum","Fenerbahce","0-3",0,3,"T1",1,3,-3,"A"
2021-01-11,2020,"Alanyaspor","Kasimpasa","1-2",1,2,"T1",1,3,-1,"A"
2021-01-15,2020,"Genclerbirligi","Karagumruk SK","1-3",1,3,"T1",1,4,-2,"A"
2021-01-16,2020,"Konyaspor","Goztep","2-3",2,3,"T1",1,5,-1,"A"
2021-01-16,2020,"Buyuksehyr","Sivasspor","1-1",1,1,"T1",1,2,0,"D"
2021-01-16,2020,"Gaziantep FK","Kayserispor","2-1",2,1,"T1",1,3,1,"H"
2021-01-16,2020,"Antalyaspor","Trabzonspor","1-1",1,1,"T1",1,2,0,"D"
2021-01-17,2020,"Denizlispor","Hatayspor","0-2",0,2,"T1",1,2,-2,"A"
2021-01-17,2020,"Yeni Malatyaspor","Rizespor","4-1",4,1,"T1",1,5,3,"H"
2021-01-17,2020,"Besiktas","Galatasaray","2-0",2,0,"T1",1,2,2,"H"
2021-01-18,2020,"Fenerbahce","Ankaragucu","3-1",3,1,"T1",1,4,2,"H"
2021-01-18,2020,"Kasimpasa","Erzurum","1-2",1,2,"T1",1,3,-1,"A"
2021-01-19,2020,"Goztep","Genclerbirligi","4-0",4,0,"T1",1,4,4,"H"
2021-01-19,2020,"Kayserispor","Buyuksehyr","2-0",2,0,"T1",1,2,2,"H"
2021-01-19,2020,"Trabzonspor","Konyaspor","3-1",3,1,"T1",1,4,2,"H"
2021-01-20,2020,"Hatayspor","Yeni Malatyaspor","1-2",1,2,"T1",1,3,-1,"A"
2021-01-20,2020,"Rizespor","Gaziantep FK","3-0",3,0,"T1",1,3,3,"H"
2021-01-20,2020,"Galatasaray","Denizlispor","6-1",6,1,"T1",1,7,5,"H"
2021-01-21,2020,"Erzurum","Alanyaspor","1-1",1,1,"T1",1,2,0,"D"
2021-01-21,2020,"Karagumruk SK","Besiktas","1-4",1,4,"T1",1,5,-3,"A"
2021-01-21,2020,"Ankaragucu","Kasimpasa","1-0",1,0,"T1",1,1,1,"H"
2021-01-21,2020,"Sivasspor","Fenerbahce","1-1",1,1,"T1",1,2,0,"D"
2021-01-23,2020,"Genclerbirligi","Trabzonspor","1-2",1,2,"T1",1,3,-1,"A"
2021-01-23,2020,"Buyuksehyr","Rizespor","1-1",1,1,"T1",1,2,0,"D"
2021-01-24,2020,"Konyaspor","Antalyaspor","0-0",0,0,"T1",1,0,0,"D"
2021-01-24,2020,"Denizlispor","Karagumruk SK","1-2",1,2,"T1",1,3,-1,"A"
2021-01-24,2020,"Yeni Malatyaspor","Galatasaray","0-1",0,1,"T1",1,1,-1,"A"
2021-01-24,2020,"Besiktas","Goztep","2-1",2,1,"T1",1,3,1,"H"
2021-01-24,2020,"Gaziantep FK","Hatayspor","1-1",1,1,"T1",1,2,0,"D"
2021-01-25,2020,"Kasimpasa","Sivasspor","2-0",2,0,"T1",1,2,2,"H"
2021-01-25,2020,"Alanyaspor","Ankaragucu","4-3",4,3,"T1",1,7,1,"H"
2021-01-25,2020,"Fenerbahce","Kayserispor","3-0",3,0,"T1",1,3,3,"H"
2021-01-29,2020,"Yeni Malatyaspor","Karagumruk SK","0-0",0,0,"T1",1,0,0,"D"
2021-01-29,2020,"Gaziantep FK","Galatasaray","1-2",1,2,"T1",1,3,-1,"A"
2021-01-30,2020,"Kasimpasa","Kayserispor","0-1",0,1,"T1",1,1,-1,"A"
2021-01-30,2020,"Buyuksehyr","Hatayspor","1-5",1,5,"T1",1,6,-4,"A"
2021-01-30,2020,"Fenerbahce","Rizespor","1-0",1,0,"T1",1,1,1,"H"
2021-01-31,2020,"Erzurum","Ankaragucu","1-0",1,0,"T1",1,1,1,"H"
2021-01-31,2020,"Alanyaspor","Sivasspor","3-1",3,1,"T1",1,4,2,"H"
2021-01-31,2020,"Denizlispor","Goztep","2-1",2,1,"T1",1,3,1,"H"
2021-01-31,2020,"Genclerbirligi","Antalyaspor","0-1",0,1,"T1",1,1,-1,"A"
2021-01-31,2020,"Besiktas","Trabzonspor","1-2",1,2,"T1",1,3,-1,"A"
2021-02-02,2020,"Hatayspor","Fenerbahce","1-2",1,2,"T1",1,3,-1,"A"
2021-02-02,2020,"Galatasaray","Buyuksehyr","3-0",3,0,"T1",1,3,3,"H"
2021-02-02,2020,"Rizespor","Kasimpasa","1-1",1,1,"T1",1,2,0,"D"
2021-02-03,2020,"Sivasspor","Erzurum","0-0",0,0,"T1",1,0,0,"D"
2021-02-03,2020,"Karagumruk SK","Gaziantep FK","2-0",2,0,"T1",1,2,2,"H"
2021-02-03,2020,"Kayserispor","Alanyaspor","1-1",1,1,"T1",1,2,0,"D"
2021-02-03,2020,"Antalyaspor","Besiktas","1-1",1,1,"T1",1,2,0,"D"
2021-02-03,2020,"Konyaspor","Genclerbirligi","0-0",0,0,"T1",1,0,0,"D"
2021-02-04,2020,"Goztep","Yeni Malatyaspor","2-2",2,2,"T1",1,4,0,"D"
2021-02-04,2020,"Trabzonspor","Denizlispor","1-0",1,0,"T1",1,1,1,"H"
2021-02-06,2020,"Kasimpasa","Hatayspor","1-4",1,4,"T1",1,5,-3,"A"
2021-02-06,2020,"Alanyaspor","Rizespor","2-1",2,1,"T1",1,3,1,"H"
2021-02-06,2020,"Buyuksehyr","Karagumruk SK","0-1",0,1,"T1",1,1,-1,"A"
2021-02-06,2020,"Fenerbahce","Galatasaray","0-1",0,1,"T1",1,1,-1,"A"
2021-02-07,2020,"Erzurum","Kayserispor","1-1",1,1,"T1",1,2,0,"D"
2021-02-07,2020,"Ankaragucu","Sivasspor","1-4",1,4,"T1",1,5,-3,"A"
2021-02-07,2020,"Denizlispor","Antalyaspor","1-1",1,1,"T1",1,2,0,"D"
2021-02-07,2020,"Besiktas","Konyaspor","1-0",1,0,"T1",1,1,1,"H"
2021-02-08,2020,"Gaziantep FK","Goztep","2-0",2,0,"T1",1,2,2,"H"
2021-02-08,2020,"Yeni Malatyaspor","Trabzonspor","0-2",0,2,"T1",1,2,-2,"A"
2021-02-12,2020,"Rizespor","Erzurum","0-2",0,2,"T1",1,2,-2,"A"
2021-02-13,2020,"Kayserispor","Ankaragucu","0-0",0,0,"T1",1,0,0,"D"
2021-02-13,2020,"Trabzonspor","Gaziantep FK","1-0",1,0,"T1",1,1,1,"H"
2021-02-13,2020,"Karagumruk SK","Fenerbahce","1-2",1,2,"T1",1,3,-1,"A"
2021-02-14,2020,"Konyaspor","Denizlispor","2-0",2,0,"T1",1,2,2,"H"
2021-02-14,2020,"Galatasaray","Kasimpasa","2-1",2,1,"T1",1,3,1,"H"
2021-02-14,2020,"Goztep","Buyuksehyr","2-1",2,1,"T1",1,3,1,"H"
2021-02-14,2020,"Hatayspor","Alanyaspor","0-0",0,0,"T1",1,0,0,"D"
2021-02-15,2020,"Genclerbirligi","Besiktas","0-3",0,3,"T1",1,3,-3,"A"
2021-02-15,2020,"Antalyaspor","Yeni Malatyaspor","1-1",1,1,"T1",1,2,0,"D"
2021-02-19,2020,"Buyuksehyr","Trabzonspor","0-1",0,1,"T1",1,1,-1,"A"
2021-02-20,2020,"Kasimpasa","Karagumruk SK","3-2",3,2,"T1",1,5,1,"H"
2021-02-20,2020,"Denizlispor","Genclerbirligi","1-0",1,0,"T1",1,1,1,"H"
2021-02-20,2020,"Yeni Malatyaspor","Konyaspor","2-3",2,3,"T1",1,5,-1,"A"
2021-02-20,2020,"Alanyaspor","Galatasaray","0-1",0,1,"T1",1,1,-1,"A"
2021-02-21,2020,"Erzurum","Hatayspor","1-3",1,3,"T1",1,4,-2,"A"
2021-02-21,2020,"Gaziantep FK","Antalyaspor","0-0",0,0,"T1",1,0,0,"D"
2021-02-21,2020,"Sivasspor","Kayserispor","2-0",2,0,"T1",1,2,2,"H"
2021-02-21,2020,"Fenerbahce","Goztep","0-1",0,1,"T1",1,1,-1,"A"
2021-02-22,2020,"Ankaragucu","Rizespor","1-1",1,1,"T1",1,2,0,"D"
2021-02-26,2020,"Genclerbirligi","Yeni Malatyaspor","1-1",1,1,"T1",1,2,0,"D"
2021-02-26,2020,"Konyaspor","Gaziantep FK","0-0",0,0,"T1",1,0,0,"D"
2021-02-26,2020,"Besiktas","Denizlispor","3-0",3,0,"T1",1,3,3,"H"
2021-02-27,2020,"Hatayspor","Ankaragucu","4-1",4,1,"T1",1,5,3,"H"
2021-02-27,2020,"Karagumruk SK","Alanyaspor","2-0",2,0,"T1",1,2,2,"H"
2021-02-27,2020,"Antalyaspor","Buyuksehyr","0-0",0,0,"T1",1,0,0,"D"
2021-02-27,2020,"Rizespor","Sivasspor","0-0",0,0,"T1",1,0,0,"D"
2021-02-27,2020,"Galatasaray","Erzurum","2-0",2,0,"T1",1,2,2,"H"
2021-02-28,2020,"Goztep","Kasimpasa","1-0",1,0,"T1",1,1,1,"H"
2021-02-28,2020,"Trabzonspor","Fenerbahce","0-1",0,1,"T1",1,1,-1,"A"
2021-03-02,2020,"Gaziantep FK","Genclerbirligi","2-1",2,1,"T1",1,3,1,"H"
2021-03-02,2020,"Yeni Malatyaspor","Besiktas","0-1",0,1,"T1",1,1,-1,"A"
2021-03-03,2020,"Erzurum","Karagumruk SK","2-2",2,2,"T1",1,4,0,"D"
2021-03-03,2020,"Buyuksehyr","Konyaspor","1-1",1,1,"T1",1,2,0,"D"
2021-03-03,2020,"Sivasspor","Hatayspor","1-1",1,1,"T1",1,2,0,"D"
2021-03-03,2020,"Ankaragucu","Galatasaray","2-1",2,1,"T1",1,3,1,"H"
2021-03-03,2020,"Kayserispor","Rizespor","2-1",2,1,"T1",1,3,1,"H"
2021-03-04,2020,"Alanyaspor","Goztep","1-1",1,1,"T1",1,2,0,"D"
2021-03-04,2020,"Kasimpasa","Trabzonspor","1-2",1,2,"T1",1,3,-1,"A"
2021-03-04,2020,"Fenerbahce","Antalyaspor","1-1",1,1,"T1",1,2,0,"D"
2021-03-06,2020,"Denizlispor","Yeni Malatyaspor","3-2",3,2,"T1",1,5,1,"H"
2021-03-06,2020,"Besiktas","Gaziantep FK","2-1",2,1,"T1",1,3,1,"H"
2021-03-07,2020,"Karagumruk SK","Ankaragucu","0-1",0,1,"T1",1,1,-1,"A"
2021-03-07,2020,"Genclerbirligi","Buyuksehyr","0-1",0,1,"T1",1,1,-1,"A"
2021-03-07,2020,"Hatayspor","Kayserispor","1-3",1,3,"T1",1,4,-2,"A"
2021-03-07,2020,"Galatasaray","Sivasspor","2-2",2,2,"T1",1,4,0,"D"
2021-03-08,2020,"Antalyaspor","Kasimpasa","1-1",1,1,"T1",1,2,0,"D"
2021-03-08,2020,"Trabzonspor","Alanyaspor","1-3",1,3,"T1",1,4,-2,"A"
2021-03-08,2020,"Goztep","Erzurum","3-1",3,1,"T1",1,4,2,"H"
2021-03-08,2020,"Konyaspor","Fenerbahce","0-3",0,3,"T1",1,3,-3,"A"
2021-03-12,2020,"Buyuksehyr","Besiktas","2-3",2,3,"T1",1,5,-1,"A"
2021-03-13,2020,"Sivasspor","Karagumruk SK","1-0",1,0,"T1",1,1,1,"H"
2021-03-13,2020,"Alanyaspor","Antalyaspor","4-0",4,0,"T1",1,4,4,"H"
2021-03-13,2020,"Rizespor","Hatayspor","1-0",1,0,"T1",1,1,1,"H"
2021-03-13,2020,"Kayserispor","Galatasaray","0-3",0,3,"T1",1,3,-3,"A"
2021-03-14,2020,"Ankaragucu","Goztep","3-0",3,0,"T1",1,3,3,"H"
2021-03-14,2020,"Erzurum","Trabzonspor","0-0",0,0,"T1",1,0,0,"D"
2021-03-14,2020,"Gaziantep FK","Denizlispor","2-0",2,0,"T1",1,2,2,"H"
2021-03-14,2020,"Fenerbahce","Genclerbirligi","1-2",1,2,"T1",1,3,-1,"A"
2021-03-15,2020,"Kasimpasa","Konyaspor","1-1",1,1,"T1",1,2,0,"D"
2021-03-19,2020,"Karagumruk SK","Kayserispor","3-0",3,0,"T1",1,3,3,"H"
2021-03-19,2020,"Galatasaray","Rizespor","3-4",3,4,"T1",1,7,-1,"A"
2021-03-20,2020,"Genclerbirligi","Kasimpasa","2-1",2,1,"T1",1,3,1,"H"
2021-03-20,2020,"Goztep","Sivasspor","3-5",3,5,"T1",1,8,-2,"A"
2021-03-20,2020,"Yeni Malatyaspor","Gaziantep FK","2-2",2,2,"T1",1,4,0,"D"
2021-03-20,2020,"Trabzonspor","Ankaragucu","4-1",4,1,"T1",1,5,3,"H"
2021-03-21,2020,"Antalyaspor","Erzurum","3-1",3,1,"T1",1,4,2,"H"
2021-03-21,2020,"Konyaspor","Alanyaspor","1-0",1,0,"T1",1,1,1,"H"
2021-03-21,2020,"Denizlispor","Buyuksehyr","0-0",0,0,"T1",1,0,0,"D"
2021-03-21,2020,"Besiktas","Fenerbahce","1-1",1,1,"T1",1,2,0,"D"
2021-04-03,2020,"Kayserispor","Goztep","1-1",1,1,"T1",1,2,0,"D"
2021-04-03,2020,"Rizespor","Karagumruk SK","0-0",0,0,"T1",1,0,0,"D"
2021-04-03,2020,"Sivasspor","Trabzonspor","0-0",0,0,"T1",1,0,0,"D"
2021-04-03,2020,"Hatayspor","Galatasaray","3-0",3,0,"T1",1,3,3,"H"
2021-04-04,2020,"Erzurum","Konyaspor","1-2",1,2,"T1",1,3,-1,"A"
2021-04-04,2020,"Alanyaspor","Genclerbirligi","1-2",1,2,"T1",1,3,-1,"A"
2021-04-04,2020,"Ankaragucu","Antalyaspor","1-0",1,0,"T1",1,1,1,"H"
2021-04-04,2020,"Buyuksehyr","Yeni Malatyaspor","3-1",3,1,"T1",1,4,2,"H"
2021-04-04,2020,"Kasimpasa","Besiktas","1-0",1,0,"T1",1,1,1,"H"
2021-04-05,2020,"Fenerbahce","Denizlispor","1-0",1,0,"T1",1,1,1,"H"
2021-04-06,2020,"Goztep","Rizespor","2-0",2,0,"T1",1,2,2,"H"
2021-04-06,2020,"Karagumruk SK","Hatayspor","1-0",1,0,"T1",1,1,1,"H"
2021-04-06,2020,"Trabzonspor","Kayserispor","1-1",1,1,"T1",1,2,0,"D"
2021-04-07,2020,"Genclerbirligi","Erzurum","1-1",1,1,"T1",1,2,0,"D"
2021-04-07,2020,"Konyaspor","Ankaragucu","1-1",1,1,"T1",1,2,0,"D"
2021-04-07,2020,"Antalyaspor","Sivasspor","2-4",2,4,"T1",1,6,-2,"A"
2021-04-07,2020,"Besiktas","Alanyaspor","3-0",3,0,"T1",1,3,3,"H"
2021-04-08,2020,"Denizlispor","Kasimpasa","1-1",1,1,"T1",1,2,0,"D"
2021-04-08,2020,"Gaziantep FK","Buyuksehyr","2-0",2,0,"T1",1,2,2,"H"
2021-04-08,2020,"Yeni Malatyaspor","Fenerbahce","1-1",1,1,"T1",1,2,0,"D"
2021-04-10,2020,"Hatayspor","Goztep","2-3",2,3,"T1",1,5,-1,"A"
2021-04-10,2020,"Rizespor","Trabzonspor","0-0",0,0,"T1",1,0,0,"D"
2021-04-10,2020,"Galatasaray","Karagumruk SK","1-1",1,1,"T1",1,2,0,"D"
2021-04-11,2020,"Sivasspor","Konyaspor","3-1",3,1,"T1",1,4,2,"H"
2021-04-11,2020,"Ankaragucu","Genclerbirligi","2-1",2,1,"T1",1,3,1,"H"
2021-04-11,2020,"Kayserispor","Antalyaspor","0-1",0,1,"T1",1,1,-1,"A"
2021-04-11,2020,"Erzurum","Besiktas","2-4",2,4,"T1",1,6,-2,"A"
2021-04-12,2020,"Kasimpasa","Yeni Malatyaspor","0-0",0,0,"T1",1,0,0,"D"
2021-04-12,2020,"Alanyaspor","Denizlispor","3-2",3,2,"T1",1,5,1,"H"
2021-04-12,2020,"Fenerbahce","Gaziantep FK","3-1",3,1,"T1",1,4,2,"H"
2021-04-16,2020,"Genclerbirligi","Sivasspor","2-3",2,3,"T1",1,5,-1,"A"
2021-04-16,2020,"Konyaspor","Kayserispor","0-0",0,0,"T1",1,0,0,"D"
2021-04-16,2020,"Antalyaspor","Rizespor","2-3",2,3,"T1",1,5,-1,"A"
2021-04-16,2020,"Besiktas","Ankaragucu","2-2",2,2,"T1",1,4,0,"D"
2021-04-17,2020,"Denizlispor","Erzurum","2-3",2,3,"T1",1,5,-1,"A"
2021-04-17,2020,"Trabzonspor","Hatayspor","1-1",1,1,"T1",1,2,0,"D"
2021-04-17,2020,"Yeni Malatyaspor","Alanyaspor","1-0",1,0,"T1",1,1,1,"H"
2021-04-17,2020,"Goztep","Galatasaray","1-3",1,3,"T1",1,4,-2,"A"
2021-04-18,2020,"Gaziantep FK","Kasimpasa","2-2",2,2,"T1",1,4,0,"D"
2021-04-18,2020,"Buyuksehyr","Fenerbahce","1-2",1,2,"T1",1,3,-1,"A"
2021-04-20,2020,"Karagumruk SK","Goztep","1-1",1,1,"T1",1,2,0,"D"
2021-04-20,2020,"Kayserispor","Genclerbirligi","2-2",2,2,"T1",1,4,0,"D"
2021-04-20,2020,"Rizespor","Konyaspor","5-3",5,3,"T1",1,8,2,"H"
2021-04-20,2020,"Hatayspor","Antalyaspor","3-2",3,2,"T1",1,5,1,"H"
2021-04-20,2020,"Sivasspor","Besiktas","0-0",0,0,"T1",1,0,0,"D"
2021-04-21,2020,"Ankaragucu","Denizlispor","1-1",1,1,"T1",1,2,0,"D"
2021-04-21,2020,"Erzurum","Yeni Malatyaspor","1-0",1,0,"T1",1,1,1,"H"
2021-04-21,2020,"Galatasaray","Trabzonspor","1-1",1,1,"T1",1,2,0,"D"
2021-04-22,2020,"Alanyaspor","Gaziantep FK","3-2",3,2,"T1",1,5,1,"H"
2021-04-22,2020,"Kasimpasa","Buyuksehyr","0-1",0,1,"T1",1,1,-1,"A"
2021-04-23,2020,"Genclerbirligi","Rizespor","2-1",2,1,"T1",1,3,1,"H"
2021-04-24,2020,"Konyaspor","Hatayspor","0-0",0,0,"T1",1,0,0,"D"
2021-04-24,2020,"Trabzonspor","Karagumruk SK","2-0",2,0,"T1",1,2,2,"H"
2021-04-24,2020,"Antalyaspor","Galatasaray","0-1",0,1,"T1",1,1,-1,"A"
2021-04-24,2020,"Besiktas","Kayserispor","3-1",3,1,"T1",1,4,2,"H"
2021-04-24,2020,"Denizlispor","Sivasspor","1-1",1,1,"T1",1,2,0,"D"
2021-04-25,2020,"Yeni Malatyaspor","Ankaragucu","2-1",2,1,"T1",1,3,1,"H"
2021-04-25,2020,"Buyuksehyr","Alanyaspor","0-0",0,0,"T1",1,0,0,"D"
2021-04-25,2020,"Gaziantep FK","Erzurum","2-3",2,3,"T1",1,5,-1,"A"
2021-04-25,2020,"Fenerbahce","Kasimpasa","3-2",3,2,"T1",1,5,1,"H"
2021-04-27,2020,"Hatayspor","Genclerbirligi","3-1",3,1,"T1",1,4,2,"H"
2021-04-28,2020,"Goztep","Trabzonspor","1-1",1,1,"T1",1,2,0,"D"
2021-04-28,2020,"Karagumruk SK","Antalyaspor","2-2",2,2,"T1",1,4,0,"D"
2021-04-28,2020,"Kayserispor","Denizlispor","6-3",6,3,"T1",1,9,3,"H"
2021-04-28,2020,"Galatasaray","Konyaspor","1-0",1,0,"T1",1,1,1,"H"
2021-04-28,2020,"Rizespor","Besiktas","2-3",2,3,"T1",1,5,-1,"A"
2021-04-29,2020,"Erzurum","Buyuksehyr","1-2",1,2,"T1",1,3,-1,"A"
2021-04-29,2020,"Sivasspor","Yeni Malatyaspor","1-0",1,0,"T1",1,1,1,"H"
2021-04-29,2020,"Alanyaspor","Fenerbahce","0-0",0,0,"T1",1,0,0,"D"
2021-04-29,2020,"Ankaragucu","Gaziantep FK","0-1",0,1,"T1",1,1,-1,"A"
2021-05-01,2020,"Besiktas","Hatayspor","7-0",7,0,"T1",1,7,7,"H"
2021-05-02,2020,"Antalyaspor","Goztep","2-3",2,3,"T1",1,5,-1,"A"
2021-05-02,2020,"Denizlispor","Rizespor","0-1",0,1,"T1",1,1,-1,"A"
2021-05-02,2020,"Konyaspor","Karagumruk SK","5-1",5,1,"T1",1,6,4,"H"
2021-05-02,2020,"Genclerbirligi","Galatasaray","0-2",0,2,"T1",1,2,-2,"A"
2021-05-03,2020,"Buyuksehyr","Ankaragucu","2-1",2,1,"T1",1,3,1,"H"
2021-05-03,2020,"Kasimpasa","Alanyaspor","3-0",3,0,"T1",1,3,3,"H"
2021-05-03,2020,"Yeni Malatyaspor","Kayserispor","1-1",1,1,"T1",1,2,0,"D"
2021-05-03,2020,"Fenerbahce","Erzurum","3-1",3,1,"T1",1,4,2,"H"
2021-05-03,2020,"Gaziantep FK","Sivasspor","0-1",0,1,"T1",1,1,-1,"A"
2021-05-08,2020,"Ankaragucu","Fenerbahce","1-2",1,2,"T1",1,3,-1,"A"
2021-05-08,2020,"Erzurum","Kasimpasa","0-1",0,1,"T1",1,1,-1,"A"
2021-05-08,2020,"Galatasaray","Besiktas","3-1",3,1,"T1",1,4,2,"H"
2021-05-08,2020,"Goztep","Konyaspor","0-1",0,1,"T1",1,1,-1,"A"
2021-05-08,2020,"Hatayspor","Denizlispor","1-0",1,0,"T1",1,1,1,"H"
2021-05-08,2020,"Karagumruk SK","Genclerbirligi","5-1",5,1,"T1",1,6,4,"H"
2021-05-08,2020,"Kayserispor","Gaziantep FK","0-0",0,0,"T1",1,0,0,"D"
2021-05-08,2020,"Rizespor","Yeni Malatyaspor","0-4",0,4,"T1",1,4,-4,"A"
2021-05-08,2020,"Sivasspor","Buyuksehyr","0-0",0,0,"T1",1,0,0,"D"
2021-05-08,2020,"Trabzonspor","Antalyaspor","2-1",2,1,"T1",1,3,1,"H"
2021-05-11,2020,"Konyaspor","Trabzonspor","1-1",1,1,"T1",1,2,0,"D"
2021-05-11,2020,"Alanyaspor","Erzurum","2-3",2,3,"T1",1,5,-1,"A"
2021-05-11,2020,"Besiktas","Karagumruk SK","1-2",1,2,"T1",1,3,-1,"A"
2021-05-11,2020,"Buyuksehyr","Kayserispor","0-0",0,0,"T1",1,0,0,"D"
2021-05-11,2020,"Denizlispor","Galatasaray","1-4",1,4,"T1",1,5,-3,"A"
2021-05-11,2020,"Fenerbahce","Sivasspor","1-2",1,2,"T1",1,3,-1,"A"
2021-05-11,2020,"Gaziantep FK","Rizespor","4-5",4,5,"T1",1,9,-1,"A"
2021-05-11,2020,"Genclerbirligi","Goztep","5-3",5,3,"T1",1,8,2,"H"
2021-05-11,2020,"Kasimpasa","Ankaragucu","3-1",3,1,"T1",1,4,2,"H"
2021-05-11,2020,"Yeni Malatyaspor","Hatayspor","1-1",1,1,"T1",1,2,0,"D"
2021-05-15,2020,"Ankaragucu","Alanyaspor","0-1",0,1,"T1",1,1,-1,"A"
2021-05-15,2020,"Antalyaspor","Konyaspor","0-0",0,0,"T1",1,0,0,"D"
2021-05-15,2020,"Hatayspor","Gaziantep FK","0-1",0,1,"T1",1,1,-1,"A"
2021-05-15,2020,"Karagumruk SK","Denizlispor","5-1",5,1,"T1",1,6,4,"H"
2021-05-15,2020,"Rizespor","Buyuksehyr","0-2",0,2,"T1",1,2,-2,"A"
2021-05-15,2020,"Sivasspor","Kasimpasa","2-1",2,1,"T1",1,3,1,"H"
2021-05-15,2020,"Galatasaray","Yeni Malatyaspor","3-1",3,1,"T1",1,4,2,"H"
2021-05-15,2020,"Goztep","Besiktas","1-2",1,2,"T1",1,3,-1,"A"
2021-05-15,2020,"Kayserispor","Fenerbahce","1-2",1,2,"T1",1,3,-1,"A"
2021-05-15,2020,"Trabzonspor","Genclerbirligi","2-1",2,1,"T1",1,3,1,"H"
2021-08-13,2021,"Besiktas","Rizespor","3-0",3,0,"T1",1,3,3,"H"
2021-08-14,2021,"Karagumruk SK","Gaziantep FK","3-2",3,2,"T1",1,5,1,"H"
2021-08-14,2021,"Altay","Kayserispor","3-0",3,0,"T1",1,3,3,"H"
2021-08-14,2021,"Hatayspor","Kasimpasa","1-1",1,1,"T1",1,2,0,"D"
2021-08-15,2021,"Buyuksehyr","Alanyaspor","0-1",0,1,"T1",1,1,-1,"A"
2021-08-15,2021,"Ad. Demirspor","Fenerbahce","0-1",0,1,"T1",1,1,-1,"A"
2021-08-15,2021,"Antalyaspor","Goztep","1-1",1,1,"T1",1,2,0,"D"
2021-08-16,2021,"Sivasspor","Konyaspor","0-1",0,1,"T1",1,1,-1,"A"
2021-08-16,2021,"Yeni Malatyaspor","Trabzonspor","1-5",1,5,"T1",1,6,-4,"A"
2021-08-16,2021,"Giresunspor","Galatasaray","0-2",0,2,"T1",1,2,-2,"A"
2021-08-20,2021,"Kayserispor","Ad. Demirspor","1-1",1,1,"T1",1,2,0,"D"
2021-08-21,2021,"Kasimpasa","Giresunspor","2-0",2,0,"T1",1,2,2,"H"
2021-08-21,2021,"Rizespor","Karagumruk SK","0-0",0,0,"T1",1,0,0,"D"
2021-08-21,2021,"Alanyaspor","Altay","1-4",1,4,"T1",1,5,-3,"A"
2021-08-21,2021,"Gaziantep FK","Besiktas","0-0",0,0,"T1",1,0,0,"D"
2021-08-22,2021,"Konyaspor","Buyuksehyr","2-1",2,1,"T1",1,3,1,"H"
2021-08-22,2021,"Fenerbahce","Antalyaspor","2-0",2,0,"T1",1,2,2,"H"
2021-08-22,2021,"Goztep","Yeni Malatyaspor","0-1",0,1,"T1",1,1,-1,"A"
2021-08-23,2021,"Trabzonspor","Sivasspor","2-1",2,1,"T1",1,3,1,"H"
2021-08-23,2021,"Galatasaray","Hatayspor","2-1",2,1,"T1",1,3,1,"H"
2021-08-27,2021,"Antalyaspor","Rizespor","3-2",3,2,"T1",1,5,1,"H"
2021-08-27,2021,"Ad. Demirspor","Konyaspor","1-1",1,1,"T1",1,2,0,"D"
2021-08-28,2021,"Buyuksehyr","Kayserispor","0-1",0,1,"T1",1,1,-1,"A"
2021-08-28,2021,"Yeni Malatyaspor","Gaziantep FK","2-0",2,0,"T1",1,2,2,"H"
2021-08-28,2021,"Besiktas","Karagumruk SK","1-0",1,0,"T1",1,1,1,"H"
2021-08-28,2021,"Hatayspor","Alanyaspor","5-0",5,0,"T1",1,5,5,"H"
2021-08-29,2021,"Kasimpasa","Galatasaray","2-2",2,2,"T1",1,4,0,"D"
2021-08-29,2021,"Sivasspor","Goztep","2-2",2,2,"T1",1,4,0,"D"
2021-08-29,2021,"Altay","Fenerbahce","0-2",0,2,"T1",1,2,-2,"A"
2021-08-29,2021,"Giresunspor","Trabzonspor","0-1",0,1,"T1",1,1,-1,"A"
2021-09-11,2021,"Karagumruk SK","Ad. Demirspor","4-0",4,0,"T1",1,4,4,"H"
2021-09-11,2021,"Konyaspor","Altay","3-1",3,1,"T1",1,4,2,"H"
2021-09-11,2021,"Besiktas","Yeni Malatyaspor","3-0",3,0,"T1",1,3,3,"H"
2021-09-11,2021,"Kayserispor","Kasimpasa","2-0",2,0,"T1",1,2,2,"H"
2021-09-12,2021,"Fenerbahce","Sivasspor","1-1",1,1,"T1",1,2,0,"D"
2021-09-12,2021,"Rizespor","Hatayspor","0-2",0,2,"T1",1,2,-2,"A"
2021-09-12,2021,"Goztep","Buyuksehyr","2-1",2,1,"T1",1,3,1,"H"
2021-09-12,2021,"Trabzonspor","Galatasaray","2-2",2,2,"T1",1,4,0,"D"
2021-09-13,2021,"Alanyaspor","Giresunspor","1-0",1,0,"T1",1,1,1,"H"
2021-09-13,2021,"Gaziantep FK","Antalyaspor","2-0",2,0,"T1",1,2,2,"H"
2021-09-17,2021,"Altay","Goztep","2-1",2,1,"T1",1,3,1,"H"
2021-09-17,2021,"Yeni Malatyaspor","Karagumruk SK","3-4",3,4,"T1",1,7,-1,"A"
2021-09-18,2021,"Sivasspor","Gaziantep FK","1-1",1,1,"T1",1,2,0,"D"
2021-09-18,2021,"Kasimpasa","Trabzonspor","0-1",0,1,"T1",1,1,-1,"A"
2021-09-18,2021,"Ad. Demirspor","Rizespor","3-1",3,1,"T1",1,4,2,"H"
2021-09-18,2021,"Antalyaspor","Besiktas","2-3",2,3,"T1",1,5,-1,"A"
2021-09-19,2021,"Giresunspor","Konyaspor","0-0",0,0,"T1",1,0,0,"D"
2021-09-19,2021,"Galatasaray","Alanyaspor","0-1",0,1,"T1",1,1,-1,"A"
2021-09-19,2021,"Buyuksehyr","Fenerbahce","2-0",2,0,"T1",1,2,2,"H"
2021-09-19,2021,"Hatayspor","Kayserispor","2-1",2,1,"T1",1,3,1,"H"
2021-09-21,2021,"Karagumruk SK","Antalyaspor","0-0",0,0,"T1",1,0,0,"D"
2021-09-21,2021,"Rizespor","Altay","1-2",1,2,"T1",1,3,-1,"A"
2021-09-21,2021,"Besiktas","Ad. Demirspor","3-3",3,3,"T1",1,6,0,"D"
2021-09-21,2021,"Yeni Malatyaspor","Sivasspor","0-1",0,1,"T1",1,1,-1,"A"
2021-09-22,2021,"Gaziantep FK","Buyuksehyr","1-0",1,0,"T1",1,1,1,"H"
2021-09-22,2021,"Goztep","Hatayspor","0-2",0,2,"T1",1,2,-2,"A"
2021-09-22,2021,"Kayserispor","Galatasaray","3-0",3,0,"T1",1,3,3,"H"
2021-09-23,2021,"Konyaspor","Trabzonspor","2-2",2,2,"T1",1,4,0,"D"
2021-09-23,2021,"Alanyaspor","Kasimpasa","2-0",2,0,"T1",1,2,2,"H"
2021-09-23,2021,"Fenerbahce","Giresunspor","2-1",2,1,"T1",1,3,1,"H"
2021-09-24,2021,"Altay","Besiktas","2-1",2,1,"T1",1,3,1,"H"
2021-09-25,2021,"Sivasspor","Karagumruk SK","4-0",4,0,"T1",1,4,4,"H"
2021-09-25,2021,"Antalyaspor","Yeni Malatyaspor","1-0",1,0,"T1",1,1,1,"H"
2021-09-25,2021,"Ad. Demirspor","Gaziantep FK","4-0",4,0,"T1",1,4,4,"H"
2021-09-26,2021,"Giresunspor","Kayserispor","1-1",1,1,"T1",1,2,0,"D"
2021-09-26,2021,"Buyuksehyr","Rizespor","3-0",3,0,"T1",1,3,3,"H"
2021-09-26,2021,"Hatayspor","Fenerbahce","1-2",1,2,"T1",1,3,-1,"A"
2021-09-26,2021,"Galatasaray","Goztep","2-1",2,1,"T1",1,3,1,"H"
2021-09-27,2021,"Kasimpasa","Konyaspor","2-2",2,2,"T1",1,4,0,"D"
2021-09-27,2021,"Trabzonspor","Alanyaspor","1-1",1,1,"T1",1,2,0,"D"
2021-10-01,2021,"Antalyaspor","Ad. Demirspor","1-2",1,2,"T1",1,3,-1,"A"
2021-10-01,2021,"Karagumruk SK","Buyuksehyr","3-1",3,1,"T1",1,4,2,"H"
2021-10-02,2021,"Konyaspor","Alanyaspor","1-1",1,1,"T1",1,2,0,"D"
2021-10-02,2021,"Goztep","Giresunspor","0-1",0,1,"T1",1,1,-1,"A"
2021-10-02,2021,"Kayserispor","Trabzonspor","1-2",1,2,"T1",1,3,-1,"A"
2021-10-02,2021,"Besiktas","Sivasspor","2-1",2,1,"T1",1,3,1,"H"
2021-10-03,2021,"Yeni Malatyaspor","Hatayspor","0-2",0,2,"T1",1,2,-2,"A"
2021-10-03,2021,"Fenerbahce","Kasimpasa","2-1",2,1,"T1",1,3,1,"H"
2021-10-03,2021,"Gaziantep FK","Altay","4-1",4,1,"T1",1,5,3,"H"
2021-10-03,2021,"Rizespor","Galatasaray","2-3",2,3,"T1",1,5,-1,"A"
2021-10-15,2021,"Buyuksehyr","Besiktas","3-2",3,2,"T1",1,5,1,"H"
2021-10-16,2021,"Giresunspor","Rizespor","2-0",2,0,"T1",1,2,2,"H"
2021-10-16,2021,"Sivasspor","Antalyaspor","2-2",2,2,"T1",1,4,0,"D"
2021-10-16,2021,"Ad. Demirspor","Yeni Malatyaspor","0-2",0,2,"T1",1,2,-2,"A"
2021-10-17,2021,"Kasimpasa","Goztep","1-2",1,2,"T1",1,3,-1,"A"
2021-10-17,2021,"Altay","Karagumruk SK","0-1",0,1,"T1",1,1,-1,"A"
2021-10-17,2021,"Galatasaray","Konyaspor","1-0",1,0,"T1",1,1,1,"H"
2021-10-17,2021,"Trabzonspor","Fenerbahce","3-1",3,1,"T1",1,4,2,"H"
2021-10-18,2021,"Alanyaspor","Kayserispor","6-3",6,3,"T1",1,9,3,"H"
2021-10-18,2021,"Hatayspor","Gaziantep FK","2-1",2,1,"T1",1,3,1,"H"
2021-10-22,2021,"Yeni Malatyaspor","Altay","2-1",2,1,"T1",1,3,1,"H"
2021-10-23,2021,"Rizespor","Kasimpasa","2-1",2,1,"T1",1,3,1,"H"
2021-10-23,2021,"Gaziantep FK","Giresunspor","1-1",1,1,"T1",1,2,0,"D"
2021-10-23,2021,"Konyaspor","Kayserispor","2-0",2,0,"T1",1,2,2,"H"
2021-10-23,2021,"Goztep","Trabzonspor","0-1",0,1,"T1",1,1,-1,"A"
2021-10-24,2021,"Karagumruk SK","Hatayspor","1-1",1,1,"T1",1,2,0,"D"
2021-10-24,2021,"Antalyaspor","Buyuksehyr","1-2",1,2,"T1",1,3,-1,"A"
2021-10-24,2021,"Sivasspor","Ad. Demirspor","1-1",1,1,"T1",1,2,0,"D"
2021-10-24,2021,"Fenerbahce","Alanyaspor","1-2",1,2,"T1",1,3,-1,"A"
2021-10-25,2021,"Besiktas","Galatasaray","2-1",2,1,"T1",1,3,1,"H"
2021-10-29,2021,"Trabzonspor","Rizespor","2-1",2,1,"T1",1,3,1,"H"
2021-10-30,2021,"Kasimpasa","Yeni Malatyaspor","2-0",2,0,"T1",1,2,2,"H"
2021-10-30,2021,"Altay","Sivasspor","1-1",1,1,"T1",1,2,0,"D"
2021-10-30,2021,"Hatayspor","Besiktas","1-0",1,0,"T1",1,1,1,"H"
2021-10-30,2021,"Konyaspor","Fenerbahce","2-1",2,1,"T1",1,3,1,"H"
2021-10-31,2021,"Kayserispor","Karagumruk SK","2-1",2,1,"T1",1,3,1,"H"
2021-10-31,2021,"Alanyaspor","Goztep","2-2",2,2,"T1",1,4,0,"D"
2021-10-31,2021,"Galatasaray","Gaziantep FK","2-0",2,0,"T1",1,2,2,"H"
2021-11-01,2021,"Buyuksehyr","Ad. Demirspor","2-1",2,1,"T1",1,3,1,"H"
2021-11-01,2021,"Giresunspor","Antalyaspor","1-2",1,2,"T1",1,3,-1,"A"
2021-11-05,2021,"Gaziantep FK","Kasimpasa","2-0",2,0,"T1",1,2,2,"H"
2021-11-05,2021,"Rizespor","Alanyaspor","2-0",2,0,"T1",1,2,2,"H"
2021-11-06,2021,"Sivasspor","Giresunspor","0-0",0,0,"T1",1,0,0,"D"
2021-11-06,2021,"Antalyaspor","Altay","1-0",1,0,"T1",1,1,1,"H"
2021-11-06,2021,"Yeni Malatyaspor","Buyuksehyr","1-3",1,3,"T1",1,4,-2,"A"
2021-11-06,2021,"Besiktas","Trabzonspor","1-2",1,2,"T1",1,3,-1,"A"
2021-11-07,2021,"Goztep","Konyaspor","0-2",0,2,"T1",1,2,-2,"A"
2021-11-07,2021,"Ad. Demirspor","Hatayspor","1-0",1,0,"T1",1,1,1,"H"
2021-11-07,2021,"Karagumruk SK","Galatasaray","1-1",1,1,"T1",1,2,0,"D"
2021-11-07,2021,"Fenerbahce","Kayserispor","2-2",2,2,"T1",1,4,0,"D"
2021-11-20,2021,"Hatayspor","Antalyaspor","3-1",3,1,"T1",1,4,2,"H"
2021-11-20,2021,"Buyuksehyr","Sivasspor","2-1",2,1,"T1",1,3,1,"H"
2021-11-20,2021,"Giresunspor","Yeni Malatyaspor","1-0",1,0,"T1",1,1,1,"H"
2021-11-20,2021,"Alanyaspor","Besiktas","2-0",2,0,"T1",1,2,2,"H"
2021-11-21,2021,"Kasimpasa","Karagumruk SK","1-3",1,3,"T1",1,4,-2,"A"
2021-11-21,2021,"Altay","Ad. Demirspor","1-3",1,3,"T1",1,4,-2,"A"
2021-11-21,2021,"Konyaspor","Rizespor","3-0",3,0,"T1",1,3,3,"H"
2021-11-21,2021,"Galatasaray","Fenerbahce","1-2",1,2,"T1",1,3,-1,"A"
2021-11-22,2021,"Kayserispor","Goztep","1-1",1,1,"T1",1,2,0,"D"
2021-11-22,2021,"Trabzonspor","Gaziantep FK","3-0",3,0,"T1",1,3,3,"H"
2021-11-26,2021,"Ad. Demirspor","Kasimpasa","0-0",0,0,"T1",1,0,0,"D"
2021-11-26,2021,"Buyuksehyr","Altay","0-0",0,0,"T1",1,0,0,"D"
2021-11-27,2021,"Antalyaspor","Alanyaspor","3-0",3,0,"T1",1,3,3,"H"
2021-11-27,2021,"Rizespor","Kayserispor","1-0",1,0,"T1",1,1,1,"H"
2021-11-27,2021,"Besiktas","Giresunspor","0-4",0,4,"T1",1,4,-4,"A"
2021-11-28,2021,"Gaziantep FK","Konyaspor","3-2",3,2,"T1",1,5,1,"H"
2021-11-28,2021,"Karagumruk SK","Trabzonspor","0-2",0,2,"T1",1,2,-2,"A"
2021-11-28,2021,"Sivasspor","Hatayspor","4-0",4,0,"T1",1,4,4,"H"
2021-11-28,2021,"Yeni Malatyaspor","Galatasaray","0-0",0,0,"T1",1,0,0,"D"
2021-11-29,2021,"Goztep","Fenerbahce","1-1",1,1,"T1",1,2,0,"D"
2021-12-03,2021,"Kasimpasa","Besiktas","1-1",1,1,"T1",1,2,0,"D"
2021-12-04,2021,"Alanyaspor","Sivasspor","0-1",0,1,"T1",1,1,-1,"A"
2021-12-04,2021,"Trabzonspor","Ad. Demirspor","2-0",2,0,"T1",1,2,2,"H"
2021-12-04,2021,"Galatasaray","Altay","2-2",2,2,"T1",1,4,0,"D"
2021-12-05,2021,"Kayserispor","Antalyaspor","2-0",2,0,"T1",1,2,2,"H"
2021-12-05,2021,"Giresunspor","Karagumruk SK","3-1",3,1,"T1",1,4,2,"H"
2021-12-05,2021,"Hatayspor","Buyuksehyr","0-3",0,3,"T1",1,3,-3,"A"
2021-12-05,2021,"Fenerbahce","Rizespor","4-0",4,0,"T1",1,4,4,"H"
2021-12-06,2021,"Goztep","Gaziantep FK","2-1",2,1,"T1",1,3,1,"H"
2021-12-06,2021,"Konyaspor","Yeni Malatyaspor","0-0",0,0,"T1",1,0,0,"D"
2021-12-10,2021,"Altay","Hatayspor","1-2",1,2,"T1",1,3,-1,"A"
2021-12-11,2021,"Karagumruk SK","Konyaspor","1-4",1,4,"T1",1,5,-3,"A"
2021-12-11,2021,"Buyuksehyr","Kasimpasa","2-1",2,1,"T1",1,3,1,"H"
2021-12-11,2021,"Rizespor","Goztep","3-1",3,1,"T1",1,4,2,"H"
2021-12-11,2021,"Antalyaspor","Trabzonspor","2-1",2,1,"T1",1,3,1,"H"
2021-12-12,2021,"Ad. Demirspor","Giresunspor","1-0",1,0,"T1",1,1,1,"H"
2021-12-12,2021,"Yeni Malatyaspor","Alanyaspor","2-6",2,6,"T1",1,8,-4,"A"
2021-12-12,2021,"Besiktas","Kayserispor","4-2",4,2,"T1",1,6,2,"H"
2021-12-13,2021,"Sivasspor","Galatasaray","1-0",1,0,"T1",1,1,1,"H"
2021-12-13,2021,"Gaziantep FK","Fenerbahce","3-2",3,2,"T1",1,5,1,"H"
2021-12-17,2021,"Giresunspor","Altay","3-1",3,1,"T1",1,4,2,"H"
2021-12-18,2021,"Kasimpasa","Sivasspor","1-3",1,3,"T1",1,4,-2,"A"
2021-12-18,2021,"Konyaspor","Antalyaspor","1-0",1,0,"T1",1,1,1,"H"
2021-12-18,2021,"Trabzonspor","Hatayspor","2-0",2,0,"T1",1,2,2,"H"
2021-12-18,2021,"Alanyaspor","Ad. Demirspor","1-3",1,3,"T1",1,4,-2,"A"
2021-12-18,2021,"Galatasaray","Buyuksehyr","1-1",1,1,"T1",1,2,0,"D"
2021-12-19,2021,"Rizespor","Yeni Malatyaspor","1-0",1,0,"T1",1,1,1,"H"
2021-12-19,2021,"Goztep","Karagumruk SK","0-1",0,1,"T1",1,1,-1,"A"
2021-12-19,2021,"Kayserispor","Gaziantep FK","0-0",0,0,"T1",1,0,0,"D"
2021-12-19,2021,"Fenerbahce","Besiktas","2-2",2,2,"T1",1,4,0,"D"
2021-12-21,2021,"Antalyaspor","Kasimpasa","1-1",1,1,"T1",1,2,0,"D"
2021-12-21,2021,"Buyuksehyr","Giresunspor","3-1",3,1,"T1",1,4,2,"H"
2021-12-21,2021,"Ad. Demirspor","Galatasaray","2-0",2,0,"T1",1,2,2,"H"
2021-12-21,2021,"Altay","Trabzonspor","1-2",1,2,"T1",1,3,-1,"A"
2021-12-22,2021,"Hatayspor","Konyaspor","1-3",1,3,"T1",1,4,-2,"A"
2021-12-22,2021,"Sivasspor","Rizespor","1-1",1,1,"T1",1,2,0,"D"
2021-12-22,2021,"Gaziantep FK","Alanyaspor","2-1",2,1,"T1",1,3,1,"H"
2021-12-22,2021,"Karagumruk SK","Fenerbahce","1-1",1,1,"T1",1,2,0,"D"
2021-12-23,2021,"Yeni Malatyaspor","Kayserispor","2-2",2,2,"T1",1,4,0,"D"
2021-12-23,2021,"Besiktas","Goztep","2-1",2,1,"T1",1,3,1,"H"
2021-12-25,2021,"Kasimpasa","Altay","2-0",2,0,"T1",1,2,2,"H"
2021-12-25,2021,"Galatasaray","Antalyaspor","2-0",2,0,"T1",1,2,2,"H"
2021-12-25,2021,"Giresunspor","Hatayspor","0-1",0,1,"T1",1,1,-1,"A"
2021-12-25,2021,"Trabzonspor","Buyuksehyr","0-0",0,0,"T1",1,0,0,"D"
2021-12-26,2021,"Rizespor","Gaziantep FK","0-1",0,1,"T1",1,1,-1,"A"
2021-12-26,2021,"Alanyaspor","Karagumruk SK","1-1",1,1,"T1",1,2,0,"D"
2021-12-26,2021,"Goztep","Ad. Demirspor","1-1",1,1,"T1",1,2,0,"D"
2021-12-26,2021,"Fenerbahce","Yeni Malatyaspor","2-0",2,0,"T1",1,2,2,"H"
2021-12-27,2021,"Kayserispor","Sivasspor","3-0",3,0,"T1",1,3,3,"H"
2021-12-27,2021,"Konyaspor","Besiktas","1-0",1,0,"T1",1,1,1,"H"
2022-01-07,2021,"Trabzonspor","Yeni Malatyaspor","1-0",1,0,"T1",1,1,1,"H"
2022-01-08,2021,"Gaziantep FK","Karagumruk SK","3-1",3,1,"T1",1,4,2,"H"
2022-01-08,2021,"Alanyaspor","Buyuksehyr","1-1",1,1,"T1",1,2,0,"D"
2022-01-08,2021,"Kasimpasa","Hatayspor","3-1",3,1,"T1",1,4,2,"H"
2022-01-08,2021,"Galatasaray","Giresunspor","0-1",0,1,"T1",1,1,-1,"A"
2022-01-09,2021,"Konyaspor","Sivasspor","0-1",0,1,"T1",1,1,-1,"A"
2022-01-09,2021,"Goztep","Antalyaspor","4-0",4,0,"T1",1,4,4,"H"
2022-01-09,2021,"Kayserispor","Altay","1-0",1,0,"T1",1,1,1,"H"
2022-01-09,2021,"Rizespor","Besiktas","2-2",2,2,"T1",1,4,0,"D"
2022-01-10,2021,"Fenerbahce","Ad. Demirspor","1-2",1,2,"T1",1,3,-1,"A"
2022-01-14,2021,"Besiktas","Gaziantep FK","1-0",1,0,"T1",1,1,1,"H"
2022-01-14,2021,"Yeni Malatyaspor","Goztep","1-2",1,2,"T1",1,3,-1,"A"
2022-01-15,2021,"Ad. Demirspor","Kayserispor","1-1",1,1,"T1",1,2,0,"D"
2022-01-15,2021,"Karagumruk SK","Rizespor","2-0",2,0,"T1",1,2,2,"H"
2022-01-15,2021,"Sivasspor","Trabzonspor","1-1",1,1,"T1",1,2,0,"D"
2022-01-15,2021,"Antalyaspor","Fenerbahce","1-1",1,1,"T1",1,2,0,"D"
2022-01-16,2021,"Altay","Alanyaspor","0-2",0,2,"T1",1,2,-2,"A"
2022-01-16,2021,"Giresunspor","Kasimpasa","0-2",0,2,"T1",1,2,-2,"A"
2022-01-16,2021,"Hatayspor","Galatasaray","4-2",4,2,"T1",1,6,2,"H"
2022-01-18,2021,"Karagumruk SK","Besiktas","0-1",0,1,"T1",1,1,-1,"A"
2022-01-18,2021,"Konyaspor","Ad. Demirspor","1-0",1,0,"T1",1,1,1,"H"
2022-01-19,2021,"Goztep","Sivasspor","2-1",2,1,"T1",1,3,1,"H"
2022-01-19,2021,"Kayserispor","Buyuksehyr","1-0",1,0,"T1",1,1,1,"H"
2022-01-19,2021,"Fenerbahce","Altay","2-1",2,1,"T1",1,3,1,"H"
2022-01-19,2021,"Trabzonspor","Giresunspor","1-1",1,1,"T1",1,2,0,"D"
2022-01-20,2021,"Alanyaspor","Hatayspor","6-0",6,0,"T1",1,6,6,"H"
2022-01-20,2021,"Rizespor","Antalyaspor","2-1",2,1,"T1",1,3,1,"H"
2022-01-20,2021,"Galatasaray","Kasimpasa","1-3",1,3,"T1",1,4,-2,"A"
2022-01-22,2021,"Yeni Malatyaspor","Besiktas","1-1",1,1,"T1",1,2,0,"D"
2022-01-22,2021,"Ad. Demirspor","Karagumruk SK","5-0",5,0,"T1",1,5,5,"H"
2022-01-22,2021,"Sivasspor","Fenerbahce","1-1",1,1,"T1",1,2,0,"D"
2022-01-22,2021,"Buyuksehyr","Goztep","1-2",1,2,"T1",1,3,-1,"A"
2022-01-23,2021,"Hatayspor","Rizespor","0-0",0,0,"T1",1,0,0,"D"
2022-01-23,2021,"Kasimpasa","Kayserispor","3-1",3,1,"T1",1,4,2,"H"
2022-01-23,2021,"Altay","Konyaspor","0-1",0,1,"T1",1,1,-1,"A"
2022-01-23,2021,"Antalyaspor","Gaziantep FK","0-0",0,0,"T1",1,0,0,"D"
2022-01-23,2021,"Giresunspor","Alanyaspor","1-3",1,3,"T1",1,4,-2,"A"
2022-01-23,2021,"Galatasaray","Trabzonspor","1-2",1,2,"T1",1,3,-1,"A"
2022-02-04,2021,"Kayserispor","Hatayspor","4-3",4,3,"T1",1,7,1,"H"
2022-02-04,2021,"Konyaspor","Giresunspor","1-0",1,0,"T1",1,1,1,"H"
2022-02-05,2021,"Gaziantep FK","Sivasspor","5-1",5,1,"T1",1,6,4,"H"
2022-02-05,2021,"Karagumruk SK","Yeni Malatyaspor","1-0",1,0,"T1",1,1,1,"H"
2022-02-05,2021,"Trabzonspor","Kasimpasa","1-0",1,0,"T1",1,1,1,"H"
2022-02-05,2021,"Fenerbahce","Buyuksehyr","0-1",0,1,"T1",1,1,-1,"A"
2022-02-06,2021,"Alanyaspor","Galatasaray","1-1",1,1,"T1",1,2,0,"D"
2022-02-06,2021,"Rizespor","Ad. Demirspor","1-3",1,3,"T1",1,4,-2,"A"
2022-02-06,2021,"Besiktas","Antalyaspor","0-0",0,0,"T1",1,0,0,"D"
2022-02-06,2021,"Goztep","Altay","0-2",0,2,"T1",1,2,-2,"A"
2022-02-11,2021,"Altay","Rizespor","0-0",0,0,"T1",1,0,0,"D"
2022-02-12,2021,"Buyuksehyr","Gaziantep FK","2-0",2,0,"T1",1,2,2,"H"
2022-02-12,2021,"Giresunspor","Fenerbahce","1-2",1,2,"T1",1,3,-1,"A"
2022-02-12,2021,"Galatasaray","Kayserispor","1-1",1,1,"T1",1,2,0,"D"
2022-02-13,2021,"Sivasspor","Yeni Malatyaspor","2-1",2,1,"T1",1,3,1,"H"
2022-02-13,2021,"Antalyaspor","Karagumruk SK","3-0",3,0,"T1",1,3,3,"H"
2022-02-13,2021,"Kasimpasa","Alanyaspor","2-2",2,2,"T1",1,4,0,"D"
2022-02-13,2021,"Trabzonspor","Konyaspor","2-1",2,1,"T1",1,3,1,"H"
2022-02-14,2021,"Ad. Demirspor","Besiktas","1-1",1,1,"T1",1,2,0,"D"
2022-02-14,2021,"Hatayspor","Goztep","2-1",2,1,"T1",1,3,1,"H"
2022-02-18,2021,"Konyaspor","Kasimpasa","4-4",4,4,"T1",1,8,0,"D"
2022-02-18,2021,"Rizespor","Buyuksehyr","0-2",0,2,"T1",1,2,-2,"A"
2022-02-19,2021,"Yeni Malatyaspor","Antalyaspor","1-2",1,2,"T1",1,3,-1,"A"
2022-02-19,2021,"Kayserispor","Giresunspor","2-1",2,1,"T1",1,3,1,"H"
2022-02-19,2021,"Besiktas","Altay","1-0",1,0,"T1",1,1,1,"H"
2022-02-20,2021,"Gaziantep FK","Ad. Demirspor","0-3",0,3,"T1",1,3,-3,"A"
2022-02-20,2021,"Alanyaspor","Trabzonspor","0-4",0,4,"T1",1,4,-4,"A"
2022-02-20,2021,"Karagumruk SK","Sivasspor","1-0",1,0,"T1",1,1,1,"H"
2022-02-20,2021,"Fenerbahce","Hatayspor","2-0",2,0,"T1",1,2,2,"H"
2022-02-21,2021,"Goztep","Galatasaray","2-3",2,3,"T1",1,5,-1,"A"
2022-02-23,2021,"Gaziantep FK","Yeni Malatyaspor","0-0",0,0,"T1",1,0,0,"D"
2022-02-22,2021,"Buyuksehyr","Konyaspor","2-1",2,1,"T1",1,3,1,"H"
2022-02-25,2021,"Ad. Demirspor","Antalyaspor","0-0",0,0,"T1",1,0,0,"D"
2022-02-25,2021,"Trabzonspor","Kayserispor","3-2",3,2,"T1",1,5,1,"H"
2022-02-26,2021,"Buyuksehyr","Karagumruk SK","1-2",1,2,"T1",1,3,-1,"A"
2022-02-26,2021,"Sivasspor","Besiktas","2-3",2,3,"T1",1,5,-1,"A"
2022-02-27,2021,"Altay","Gaziantep FK","3-2",3,2,"T1",1,5,1,"H"
2022-02-27,2021,"Giresunspor","Goztep","3-1",3,1,"T1",1,4,2,"H"
2022-02-27,2021,"Alanyaspor","Konyaspor","5-1",5,1,"T1",1,6,4,"H"
2022-02-27,2021,"Hatayspor","Yeni Malatyaspor","5-2",5,2,"T1",1,7,3,"H"
2022-02-27,2021,"Galatasaray","Rizespor","4-2",4,2,"T1",1,6,2,"H"
2022-02-28,2021,"Kasimpasa","Fenerbahce","1-2",1,2,"T1",1,3,-1,"A"
2022-03-04,2021,"Yeni Malatyaspor","Ad. Demirspor","1-0",1,0,"T1",1,1,1,"H"
2022-03-05,2021,"Goztep","Kasimpasa","2-3",2,3,"T1",1,5,-1,"A"
2022-03-05,2021,"Rizespor","Giresunspor","1-2",1,2,"T1",1,3,-1,"A"
2022-03-05,2021,"Konyaspor","Galatasaray","2-0",2,0,"T1",1,2,2,"H"
2022-03-06,2021,"Karagumruk SK","Altay","0-0",0,0,"T1",1,0,0,"D"
2022-03-06,2021,"Antalyaspor","Sivasspor","1-0",1,0,"T1",1,1,1,"H"
2022-03-06,2021,"Fenerbahce","Trabzonspor","1-1",1,1,"T1",1,2,0,"D"
2022-03-07,2021,"Besiktas","Buyuksehyr","2-2",2,2,"T1",1,4,0,"D"
2022-03-07,2021,"Gaziantep FK","Hatayspor","2-2",2,2,"T1",1,4,0,"D"
2022-03-07,2021,"Kayserispor","Alanyaspor","1-2",1,2,"T1",1,3,-1,"A"
2022-03-12,2021,"Hatayspor","Karagumruk SK","3-0",3,0,"T1",1,3,3,"H"
2022-03-12,2021,"Altay","Yeni Malatyaspor","1-0",1,0,"T1",1,1,1,"H"
2022-03-12,2021,"Kasimpasa","Rizespor","3-1",3,1,"T1",1,4,2,"H"
2022-03-12,2021,"Trabzonspor","Goztep","4-2",4,2,"T1",1,6,2,"H"
2022-03-13,2021,"Kayserispor","Konyaspor","2-3",2,3,"T1",1,5,-1,"A"
2022-03-13,2021,"Ad. Demirspor","Sivasspor","2-3",2,3,"T1",1,5,-1,"A"
2022-03-13,2021,"Alanyaspor","Fenerbahce","2-5",2,5,"T1",1,7,-3,"A"
2022-03-14,2021,"Buyuksehyr","Antalyaspor","0-1",0,1,"T1",1,1,-1,"A"
2022-03-14,2021,"Galatasaray","Besiktas","2-1",2,1,"T1",1,3,1,"H"
2022-03-14,2021,"Giresunspor","Gaziantep FK","2-1",2,1,"T1",1,3,1,"H"
2022-03-18,2021,"Karagumruk SK","Kayserispor","3-0",3,0,"T1",1,3,3,"H"
2022-03-18,2021,"Rizespor","Trabzonspor","3-2",3,2,"T1",1,5,1,"H"
2022-03-19,2021,"Yeni Malatyaspor","Kasimpasa","0-2",0,2,"T1",1,2,-2,"A"
2022-03-19,2021,"Ad. Demirspor","Buyuksehyr","2-1",2,1,"T1",1,3,1,"H"
2022-03-19,2021,"Goztep","Alanyaspor","0-2",0,2,"T1",1,2,-2,"A"
2022-03-19,2021,"Besiktas","Hatayspor","1-1",1,1,"T1",1,2,0,"D"
2022-03-20,2021,"Antalyaspor","Giresunspor","4-1",4,1,"T1",1,5,3,"H"
2022-03-20,2021,"Sivasspor","Altay","2-1",2,1,"T1",1,3,1,"H"
2022-03-20,2021,"Gaziantep FK","Galatasaray","3-1",3,1,"T1",1,4,2,"H"
2022-03-20,2021,"Fenerbahce","Konyaspor","2-1",2,1,"T1",1,3,1,"H"
2022-04-02,2021,"Giresunspor","Sivasspor","2-2",2,2,"T1",1,4,0,"D"
2022-04-02,2021,"Altay","Antalyaspor","1-2",1,2,"T1",1,3,-1,"A"
2022-04-02,2021,"Kayserispor","Fenerbahce","0-4",0,4,"T1",1,4,-4,"A"
2022-04-02,2021,"Galatasaray","Karagumruk SK","2-0",2,0,"T1",1,2,2,"H"
2022-04-03,2021,"Kasimpasa","Gaziantep FK","2-1",2,1,"T1",1,3,1,"H"
2022-04-03,2021,"Alanyaspor","Rizespor","2-1",2,1,"T1",1,3,1,"H"
2022-04-03,2021,"Konyaspor","Goztep","3-0",3,0,"T1",1,3,3,"H"
2022-04-03,2021,"Trabzonspor","Besiktas","1-1",1,1,"T1",1,2,0,"D"
2022-04-04,2021,"Buyuksehyr","Yeni Malatyaspor","1-0",1,0,"T1",1,1,1,"H"
2022-04-04,2021,"Hatayspor","Ad. Demirspor","0-0",0,0,"T1",1,0,0,"D"
2022-04-09,2021,"Karagumruk SK","Kasimpasa","3-2",3,2,"T1",1,5,1,"H"
2022-04-09,2021,"Goztep","Kayserispor","1-2",1,2,"T1",1,3,-1,"A"
2022-04-09,2021,"Rizespor","Konyaspor","2-1",2,1,"T1",1,3,1,"H"
2022-04-09,2021,"Besiktas","Alanyaspor","4-1",4,1,"T1",1,5,3,"H"
2022-04-09,2021,"Gaziantep FK","Trabzonspor","0-0",0,0,"T1",1,0,0,"D"
2022-04-10,2021,"Yeni Malatyaspor","Giresunspor","0-1",0,1,"T1",1,1,-1,"A"
2022-04-10,2021,"Ad. Demirspor","Altay","3-1",3,1,"T1",1,4,2,"H"
2022-04-10,2021,"Sivasspor","Buyuksehyr","0-2",0,2,"T1",1,2,-2,"A"
2022-04-10,2021,"Fenerbahce","Galatasaray","2-0",2,0,"T1",1,2,2,"H"
2022-04-11,2021,"Antalyaspor","Hatayspor","4-1",4,1,"T1",1,5,3,"H"
2022-04-15,2021,"Kayserispor","Rizespor","1-1",1,1,"T1",1,2,0,"D"
2022-04-15,2021,"Trabzonspor","Karagumruk SK","1-1",1,1,"T1",1,2,0,"D"
2022-04-16,2021,"Hatayspor","Sivasspor","1-1",1,1,"T1",1,2,0,"D"
2022-04-16,2021,"Alanyaspor","Antalyaspor","1-3",1,3,"T1",1,4,-2,"A"
2022-04-16,2021,"Altay","Buyuksehyr","1-1",1,1,"T1",1,2,0,"D"
2022-04-16,2021,"Fenerbahce","Goztep","2-0",2,0,"T1",1,2,2,"H"
2022-04-17,2021,"Konyaspor","Gaziantep FK","4-1",4,1,"T1",1,5,3,"H"
2022-04-17,2021,"Kasimpasa","Ad. Demirspor","4-0",4,0,"T1",1,4,4,"H"
2022-04-17,2021,"Giresunspor","Besiktas","0-0",0,0,"T1",1,0,0,"D"
2022-04-18,2021,"Galatasaray","Yeni Malatyaspor","2-0",2,0,"T1",1,2,2,"H"
2022-04-22,2021,"Rizespor","Fenerbahce","0-6",0,6,"T1",1,6,-6,"A"
2022-04-23,2021,"Gaziantep FK","Goztep","1-1",1,1,"T1",1,2,0,"D"
2022-04-23,2021,"Karagumruk SK","Giresunspor","2-1",2,1,"T1",1,3,1,"H"
2022-04-23,2021,"Ad. Demirspor","Trabzonspor","1-3",1,3,"T1",1,4,-2,"A"
2022-04-24,2021,"Buyuksehyr","Hatayspor","3-0",3,0,"T1",1,3,3,"H"
2022-04-24,2021,"Yeni Malatyaspor","Konyaspor","2-3",2,3,"T1",1,5,-1,"A"
2022-04-24,2021,"Altay","Galatasaray","0-1",0,1,"T1",1,1,-1,"A"
2022-04-24,2021,"Antalyaspor","Kayserispor","1-1",1,1,"T1",1,2,0,"D"
2022-04-25,2021,"Besiktas","Kasimpasa","0-3",0,3,"T1",1,3,-3,"A"
2022-04-25,2021,"Sivasspor","Alanyaspor","1-0",1,0,"T1",1,1,1,"H"
2022-04-29,2021,"Fenerbahce","Gaziantep FK","3-2",3,2,"T1",1,5,1,"H"
2022-04-29,2021,"Giresunspor","Ad. Demirspor","2-0",2,0,"T1",1,2,2,"H"
2022-04-30,2021,"Kasimpasa","Buyuksehyr","2-3",2,3,"T1",1,5,-1,"A"
2022-04-30,2021,"Konyaspor","Karagumruk SK","1-2",1,2,"T1",1,3,-1,"A"
2022-04-30,2021,"Hatayspor","Altay","0-1",0,1,"T1",1,1,-1,"A"
2022-04-30,2021,"Trabzonspor","Antalyaspor","2-2",2,2,"T1",1,4,0,"D"
2022-05-01,2021,"Alanyaspor","Yeni Malatyaspor","2-1",2,1,"T1",1,3,1,"H"
2022-05-01,2021,"Kayserispor","Besiktas","2-3",2,3,"T1",1,5,-1,"A"
2022-05-01,2021,"Galatasaray","Sivasspor","2-3",2,3,"T1",1,5,-1,"A"
2022-05-01,2021,"Goztep","Rizespor","1-7",1,7,"T1",1,8,-6,"A"
2022-05-06,2021,"Gaziantep FK","Kayserispor","1-1",1,1,"T1",1,2,0,"D"
2022-05-06,2021,"Hatayspor","Trabzonspor","1-1",1,1,"T1",1,2,0,"D"
2022-05-07,2021,"Karagumruk SK","Goztep","3-1",3,1,"T1",1,4,2,"H"
2022-05-07,2021,"Sivasspor","Kasimpasa","1-3",1,3,"T1",1,4,-2,"A"
2022-05-07,2021,"Ad. Demirspor","Alanyaspor","1-2",1,2,"T1",1,3,-1,"A"
2022-05-07,2021,"Buyuksehyr","Galatasaray","0-0",0,0,"T1",1,0,0,"D"
2022-05-08,2021,"Altay","Giresunspor","1-1",1,1,"T1",1,2,0,"D"
2022-05-08,2021,"Yeni Malatyaspor","Rizespor","1-3",1,3,"T1",1,4,-2,"A"
2022-05-08,2021,"Besiktas","Fenerbahce","1-1",1,1,"T1",1,2,0,"D"
2022-05-09,2021,"Antalyaspor","Konyaspor","3-2",3,2,"T1",1,5,1,"H"
2022-05-14,2021,"Kayserispor","Yeni Malatyaspor","3-0",3,0,"T1",1,3,3,"H"
2022-05-15,2021,"Goztep","Besiktas","0-2",0,2,"T1",1,2,-2,"A"
2022-05-15,2021,"Trabzonspor","Altay","2-1",2,1,"T1",1,3,1,"H"
2022-05-15,2021,"Alanyaspor","Gaziantep FK","3-0",3,0,"T1",1,3,3,"H"
2022-05-15,2021,"Fenerbahce","Karagumruk SK","0-0",0,0,"T1",1,0,0,"D"
2022-05-15,2021,"Giresunspor","Buyuksehyr","1-1",1,1,"T1",1,2,0,"D"
2022-05-15,2021,"Kasimpasa","Antalyaspor","2-4",2,4,"T1",1,6,-2,"A"
2022-05-15,2021,"Konyaspor","Hatayspor","3-1",3,1,"T1",1,4,2,"H"
2022-05-16,2021,"Galatasaray","Ad. Demirspor","3-2",3,2,"T1",1,5,1,"H"
2022-05-16,2021,"Rizespor","Sivasspor","1-2",1,2,"T1",1,3,-1,"A"
2022-05-20,2021,"Antalyaspor","Galatasaray","1-1",1,1,"T1",1,2,0,"D"
2022-05-20,2021,"Gaziantep FK","Rizespor","2-0",2,0,"T1",1,2,2,"H"
2022-05-21,2021,"Altay","Kasimpasa","2-4",2,4,"T1",1,6,-2,"A"
2022-05-21,2021,"Sivasspor","Kayserispor","2-1",2,1,"T1",1,3,1,"H"
2022-05-21,2021,"Besiktas","Konyaspor","1-1",1,1,"T1",1,2,0,"D"
2022-05-21,2021,"Yeni Malatyaspor","Fenerbahce","0-5",0,5,"T1",1,5,-5,"A"
2022-05-22,2021,"Buyuksehyr","Trabzonspor","3-1",3,1,"T1",1,4,2,"H"
2022-05-22,2021,"Karagumruk SK","Alanyaspor","0-1",0,1,"T1",1,1,-1,"A"
2022-05-22,2021,"Ad. Demirspor","Goztep","7-0",7,0,"T1",1,7,7,"H"
2022-05-22,2021,"Hatayspor","Giresunspor","4-1",4,1,"T1",1,5,3,"H"
